ID,RO64,RO32,S16,E8,F4,NCG,Total
0,200,100,120,160,160,0,740
1,180,100,80,80,160,0,600
2,230,60,40,0,0,0,330
3,200,120,80,80,0,0,480
4,190,120,120,80,0,0,510
5,240,80,120,240,320,320,1320
6,200,160,200,240,160,0,960
7,240,100,40,0,0,0,380
8,200,140,80,80,160,0,660
9,190,100,160,80,160,0,690
10,190,140,40,0,0,0,370
11,250,160,160,80,0,0,650
12,210,120,120,240,160,320,1170
13,200,120,120,80,160,0,680
14,210,160,120,80,0,0,570
15,210,100,80,80,0,0,470
16,190,160,160,160,160,0,830
17,210,180,240,160,160,0,950
18,190,100,80,160,160,0,690
19,200,160,160,160,0,0,680
20,190,120,80,160,160,320,1030
21,180,120,160,80,160,0,700
22,190,140,160,240,320,0,1050
23,190,120,160,160,0,0,630
24,200,160,200,160,0,0,720
25,210,160,40,0,0,0,410
26,160,80,120,240,160,0,760
27,160,160,160,160,160,0,800
28,190,100,80,0,0,0,370
29,210,120,80,0,0,0,410
30,200,140,160,160,320,0,980
31,160,120,120,160,160,0,720
32,220,180,200,240,320,320,1480
33,170,120,80,160,320,320,1170
34,190,160,80,0,0,0,430
35,210,80,80,160,0,0,530
36,230,140,160,240,160,0,930
37,200,120,160,80,0,0,560
38,170,140,160,80,160,0,710
39,180,120,40,80,160,0,580
40,210,120,120,240,160,0,850
41,220,80,40,80,160,0,580
42,180,120,120,160,320,0,900
43,210,120,120,160,160,0,770
44,240,140,120,160,320,320,1300
45,180,80,0,0,0,0,260
46,190,120,160,240,320,0,1030
47,190,140,120,160,320,320,1250
48,180,140,160,240,320,0,1040
49,180,100,120,240,320,0,960
50,180,120,80,80,0,0,460
51,180,120,0,0,0,0,300
52,210,160,160,160,160,0,850
53,200,120,120,160,320,0,920
54,200,120,80,80,160,0,640
55,180,120,120,160,160,0,740
56,180,60,0,0,0,0,240
57,230,100,120,240,320,0,1010
58,140,120,40,0,0,0,300
59,210,140,120,0,0,0,470
60,200,80,80,80,0,0,440
61,180,100,120,160,160,0,720
62,200,100,120,160,0,0,580
63,200,120,80,80,160,0,640
64,210,100,80,80,160,0,630
65,230,80,120,160,160,0,750
66,170,80,80,80,160,0,570
67,170,100,120,160,320,320,1190
68,170,100,40,80,160,0,550
69,200,160,160,240,160,0,920
70,210,200,240,160,160,0,970
71,150,100,160,240,160,0,810
72,160,40,80,160,320,0,760
73,220,100,0,0,0,0,320
74,200,160,40,80,160,320,960
75,180,120,40,0,0,0,340
76,170,80,120,160,160,0,690
77,190,120,80,160,160,0,710
78,250,160,200,160,320,0,1090
79,180,140,120,160,160,0,760
80,180,100,120,240,0,0,640
81,240,80,80,0,0,0,400
82,210,160,120,0,0,0,490
83,170,100,120,80,160,0,630
84,180,120,120,160,160,0,740
85,190,80,40,80,0,0,390
86,190,120,120,160,160,0,750
87,190,100,40,80,0,0,410
88,170,100,40,80,0,0,390
89,250,140,160,160,320,320,1350
90,220,120,80,80,160,320,980
91,180,100,80,160,160,0,680
92,170,120,160,160,160,0,770
93,210,120,40,80,0,0,450
94,210,160,200,160,160,320,1210
95,180,160,120,240,320,0,1020
96,200,140,120,160,160,0,780
97,210,160,120,160,160,0,810
98,180,160,120,160,160,0,780
99,230,160,80,80,0,0,550
100,230,100,80,160,320,0,890
101,200,100,80,80,0,0,460
102,200,120,80,0,0,0,400
103,180,140,80,80,160,0,640
104,180,140,200,240,320,0,1080
105,190,60,40,0,0,0,290
106,220,80,40,80,0,0,420
107,200,60,40,80,160,0,540
108,170,100,80,80,0,0,430
109,200,80,80,0,0,0,360
110,200,100,160,80,0,0,540
111,180,160,160,160,160,0,820
112,230,140,160,240,0,0,770
113,180,140,120,0,0,0,440
114,190,140,160,160,160,0,810
115,240,160,160,80,0,0,640
116,220,120,80,160,0,0,580
117,150,120,160,240,160,0,830
118,160,80,80,80,0,0,400
119,190,120,80,0,0,0,390
120,250,100,40,0,0,0,390
121,230,100,120,160,160,0,770
122,210,140,40,80,0,0,470
123,180,160,200,80,160,0,780
124,210,160,120,240,160,0,890
125,210,120,120,80,160,0,690
126,230,140,80,80,160,0,690
127,240,140,160,0,0,0,540
128,200,140,160,160,160,0,820
129,200,140,160,0,0,0,500
130,160,60,80,0,0,0,300
131,180,140,80,80,0,0,480
132,210,120,160,80,160,320,1050
133,170,120,160,160,160,0,770
134,180,80,40,0,0,0,300
135,190,100,40,80,160,0,570
136,160,120,80,160,0,0,520
137,180,100,40,0,0,0,320
138,180,140,160,80,0,0,560
139,190,120,120,160,160,0,750
140,190,140,80,80,160,0,650
141,230,160,160,80,160,0,790
142,170,60,80,160,160,0,630
143,210,100,40,0,0,0,350
144,210,140,160,80,0,0,590
145,190,140,160,160,320,320,1290
146,220,120,120,160,160,0,780
147,170,60,80,0,0,0,310
148,200,140,120,0,0,0,460
149,200,120,160,160,160,0,800
150,180,120,120,160,160,0,740
151,180,120,160,240,320,320,1340
152,230,120,120,80,0,0,550
153,230,160,160,80,0,0,630
154,240,140,160,80,160,0,780
155,200,60,120,160,0,0,540
156,190,120,80,80,0,0,470
157,170,120,160,80,160,0,690
158,180,80,40,0,0,0,300
159,190,100,80,160,160,0,690
160,210,120,120,80,160,0,690
161,210,120,80,80,160,0,650
162,210,80,120,160,160,0,730
163,170,120,160,80,160,0,690
164,170,80,120,240,320,0,930
165,190,180,160,80,160,0,770
166,170,140,200,240,320,0,1070
167,220,140,160,80,160,0,760
168,170,80,80,80,160,0,570
169,200,100,80,80,160,0,620
170,170,160,120,160,0,0,610
171,180,100,80,0,0,0,360
172,210,120,80,160,160,0,730
173,170,140,0,0,0,0,310
174,240,160,160,160,160,0,880
175,210,140,120,160,160,320,1110
176,170,140,40,0,0,0,350
177,170,80,80,80,160,0,570
178,210,60,80,80,160,0,590
179,180,100,120,160,160,0,720
180,140,100,200,80,160,0,680
181,180,100,40,80,0,0,400
182,220,160,160,160,320,320,1340
183,170,140,80,80,160,0,630
184,190,100,80,0,0,0,370
185,230,100,40,80,0,0,450
186,180,120,40,80,160,320,900
187,170,100,40,0,0,0,310
188,200,100,80,80,0,0,460
189,190,160,160,160,320,0,990
190,180,180,200,0,0,0,560
191,180,120,120,80,160,0,660
192,190,140,120,80,160,0,690
193,210,140,40,0,0,0,390
194,220,120,120,240,320,320,1340
195,220,140,160,240,320,0,1080
196,240,120,120,160,160,0,800
197,150,40,40,0,0,0,230
198,200,120,80,160,320,320,1200
199,230,120,160,160,160,0,830
200,210,120,40,80,160,0,610
201,190,140,160,160,0,0,650
202,240,160,120,80,0,0,600
203,220,100,80,0,0,0,400
204,200,80,80,80,0,0,440
205,200,160,120,160,320,0,960
206,240,140,120,80,160,0,740
207,170,80,120,160,320,320,1170
208,210,100,120,160,320,0,910
209,180,100,120,160,160,0,720
210,220,120,40,80,0,0,460
211,140,160,120,160,160,0,740
212,190,140,160,240,320,0,1050
213,200,120,120,160,160,320,1080
214,190,60,40,80,160,0,530
215,170,100,40,80,160,0,550
216,160,80,0,0,0,0,240
217,220,180,160,80,160,0,800
218,200,80,40,0,0,0,320
219,200,120,160,80,160,0,720
220,200,100,120,160,160,0,740
221,190,100,120,80,160,0,650
222,170,140,160,240,320,0,1030
223,220,140,160,160,0,0,680
224,190,120,160,0,0,0,470
225,190,140,120,160,160,0,770
226,170,100,40,0,0,0,310
227,190,120,120,80,0,0,510
228,190,140,80,80,0,0,490
229,140,100,80,80,160,0,560
230,240,160,80,80,160,0,720
231,210,120,80,80,160,0,650
232,210,200,160,160,0,0,730
233,180,160,200,160,320,0,1020
234,190,100,80,80,160,0,610
235,240,160,120,160,0,0,680
236,180,140,80,0,0,0,400
237,190,60,80,80,160,0,570
238,190,140,40,0,0,0,370
239,180,40,40,0,0,0,260
240,200,120,0,0,0,0,320
241,190,120,80,80,160,0,630
242,230,120,120,80,160,0,710
243,190,140,120,80,160,0,690
244,180,140,40,80,160,0,600
245,190,80,40,0,0,0,310
246,230,180,160,80,0,0,650
247,230,140,120,0,0,0,490
248,170,100,120,160,160,0,710
249,240,180,160,160,320,0,1060
250,140,100,0,0,0,0,240
251,190,140,160,160,160,0,810
252,180,100,80,80,160,0,600
253,180,120,120,160,160,0,740
254,190,160,80,80,0,0,510
255,190,100,120,80,160,320,970
256,210,180,160,160,160,0,870
257,160,160,80,160,160,0,720
258,210,120,160,80,160,0,730
259,160,120,120,80,0,0,480
260,160,140,120,80,160,320,980
261,200,80,40,80,160,320,880
262,200,160,120,80,160,0,720
263,200,160,160,80,160,0,760
264,200,140,160,240,0,0,740
265,210,80,120,80,160,0,650
266,190,120,160,160,160,0,790
267,190,100,40,80,0,0,410
268,200,80,40,0,0,0,320
269,190,140,120,160,320,0,930
270,230,120,120,80,160,0,710
271,190,100,120,80,160,0,650
272,210,120,40,0,0,0,370
273,190,80,120,160,160,0,710
274,190,220,120,80,160,0,770
275,210,120,200,240,160,320,1250
276,220,120,120,240,160,0,860
277,220,100,80,160,160,320,1040
278,200,140,160,160,320,320,1300
279,190,140,120,80,0,0,530
280,190,120,80,160,160,0,710
281,210,120,80,80,0,0,490
282,240,200,80,80,160,0,760
283,250,140,80,80,160,0,710
284,190,80,40,80,160,0,550
285,190,120,120,160,160,320,1070
286,210,80,80,80,160,0,610
287,190,180,120,80,160,0,730
288,210,180,160,160,160,0,870
289,240,180,80,80,0,0,580
290,200,120,80,80,0,0,480
291,170,60,80,80,0,0,390
292,190,80,120,160,160,0,710
293,190,100,120,80,160,0,650
294,170,140,120,160,160,320,1070
295,200,140,160,160,320,0,980
296,180,140,120,80,0,0,520
297,190,120,160,80,160,320,1030
298,190,140,120,0,0,0,450
299,210,200,120,80,160,0,770
300,180,60,40,80,160,0,520
301,220,180,80,160,320,320,1280
302,210,80,120,160,160,0,730
303,200,120,200,80,160,0,760
304,190,80,40,80,160,320,870
305,220,180,120,80,0,0,600
306,180,80,80,160,320,320,1140
307,210,140,160,160,320,0,990
308,210,120,80,80,0,0,490
309,220,200,160,160,320,320,1380
310,190,120,80,80,160,0,630
311,190,20,40,80,0,0,330
312,190,60,80,160,0,0,490
313,240,120,80,0,0,0,440
314,210,120,80,0,0,0,410
315,180,100,120,160,160,320,1040
316,210,80,80,160,160,0,690
317,210,100,120,80,0,0,510
318,210,140,160,240,160,320,1230
319,180,100,120,80,0,0,480
320,190,140,120,80,0,0,530
321,210,180,80,80,160,0,710
322,170,80,80,0,0,0,330
323,180,120,40,80,160,0,580
324,160,140,160,160,160,0,780
325,210,160,120,80,0,0,570
326,140,80,40,80,160,320,820
327,170,120,120,0,0,0,410
328,190,120,120,80,160,0,670
329,200,120,120,80,160,0,680
330,180,100,80,80,160,0,600
331,190,80,40,0,0,0,310
332,210,60,40,0,0,0,310
333,150,120,160,80,160,0,670
334,210,140,80,80,0,0,510
335,200,200,200,160,160,0,920
336,220,60,80,0,0,0,360
337,140,80,120,0,0,0,340
338,200,100,40,80,160,0,580
339,210,120,40,0,0,0,370
340,200,140,120,80,0,0,540
341,170,120,120,160,160,0,730
342,140,60,80,160,160,320,920
343,170,80,40,80,160,0,530
344,220,100,0,0,0,0,320
345,190,120,80,80,160,0,630
346,220,80,160,0,0,0,460
347,190,140,80,80,160,0,650
348,230,180,40,0,0,0,450
349,200,100,40,0,0,0,340
350,210,140,240,240,160,0,990
351,210,140,120,160,160,0,790
352,190,160,120,80,0,0,550
353,160,120,120,160,160,0,720
354,210,120,160,160,320,0,970
355,190,120,120,160,320,0,910
356,200,100,160,160,160,0,780
357,200,180,120,80,160,0,740
358,210,120,0,0,0,0,330
359,200,120,160,80,160,320,1040
360,180,160,120,80,0,0,540
361,190,140,160,240,160,0,890
362,210,40,80,160,160,320,970
363,190,140,120,160,160,0,770
364,160,160,120,80,160,0,680
365,220,120,40,80,160,0,620
366,180,120,40,80,160,320,900
367,180,180,160,240,160,0,920
368,210,120,40,0,0,0,370
369,210,120,40,80,0,0,450
370,220,180,80,160,160,320,1120
371,190,60,80,160,160,0,650
372,170,100,80,80,160,0,590
373,210,180,160,160,0,0,710
374,180,100,80,0,0,0,360
375,190,120,160,80,0,0,550
376,200,160,160,80,160,320,1080
377,200,100,160,240,160,0,860
378,190,100,120,240,320,320,1290
379,220,60,80,80,0,0,440
380,190,160,160,160,0,0,670
381,220,140,120,160,160,0,800
382,210,120,40,0,0,0,370
383,170,140,80,80,0,0,470
384,170,140,160,160,160,320,1110
385,190,120,120,80,160,0,670
386,190,140,160,160,0,0,650
387,180,120,80,160,320,320,1180
388,200,140,160,80,160,0,740
389,200,120,80,80,160,0,640
390,240,220,200,160,320,320,1460
391,220,160,120,0,0,0,500
392,200,140,40,80,160,0,620
393,200,140,40,0,0,0,380
394,220,120,80,80,160,0,660
395,170,140,120,160,160,0,750
396,220,100,80,0,0,0,400
397,220,140,40,80,160,0,640
398,180,60,40,80,160,0,520
399,200,140,80,80,0,0,500
400,190,140,120,160,160,0,770
401,180,120,160,80,0,0,540
402,210,140,80,80,0,0,510
403,190,140,120,0,0,0,450
404,230,100,80,80,160,0,650
405,180,80,80,160,160,0,660
406,240,120,120,80,160,0,720
407,180,100,120,80,0,0,480
408,160,120,160,80,160,0,680
409,160,100,160,0,0,0,420
410,180,140,80,80,160,0,640
411,170,120,120,160,320,320,1210
412,200,140,200,240,320,0,1100
413,210,160,160,160,160,0,850
414,210,100,0,0,0,0,310
415,200,100,80,160,320,320,1180
416,180,60,80,80,160,0,560
417,170,80,120,80,160,0,610
418,200,100,120,160,320,0,900
419,190,140,160,160,160,0,810
420,190,100,40,80,0,0,410
421,200,120,160,80,160,0,720
422,190,140,120,160,160,0,770
423,230,100,80,80,0,0,490
424,180,140,120,240,320,320,1320
425,190,120,80,160,160,0,710
426,200,140,80,0,0,0,420
427,230,140,120,160,160,320,1130
428,160,160,200,160,160,0,840
429,230,100,120,160,0,0,610
430,230,120,80,80,160,0,670
431,190,120,120,160,160,0,750
432,190,140,200,160,160,0,850
433,150,80,40,0,0,0,270
434,230,200,120,80,0,0,630
435,180,120,120,160,0,0,580
436,210,160,240,80,0,0,690
437,200,80,40,0,0,0,320
438,170,120,80,160,160,0,690
439,210,180,160,160,160,0,870
440,200,140,120,160,160,0,780
441,210,200,200,0,0,0,610
442,180,120,120,80,0,0,500
443,190,160,200,240,320,320,1430
444,220,140,80,80,160,0,680
445,190,100,80,0,0,0,370
446,210,100,120,160,160,0,750
447,210,120,160,80,160,320,1050
448,200,160,200,240,320,0,1120
449,180,100,120,80,160,0,640
450,210,160,120,80,0,0,570
451,220,140,160,160,160,0,840
452,230,200,160,80,160,0,830
453,180,120,200,80,0,0,580
454,190,120,120,160,160,0,750
455,190,100,160,80,0,0,530
456,180,60,80,80,0,0,400
457,230,140,80,80,160,0,690
458,220,140,120,160,320,0,960
459,240,180,120,160,160,0,860
460,240,160,120,0,0,0,520
461,190,160,120,80,160,0,710
462,190,100,40,80,0,0,410
463,180,160,160,240,320,0,1060
464,200,100,80,80,160,0,620
465,200,140,120,160,160,0,780
466,190,100,120,80,160,0,650
467,220,120,0,0,0,0,340
468,210,120,120,80,0,0,530
469,220,140,120,160,160,320,1120
470,210,160,120,160,320,320,1290
471,200,120,80,80,160,320,960
472,180,100,40,80,160,320,880
473,220,100,80,160,160,0,720
474,240,160,120,160,0,0,680
475,190,140,160,80,160,320,1050
476,160,140,120,80,160,0,660
477,190,120,120,160,160,320,1070
478,180,180,120,80,160,0,720
479,180,140,200,80,160,0,760
480,210,160,160,240,160,0,930
481,180,120,80,80,160,0,620
482,200,100,80,0,0,0,380
483,170,100,80,0,0,0,350
484,190,100,160,160,320,320,1250
485,230,200,120,80,160,0,790
486,170,140,160,160,160,0,790
487,160,140,200,80,160,320,1060
488,200,140,120,80,160,320,1020
489,230,140,160,80,0,0,610
490,210,140,120,80,0,0,550
491,220,100,0,0,0,0,320
492,190,120,80,80,160,0,630
493,190,100,120,240,160,320,1130
494,220,140,160,240,160,0,920
495,190,140,120,160,160,0,770
496,150,80,80,80,160,0,550
497,190,100,80,80,160,0,610
498,200,160,160,160,320,0,1000
499,220,100,80,80,160,320,960
500,220,140,200,240,320,320,1440
501,240,120,40,80,0,0,480
502,230,180,120,80,160,0,770
503,220,140,80,0,0,0,440
504,160,120,200,160,160,320,1120
505,200,140,80,80,160,0,660
506,210,80,80,80,160,0,610
507,180,140,80,0,0,0,400
508,190,120,120,80,160,0,670
509,150,120,160,160,160,0,750
510,200,140,120,80,160,0,700
511,190,80,120,160,160,0,710
512,130,120,160,160,160,320,1050
513,220,140,120,80,0,0,560
514,230,140,120,80,0,0,570
515,210,180,160,160,160,0,870
516,230,140,80,0,0,0,450
517,170,140,40,0,0,0,350
518,220,160,160,80,0,0,620
519,190,100,80,160,0,0,530
520,160,80,120,80,160,0,600
521,180,100,160,160,160,0,760
522,190,160,120,80,0,0,550
523,210,140,160,240,320,320,1390
524,210,120,80,80,160,0,650
525,200,100,80,80,160,0,620
526,240,180,200,160,160,0,940
527,210,140,120,80,0,0,550
528,210,140,80,80,160,0,670
529,210,140,160,80,160,0,750
530,190,80,120,80,160,320,950
531,210,160,80,80,0,0,530
532,150,120,0,0,0,0,270
533,170,160,120,0,0,0,450
534,180,100,40,0,0,0,320
535,200,140,80,160,160,0,740
536,200,140,160,240,160,0,900
537,190,100,80,80,160,0,610
538,200,140,160,240,320,0,1060
539,170,60,40,80,0,0,350
540,210,100,80,80,160,320,950
541,170,120,40,80,0,0,410
542,200,160,120,80,160,0,720
543,150,180,80,0,0,0,410
544,180,120,80,0,0,0,380
545,140,120,160,160,160,320,1060
546,200,140,160,160,160,0,820
547,170,140,200,160,0,0,670
548,180,120,120,80,0,0,500
549,240,160,80,0,0,0,480
550,200,100,80,80,0,0,460
551,200,120,160,80,160,0,720
552,190,120,80,160,0,0,550
553,200,100,160,240,160,320,1180
554,210,120,80,0,0,0,410
555,200,140,120,80,0,0,540
556,170,160,200,160,320,0,1010
557,200,120,200,240,160,0,920
558,130,60,80,80,0,0,350
559,180,100,80,160,160,0,680
560,240,140,120,80,160,0,740
561,220,140,120,160,160,0,800
562,200,120,160,80,160,320,1040
563,150,120,40,0,0,0,310
564,180,80,80,80,0,0,420
565,220,140,200,240,160,0,960
566,180,120,80,80,160,0,620
567,190,160,120,80,0,0,550
568,200,180,120,160,0,0,660
569,230,140,120,160,160,320,1130
570,170,60,40,80,0,0,350
571,190,80,80,80,0,0,430
572,210,140,120,160,160,0,790
573,230,140,120,80,0,0,570
574,200,140,80,80,160,0,660
575,200,140,80,80,0,0,500
576,190,140,120,160,160,0,770
577,190,100,40,80,0,0,410
578,220,100,120,160,320,0,920
579,160,80,80,80,160,0,560
580,210,120,80,80,160,320,970
581,200,140,80,160,160,320,1060
582,190,60,40,0,0,0,290
583,190,180,200,240,160,320,1290
584,210,100,40,0,0,0,350
585,200,120,160,160,0,0,640
586,180,140,80,160,160,0,720
587,190,160,160,80,160,0,750
588,170,180,120,80,0,0,550
589,150,140,80,80,160,320,930
590,140,80,80,80,160,0,540
591,260,180,120,160,320,0,1040
592,180,100,40,80,160,0,560
593,210,120,160,160,0,0,650
594,200,120,120,80,0,0,520
595,220,140,40,0,0,0,400
596,230,200,80,160,160,0,830
597,140,120,160,160,160,0,740
598,220,160,160,80,160,0,780
599,190,120,80,0,0,0,390
600,200,100,120,160,320,0,900
601,190,80,80,80,160,0,590
602,150,140,200,160,320,0,970
603,160,160,120,160,160,0,760
604,190,180,200,240,160,0,970
605,250,120,80,80,0,0,530
606,160,100,40,80,160,0,540
607,210,80,80,80,0,0,450
608,160,100,40,0,0,0,300
609,150,140,160,240,160,0,850
610,190,160,160,80,0,0,590
611,210,140,120,80,160,0,710
612,190,100,120,80,0,0,490
613,190,100,80,160,0,0,530
614,210,100,120,80,160,0,670
615,230,180,120,160,0,0,690
616,190,120,120,160,320,320,1230
617,240,160,160,240,160,320,1280
618,220,100,80,80,160,0,640
619,170,100,80,80,0,0,430
620,190,120,120,160,0,0,590
621,230,160,120,160,0,0,670
622,200,120,160,160,320,320,1280
623,210,120,160,160,0,0,650
624,170,140,160,160,160,0,790
625,240,160,120,80,160,320,1080
626,240,80,40,80,160,0,600
627,190,100,80,80,160,0,610
628,180,100,40,80,160,0,560
629,250,100,120,80,0,0,550
630,130,80,80,80,0,0,370
631,210,120,80,80,0,0,490
632,180,80,80,0,0,0,340
633,160,80,120,80,160,0,600
634,200,140,160,160,320,0,980
635,190,120,80,160,160,0,710
636,190,60,0,0,0,0,250
637,200,180,160,160,160,320,1180
638,180,80,120,160,320,320,1180
639,160,80,80,160,320,0,800
640,180,160,200,160,160,0,860
641,210,120,40,80,160,0,610
642,150,120,160,160,160,0,750
643,180,120,120,80,0,0,500
644,230,140,40,0,0,0,410
645,220,120,120,0,0,0,460
646,180,120,80,0,0,0,380
647,230,80,120,80,0,0,510
648,200,140,160,240,320,320,1380
649,220,80,80,80,0,0,460
650,240,140,40,80,160,0,660
651,170,80,120,80,0,0,450
652,170,160,200,80,0,0,610
653,210,140,160,160,160,0,830
654,180,80,40,80,160,0,540
655,200,100,120,80,160,0,660
656,210,80,120,80,160,0,650
657,200,160,80,80,0,0,520
658,210,100,160,160,160,320,1110
659,200,120,40,80,160,0,600
660,200,120,160,160,160,0,800
661,190,80,80,0,0,0,350
662,200,100,80,80,160,320,940
663,200,180,40,0,0,0,420
664,190,100,80,80,160,0,610
665,160,80,40,80,0,0,360
666,200,100,120,160,160,0,740
667,180,200,160,160,160,320,1180
668,200,100,120,160,160,0,740
669,210,160,120,80,160,0,730
670,260,140,120,80,0,0,600
671,200,120,120,80,160,0,680
672,200,140,160,80,160,0,740
673,200,140,80,0,0,0,420
674,230,80,40,0,0,0,350
675,180,80,40,80,0,0,380
676,230,160,120,160,0,0,670
677,220,160,120,160,320,0,980
678,170,120,80,0,0,0,370
679,190,80,40,80,160,0,550
680,180,140,80,80,160,0,640
681,210,140,120,160,160,0,790
682,170,80,120,160,160,0,690
683,200,100,120,80,0,0,500
684,210,160,120,80,0,0,570
685,180,120,40,0,0,0,340
686,230,100,40,80,0,0,450
687,190,160,120,0,0,0,470
688,180,120,200,160,160,0,820
689,180,80,80,80,0,0,420
690,230,80,80,80,160,0,630
691,190,160,120,240,160,0,870
692,120,120,80,80,160,0,560
693,230,180,200,160,160,320,1250
694,150,140,80,80,0,0,450
695,240,180,160,240,160,0,980
696,170,160,80,160,320,320,1210
697,200,140,160,160,160,320,1140
698,190,100,160,80,0,0,530
699,200,120,80,80,160,0,640
700,170,60,40,80,160,0,510
701,210,140,120,80,160,0,710
702,240,140,80,80,160,0,700
703,210,120,40,80,160,0,610
704,180,160,40,80,160,320,940
705,180,100,40,80,160,0,560
706,170,120,120,80,160,0,650
707,190,100,80,160,0,0,530
708,200,100,160,160,160,0,780
709,210,140,40,80,160,0,630
710,190,160,80,80,160,0,670
711,190,120,80,80,160,0,630
712,230,140,120,80,160,0,730
713,150,120,40,80,160,0,550
714,180,120,40,0,0,0,340
715,190,100,120,80,160,0,650
716,250,140,160,160,320,0,1030
717,220,120,120,240,320,0,1020
718,180,180,200,160,0,0,720
719,190,160,160,160,0,0,670
720,230,120,160,80,0,0,590
721,170,80,40,0,0,0,290
722,200,180,160,0,0,0,540
723,160,80,80,160,160,0,640
724,190,140,80,80,160,0,650
725,200,160,80,160,320,320,1240
726,170,80,40,80,160,0,530
727,210,100,80,80,0,0,470
728,200,220,200,240,160,0,1020
729,180,100,40,80,160,0,560
730,180,140,120,80,0,0,520
731,220,140,200,160,0,0,720
732,240,160,120,160,320,320,1320
733,170,100,80,80,160,0,590
734,160,60,80,160,160,0,620
735,230,80,120,80,0,0,510
736,270,180,200,80,0,0,730
737,200,120,40,80,160,0,600
738,200,140,200,160,160,320,1180
739,160,80,80,80,160,0,560
740,190,80,80,80,160,0,590
741,210,140,80,0,0,0,430
742,200,160,160,80,160,0,760
743,190,120,120,80,0,0,510
744,190,120,80,80,160,320,950
745,180,140,80,80,160,0,640
746,210,120,120,160,160,0,770
747,160,80,120,160,160,0,680
748,180,140,160,160,320,0,960
749,140,160,80,80,160,0,620
750,170,100,80,80,160,320,910
751,180,120,40,80,0,0,420
752,190,100,120,160,160,0,730
753,170,80,40,80,160,320,850
754,230,100,40,0,0,0,370
755,230,100,160,240,160,0,890
756,190,100,160,80,160,320,1010
757,150,80,120,160,160,0,670
758,200,60,40,80,0,0,380
759,230,120,120,160,160,0,790
760,190,100,120,160,160,0,730
761,170,120,160,240,0,0,690
762,170,60,40,0,0,0,270
763,220,100,80,160,320,320,1200
764,220,140,160,80,0,0,600
765,180,140,120,80,160,0,680
766,190,80,80,0,0,0,350
767,190,120,160,80,0,0,550
768,190,80,80,160,160,0,670
769,200,120,120,160,160,320,1080
770,210,160,160,160,0,0,690
771,180,100,40,0,0,0,320
772,210,120,160,160,320,0,970
773,180,40,80,80,160,0,540
774,190,180,80,160,320,320,1250
775,210,40,0,0,0,0,250
776,180,160,120,80,0,0,540
777,180,120,40,80,0,0,420
778,200,120,40,80,0,0,440
779,190,80,80,160,160,0,670
780,220,120,120,240,160,0,860
781,200,140,160,240,160,0,900
782,180,100,120,160,160,0,720
783,170,140,120,160,0,0,590
784,180,100,120,80,0,0,480
785,210,140,120,80,0,0,550
786,220,160,160,80,160,0,780
787,180,120,120,80,160,0,660
788,170,100,160,240,320,0,990
789,200,100,40,80,160,0,580
790,250,140,120,0,0,0,510
791,140,120,0,0,0,0,260
792,220,140,80,80,0,0,520
793,230,120,160,160,0,0,670
794,210,120,80,160,160,0,730
795,180,120,80,160,320,320,1180
796,200,140,120,160,320,320,1260
797,180,140,80,80,0,0,480
798,180,140,80,160,0,0,560
799,200,180,80,80,0,0,540
800,170,160,160,240,0,0,730
801,200,120,80,80,160,320,960
802,200,100,40,80,160,0,580
803,230,60,120,80,160,0,650
804,210,120,80,80,0,0,490
805,190,120,160,160,160,320,1110
806,170,120,120,80,160,0,650
807,180,120,80,80,160,0,620
808,250,140,160,160,160,0,870
809,210,120,80,80,160,0,650
810,150,60,80,80,0,0,370
811,130,140,120,80,160,0,630
812,220,200,160,240,320,0,1140
813,240,180,200,240,160,0,1020
814,180,120,120,0,0,0,420
815,180,100,120,80,160,0,640
816,230,140,120,160,160,0,810
817,160,140,160,160,320,0,940
818,210,100,80,80,0,0,470
819,220,80,120,80,0,0,500
820,190,80,80,80,0,0,430
821,180,120,120,160,160,0,740
822,170,60,80,80,160,0,550
823,220,120,160,160,320,0,980
824,190,100,160,80,0,0,530
825,180,120,80,0,0,0,380
826,180,140,200,80,160,0,760
827,160,100,120,80,160,0,620
828,220,100,120,160,320,0,920
829,180,100,120,160,160,0,720
830,200,140,160,0,0,0,500
831,200,100,40,80,0,0,420
832,180,100,80,160,160,320,1000
833,210,100,80,160,0,0,550
834,240,180,80,80,160,320,1060
835,220,140,160,160,160,0,840
836,180,100,80,0,0,0,360
837,170,140,120,0,0,0,430
838,170,120,80,0,0,0,370
839,210,100,160,160,160,0,790
840,250,200,200,240,0,0,890
841,200,120,120,160,160,0,760
842,170,140,120,80,0,0,510
843,170,80,160,160,0,0,570
844,210,140,80,0,0,0,430
845,220,180,120,80,0,0,600
846,200,100,40,0,0,0,340
847,210,80,40,80,0,0,410
848,220,140,120,160,320,0,960
849,170,80,40,80,160,0,530
850,170,200,200,0,0,0,570
851,200,200,120,80,0,0,600
852,190,80,80,80,0,0,430
853,210,120,80,80,0,0,490
854,170,120,80,160,160,0,690
855,220,160,80,80,160,0,700
856,200,120,80,80,160,0,640
857,210,160,120,160,0,0,650
858,170,80,80,80,160,320,890
859,170,180,120,160,160,320,1110
860,210,120,120,80,0,0,530
861,180,120,120,80,160,0,660
862,200,180,120,160,0,0,660
863,230,120,120,80,0,0,550
864,190,160,120,80,160,0,710
865,220,140,240,160,0,0,760
866,250,200,80,80,0,0,610
867,190,100,120,160,0,0,570
868,220,140,80,80,160,0,680
869,220,80,80,160,160,0,700
870,210,80,80,0,0,0,370
871,180,120,120,80,160,320,980
872,230,180,40,0,0,0,450
873,190,80,80,80,160,0,590
874,190,120,40,80,160,0,590
875,180,140,80,160,320,320,1200
876,180,120,80,80,0,0,460
877,200,100,120,80,160,0,660
878,150,120,120,80,160,0,630
879,230,200,120,80,160,0,790
880,190,60,80,160,320,320,1130
881,210,80,120,80,160,0,650
882,160,120,120,160,160,0,720
883,220,140,80,0,0,0,440
884,160,120,120,160,160,320,1040
885,230,140,80,80,160,0,690
886,210,60,40,80,160,0,550
887,220,120,80,80,0,0,500
888,220,160,240,0,0,0,620
889,210,100,40,80,0,0,430
890,200,80,40,80,160,0,560
891,150,140,120,160,160,0,730
892,120,60,40,80,0,0,300
893,190,100,80,80,160,0,610
894,210,100,120,80,160,0,670
895,210,140,120,160,160,0,790
896,200,120,80,80,160,320,960
897,240,140,80,80,0,0,540
898,200,120,80,0,0,0,400
899,200,140,160,160,0,0,660
900,160,60,80,80,0,0,380
901,210,120,120,80,0,0,530
902,210,160,200,160,0,0,730
903,180,160,80,80,0,0,500
904,160,100,80,160,160,0,660
905,190,120,120,80,160,320,990
906,220,120,120,160,160,0,780
907,140,120,40,80,0,0,380
908,180,60,120,80,160,0,600
909,190,80,80,0,0,0,350
910,190,120,120,240,320,0,990
911,220,140,200,80,160,0,800
912,200,140,80,80,160,0,660
913,200,100,80,160,160,0,700
914,200,80,80,80,160,0,600
915,170,80,80,160,160,0,650
916,160,120,120,80,0,0,480
917,180,140,160,240,320,0,1040
918,170,160,120,80,0,0,530
919,210,120,160,80,160,0,730
920,180,100,80,160,160,0,680
921,190,160,0,0,0,0,350
922,220,100,120,160,160,0,760
923,210,120,120,80,0,0,530
924,180,160,160,240,160,320,1220
925,180,120,120,80,160,0,660
926,200,180,80,80,160,0,700
927,190,100,80,160,320,0,850
928,160,140,80,80,160,0,620
929,200,60,40,0,0,0,300
930,180,120,120,80,160,0,660
931,220,140,120,160,160,0,800
932,220,120,80,160,320,320,1220
933,240,120,80,160,160,0,760
934,230,140,40,80,160,0,650
935,180,200,160,80,0,0,620
936,190,120,160,240,320,320,1350
937,220,160,120,160,320,0,980
938,190,140,120,160,160,0,770
939,190,140,80,80,160,0,650
940,170,140,120,160,160,0,750
941,180,140,80,80,160,0,640
942,230,140,120,160,0,0,650
943,210,120,120,80,0,0,530
944,170,120,160,80,0,0,530
945,190,100,80,0,0,0,370
946,180,120,160,160,160,0,780
947,180,120,120,160,0,0,580
948,200,120,160,160,160,320,1120
949,240,120,120,160,0,0,640
950,190,60,80,0,0,0,330
951,200,120,80,0,0,0,400
952,180,120,80,80,0,0,460
953,220,100,120,240,320,0,1000
954,190,180,40,0,0,0,410
955,220,140,120,80,160,0,720
956,220,160,120,80,160,0,740
957,230,180,40,0,0,0,450
958,220,100,160,160,160,320,1120
959,190,120,120,160,160,0,750
960,230,140,160,80,0,0,610
961,210,140,160,160,160,320,1150
962,240,100,80,80,160,0,660
963,180,80,120,160,160,0,700
964,190,100,80,80,160,320,930
965,190,100,40,0,0,0,330
966,220,160,120,80,160,0,740
967,140,100,120,80,160,320,920
968,250,100,120,80,160,0,710
969,170,120,80,160,160,0,690
970,190,100,80,80,160,0,610
971,180,120,120,160,320,320,1220
972,170,100,120,0,0,0,390
973,210,80,40,0,0,0,330
974,210,140,160,160,0,0,670
975,180,160,240,160,160,0,900
976,170,100,160,160,160,0,750
977,190,140,120,160,320,320,1250
978,220,180,160,80,160,0,800
979,200,140,120,80,160,320,1020
980,210,140,80,80,160,0,670
981,170,180,80,80,0,0,510
982,180,120,80,160,160,320,1020
983,210,120,160,240,160,320,1210
984,190,140,200,240,0,0,770
985,200,120,160,240,320,0,1040
986,210,80,120,160,160,0,730
987,200,140,120,80,0,0,540
988,170,120,160,160,320,0,930
989,170,120,80,80,160,0,610
990,190,140,160,80,0,0,570
991,170,120,120,80,0,0,490
992,190,120,40,80,160,0,590
993,130,100,40,80,160,0,510
994,240,140,80,80,0,0,540
995,160,120,80,80,160,320,920
996,160,120,80,80,160,0,600
997,210,100,120,160,160,0,750
998,210,140,80,80,0,0,510
999,180,120,120,80,160,0,660
1000,180,160,200,160,160,0,860
1001,210,100,120,80,160,0,670
1002,190,60,40,80,0,0,370
1003,200,120,120,80,0,0,520
1004,180,60,80,80,0,0,400
1005,160,140,120,80,0,0,500
1006,200,120,80,80,160,0,640
1007,190,140,80,80,0,0,490
1008,210,140,160,240,160,0,910
1009,200,120,120,160,0,0,600
1010,170,100,80,80,160,0,590
1011,190,140,80,0,0,0,410
1012,190,180,160,160,160,0,850
1013,220,200,120,80,0,0,620
1014,190,120,120,160,160,0,750
1015,220,120,120,160,160,0,780
1016,220,160,120,160,160,0,820
1017,200,120,120,160,320,320,1240
1018,180,160,120,0,0,0,460
1019,200,100,80,80,0,0,460
1020,170,140,80,80,160,0,630
1021,220,100,80,160,320,320,1200
1022,210,100,0,0,0,0,310
1023,180,100,120,160,0,0,560
1024,200,120,40,80,160,0,600
1025,180,120,160,240,320,0,1020
1026,210,100,120,160,320,0,910
1027,200,160,120,80,160,0,720
1028,230,180,160,80,0,0,650
1029,200,180,80,160,320,0,940
1030,200,160,80,80,160,0,680
1031,190,120,120,80,160,0,670
1032,220,140,80,80,160,0,680
1033,170,80,40,80,0,0,370
1034,230,140,160,80,160,0,770
1035,210,140,40,0,0,0,390
1036,210,140,120,0,0,0,470
1037,180,160,160,160,160,0,820
1038,250,160,160,160,320,320,1370
1039,200,160,120,240,320,0,1040
1040,190,120,120,80,0,0,510
1041,160,80,120,160,160,0,680
1042,170,100,80,160,0,0,510
1043,220,120,80,0,0,0,420
1044,230,140,80,80,160,0,690
1045,210,100,40,0,0,0,350
1046,220,140,80,160,160,0,760
1047,170,100,120,80,160,0,630
1048,230,100,80,160,0,0,570
1049,190,160,40,80,0,0,470
1050,190,180,80,0,0,0,450
1051,210,160,200,80,160,0,810
1052,180,160,80,80,0,0,500
1053,180,180,160,240,160,0,920
1054,210,180,120,0,0,0,510
1055,170,60,40,80,160,320,830
1056,230,40,80,160,0,0,510
1057,180,120,80,80,0,0,460
1058,220,140,120,160,0,0,640
1059,230,100,160,160,320,320,1290
1060,190,120,80,160,160,0,710
1061,220,180,120,80,160,320,1080
1062,210,120,200,80,160,0,770
1063,170,140,160,80,0,0,550
1064,170,120,120,80,160,0,650
1065,230,120,120,80,160,320,1030
1066,230,120,120,80,0,0,550
1067,260,140,80,0,0,0,480
1068,250,120,40,80,160,0,650
1069,150,120,80,80,0,0,430
1070,190,140,120,160,160,0,770
1071,190,160,120,80,0,0,550
1072,200,160,40,80,160,0,640
1073,210,120,80,80,160,0,650
1074,230,140,80,0,0,0,450
1075,190,160,120,160,160,0,790
1076,210,120,80,160,160,0,730
1077,190,80,120,160,160,0,710
1078,240,140,160,80,0,0,620
1079,200,120,120,160,320,320,1240
1080,200,180,80,0,0,0,460
1081,220,120,80,80,160,0,660
1082,160,100,80,80,160,0,580
1083,150,140,120,160,160,320,1050
1084,190,60,80,0,0,0,330
1085,240,100,160,160,160,0,820
1086,180,140,120,80,160,0,680
1087,170,160,160,80,160,0,730
1088,200,100,80,80,160,320,940
1089,220,120,120,160,160,0,780
1090,210,160,120,80,0,0,570
1091,180,120,80,160,160,0,700
1092,210,140,80,0,0,0,430
1093,190,80,80,0,0,0,350
1094,150,120,80,160,160,0,670
1095,210,120,80,80,160,0,650
1096,210,120,80,0,0,0,410
1097,200,120,40,80,0,0,440
1098,170,100,0,0,0,0,270
1099,190,120,160,0,0,0,470
1100,220,100,120,0,0,0,440
1101,200,160,160,80,0,0,600
1102,180,120,80,80,160,0,620
1103,200,80,80,80,0,0,440
1104,220,180,240,240,0,0,880
1105,190,80,40,0,0,0,310
1106,240,100,80,80,160,0,660
1107,220,200,160,240,320,0,1140
1108,180,80,80,160,320,0,820
1109,170,120,80,0,0,0,370
1110,180,140,80,160,160,0,720
1111,200,160,80,80,0,0,520
1112,180,60,40,80,160,0,520
1113,190,140,160,160,320,0,970
1114,240,100,80,80,0,0,500
1115,150,120,80,160,320,320,1150
1116,240,180,160,80,0,0,660
1117,170,140,120,80,0,0,510
1118,180,180,80,80,160,0,680
1119,230,180,120,80,160,0,770
1120,200,120,160,240,320,320,1360
1121,220,180,120,0,0,0,520
1122,170,80,80,80,160,0,570
1123,150,60,120,160,160,0,650
1124,220,140,160,160,160,0,840
1125,160,140,120,80,160,0,660
1126,230,120,80,80,160,0,670
1127,220,60,0,0,0,0,280
1128,220,140,160,80,160,0,760
1129,230,160,120,80,160,320,1070
1130,190,140,80,160,160,0,730
1131,170,100,80,0,0,0,350
1132,220,100,160,80,160,0,720
1133,220,120,80,80,0,0,500
1134,180,140,160,240,160,0,880
1135,170,100,80,80,0,0,430
1136,180,120,80,80,0,0,460
1137,210,120,160,160,160,0,810
1138,190,80,40,80,160,320,870
1139,180,60,40,80,0,0,360
1140,210,220,200,160,160,0,950
1141,210,140,120,160,0,0,630
1142,220,80,120,240,0,0,660
1143,170,120,120,160,160,0,730
1144,190,160,80,80,160,0,670
1145,220,200,160,80,160,0,820
1146,190,160,40,80,160,0,630
1147,220,160,80,80,0,0,540
1148,190,100,80,80,160,0,610
1149,210,180,40,80,0,0,510
1150,190,60,0,0,0,0,250
1151,220,100,80,80,160,0,640
1152,140,120,200,240,160,0,860
1153,180,140,80,80,160,0,640
1154,210,140,120,80,160,0,710
1155,190,100,120,80,0,0,490
1156,180,140,160,160,0,0,640
1157,210,140,120,80,160,0,710
1158,160,120,40,0,0,0,320
1159,210,160,80,80,160,0,690
1160,150,80,120,240,320,0,910
1161,250,200,120,80,0,0,650
1162,210,140,80,80,0,0,510
1163,170,120,120,240,160,0,810
1164,170,120,120,160,320,0,890
1165,220,120,80,80,0,0,500
1166,190,140,120,160,320,320,1250
1167,210,160,120,160,160,0,810
1168,210,140,120,80,160,320,1030
1169,190,140,120,160,160,0,770
1170,160,60,40,80,160,0,500
1171,180,120,80,80,160,0,620
1172,240,120,200,240,160,0,960
1173,170,120,80,80,160,0,610
1174,210,100,120,80,160,0,670
1175,170,40,40,80,160,0,490
1176,200,80,120,160,160,0,720
1177,230,180,200,160,160,0,930
1178,160,100,40,0,0,0,300
1179,170,60,80,80,160,0,550
1180,200,120,120,80,0,0,520
1181,160,160,160,80,0,0,560
1182,190,80,160,0,0,0,430
1183,210,140,120,160,0,0,630
1184,200,200,120,80,0,0,600
1185,200,120,160,160,160,320,1120
1186,180,80,160,80,0,0,500
1187,150,100,40,0,0,0,290
1188,220,160,40,80,0,0,500
1189,180,60,80,80,160,0,560
1190,160,100,160,80,160,0,660
1191,190,160,160,80,0,0,590
1192,210,100,120,160,160,0,750
1193,160,120,160,160,160,0,760
1194,170,80,80,80,0,0,410
1195,220,120,120,160,160,0,780
1196,190,140,120,80,160,0,690
1197,210,160,120,80,160,0,730
1198,230,140,80,80,0,0,530
1199,180,140,80,0,0,0,400
1200,170,80,80,80,160,0,570
1201,200,120,80,80,160,0,640
1202,190,60,80,80,160,0,570
1203,180,140,120,160,320,320,1240
1204,180,100,120,80,160,320,960
1205,200,100,40,80,0,0,420
1206,210,120,160,80,160,0,730
1207,200,100,40,0,0,0,340
1208,210,160,160,0,0,0,530
1209,220,100,120,80,160,0,680
1210,210,220,160,160,160,0,910
1211,180,100,120,160,0,0,560
1212,200,120,120,80,160,0,680
1213,210,120,80,160,160,0,730
1214,170,80,80,80,0,0,410
1215,180,100,40,80,0,0,400
1216,240,140,120,80,160,0,740
1217,190,80,40,80,0,0,390
1218,170,140,40,80,160,320,910
1219,140,160,120,80,0,0,500
1220,230,120,120,80,0,0,550
1221,230,140,120,160,160,0,810
1222,200,120,80,160,160,0,720
1223,210,140,120,0,0,0,470
1224,200,180,160,80,160,0,780
1225,210,140,120,160,0,0,630
1226,160,140,120,160,0,0,580
1227,180,100,120,160,0,0,560
1228,180,120,160,0,0,0,460
1229,170,80,120,80,160,0,610
1230,180,100,40,0,0,0,320
1231,190,140,80,80,160,0,650
1232,200,160,160,80,0,0,600
1233,170,160,160,80,160,0,730
1234,170,100,120,160,160,0,710
1235,260,140,120,80,0,0,600
1236,190,120,160,160,320,0,950
1237,190,140,120,80,0,0,530
1238,200,60,80,160,0,0,500
1239,180,80,40,80,160,0,540
1240,220,160,160,160,320,0,1020
1241,180,120,200,160,160,0,820
1242,190,100,80,0,0,0,370
1243,160,40,40,80,160,0,480
1244,220,140,80,80,160,320,1000
1245,230,120,120,160,320,0,950
1246,220,120,120,80,160,0,700
1247,130,80,120,0,0,0,330
1248,200,160,200,240,160,0,960
1249,120,80,160,160,160,0,680
1250,180,80,80,80,160,0,580
1251,170,200,120,80,0,0,570
1252,170,100,160,160,0,0,590
1253,190,100,80,160,160,0,690
1254,200,160,120,80,160,320,1040
1255,180,40,80,160,320,0,780
1256,230,120,40,80,160,0,630
1257,190,140,80,80,0,0,490
1258,230,100,40,80,160,0,610
1259,190,140,120,80,0,0,530
1260,160,80,40,80,160,0,520
1261,190,140,40,0,0,0,370
1262,190,140,40,80,160,0,610
1263,170,100,80,80,0,0,430
1264,210,160,120,0,0,0,490
1265,200,140,120,160,160,0,780
1266,240,140,120,0,0,0,500
1267,180,140,160,80,0,0,560
1268,240,180,40,80,160,0,700
1269,190,120,160,80,0,0,550
1270,210,160,200,160,160,0,890
1271,180,120,80,0,0,0,380
1272,180,80,40,0,0,0,300
1273,260,120,160,80,160,0,780
1274,230,100,160,160,160,0,810
1275,180,160,160,240,160,0,900
1276,180,140,200,160,320,0,1000
1277,220,200,120,240,320,0,1100
1278,210,140,160,240,320,320,1390
1279,240,160,80,80,160,0,720
1280,150,140,120,160,0,0,570
1281,200,100,80,160,0,0,540
1282,230,140,160,80,0,0,610
1283,200,160,160,160,160,0,840
1284,190,140,120,160,160,320,1090
1285,180,180,80,80,160,0,680
1286,200,200,80,80,0,0,560
1287,200,160,200,80,160,0,800
1288,190,100,200,240,160,0,890
1289,120,120,80,80,160,0,560
1290,210,100,80,80,160,320,950
1291,170,100,80,80,0,0,430
1292,180,140,120,160,160,0,760
1293,200,60,40,0,0,0,300
1294,190,140,80,80,160,0,650
1295,230,120,80,160,0,0,590
1296,170,140,160,240,160,0,870
1297,210,120,40,80,0,0,450
1298,230,140,160,160,160,0,850
1299,170,100,120,80,0,0,470
1300,180,120,80,80,160,0,620
1301,180,100,40,0,0,0,320
1302,180,100,120,160,160,0,720
1303,180,120,120,160,0,0,580
1304,190,100,120,160,0,0,570
1305,180,120,80,160,320,320,1180
1306,200,120,200,80,0,0,600
1307,210,80,80,80,0,0,450
1308,170,80,120,160,160,320,1010
1309,220,140,160,80,160,0,760
1310,180,160,160,160,160,0,820
1311,220,100,120,160,160,0,760
1312,190,60,80,80,0,0,410
1313,190,140,160,160,160,0,810
1314,240,120,120,160,320,0,960
1315,170,120,40,80,160,320,890
1316,220,140,160,160,160,0,840
1317,210,80,0,0,0,0,290
1318,220,80,80,0,0,0,380
1319,190,100,120,160,160,0,730
1320,260,120,40,0,0,0,420
1321,170,140,120,160,0,0,590
1322,190,100,80,80,160,0,610
1323,180,100,120,160,160,0,720
1324,180,40,40,0,0,0,260
1325,160,160,200,80,0,0,600
1326,170,40,80,80,0,0,370
1327,200,120,120,160,160,320,1080
1328,180,140,120,80,160,0,680
1329,200,100,80,80,160,0,620
1330,190,80,120,160,320,0,870
1331,210,120,200,240,320,320,1410
1332,200,120,80,0,0,0,400
1333,200,160,80,80,160,0,680
1334,200,100,40,80,160,320,900
1335,220,160,120,80,0,0,580
1336,200,160,160,240,320,0,1080
1337,160,80,80,0,0,0,320
1338,200,160,80,80,160,320,1000
1339,200,140,120,80,0,0,540
1340,210,120,80,80,160,320,970
1341,200,140,160,160,160,0,820
1342,200,120,120,80,160,320,1000
1343,210,80,80,0,0,0,370
1344,200,100,120,160,160,0,740
1345,200,180,120,80,160,0,740
1346,230,140,160,80,0,0,610
1347,180,80,120,0,0,0,380
1348,200,140,120,160,160,0,780
1349,160,100,40,80,0,0,380
1350,190,120,40,80,160,0,590
1351,180,140,40,80,0,0,440
1352,230,120,80,80,160,0,670
1353,210,120,80,80,0,0,490
1354,200,160,120,80,160,320,1040
1355,190,140,200,0,0,0,530
1356,230,100,40,0,0,0,370
1357,240,100,120,160,320,0,940
1358,180,120,80,80,0,0,460
1359,250,140,80,80,160,0,710
1360,210,180,120,0,0,0,510
1361,210,100,80,0,0,0,390
1362,180,120,80,80,0,0,460
1363,240,180,120,160,160,0,860
1364,210,100,40,80,160,0,590
1365,240,160,80,80,160,320,1040
1366,130,80,120,80,0,0,410
1367,190,200,120,80,0,0,590
1368,180,100,160,0,0,0,440
1369,180,80,40,0,0,0,300
1370,160,100,80,80,0,0,420
1371,220,160,160,0,0,0,540
1372,220,100,40,0,0,0,360
1373,180,80,80,0,0,0,340
1374,210,160,120,0,0,0,490
1375,210,80,0,0,0,0,290
1376,190,160,120,80,0,0,550
1377,200,140,0,0,0,0,340
1378,200,140,200,160,320,320,1340
1379,220,180,80,80,0,0,560
1380,220,160,160,240,0,0,780
1381,180,200,120,0,0,0,500
1382,210,140,160,160,320,320,1310
1383,180,100,80,0,0,0,360
1384,200,140,80,80,160,0,660
1385,200,140,80,80,160,0,660
1386,220,100,80,0,0,0,400
1387,170,80,80,80,0,0,410
1388,220,100,120,160,160,0,760
1389,190,180,120,80,160,0,730
1390,210,180,80,0,0,0,470
1391,190,140,80,80,160,0,650
1392,190,100,160,160,160,0,770
1393,190,140,40,0,0,0,370
1394,210,80,80,0,0,0,370
1395,220,160,200,160,160,320,1220
1396,250,160,160,160,160,0,890
1397,230,140,160,160,320,0,1010
1398,180,120,120,80,0,0,500
1399,190,120,120,240,320,0,990
1400,190,140,160,80,0,0,570
1401,200,120,120,160,320,320,1240
1402,200,120,120,240,160,0,840
1403,190,120,80,80,160,0,630
1404,200,100,120,160,160,0,740
1405,230,180,80,0,0,0,490
1406,180,80,40,80,0,0,380
1407,210,80,120,80,160,0,650
1408,200,140,160,160,0,0,660
1409,160,100,120,0,0,0,380
1410,180,160,160,160,160,0,820
1411,200,200,120,160,160,0,840
1412,160,80,80,80,160,0,560
1413,200,100,80,0,0,0,380
1414,150,100,120,160,320,320,1170
1415,190,140,160,160,320,320,1290
1416,220,100,160,240,320,0,1040
1417,200,80,80,80,160,0,600
1418,150,80,80,80,160,0,550
1419,190,120,120,160,160,0,750
1420,190,80,120,160,320,0,870
1421,180,80,40,0,0,0,300
1422,210,100,120,160,320,0,910
1423,220,100,80,160,160,0,720
1424,170,120,160,160,160,0,770
1425,220,140,40,80,160,0,640
1426,160,60,80,80,160,0,540
1427,200,100,120,80,160,0,660
1428,210,100,120,80,160,0,670
1429,180,120,120,160,160,0,740
1430,220,180,80,80,160,0,720
1431,190,120,120,80,0,0,510
1432,210,160,160,160,160,0,850
1433,220,140,120,0,0,0,480
1434,180,100,80,80,160,0,600
1435,190,160,120,0,0,0,470
1436,200,140,160,160,160,0,820
1437,180,120,80,160,0,0,540
1438,230,140,120,80,160,0,730
1439,210,160,160,160,160,0,850
1440,180,120,160,240,160,0,860
1441,200,120,80,160,320,320,1200
1442,220,80,120,80,0,0,500
1443,180,140,120,0,0,0,440
1444,210,160,40,80,0,0,490
1445,220,120,80,80,0,0,500
1446,210,140,120,160,320,0,950
1447,210,140,40,80,160,0,630
1448,210,100,120,160,160,0,750
1449,210,100,80,80,0,0,470
1450,190,140,80,80,0,0,490
1451,170,120,80,80,160,320,930
1452,230,120,120,80,160,0,710
1453,180,140,120,160,0,0,600
1454,160,120,120,240,160,0,800
1455,180,80,40,80,160,320,860
1456,200,100,40,80,160,0,580
1457,200,120,160,160,0,0,640
1458,210,120,80,80,0,0,490
1459,160,160,160,0,0,0,480
1460,190,140,160,80,160,0,730
1461,210,200,120,80,160,0,770
1462,200,220,120,160,160,0,860
1463,190,100,80,0,0,0,370
1464,150,100,80,0,0,0,330
1465,210,120,120,160,320,320,1250
1466,200,160,120,80,0,0,560
1467,240,120,120,0,0,0,480
1468,190,100,40,80,160,0,570
1469,180,160,160,80,160,0,740
1470,200,160,80,80,0,0,520
1471,200,140,200,80,160,0,780
1472,150,140,120,240,320,0,970
1473,190,120,160,160,0,0,630
1474,220,200,80,160,320,320,1300
1475,180,120,120,240,160,0,820
1476,250,120,120,80,160,0,730
1477,230,160,80,80,160,0,710
1478,220,120,120,80,160,0,700
1479,200,100,80,160,0,0,540
1480,180,100,80,160,160,0,680
1481,190,120,160,160,160,0,790
1482,220,180,80,160,160,0,800
1483,170,120,160,160,160,0,770
1484,200,80,40,80,160,0,560
1485,210,100,120,80,0,0,510
1486,200,140,120,80,160,0,700
1487,220,140,120,240,160,0,880
1488,200,100,80,80,160,320,940
1489,170,120,120,160,0,0,570
1490,170,60,80,80,0,0,390
1491,210,100,120,80,160,0,670
1492,230,100,80,80,160,320,970
1493,210,120,80,160,160,0,730
1494,210,80,80,0,0,0,370
1495,220,100,80,160,0,0,560
1496,230,60,0,0,0,0,290
1497,210,140,160,80,160,0,750
1498,190,100,160,160,0,0,610
1499,170,60,0,0,0,0,230
1500,220,120,80,80,160,0,660
1501,220,200,160,160,160,0,900
1502,190,80,40,0,0,0,310
1503,190,180,160,80,160,0,770
1504,180,140,160,80,160,0,720
1505,200,100,120,160,160,320,1060
1506,180,120,80,80,160,0,620
1507,170,140,160,80,160,0,710
1508,190,160,120,80,0,0,550
1509,180,100,80,160,160,0,680
1510,180,80,80,80,160,320,900
1511,220,120,120,80,0,0,540
1512,180,80,120,80,160,0,620
1513,220,100,40,0,0,0,360
1514,170,100,120,80,0,0,470
1515,210,100,80,0,0,0,390
1516,220,140,160,240,320,320,1400
1517,170,120,80,80,0,0,450
1518,210,140,160,80,0,0,590
1519,210,180,160,80,160,0,790
1520,240,160,120,80,160,0,760
1521,170,120,40,0,0,0,330
1522,190,80,40,0,0,0,310
1523,210,80,80,160,160,0,690
1524,210,200,40,80,160,0,690
1525,210,80,0,0,0,0,290
1526,250,160,200,160,0,0,770
1527,230,120,120,80,0,0,550
1528,220,100,120,80,0,0,520
1529,190,80,80,160,0,0,510
1530,200,120,120,160,160,0,760
1531,220,120,120,80,160,320,1020
1532,190,80,80,160,160,320,990
1533,220,120,80,80,0,0,500
1534,220,160,120,160,320,320,1300
1535,210,100,160,240,0,0,710
1536,190,80,120,160,160,0,710
1537,220,140,120,80,0,0,560
1538,210,180,120,80,160,320,1070
1539,230,160,80,80,160,0,710
1540,210,120,120,160,0,0,610
1541,230,140,40,80,0,0,490
1542,170,40,40,0,0,0,250
1543,190,60,0,0,0,0,250
1544,240,180,200,160,0,0,780
1545,180,160,80,80,160,0,660
1546,220,100,80,80,0,0,480
1547,210,140,120,80,0,0,550
1548,200,200,160,240,0,0,800
1549,190,200,200,240,320,320,1470
1550,170,160,160,80,0,0,570
1551,200,140,160,160,320,320,1300
1552,210,100,40,80,160,0,590
1553,190,160,120,160,160,0,790
1554,170,120,120,0,0,0,410
1555,190,120,80,80,0,0,470
1556,230,120,120,160,160,0,790
1557,170,60,80,80,160,320,870
1558,140,100,120,0,0,0,360
1559,190,80,120,80,160,320,950
1560,200,140,160,80,0,0,580
1561,210,80,40,80,160,0,570
1562,180,120,120,80,160,320,980
1563,200,120,120,160,160,0,760
1564,200,160,160,80,160,0,760
1565,180,120,120,0,0,0,420
1566,220,100,160,80,160,0,720
1567,200,100,120,160,320,0,900
1568,190,160,200,80,160,0,790
1569,180,160,160,80,0,0,580
1570,160,120,80,80,160,0,600
1571,160,140,160,80,0,0,540
1572,250,140,80,160,320,320,1270
1573,180,80,80,0,0,0,340
1574,190,100,160,160,0,0,610
1575,200,40,80,80,160,0,560
1576,230,120,160,160,320,0,990
1577,190,120,40,80,160,0,590
1578,210,160,160,80,0,0,610
1579,210,120,80,0,0,0,410
1580,190,120,120,80,0,0,510
1581,200,160,160,160,160,0,840
1582,180,160,120,160,320,320,1260
1583,190,160,120,160,160,0,790
1584,190,100,120,160,160,0,730
1585,240,160,120,80,160,320,1080
1586,200,80,120,80,0,0,480
1587,190,180,120,80,160,0,730
1588,180,100,120,160,0,0,560
1589,210,140,80,80,160,0,670
1590,180,120,120,80,160,320,980
1591,190,140,80,0,0,0,410
1592,210,140,120,80,160,0,710
1593,220,100,80,80,0,0,480
1594,220,120,120,80,0,0,540
1595,180,140,80,0,0,0,400
1596,150,20,40,80,160,0,450
1597,190,120,40,80,0,0,430
1598,210,160,120,160,160,0,810
1599,180,140,160,80,0,0,560
1600,180,60,80,160,160,0,640
1601,190,120,120,160,160,0,750
1602,200,60,40,80,160,0,540
1603,190,120,120,80,0,0,510
1604,220,100,120,160,0,0,600
1605,210,60,80,160,160,0,670
1606,160,80,80,0,0,0,320
1607,240,80,80,80,160,0,640
1608,190,140,120,0,0,0,450
1609,230,160,40,0,0,0,430
1610,200,140,120,160,160,320,1100
1611,180,120,120,80,160,320,980
1612,190,160,160,160,160,0,830
1613,220,120,80,80,160,0,660
1614,220,140,80,80,0,0,520
1615,220,180,120,80,160,0,760
1616,190,140,120,160,320,0,930
1617,190,100,80,0,0,0,370
1618,210,100,80,80,160,320,950
1619,240,100,120,80,0,0,540
1620,160,140,120,0,0,0,420
1621,220,140,120,80,160,0,720
1622,200,120,120,160,160,0,760
1623,190,160,80,80,160,0,670
1624,200,200,120,160,320,0,1000
1625,190,120,120,80,160,320,990
1626,200,100,120,80,0,0,500
1627,210,120,40,80,160,0,610
1628,180,60,40,80,0,0,360
1629,180,120,80,80,0,0,460
1630,220,120,80,0,0,0,420
1631,200,160,200,240,160,0,960
1632,170,100,40,0,0,0,310
1633,230,80,120,80,160,0,670
1634,170,120,80,80,160,0,610
1635,190,120,160,240,160,0,870
1636,150,100,80,80,160,0,570
1637,200,100,80,160,320,0,860
1638,180,120,200,160,320,0,980
1639,180,120,80,80,160,0,620
1640,200,100,120,160,0,0,580
1641,210,160,200,240,320,0,1130
1642,220,160,160,240,160,0,940
1643,220,180,80,0,0,0,480
1644,240,100,40,0,0,0,380
1645,190,100,80,0,0,0,370
1646,180,160,160,80,0,0,580
1647,200,160,160,160,160,0,840
1648,170,120,160,240,320,0,1010
1649,200,180,160,80,0,0,620
1650,220,120,40,80,160,0,620
1651,200,100,120,160,160,0,740
1652,190,180,80,80,0,0,530
1653,190,160,120,0,0,0,470
1654,190,100,120,80,160,0,650
1655,220,100,120,80,0,0,520
1656,190,120,120,160,320,0,910
1657,230,100,80,80,160,0,650
1658,190,160,160,80,0,0,590
1659,210,200,160,0,0,0,570
1660,230,100,40,80,0,0,450
1661,210,140,160,160,320,320,1310
1662,200,160,120,80,160,320,1040
1663,200,100,80,160,160,0,700
1664,170,120,80,160,160,0,690
1665,250,120,80,160,160,0,770
1666,210,140,200,240,320,320,1430
1667,210,80,40,0,0,0,330
1668,200,180,80,0,0,0,460
1669,190,140,200,240,320,0,1090
1670,160,80,80,80,0,0,400
1671,210,120,120,160,160,0,770
1672,180,140,200,240,320,0,1080
1673,220,140,200,240,160,0,960
1674,210,80,80,80,160,0,610
1675,170,60,0,0,0,0,230
1676,200,140,160,0,0,0,500
1677,220,120,80,160,160,0,740
1678,180,120,160,160,160,0,780
1679,170,100,80,80,160,0,590
1680,220,120,200,160,320,0,1020
1681,130,120,160,80,0,0,490
1682,210,120,120,0,0,0,450
1683,190,120,160,160,160,0,790
1684,160,60,80,80,160,0,540
1685,180,100,120,160,0,0,560
1686,210,140,200,240,320,0,1110
1687,180,140,160,80,0,0,560
1688,200,120,40,80,0,0,440
1689,190,80,0,0,0,0,270
1690,210,100,160,160,160,320,1110
1691,210,140,80,0,0,0,430
1692,220,120,80,80,160,0,660
1693,190,140,120,0,0,0,450
1694,220,120,80,80,160,0,660
1695,150,100,40,80,160,0,530
1696,170,120,120,160,160,0,730
1697,210,100,160,80,0,0,550
1698,190,80,40,0,0,0,310
1699,180,140,160,160,320,320,1280
1700,190,60,80,80,0,0,410
1701,180,140,120,80,160,0,680
1702,180,160,120,0,0,0,460
1703,200,120,160,160,320,0,960
1704,190,140,40,80,160,0,610
1705,200,160,120,80,160,0,720
1706,190,120,120,160,320,320,1230
1707,210,100,120,160,0,0,590
1708,190,60,40,0,0,0,290
1709,160,60,40,0,0,0,260
1710,220,120,160,0,0,0,500
1711,200,100,120,160,160,0,740
1712,210,120,80,80,160,0,650
1713,190,100,120,160,320,0,890
1714,160,100,120,160,160,0,700
1715,200,120,80,160,160,0,720
1716,200,120,80,160,160,0,720
1717,220,120,120,80,0,0,540
1718,180,100,80,80,160,0,600
1719,200,180,160,160,160,0,860
1720,210,160,120,80,160,0,730
1721,190,40,40,80,160,0,510
1722,190,160,80,0,0,0,430
1723,230,180,120,80,160,0,770
1724,160,160,200,80,160,0,760
1725,210,100,80,80,0,0,470
1726,170,160,80,80,160,0,650
1727,220,80,40,0,0,0,340
1728,180,100,80,0,0,0,360
1729,180,140,160,240,160,0,880
1730,170,60,40,0,0,0,270
1731,210,120,120,80,160,0,690
1732,170,180,200,240,320,320,1430
1733,210,160,80,80,0,0,530
1734,180,140,80,80,160,0,640
1735,190,140,120,80,160,0,690
1736,160,140,160,240,0,0,700
1737,230,140,120,160,160,0,810
1738,240,80,80,160,160,0,720
1739,230,120,120,80,160,0,710
1740,160,120,160,80,0,0,520
1741,210,120,120,80,0,0,530
1742,200,140,200,160,160,0,860
1743,190,120,120,80,0,0,510
1744,190,60,80,80,160,0,570
1745,220,80,160,80,160,0,700
1746,120,60,80,0,0,0,260
1747,170,100,80,80,160,0,590
1748,200,200,160,160,160,0,880
1749,200,140,120,80,0,0,540
1750,220,160,120,160,320,0,980
1751,190,100,40,0,0,0,330
1752,190,100,80,80,160,0,610
1753,200,80,160,240,160,0,840
1754,200,100,80,80,0,0,460
1755,200,160,200,160,320,0,1040
1756,220,120,80,160,160,0,740
1757,240,180,80,80,0,0,580
1758,180,100,80,0,0,0,360
1759,170,120,80,80,160,0,610
1760,190,180,80,80,0,0,530
1761,190,140,120,80,160,320,1010
1762,180,140,160,240,160,0,880
1763,190,100,80,80,160,320,930
1764,160,100,80,160,320,0,820
1765,220,180,120,160,0,0,680
1766,240,100,80,80,160,0,660
1767,200,120,80,160,160,0,720
1768,210,120,120,240,160,0,850
1769,190,140,120,160,320,0,930
1770,220,140,80,0,0,0,440
1771,150,60,40,80,160,0,490
1772,180,120,120,80,0,0,500
1773,190,80,80,160,160,320,990
1774,210,100,160,160,160,0,790
1775,190,140,120,80,0,0,530
1776,220,140,120,80,160,0,720
1777,220,160,120,160,160,0,820
1778,200,160,120,80,160,0,720
1779,160,60,80,80,160,0,540
1780,200,160,120,80,160,0,720
1781,220,120,40,0,0,0,380
1782,170,80,40,80,160,0,530
1783,160,60,40,80,160,0,500
1784,150,100,80,0,0,0,330
1785,230,80,80,160,0,0,550
1786,160,60,80,80,160,0,540
1787,190,120,160,80,160,320,1030
1788,200,100,120,160,320,320,1220
1789,190,140,120,80,160,0,690
1790,230,140,120,0,0,0,490
1791,170,140,80,0,0,0,390
1792,220,140,160,80,160,320,1080
1793,180,180,120,160,160,0,800
1794,200,140,120,160,160,0,780
1795,210,140,160,80,0,0,590
1796,150,140,120,160,320,0,890
1797,160,140,80,160,320,320,1180
1798,230,120,160,160,320,0,990
1799,150,100,80,160,320,320,1130
1800,200,120,80,80,160,0,640
1801,150,80,80,80,160,0,550
1802,180,100,80,80,0,0,440
1803,190,140,80,0,0,0,410
1804,220,120,120,80,160,0,700
1805,190,120,120,160,160,0,750
1806,190,120,120,80,160,0,670
1807,180,140,40,80,160,0,600
1808,200,100,80,80,160,0,620
1809,200,140,160,160,160,0,820
1810,190,80,80,80,0,0,430
1811,210,140,80,80,160,0,670
1812,210,160,80,80,160,0,690
1813,190,60,0,0,0,0,250
1814,210,140,120,0,0,0,470
1815,220,60,40,0,0,0,320
1816,180,100,120,160,160,0,720
1817,170,160,80,80,160,0,650
1818,220,140,80,80,160,0,680
1819,200,100,80,160,320,0,860
1820,180,120,120,240,320,320,1300
1821,230,160,40,80,160,320,990
1822,200,60,0,0,0,0,260
1823,200,140,120,160,160,0,780
1824,200,120,120,160,160,0,760
1825,150,100,120,0,0,0,370
1826,190,120,120,80,160,0,670
1827,230,180,160,160,320,0,1050
1828,210,100,160,160,160,320,1110
1829,180,140,80,80,160,0,640
1830,180,160,120,0,0,0,460
1831,220,120,120,0,0,0,460
1832,170,160,120,0,0,0,450
1833,190,160,160,240,0,0,750
1834,200,160,120,80,160,0,720
1835,170,80,80,80,160,0,570
1836,210,60,120,240,160,0,790
1837,200,120,80,80,160,0,640
1838,170,60,80,80,160,320,870
1839,210,120,40,0,0,0,370
1840,180,80,80,0,0,0,340
1841,180,200,80,0,0,0,460
1842,240,160,120,80,0,0,600
1843,200,160,80,80,160,0,680
1844,230,200,80,80,0,0,590
1845,180,100,120,80,160,0,640
1846,220,160,120,80,160,0,740
1847,200,160,160,160,160,320,1160
1848,200,100,40,0,0,0,340
1849,140,80,80,160,160,0,620
1850,220,120,80,160,320,320,1220
1851,210,100,80,160,320,320,1190
1852,200,120,80,80,0,0,480
1853,160,180,160,80,0,0,580
1854,190,120,160,240,320,0,1030
1855,220,60,40,0,0,0,320
1856,220,160,240,240,320,0,1180
1857,200,120,80,80,160,320,960
1858,180,160,160,160,160,320,1140
1859,200,60,80,80,0,0,420
1860,200,100,120,160,160,0,740
1861,230,120,160,160,0,0,670
1862,160,80,80,80,160,0,560
1863,200,160,200,160,0,0,720
1864,210,120,120,240,320,0,1010
1865,210,160,80,80,160,320,1010
1866,180,140,40,0,0,0,360
1867,190,120,200,240,320,0,1070
1868,190,100,120,80,160,320,970
1869,200,120,80,160,160,0,720
1870,190,200,160,240,320,0,1110
1871,230,120,40,80,160,0,630
1872,180,140,120,160,320,0,920
1873,220,180,160,80,160,320,1120
1874,210,140,200,160,160,0,870
1875,160,120,120,0,0,0,400
1876,200,100,80,80,160,320,940
1877,220,120,80,80,160,0,660
1878,150,180,120,80,0,0,530
1879,170,120,120,80,160,0,650
1880,180,140,120,80,160,0,680
1881,210,80,40,80,160,320,890
1882,210,120,160,80,0,0,570
1883,140,100,40,80,0,0,360
1884,170,80,40,0,0,0,290
1885,170,140,160,240,320,0,1030
1886,200,120,200,80,0,0,600
1887,180,100,80,80,160,0,600
1888,170,120,80,160,160,0,690
1889,220,120,120,80,0,0,540
1890,190,100,80,80,160,0,610
1891,190,60,40,0,0,0,290
1892,170,160,120,80,160,0,690
1893,190,120,120,240,320,320,1310
1894,200,120,40,80,160,0,600
1895,230,140,160,240,160,0,930
1896,240,160,120,0,0,0,520
1897,230,180,160,160,160,0,890
1898,210,160,160,160,160,0,850
1899,220,180,80,80,160,0,720
1900,220,160,160,80,160,0,780
1901,210,100,120,0,0,0,430
1902,180,120,120,80,160,320,980
1903,180,120,40,0,0,0,340
1904,180,140,160,240,320,0,1040
1905,220,80,120,160,160,0,740
1906,240,160,80,0,0,0,480
1907,200,120,200,160,160,0,840
1908,220,80,0,0,0,0,300
1909,230,80,120,160,160,0,750
1910,180,120,80,80,160,0,620
1911,200,140,120,160,320,320,1260
1912,200,140,120,160,160,0,780
1913,190,160,120,0,0,0,470
1914,250,120,80,80,160,0,690
1915,160,100,80,80,160,0,580
1916,190,120,120,80,0,0,510
1917,200,160,200,160,160,0,880
1918,220,120,40,0,0,0,380
1919,230,120,80,160,0,0,590
1920,220,100,80,80,0,0,480
1921,200,120,120,160,160,0,760
1922,200,80,0,0,0,0,280
1923,200,140,160,240,320,0,1060
1924,200,140,120,160,0,0,620
1925,140,140,80,0,0,0,360
1926,200,140,80,0,0,0,420
1927,200,80,80,160,160,0,680
1928,190,160,160,240,320,320,1390
1929,160,100,80,80,160,0,580
1930,240,120,80,80,160,0,680
1931,170,120,80,160,0,0,530
1932,220,100,80,80,160,320,960
1933,200,100,120,160,160,0,740
1934,220,120,120,160,160,0,780
1935,180,60,80,80,160,0,560
1936,190,140,40,80,160,0,610
1937,170,120,160,80,0,0,530
1938,220,120,80,80,0,0,500
1939,190,120,120,160,160,0,750
1940,170,80,120,160,0,0,530
1941,190,120,160,160,0,0,630
1942,210,120,80,80,0,0,490
1943,210,120,160,160,160,0,810
1944,160,80,80,160,160,320,960
1945,170,120,160,80,160,0,690
1946,210,140,80,0,0,0,430
1947,240,100,160,240,320,0,1060
1948,180,120,120,160,160,0,740
1949,200,120,120,80,160,0,680
1950,220,160,160,160,160,0,860
1951,210,120,0,0,0,0,330
1952,240,180,80,80,0,0,580
1953,150,100,40,0,0,0,290
1954,170,160,80,160,320,0,890
1955,190,120,120,0,0,0,430
1956,190,100,120,160,320,320,1210
1957,170,60,40,0,0,0,270
1958,190,140,120,160,0,0,610
1959,240,120,40,80,0,0,480
1960,230,160,80,80,0,0,550
1961,190,120,120,160,160,0,750
1962,210,120,120,0,0,0,450
1963,180,100,80,80,0,0,440
1964,210,80,120,0,0,0,410
1965,150,40,0,0,0,0,190
1966,150,60,40,80,160,0,490
1967,220,100,160,160,160,0,800
1968,210,140,120,80,160,0,710
1969,220,160,120,0,0,0,500
1970,230,80,40,0,0,0,350
1971,190,140,120,80,160,0,690
1972,180,100,80,80,160,0,600
1973,200,80,120,160,160,0,720
1974,200,100,80,80,160,0,620
1975,190,120,120,80,160,0,670
1976,190,120,40,80,160,0,590
1977,190,120,40,0,0,0,350
1978,180,140,160,160,320,320,1280
1979,230,220,200,160,160,0,970
1980,200,100,40,0,0,0,340
1981,210,140,160,160,0,0,670
1982,210,140,120,80,160,0,710
1983,210,100,120,160,160,0,750
1984,210,140,120,80,0,0,550
1985,230,100,160,160,0,0,650
1986,190,120,120,80,0,0,510
1987,190,160,120,80,0,0,550
1988,160,160,80,80,0,0,480
1989,220,160,120,80,0,0,580
1990,190,140,80,80,160,0,650
1991,230,180,120,80,160,0,770
1992,200,120,80,80,160,0,640
1993,230,120,120,80,160,0,710
1994,210,180,120,240,160,320,1230
1995,160,80,80,160,160,0,640
1996,190,160,200,80,160,0,790
1997,200,140,120,80,0,0,540
1998,210,100,120,80,0,0,510
1999,190,140,80,80,0,0,490
2000,230,120,120,160,0,0,630
2001,160,100,80,160,160,0,660
2002,160,60,80,160,320,0,780
2003,180,180,200,160,160,0,880
2004,210,160,80,80,0,0,530
2005,210,100,120,80,160,0,670
2006,190,100,80,80,0,0,450
2007,220,80,80,160,0,0,540
2008,190,100,40,0,0,0,330
2009,180,120,120,80,0,0,500
2010,190,120,40,80,160,0,590
2011,200,60,80,80,160,0,580
2012,250,180,120,80,0,0,630
2013,150,140,160,160,320,0,930
2014,200,120,120,160,320,320,1240
2015,250,160,80,80,160,0,730
2016,220,160,80,160,0,0,620
2017,220,160,80,80,160,320,1020
2018,200,160,80,80,160,0,680
2019,210,120,80,80,160,0,650
2020,190,140,120,240,320,0,1010
2021,210,160,120,80,0,0,570
2022,160,40,40,80,160,0,480
2023,220,100,80,80,0,0,480
2024,230,180,120,0,0,0,530
2025,190,100,80,80,0,0,450
2026,200,100,160,160,320,0,940
2027,190,160,120,240,320,0,1030
2028,210,160,80,160,160,0,770
2029,200,140,40,0,0,0,380
2030,210,140,80,80,0,0,510
2031,230,100,120,160,160,0,770
2032,180,120,120,160,320,0,900
2033,160,80,40,80,160,320,840
2034,250,160,80,80,0,0,570
2035,150,60,0,0,0,0,210
2036,200,80,80,80,160,0,600
2037,170,160,160,80,160,0,730
2038,200,100,80,80,160,0,620
2039,220,100,80,0,0,0,400
2040,220,120,120,160,160,0,780
2041,180,140,80,80,160,0,640
2042,200,140,80,80,160,0,660
2043,230,80,80,80,0,0,470
2044,180,120,80,160,160,0,700
2045,190,120,40,0,0,0,350
2046,170,120,120,160,160,0,730
2047,170,60,40,80,160,0,510
2048,170,80,120,80,160,0,610
2049,230,160,80,160,0,0,630
2050,160,140,160,160,160,0,780
2051,190,80,120,160,160,0,710
2052,210,120,120,80,160,0,690
2053,230,180,120,160,160,0,850
2054,220,160,120,160,160,0,820
2055,180,180,40,0,0,0,400
2056,220,140,200,160,320,0,1040
2057,230,180,160,160,320,0,1050
2058,230,160,80,80,0,0,550
2059,190,80,40,80,160,0,550
2060,180,60,0,0,0,0,240
2061,180,160,160,240,320,320,1380
2062,210,120,120,80,160,0,690
2063,170,120,160,160,320,0,930
2064,190,100,80,160,160,0,690
2065,190,140,160,240,160,320,1210
2066,180,140,240,80,160,0,800
2067,210,100,80,80,0,0,470
2068,160,100,80,80,0,0,420
2069,200,180,80,0,0,0,460
2070,170,140,80,0,0,0,390
2071,220,100,120,160,160,320,1080
2072,180,140,160,240,160,0,880
2073,240,160,120,80,160,0,760
2074,220,140,160,160,160,0,840
2075,200,160,160,160,160,0,840
2076,200,80,120,80,0,0,480
2077,150,100,120,160,160,0,690
2078,220,140,120,160,160,0,800
2079,160,160,80,80,0,0,480
2080,170,120,80,80,160,0,610
2081,180,100,200,240,160,0,880
2082,220,140,120,160,160,0,800
2083,190,80,80,80,160,0,590
2084,190,160,120,160,320,320,1270
2085,170,100,160,160,320,320,1230
2086,230,200,120,80,0,0,630
2087,220,180,40,0,0,0,440
2088,200,120,80,80,0,0,480
2089,180,80,120,240,160,0,780
2090,190,100,80,80,0,0,450
2091,210,120,160,80,160,0,730
2092,180,80,120,80,160,0,620
2093,180,100,160,160,160,0,760
2094,190,100,120,160,160,0,730
2095,180,120,80,0,0,0,380
2096,220,160,160,0,0,0,540
2097,240,160,80,80,0,0,560
2098,200,140,120,80,160,0,700
2099,200,140,120,0,0,0,460
2100,160,100,40,0,0,0,300
2101,190,80,40,80,0,0,390
2102,190,140,120,80,160,0,690
2103,230,180,120,160,0,0,690
2104,210,140,120,80,160,0,710
2105,200,100,120,80,160,320,980
2106,150,60,40,0,0,0,250
2107,220,140,160,160,160,0,840
2108,230,160,120,160,160,0,830
2109,200,100,120,80,0,0,500
2110,190,100,120,80,0,0,490
2111,190,120,40,0,0,0,350
2112,170,140,80,160,160,0,710
2113,200,60,40,80,160,0,540
2114,180,100,120,80,0,0,480
2115,190,80,40,80,0,0,390
2116,220,80,120,80,0,0,500
2117,210,140,160,80,0,0,590
2118,180,120,120,0,0,0,420
2119,180,100,80,80,160,320,920
2120,200,120,200,0,0,0,520
2121,200,160,120,80,160,0,720
2122,160,140,160,80,160,320,1020
2123,180,120,120,80,0,0,500
2124,140,100,120,160,160,0,680
2125,180,140,160,80,0,0,560
2126,200,140,80,0,0,0,420
2127,260,140,120,80,160,0,760
2128,190,160,160,80,0,0,590
2129,210,80,80,0,0,0,370
2130,230,140,80,160,160,320,1090
2131,200,80,80,80,160,320,920
2132,160,80,80,80,0,0,400
2133,180,120,120,80,160,320,980
2134,170,100,0,0,0,0,270
2135,210,100,120,80,0,0,510
2136,170,100,120,80,160,0,630
2137,210,140,120,240,160,0,870
2138,220,100,120,80,160,320,1000
2139,220,200,200,80,160,0,860
2140,180,100,80,80,160,0,600
2141,230,140,40,0,0,0,410
2142,210,140,120,80,160,320,1030
2143,170,160,160,160,160,0,810
2144,200,120,0,0,0,0,320
2145,230,160,200,80,160,0,830
2146,220,140,40,80,160,0,640
2147,230,200,80,80,160,0,750
2148,210,140,120,160,320,0,950
2149,200,140,80,0,0,0,420
2150,210,120,80,80,160,0,650
2151,140,80,80,160,320,0,780
2152,210,160,80,80,160,320,1010
2153,200,160,160,240,160,320,1240
2154,210,200,120,160,160,0,850
2155,220,100,80,0,0,0,400
2156,170,60,40,80,0,0,350
2157,180,80,80,80,160,0,580
2158,220,180,80,80,160,0,720
2159,180,120,120,160,320,320,1220
2160,170,100,80,160,160,320,990
2161,210,180,120,240,320,320,1390
2162,210,120,120,80,160,0,690
2163,210,100,120,80,0,0,510
2164,210,140,80,80,0,0,510
2165,160,120,160,80,160,0,680
2166,180,100,80,80,160,0,600
2167,200,60,80,80,0,0,420
2168,190,120,80,160,0,0,550
2169,190,20,40,80,0,0,330
2170,190,120,120,80,0,0,510
2171,180,140,80,0,0,0,400
2172,220,140,80,0,0,0,440
2173,210,200,160,160,0,0,730
2174,180,120,80,0,0,0,380
2175,200,160,120,80,160,0,720
2176,200,140,120,160,160,0,780
2177,170,120,120,80,160,0,650
2178,200,80,120,80,160,0,640
2179,170,120,160,80,0,0,530
2180,200,160,160,160,160,320,1160
2181,200,100,80,80,0,0,460
2182,130,100,120,240,320,0,910
2183,200,100,120,80,160,320,980
2184,150,80,120,160,160,0,670
2185,160,140,160,160,0,0,620
2186,180,100,120,160,160,0,720
2187,150,120,160,80,160,0,670
2188,200,140,80,80,0,0,500
2189,210,100,80,80,0,0,470
2190,180,80,40,0,0,0,300
2191,170,120,120,80,160,0,650
2192,210,100,120,240,160,0,830
2193,190,160,120,160,160,0,790
2194,190,160,160,240,320,0,1070
2195,230,180,80,160,160,320,1130
2196,220,140,120,160,160,320,1120
2197,240,140,120,160,320,0,980
2198,220,120,120,160,160,0,780
2199,220,120,80,80,160,0,660
2200,150,80,40,80,160,320,830
2201,190,140,0,0,0,0,330
2202,220,140,120,0,0,0,480
2203,230,140,120,160,160,320,1130
2204,210,140,120,160,160,320,1110
2205,200,140,160,160,160,0,820
2206,220,140,200,240,320,320,1440
2207,230,140,160,80,0,0,610
2208,220,200,120,160,160,0,860
2209,210,100,120,160,320,0,910
2210,180,120,160,80,0,0,540
2211,210,160,120,80,160,0,730
2212,230,160,120,80,0,0,590
2213,210,100,160,80,160,0,710
2214,190,80,80,80,160,0,590
2215,170,80,120,160,160,0,690
2216,220,100,120,160,160,0,760
2217,210,140,160,240,160,320,1230
2218,180,120,120,240,320,0,980
2219,180,120,120,0,0,0,420
2220,160,100,80,80,160,0,580
2221,200,160,120,0,0,0,480
2222,240,140,120,80,0,0,580
2223,220,160,120,240,320,0,1060
2224,200,120,120,160,320,320,1240
2225,190,180,120,160,320,0,970
2226,220,120,80,80,160,0,660
2227,160,80,160,80,160,0,640
2228,220,120,80,160,160,0,740
2229,180,180,160,80,160,0,760
2230,180,120,120,160,320,320,1220
2231,180,140,160,80,0,0,560
2232,220,160,80,80,160,0,700
2233,180,120,120,80,0,0,500
2234,180,100,120,160,320,320,1200
2235,210,120,80,0,0,0,410
2236,180,100,40,80,160,0,560
2237,180,140,160,160,160,0,800
2238,220,120,80,80,160,0,660
2239,180,120,160,160,160,0,780
2240,210,140,160,240,160,0,910
2241,190,160,120,160,320,0,950
2242,220,60,80,80,160,320,920
2243,180,80,120,240,320,320,1260
2244,210,160,200,240,320,0,1130
2245,170,140,240,80,0,0,630
2246,160,160,120,80,160,320,1000
2247,200,100,40,80,160,0,580
2248,190,100,120,80,0,0,490
2249,200,80,40,80,160,0,560
2250,200,180,160,160,0,0,700
2251,210,120,120,240,160,0,850
2252,180,100,80,160,320,0,840
2253,210,140,160,160,160,320,1150
2254,190,80,80,80,160,0,590
2255,190,60,120,160,0,0,530
2256,190,120,40,0,0,0,350
2257,210,200,200,160,160,0,930
2258,210,120,120,160,0,0,610
2259,190,120,80,0,0,0,390
2260,180,80,40,80,160,320,860
2261,210,140,120,160,0,0,630
2262,210,120,80,160,0,0,570
2263,210,160,120,0,0,0,490
2264,190,100,160,160,320,0,930
2265,200,80,120,80,160,0,640
2266,160,160,160,80,160,0,720
2267,210,140,200,240,160,0,950
2268,190,100,40,80,160,0,570
2269,200,80,120,80,0,0,480
2270,190,120,40,0,0,0,350
2271,190,180,160,160,320,0,1010
2272,160,140,80,80,160,0,620
2273,200,100,80,0,0,0,380
2274,180,80,40,80,160,0,540
2275,240,180,200,240,0,0,860
2276,250,140,80,80,160,0,710
2277,190,120,80,80,160,0,630
2278,210,180,80,0,0,0,470
2279,210,140,160,160,320,0,990
2280,170,120,160,240,320,0,1010
2281,180,120,40,0,0,0,340
2282,210,180,160,240,160,0,950
2283,200,100,160,80,160,0,700
2284,200,140,160,160,160,0,820
2285,210,120,160,160,320,0,970
2286,230,140,120,160,160,0,810
2287,180,120,120,80,160,0,660
2288,220,160,160,160,0,0,700
2289,180,60,80,80,0,0,400
2290,190,100,120,160,320,0,890
2291,190,160,120,80,160,320,1030
2292,170,120,160,160,0,0,610
2293,210,140,160,160,160,0,830
2294,230,140,80,80,160,0,690
2295,220,120,120,80,160,320,1020
2296,190,120,120,160,160,320,1070
2297,230,60,40,0,0,0,330
2298,180,100,160,80,0,0,520
2299,220,180,160,160,160,0,880
2300,150,80,120,80,160,0,590
2301,220,120,120,80,160,0,700
2302,160,20,40,80,0,0,300
2303,190,120,120,160,160,320,1070
2304,170,120,80,80,160,320,930
2305,200,140,160,80,160,320,1060
2306,200,140,80,80,160,0,660
2307,200,160,160,160,160,320,1160
2308,180,60,120,80,160,0,600
2309,220,120,120,160,0,0,620
2310,190,120,120,0,0,0,430
2311,220,100,120,160,320,0,920
2312,250,120,40,80,160,0,650
2313,190,120,80,160,160,320,1030
2314,220,140,120,80,0,0,560
2315,180,100,80,160,320,0,840
2316,210,80,40,0,0,0,330
2317,200,100,120,80,160,0,660
2318,190,100,40,80,160,0,570
2319,230,120,120,160,320,0,950
2320,180,140,120,80,160,0,680
2321,160,100,120,0,0,0,380
2322,230,100,160,80,0,0,570
2323,200,100,80,80,160,0,620
2324,200,100,40,0,0,0,340
2325,200,100,80,160,320,0,860
2326,230,120,80,80,160,0,670
2327,200,180,160,0,0,0,540
2328,160,120,120,80,160,0,640
2329,230,80,80,80,0,0,470
2330,210,120,40,0,0,0,370
2331,220,140,120,160,160,0,800
2332,170,140,160,80,160,0,710
2333,220,140,80,160,160,0,760
2334,200,140,120,160,0,0,620
2335,160,180,160,80,0,0,580
2336,180,140,80,80,160,0,640
2337,220,160,240,80,0,0,700
2338,170,60,80,80,160,0,550
2339,200,120,120,160,320,0,920
2340,210,120,80,80,0,0,490
2341,240,120,120,0,0,0,480
2342,230,100,160,0,0,0,490
2343,190,80,80,0,0,0,350
2344,170,100,120,240,160,0,790
2345,180,60,40,80,160,0,520
2346,220,100,80,160,320,0,880
2347,190,120,120,160,160,0,750
2348,200,160,80,0,0,0,440
2349,200,120,120,160,0,0,600
2350,180,180,240,240,160,0,1000
2351,160,120,80,80,0,0,440
2352,160,120,80,0,0,0,360
2353,160,80,40,0,0,0,280
2354,160,60,80,80,0,0,380
2355,200,140,160,80,0,0,580
2356,150,120,120,80,160,0,630
2357,200,120,160,160,160,0,800
2358,210,180,120,160,320,0,990
2359,220,140,120,80,0,0,560
2360,190,60,40,80,160,0,530
2361,180,60,80,80,160,0,560
2362,200,160,160,80,0,0,600
2363,210,80,40,80,160,0,570
2364,190,120,40,0,0,0,350
2365,210,160,200,240,0,0,810
2366,210,120,200,80,160,0,770
2367,170,80,80,0,0,0,330
2368,220,60,40,80,160,0,560
2369,190,120,200,80,160,0,750
2370,230,120,160,80,0,0,590
2371,200,100,40,80,0,0,420
2372,170,100,120,240,160,0,790
2373,190,100,40,0,0,0,330
2374,160,100,120,0,0,0,380
2375,200,160,80,80,160,320,1000
2376,170,140,120,160,0,0,590
2377,170,100,80,160,160,320,990
2378,220,160,120,0,0,0,500
2379,220,100,120,80,160,0,680
2380,240,140,80,80,0,0,540
2381,170,100,120,160,160,0,710
2382,190,100,40,80,0,0,410
2383,200,140,80,80,160,320,980
2384,210,80,80,80,160,0,610
2385,210,100,120,80,0,0,510
2386,220,180,160,160,160,0,880
2387,210,160,120,80,0,0,570
2388,210,200,200,240,160,320,1330
2389,170,100,40,80,160,0,550
2390,160,100,80,80,160,0,580
2391,160,80,120,80,160,0,600
2392,180,80,80,0,0,0,340
2393,220,120,160,160,160,0,820
2394,170,120,120,160,320,0,890
2395,220,100,80,80,0,0,480
2396,180,100,40,80,160,0,560
2397,220,120,160,0,0,0,500
2398,170,100,160,240,160,0,830
2399,220,160,40,80,160,0,660
2400,180,100,160,240,320,320,1320
2401,210,100,80,0,0,0,390
2402,190,140,40,80,0,0,450
2403,190,160,120,80,160,0,710
2404,220,60,80,0,0,0,360
2405,170,80,120,160,160,0,690
2406,210,120,160,80,0,0,570
2407,180,120,40,80,160,0,580
2408,200,140,80,160,160,0,740
2409,230,140,120,240,320,0,1050
2410,180,80,40,80,0,0,380
2411,190,140,120,80,0,0,530
2412,220,160,120,80,160,0,740
2413,220,160,80,0,0,0,460
2414,190,140,120,80,0,0,530
2415,240,120,40,0,0,0,400
2416,170,160,80,80,160,0,650
2417,220,160,160,160,160,0,860
2418,200,140,80,80,160,0,660
2419,220,140,120,80,0,0,560
2420,190,100,40,0,0,0,330
2421,180,120,80,0,0,0,380
2422,220,160,80,160,160,0,780
2423,180,120,80,0,0,0,380
2424,210,140,120,80,160,0,710
2425,220,140,120,80,0,0,560
2426,220,120,120,80,0,0,540
2427,200,160,120,0,0,0,480
2428,190,140,40,80,160,320,930
2429,210,120,80,0,0,0,410
2430,230,140,120,80,0,0,570
2431,190,160,160,160,160,0,830
2432,200,120,120,160,0,0,600
2433,250,80,80,80,160,0,650
2434,200,120,80,80,160,0,640
2435,220,100,80,80,0,0,480
2436,220,100,80,0,0,0,400
2437,230,140,160,0,0,0,530
2438,180,60,120,160,320,0,840
2439,190,120,120,80,160,0,670
2440,220,40,40,80,160,0,540
2441,180,80,120,80,160,0,620
2442,160,120,120,80,0,0,480
2443,220,140,160,160,160,0,840
2444,200,120,40,80,160,0,600
2445,190,140,160,160,0,0,650
2446,180,120,120,160,320,320,1220
2447,190,120,80,80,160,0,630
2448,210,100,120,80,160,0,670
2449,150,60,40,80,0,0,330
2450,210,140,160,80,160,320,1070
2451,250,200,200,80,0,0,730
2452,170,140,160,0,0,0,470
2453,220,100,120,160,160,0,760
2454,200,80,40,0,0,0,320
2455,220,100,80,80,160,0,640
2456,210,120,80,0,0,0,410
2457,200,100,120,80,0,0,500
2458,170,60,120,80,0,0,430
2459,210,120,120,160,0,0,610
2460,210,140,120,0,0,0,470
2461,170,160,120,160,0,0,610
2462,170,140,160,240,160,320,1190
2463,210,100,120,80,160,0,670
2464,170,80,120,160,160,320,1010
2465,210,120,120,80,160,0,690
2466,220,160,160,160,0,0,700
2467,230,80,120,80,0,0,510
2468,210,160,120,160,160,0,810
2469,160,60,0,0,0,0,220
2470,230,140,80,160,0,0,610
2471,210,100,120,160,160,0,750
2472,230,120,120,80,0,0,550
2473,150,80,80,160,160,0,630
2474,190,100,80,160,160,0,690
2475,140,120,80,160,320,0,820
2476,220,140,160,240,320,320,1400
2477,190,120,160,240,320,0,1030
2478,220,120,80,80,160,0,660
2479,230,120,120,0,0,0,470
2480,180,120,160,160,160,0,780
2481,210,80,40,80,160,0,570
2482,180,60,80,160,160,0,640
2483,220,160,160,80,160,0,780
2484,170,120,160,160,160,320,1090
2485,190,100,120,160,320,0,890
2486,220,100,80,0,0,0,400
2487,180,140,240,160,0,0,720
2488,150,100,40,0,0,0,290
2489,200,160,40,80,0,0,480
2490,180,80,80,0,0,0,340
2491,200,140,120,160,160,0,780
2492,170,100,80,80,0,0,430
2493,200,140,200,240,320,320,1420
2494,200,80,40,80,160,320,880
2495,210,180,160,160,0,0,710
2496,190,160,160,160,320,320,1310
2497,200,100,120,0,0,0,420
2498,190,140,0,0,0,0,330
2499,160,160,200,160,160,320,1160
2500,180,120,160,80,0,0,540
2501,190,160,120,160,320,0,950
2502,210,140,160,160,320,0,990
2503,230,120,80,160,160,0,750
2504,180,120,40,0,0,0,340
2505,200,100,80,80,160,0,620
2506,220,180,120,80,160,320,1080
2507,170,60,80,160,160,0,630
2508,180,120,160,160,160,0,780
2509,220,140,120,80,160,320,1040
2510,150,100,40,80,0,0,370
2511,180,60,40,0,0,0,280
2512,210,100,120,80,160,0,670
2513,200,160,160,80,0,0,600
2514,200,120,40,80,160,320,920
2515,170,140,120,80,0,0,510
2516,190,140,160,160,160,0,810
2517,160,120,120,80,0,0,480
2518,140,80,80,80,0,0,380
2519,200,120,120,160,160,0,760
2520,190,80,40,80,160,0,550
2521,190,120,160,160,160,0,790
2522,190,60,40,0,0,0,290
2523,210,120,80,0,0,0,410
2524,190,120,200,80,0,0,590
2525,180,120,120,160,160,320,1060
2526,230,80,0,0,0,0,310
2527,180,80,80,80,160,0,580
2528,150,100,160,80,0,0,490
2529,170,140,120,160,320,0,910
2530,190,60,40,0,0,0,290
2531,170,120,40,80,160,0,570
2532,190,160,160,80,0,0,590
2533,160,100,120,240,320,0,940
2534,160,100,40,80,160,320,860
2535,200,100,40,80,160,0,580
2536,200,140,120,80,160,0,700
2537,220,160,80,80,0,0,540
2538,190,120,80,80,0,0,470
2539,180,120,80,160,160,0,700
2540,180,100,80,80,160,0,600
2541,210,120,80,80,160,0,650
2542,180,100,80,160,160,0,680
2543,160,100,120,80,160,0,620
2544,160,100,80,80,160,0,580
2545,150,100,120,0,0,0,370
2546,210,120,80,0,0,0,410
2547,200,100,80,80,160,320,940
2548,180,100,80,80,0,0,440
2549,190,100,120,80,0,0,490
2550,160,120,80,80,160,0,600
2551,190,120,160,80,0,0,550
2552,200,180,160,160,320,0,1020
2553,170,100,80,160,320,0,830
2554,190,60,80,160,0,0,490
2555,220,140,120,0,0,0,480
2556,210,140,160,0,0,0,510
2557,180,100,120,80,160,0,640
2558,180,80,120,80,160,0,620
2559,210,120,160,80,160,0,730
2560,200,120,160,160,0,0,640
2561,180,160,120,0,0,0,460
2562,210,120,120,80,0,0,530
2563,190,140,160,80,160,0,730
2564,200,140,80,0,0,0,420
2565,210,120,120,160,320,320,1250
2566,150,140,120,80,160,0,650
2567,190,140,160,160,160,0,810
2568,180,140,40,80,0,0,440
2569,210,120,120,160,160,0,770
2570,220,120,0,0,0,0,340
2571,200,140,120,160,160,0,780
2572,170,120,120,80,160,0,650
2573,210,120,120,160,160,0,770
2574,200,140,40,80,160,0,620
2575,170,60,40,0,0,0,270
2576,170,140,80,160,160,0,710
2577,180,120,160,80,0,0,540
2578,210,200,160,80,0,0,650
2579,200,140,200,160,320,0,1020
2580,180,140,80,160,160,0,720
2581,200,160,160,160,160,320,1160
2582,220,60,40,80,0,0,400
2583,220,160,80,160,160,0,780
2584,200,100,80,160,320,320,1180
2585,210,140,160,80,0,0,590
2586,190,140,240,240,320,320,1450
2587,210,80,160,80,0,0,530
2588,170,140,120,160,160,0,750
2589,190,160,80,80,0,0,510
2590,210,140,120,80,0,0,550
2591,190,120,160,160,160,0,790
2592,160,100,160,80,160,0,660
2593,210,140,160,160,320,0,990
2594,200,140,80,80,160,320,980
2595,210,120,40,80,160,0,610
2596,230,140,120,160,320,320,1290
2597,180,120,120,160,160,320,1060
2598,220,140,120,80,160,320,1040
2599,210,140,160,240,160,0,910
2600,240,180,160,240,320,320,1460
2601,200,180,40,80,160,0,660
2602,170,180,160,160,320,0,990
2603,230,160,80,160,160,0,790
2604,210,200,240,80,0,0,730
2605,190,120,120,160,320,0,910
2606,200,80,120,160,320,320,1200
2607,200,160,160,160,0,0,680
2608,180,120,80,80,160,0,620
2609,190,120,120,80,0,0,510
2610,220,120,200,240,160,0,940
2611,170,140,80,80,160,0,630
2612,200,120,80,160,0,0,560
2613,170,100,80,160,160,0,670
2614,230,200,120,80,160,0,790
2615,230,140,80,160,160,0,770
2616,150,120,80,0,0,0,350
2617,200,120,40,0,0,0,360
2618,180,100,40,80,160,0,560
2619,170,180,240,240,320,0,1150
2620,210,140,160,80,160,0,750
2621,180,100,80,0,0,0,360
2622,130,60,40,80,160,0,470
2623,190,80,80,160,160,0,670
2624,190,140,160,160,320,0,970
2625,170,120,160,160,320,0,930
2626,180,100,80,80,160,0,600
2627,180,140,200,240,160,0,920
2628,220,80,160,240,0,0,700
2629,200,140,160,240,160,0,900
2630,190,100,40,80,0,0,410
2631,220,100,80,80,0,0,480
2632,170,140,200,160,320,0,990
2633,190,100,80,80,160,0,610
2634,170,80,80,80,160,320,890
2635,200,140,160,240,320,320,1380
2636,170,120,120,80,0,0,490
2637,190,140,160,160,160,0,810
2638,210,140,120,80,160,320,1030
2639,170,120,120,0,0,0,410
2640,220,100,80,160,0,0,560
2641,160,140,120,160,320,0,900
2642,220,160,120,80,160,0,740
2643,230,140,120,80,0,0,570
2644,240,160,120,160,160,0,840
2645,180,80,160,240,320,320,1300
2646,220,100,80,160,160,0,720
2647,200,100,120,80,160,0,660
2648,190,120,40,80,0,0,430
2649,170,120,160,240,160,0,850
2650,200,120,40,80,160,320,920
2651,220,140,120,160,0,0,640
2652,190,200,120,80,160,0,750
2653,240,160,120,80,0,0,600
2654,200,140,80,80,160,320,980
2655,240,160,120,80,0,0,600
2656,200,140,160,160,320,0,980
2657,190,120,80,80,160,0,630
2658,180,160,80,80,0,0,500
2659,200,100,80,0,0,0,380
2660,220,140,200,160,160,320,1200
2661,190,120,40,0,0,0,350
2662,170,80,120,160,320,0,850
2663,190,80,80,80,160,0,590
2664,230,180,160,160,160,0,890
2665,230,120,120,160,320,0,950
2666,200,120,160,240,320,0,1040
2667,170,100,120,80,0,0,470
2668,170,120,80,80,160,320,930
2669,190,160,80,160,320,0,910
2670,180,80,80,160,160,0,660
2671,190,140,120,160,160,0,770
2672,190,120,40,80,0,0,430
2673,210,140,160,160,320,0,990
2674,260,140,120,80,0,0,600
2675,200,100,120,0,0,0,420
2676,200,160,120,80,160,0,720
2677,210,140,80,80,160,320,990
2678,200,40,40,80,160,0,520
2679,230,140,200,240,160,0,970
2680,210,100,160,80,0,0,550
2681,210,140,120,160,160,320,1110
2682,200,100,120,160,160,0,740
2683,180,100,120,0,0,0,400
2684,210,80,0,0,0,0,290
2685,140,100,80,0,0,0,320
2686,180,140,80,160,320,0,880
2687,230,40,80,0,0,0,350
2688,220,60,40,0,0,0,320
2689,180,160,80,80,0,0,500
2690,230,160,240,160,160,320,1270
2691,180,100,120,80,160,0,640
2692,220,140,160,160,0,0,680
2693,210,140,160,160,160,0,830
2694,220,120,120,160,160,0,780
2695,180,80,40,80,160,0,540
2696,230,160,120,80,160,0,750
2697,210,80,120,160,320,0,890
2698,160,160,160,160,0,0,640
2699,180,120,160,160,160,0,780
2700,150,100,120,160,0,0,530
2701,200,140,120,160,160,0,780
2702,150,80,80,160,160,0,630
2703,210,180,160,160,320,320,1350
2704,190,120,120,160,160,0,750
2705,190,160,80,80,160,0,670
2706,190,60,0,0,0,0,250
2707,220,160,80,0,0,0,460
2708,190,100,40,0,0,0,330
2709,190,140,80,160,320,0,890
2710,180,120,160,160,160,0,780
2711,190,140,120,160,0,0,610
2712,190,120,80,80,160,0,630
2713,190,200,160,80,160,320,1110
2714,220,120,120,80,160,0,700
2715,200,140,80,160,160,0,740
2716,170,80,40,80,160,0,530
2717,190,160,40,80,0,0,470
2718,190,60,80,80,0,0,410
2719,190,100,80,160,160,320,1010
2720,190,60,80,160,0,0,490
2721,240,100,160,160,320,0,980
2722,210,140,160,160,160,0,830
2723,190,120,80,160,160,0,710
2724,170,140,120,0,0,0,430
2725,260,160,120,80,160,0,780
2726,200,80,0,0,0,0,280
2727,170,100,40,80,160,0,550
2728,200,100,40,0,0,0,340
2729,210,140,40,80,160,0,630
2730,200,160,120,160,160,320,1120
2731,230,220,160,160,160,320,1250
2732,230,140,120,160,320,0,970
2733,220,140,120,160,160,320,1120
2734,190,80,80,80,160,0,590
2735,220,120,120,80,160,0,700
2736,160,80,80,160,160,0,640
2737,210,160,120,160,320,0,970
2738,190,100,80,80,160,0,610
2739,210,100,200,80,0,0,590
2740,240,100,160,80,160,0,740
2741,190,100,160,80,0,0,530
2742,200,160,160,80,160,0,760
2743,190,140,160,160,160,0,810
2744,240,100,120,160,0,0,620
2745,210,120,40,80,160,0,610
2746,200,180,120,160,160,320,1140
2747,160,80,80,80,160,0,560
2748,220,100,80,80,160,0,640
2749,200,80,80,80,0,0,440
2750,220,100,120,240,320,320,1320
2751,220,60,40,80,160,0,560
2752,200,140,80,80,0,0,500
2753,180,100,80,80,160,0,600
2754,200,180,200,80,160,0,820
2755,210,120,120,240,320,320,1330
2756,200,160,160,160,0,0,680
2757,210,100,160,0,0,0,470
2758,220,120,40,80,0,0,460
2759,180,140,120,160,160,0,760
2760,160,140,160,240,0,0,700
2761,240,160,120,160,320,320,1320
2762,200,80,40,80,160,0,560
2763,220,180,160,80,160,0,800
2764,220,160,80,0,0,0,460
2765,200,160,200,160,160,0,880
2766,200,160,120,80,0,0,560
2767,190,100,80,160,160,0,690
2768,160,100,160,160,320,320,1220
2769,190,140,160,0,0,0,490
2770,210,120,80,0,0,0,410
2771,160,140,120,160,320,0,900
2772,160,120,0,0,0,0,280
2773,150,120,160,80,0,0,510
2774,230,140,160,160,0,0,690
2775,200,180,120,160,160,0,820
2776,160,140,160,160,160,0,780
2777,190,100,120,80,0,0,490
2778,210,80,120,160,160,0,730
2779,190,120,120,160,160,320,1070
2780,200,120,120,240,320,0,1000
2781,220,180,120,0,0,0,520
2782,170,140,120,160,160,320,1070
2783,210,100,120,240,160,0,830
2784,190,140,80,0,0,0,410
2785,180,60,40,80,0,0,360
2786,210,120,120,0,0,0,450
2787,190,100,80,160,160,0,690
2788,210,80,120,160,0,0,570
2789,220,180,160,240,160,0,960
2790,190,140,80,0,0,0,410
2791,190,100,200,80,160,0,730
2792,190,180,160,160,160,0,850
2793,210,100,120,80,160,0,670
2794,250,180,80,0,0,0,510
2795,200,120,80,80,160,0,640
2796,230,120,160,160,0,0,670
2797,160,60,40,80,160,0,500
2798,200,120,120,160,160,0,760
2799,170,140,120,160,0,0,590
2800,180,100,120,80,0,0,480
2801,190,140,80,80,160,0,650
2802,190,100,160,160,320,0,930
2803,190,40,40,80,160,0,510
2804,240,80,40,0,0,0,360
2805,230,160,120,80,0,0,590
2806,180,120,80,80,160,0,620
2807,200,160,160,160,160,320,1160
2808,220,160,0,0,0,0,380
2809,200,60,120,160,320,320,1180
2810,200,140,120,160,320,0,940
2811,210,160,160,160,160,0,850
2812,180,120,120,80,160,320,980
2813,180,100,80,160,160,0,680
2814,220,180,240,80,160,0,880
2815,220,120,120,80,0,0,540
2816,190,140,120,240,160,320,1170
2817,150,120,160,80,160,320,990
2818,170,100,160,160,160,0,750
2819,230,160,160,160,160,320,1190
2820,190,120,160,0,0,0,470
2821,160,140,120,80,0,0,500
2822,180,160,120,80,160,320,1020
2823,190,120,80,80,160,320,950
2824,240,120,160,160,160,0,840
2825,200,100,40,0,0,0,340
2826,190,80,80,160,320,0,830
2827,190,100,120,240,320,0,970
2828,210,160,40,0,0,0,410
2829,200,140,80,160,320,320,1220
2830,180,100,40,0,0,0,320
2831,230,140,80,80,160,0,690
2832,220,120,120,80,160,320,1020
2833,200,160,80,160,160,0,760
2834,210,120,200,80,0,0,610
2835,210,100,120,160,320,0,910
2836,190,80,80,80,0,0,430
2837,220,160,160,160,160,0,860
2838,200,140,80,80,0,0,500
2839,200,140,120,240,160,0,860
2840,240,160,160,160,160,320,1200
2841,190,140,160,160,160,0,810
2842,250,80,80,0,0,0,410
2843,180,140,160,160,320,0,960
2844,190,120,120,80,160,0,670
2845,190,140,120,160,0,0,610
2846,220,120,80,80,0,0,500
2847,190,100,40,80,160,0,570
2848,170,80,80,0,0,0,330
2849,200,100,80,0,0,0,380
2850,220,140,40,80,160,0,640
2851,210,80,120,80,0,0,490
2852,190,140,40,0,0,0,370
2853,200,100,80,0,0,0,380
2854,210,100,80,80,160,0,630
2855,210,140,160,160,0,0,670
2856,220,160,160,80,0,0,620
2857,150,140,120,160,160,320,1050
2858,170,80,40,80,160,0,530
2859,240,120,120,80,160,0,720
2860,200,120,120,240,320,320,1320
2861,190,80,40,80,160,0,550
2862,180,140,80,160,160,0,720
2863,210,120,120,160,320,0,930
2864,210,100,120,0,0,0,430
2865,200,140,120,0,0,0,460
2866,210,140,120,80,0,0,550
2867,230,120,120,80,0,0,550
2868,180,80,40,80,160,320,860
2869,220,180,160,80,160,320,1120
2870,240,140,120,80,0,0,580
2871,200,140,120,160,0,0,620
2872,210,120,120,160,0,0,610
2873,230,160,160,160,0,0,710
2874,180,80,40,80,0,0,380
2875,200,140,120,80,0,0,540
2876,210,140,160,160,160,0,830
2877,230,180,120,80,160,0,770
2878,190,100,0,0,0,0,290
2879,170,40,40,80,160,0,490
2880,190,140,80,0,0,0,410
2881,190,120,120,160,0,0,590
2882,240,120,120,0,0,0,480
2883,230,100,120,80,160,0,690
2884,230,140,80,80,0,0,530
2885,180,100,80,80,0,0,440
2886,170,140,160,80,160,0,710
2887,210,160,120,240,160,0,890
2888,200,80,80,0,0,0,360
2889,240,100,40,0,0,0,380
2890,200,120,200,80,0,0,600
2891,190,100,80,80,160,0,610
2892,240,160,120,160,320,0,1000
2893,190,140,40,80,160,0,610
2894,180,100,120,160,320,0,880
2895,190,100,80,80,0,0,450
2896,180,220,160,160,320,0,1040
2897,180,120,80,160,160,0,700
2898,200,120,160,80,160,0,720
2899,210,100,200,160,160,0,830
2900,230,120,80,0,0,0,430
2901,220,60,0,0,0,0,280
2902,180,100,120,160,160,0,720
2903,240,160,80,0,0,0,480
2904,150,60,120,0,0,0,330
2905,210,100,80,80,0,0,470
2906,210,100,80,0,0,0,390
2907,200,160,0,0,0,0,360
2908,200,120,120,80,160,320,1000
2909,140,100,120,80,160,0,600
2910,180,120,120,80,0,0,500
2911,210,140,160,80,0,0,590
2912,200,80,40,80,160,0,560
2913,210,180,160,80,160,0,790
2914,190,140,160,160,320,0,970
2915,190,120,80,0,0,0,390
2916,200,80,80,80,0,0,440
2917,170,200,200,160,320,320,1370
2918,200,60,40,80,160,0,540
2919,200,80,80,80,160,320,920
2920,200,120,120,160,160,320,1080
2921,170,120,120,80,0,0,490
2922,230,140,120,160,160,0,810
2923,190,160,120,80,160,0,710
2924,160,60,80,80,0,0,380
2925,210,100,80,0,0,0,390
2926,140,80,80,80,160,0,540
2927,190,140,120,160,160,320,1090
2928,230,140,80,80,160,0,690
2929,190,140,120,160,320,0,930
2930,200,140,160,240,320,320,1380
2931,200,120,160,80,160,0,720
2932,230,120,120,160,160,0,790
2933,200,120,120,80,160,0,680
2934,180,60,120,160,160,0,680
2935,210,180,120,80,0,0,590
2936,180,80,120,160,320,0,860
2937,190,80,80,160,160,0,670
2938,220,120,80,80,0,0,500
2939,200,180,200,160,320,0,1060
2940,210,140,200,160,160,0,870
2941,190,80,80,80,0,0,430
2942,180,120,200,160,160,0,820
2943,180,160,120,160,0,0,620
2944,190,100,120,240,320,0,970
2945,240,120,160,80,0,0,600
2946,180,120,120,240,0,0,660
2947,210,160,120,160,160,0,810
2948,190,180,200,80,160,320,1130
2949,200,140,160,240,160,0,900
2950,220,160,160,160,160,0,860
2951,230,180,80,80,0,0,570
2952,220,180,160,80,0,0,640
2953,130,100,120,160,160,320,990
2954,200,160,80,0,0,0,440
2955,210,140,120,80,160,320,1030
2956,210,100,80,80,160,0,630
2957,160,120,80,80,0,0,440
2958,200,80,40,0,0,0,320
2959,170,120,120,80,160,0,650
2960,210,120,120,0,0,0,450
2961,200,160,120,0,0,0,480
2962,210,140,80,160,320,0,910
2963,170,120,200,160,160,0,810
2964,160,100,120,80,160,0,620
2965,220,120,80,80,0,0,500
2966,200,140,80,80,160,0,660
2967,210,120,40,80,160,0,610
2968,160,80,40,80,0,0,360
2969,200,100,0,0,0,0,300
2970,210,160,120,0,0,0,490
2971,180,160,200,240,0,0,780
2972,200,20,40,0,0,0,260
2973,220,160,200,80,160,0,820
2974,220,120,120,160,0,0,620
2975,140,80,40,80,0,0,340
2976,210,140,80,80,0,0,510
2977,170,80,80,0,0,0,330
2978,190,100,160,160,160,0,770
2979,210,120,120,160,320,320,1250
2980,190,180,120,80,0,0,570
2981,210,160,200,160,0,0,730
2982,160,80,120,160,160,320,1000
2983,160,120,160,80,0,0,520
2984,190,120,120,160,160,0,750
2985,190,140,200,80,160,0,770
2986,210,80,40,80,160,0,570
2987,180,60,80,0,0,0,320
2988,190,120,120,80,160,320,990
2989,210,100,40,0,0,0,350
2990,190,160,40,0,0,0,390
2991,200,140,160,80,160,0,740
2992,230,100,40,80,160,0,610
2993,180,140,160,160,160,0,800
2994,200,100,80,160,160,0,700
2995,160,80,80,0,0,0,320
2996,220,100,120,160,160,0,760
2997,190,100,80,160,320,0,850
2998,140,100,80,80,160,0,560
2999,210,80,80,80,0,0,450
3000,160,140,80,80,160,320,940
3001,190,100,120,80,160,0,650
3002,180,160,120,240,160,320,1180
3003,170,100,80,80,0,0,430
3004,190,140,160,160,0,0,650
3005,220,180,40,80,0,0,520
3006,200,100,40,0,0,0,340
3007,160,120,160,80,0,0,520
3008,250,160,200,160,160,0,930
3009,170,80,80,0,0,0,330
3010,190,180,160,240,320,0,1090
3011,210,100,120,160,320,0,910
3012,230,100,160,80,160,0,730
3013,210,160,120,80,160,0,730
3014,170,140,80,80,160,0,630
3015,180,160,160,160,320,0,980
3016,200,140,80,160,0,0,580
3017,200,100,0,0,0,0,300
3018,150,120,80,160,0,0,510
3019,210,100,40,0,0,0,350
3020,200,160,120,80,160,0,720
3021,190,60,0,0,0,0,250
3022,170,160,160,160,0,0,650
3023,210,60,80,0,0,0,350
3024,160,60,80,160,0,0,460
3025,180,120,160,160,320,320,1260
3026,220,100,80,0,0,0,400
3027,170,100,80,0,0,0,350
3028,130,80,40,80,0,0,330
3029,200,120,80,80,160,0,640
3030,190,120,80,80,160,0,630
3031,170,120,160,80,0,0,530
3032,180,80,0,0,0,0,260
3033,180,100,0,0,0,0,280
3034,160,100,40,80,160,0,540
3035,170,140,160,240,320,0,1030
3036,200,180,160,160,160,0,860
3037,160,100,80,80,160,0,580
3038,140,80,120,80,160,0,580
3039,190,120,80,160,160,0,710
3040,200,180,120,80,160,320,1060
3041,210,180,160,160,320,0,1030
3042,180,120,40,80,0,0,420
3043,160,100,120,80,0,0,460
3044,200,160,120,80,160,0,720
3045,180,80,80,80,0,0,420
3046,200,80,80,80,160,0,600
3047,220,160,80,80,160,0,700
3048,190,140,80,0,0,0,410
3049,220,160,200,160,160,0,900
3050,210,100,80,80,160,0,630
3051,140,60,80,160,320,0,760
3052,200,60,0,0,0,0,260
3053,210,200,120,80,0,0,610
3054,180,140,120,160,0,0,600
3055,200,60,80,160,160,0,660
3056,200,200,200,240,320,0,1160
3057,150,100,120,80,0,0,450
3058,220,140,80,0,0,0,440
3059,170,180,160,240,160,0,910
3060,190,160,80,0,0,0,430
3061,200,160,200,160,160,0,880
3062,190,120,120,80,160,0,670
3063,170,140,80,80,160,0,630
3064,210,100,40,80,160,0,590
3065,170,80,80,80,160,0,570
3066,210,120,40,0,0,0,370
3067,180,160,240,80,160,320,1140
3068,180,140,160,160,160,0,800
3069,140,100,120,80,160,0,600
3070,200,100,80,160,320,0,860
3071,210,160,120,80,0,0,570
3072,220,100,80,160,160,0,720
3073,150,80,120,160,320,320,1150
3074,210,160,160,80,160,320,1090
3075,180,140,120,80,0,0,520
3076,200,120,120,0,0,0,440
3077,200,100,80,0,0,0,380
3078,240,160,120,80,0,0,600
3079,180,120,120,240,320,0,980
3080,170,40,0,0,0,0,210
3081,180,160,200,80,0,0,620
3082,190,120,120,160,320,320,1230
3083,200,120,80,0,0,0,400
3084,180,180,160,160,0,0,680
3085,200,60,0,0,0,0,260
3086,210,80,120,160,0,0,570
3087,210,100,80,160,160,0,710
3088,180,100,80,80,0,0,440
3089,190,120,120,80,160,320,990
3090,180,200,200,80,0,0,660
3091,210,100,80,0,0,0,390
3092,170,80,0,0,0,0,250
3093,220,140,120,160,320,0,960
3094,140,100,80,160,320,0,800
3095,170,80,120,160,320,0,850
3096,160,140,80,160,320,0,860
3097,220,100,80,80,160,0,640
3098,200,140,40,80,160,320,940
3099,190,120,120,80,0,0,510
3100,250,60,40,80,160,0,590
3101,180,140,160,80,0,0,560
3102,220,80,80,80,160,320,940
3103,230,80,40,0,0,0,350
3104,190,120,80,80,160,0,630
3105,210,180,80,160,320,0,950
3106,190,120,80,0,0,0,390
3107,190,120,40,80,0,0,430
3108,220,120,80,160,320,320,1220
3109,190,80,120,160,0,0,550
3110,220,80,120,0,0,0,420
3111,190,120,120,160,320,0,910
3112,240,180,120,240,320,0,1100
3113,190,80,40,80,160,0,550
3114,180,100,160,160,320,320,1240
3115,210,100,80,80,160,0,630
3116,180,160,160,160,160,0,820
3117,200,60,80,0,0,0,340
3118,230,100,120,160,160,0,770
3119,190,140,160,80,160,0,730
3120,220,100,80,80,160,0,640
3121,240,140,40,0,0,0,420
3122,210,140,80,0,0,0,430
3123,200,120,80,80,160,0,640
3124,180,80,80,0,0,0,340
3125,170,120,120,80,160,0,650
3126,200,140,160,160,320,0,980
3127,210,140,80,160,160,0,750
3128,180,60,40,80,160,0,520
3129,200,120,80,80,160,0,640
3130,250,160,120,160,160,320,1170
3131,210,140,120,0,0,0,470
3132,200,140,80,80,160,0,660
3133,140,140,120,160,160,0,720
3134,190,140,120,240,160,0,850
3135,190,120,160,0,0,0,470
3136,220,120,120,240,160,0,860
3137,190,140,160,160,160,0,810
3138,190,120,40,80,160,0,590
3139,180,80,80,80,160,320,900
3140,180,120,120,160,0,0,580
3141,190,140,160,0,0,0,490
3142,200,160,120,160,320,320,1280
3143,190,120,80,0,0,0,390
3144,170,160,160,160,160,320,1130
3145,180,120,120,160,160,0,740
3146,160,120,120,80,160,0,640
3147,210,120,120,0,0,0,450
3148,180,100,120,160,320,0,880
3149,220,140,80,0,0,0,440
3150,190,80,120,80,160,0,630
3151,230,120,120,240,160,0,870
3152,160,100,120,80,0,0,460
3153,170,60,40,0,0,0,270
3154,250,160,40,0,0,0,450
3155,220,160,160,80,160,0,780
3156,220,160,120,80,160,0,740
3157,200,100,160,80,0,0,540
3158,190,140,120,160,160,0,770
3159,210,100,80,160,160,0,710
3160,220,160,120,80,160,0,740
3161,200,140,160,160,320,0,980
3162,240,200,200,80,160,0,880
3163,220,120,120,240,160,0,860
3164,200,160,80,0,0,0,440
3165,220,80,80,0,0,0,380
3166,230,140,120,80,160,0,730
3167,220,140,80,160,0,0,600
3168,200,160,160,160,160,320,1160
3169,200,140,160,240,160,0,900
3170,230,160,160,160,160,0,870
3171,190,200,200,160,160,320,1230
3172,210,200,120,80,160,0,770
3173,240,180,80,0,0,0,500
3174,250,180,160,80,160,0,830
3175,190,140,160,80,160,0,730
3176,190,140,120,160,0,0,610
3177,240,160,120,80,160,0,760
3178,210,80,80,80,160,0,610
3179,190,120,120,80,160,0,670
3180,200,180,120,80,160,0,740
3181,210,100,80,80,0,0,470
3182,200,140,160,160,160,320,1140
3183,180,160,160,160,0,0,660
3184,200,140,120,240,320,0,1020
3185,220,140,80,80,0,0,520
3186,210,140,40,80,0,0,470
3187,180,140,160,160,0,0,640
3188,200,140,120,160,160,320,1100
3189,200,140,120,160,160,0,780
3190,180,80,40,0,0,0,300
3191,220,120,160,160,160,0,820
3192,200,160,200,80,160,0,800
3193,170,100,80,80,160,0,590
3194,200,180,200,240,0,0,820
3195,150,120,80,160,160,0,670
3196,220,140,120,160,160,320,1120
3197,180,140,120,80,0,0,520
3198,220,140,80,80,0,0,520
3199,150,60,80,0,0,0,290
3200,180,160,160,0,0,0,500
3201,210,120,120,240,160,0,850
3202,220,140,80,80,160,0,680
3203,150,140,120,240,320,320,1290
3204,240,120,80,0,0,0,440
3205,190,120,80,0,0,0,390
3206,190,100,40,80,160,0,570
3207,190,140,80,80,160,0,650
3208,190,120,120,160,160,0,750
3209,220,120,120,160,160,0,780
3210,170,120,40,80,0,0,410
3211,220,160,80,160,320,320,1260
3212,210,120,120,160,320,320,1250
3213,200,60,80,80,160,0,580
3214,240,200,120,160,0,0,720
3215,170,100,120,240,320,0,950
3216,200,140,40,0,0,0,380
3217,180,160,200,240,320,0,1100
3218,170,120,80,160,320,0,850
3219,180,160,160,80,160,0,740
3220,200,80,80,160,160,0,680
3221,240,140,160,80,0,0,620
3222,200,120,120,80,160,0,680
3223,200,100,120,80,160,0,660
3224,180,80,80,160,320,0,820
3225,170,140,80,160,160,0,710
3226,200,160,120,80,160,320,1040
3227,190,80,40,0,0,0,310
3228,240,120,80,0,0,0,440
3229,220,160,80,80,0,0,540
3230,200,60,120,80,160,320,940
3231,210,80,120,80,160,0,650
3232,180,140,120,160,160,0,760
3233,230,140,80,80,160,0,690
3234,180,100,80,80,160,0,600
3235,220,100,80,80,160,0,640
3236,210,180,160,80,160,320,1110
3237,140,60,80,80,0,0,360
3238,230,120,160,160,160,0,830
3239,200,160,120,240,160,0,880
3240,150,60,120,80,0,0,410
3241,200,100,80,160,160,0,700
3242,180,60,80,80,0,0,400
3243,170,80,120,160,160,0,690
3244,220,160,80,0,0,0,460
3245,180,140,120,160,160,0,760
3246,220,140,80,0,0,0,440
3247,210,140,80,0,0,0,430
3248,200,120,40,80,0,0,440
3249,230,100,80,80,0,0,490
3250,200,80,80,80,160,0,600
3251,220,140,160,160,160,0,840
3252,200,120,120,160,320,320,1240
3253,150,100,120,160,160,0,690
3254,230,80,120,80,0,0,510
3255,240,60,80,80,160,0,620
3256,180,100,80,0,0,0,360
3257,190,140,160,80,0,0,570
3258,210,120,80,80,160,0,650
3259,190,160,80,80,0,0,510
3260,210,100,80,160,160,0,710
3261,210,120,40,80,0,0,450
3262,150,120,120,80,160,320,950
3263,210,120,80,160,160,0,730
3264,160,180,120,80,0,0,540
3265,200,80,120,160,160,0,720
3266,240,120,80,80,160,0,680
3267,140,100,160,80,160,0,640
3268,210,140,120,80,0,0,550
3269,220,140,160,80,0,0,600
3270,180,100,120,160,160,0,720
3271,180,80,80,80,160,0,580
3272,220,100,80,80,160,0,640
3273,190,100,80,160,0,0,530
3274,210,80,40,80,160,0,570
3275,200,120,240,160,160,320,1200
3276,140,100,120,80,0,0,440
3277,180,100,80,160,320,320,1160
3278,230,140,120,160,0,0,650
3279,190,140,120,160,320,320,1250
3280,220,120,160,160,160,0,820
3281,220,120,120,160,0,0,620
3282,170,140,200,160,160,320,1150
3283,190,120,120,80,160,0,670
3284,190,180,120,80,0,0,570
3285,210,180,120,80,160,0,750
3286,170,80,40,0,0,0,290
3287,210,100,40,0,0,0,350
3288,210,120,40,80,160,0,610
3289,200,140,160,0,0,0,500
3290,210,180,120,80,0,0,590
3291,180,60,40,80,160,0,520
3292,210,140,80,0,0,0,430
3293,200,120,80,0,0,0,400
3294,220,140,240,160,0,0,760
3295,220,140,80,0,0,0,440
3296,180,100,120,80,160,0,640
3297,220,100,80,160,320,0,880
3298,210,100,80,80,160,320,950
3299,260,160,120,80,160,0,780
3300,170,80,40,0,0,0,290
3301,170,120,160,240,160,0,850
3302,180,180,160,80,160,0,760
3303,200,120,120,240,160,0,840
3304,170,120,0,0,0,0,290
3305,200,100,40,80,0,0,420
3306,210,80,40,80,160,0,570
3307,200,100,120,80,160,0,660
3308,210,100,40,0,0,0,350
3309,230,140,80,80,0,0,530
3310,180,120,40,0,0,0,340
3311,170,80,40,80,160,0,530
3312,180,140,160,160,0,0,640
3313,190,40,40,0,0,0,270
3314,200,200,40,80,160,320,1000
3315,230,120,120,80,160,0,710
3316,160,140,120,160,320,0,900
3317,170,140,80,80,0,0,470
3318,190,100,120,0,0,0,410
3319,180,180,120,160,320,0,960
3320,190,120,40,80,160,0,590
3321,220,200,120,240,320,0,1100
3322,210,120,120,80,0,0,530
3323,240,100,40,80,0,0,460
3324,200,160,80,80,160,0,680
3325,200,140,160,160,320,0,980
3326,190,120,160,80,160,0,710
3327,200,140,80,80,0,0,500
3328,150,60,80,80,160,0,530
3329,130,80,160,160,320,0,850
3330,190,120,80,0,0,0,390
3331,230,200,200,240,160,0,1030
3332,200,120,80,160,160,0,720
3333,210,100,160,160,320,0,950
3334,240,140,120,0,0,0,500
3335,210,140,80,80,160,320,990
3336,180,180,200,160,320,0,1040
3337,180,60,120,160,320,320,1160
3338,230,140,80,160,160,320,1090
3339,200,120,120,80,160,320,1000
3340,210,140,120,80,160,0,710
3341,200,140,80,160,160,0,740
3342,250,140,80,160,160,0,790
3343,230,120,80,80,0,0,510
3344,180,120,120,80,0,0,500
3345,180,140,80,80,0,0,480
3346,190,140,120,80,0,0,530
3347,210,120,200,160,0,0,690
3348,190,160,200,240,320,320,1430
3349,180,140,120,80,160,0,680
3350,170,100,40,0,0,0,310
3351,200,80,80,80,160,0,600
3352,190,120,40,0,0,0,350
3353,200,100,80,160,160,0,700
3354,190,100,80,80,0,0,450
3355,200,160,160,80,0,0,600
3356,170,100,120,0,0,0,390
3357,200,140,160,160,160,320,1140
3358,150,180,120,80,0,0,530
3359,180,100,120,80,160,0,640
3360,200,60,120,160,160,0,700
3361,190,120,120,80,160,0,670
3362,220,140,120,0,0,0,480
3363,200,80,40,80,160,0,560
3364,220,100,40,0,0,0,360
3365,190,160,240,160,0,0,750
3366,190,80,120,160,160,0,710
3367,220,100,120,160,160,0,760
3368,190,160,160,240,0,0,750
3369,200,140,120,160,160,0,780
3370,190,100,120,240,320,0,970
3371,200,180,160,0,0,0,540
3372,200,100,40,0,0,0,340
3373,160,100,120,80,160,0,620
3374,180,160,200,160,0,0,700
3375,160,80,80,160,160,0,640
3376,180,120,120,80,160,320,980
3377,240,140,160,240,160,320,1260
3378,200,120,80,160,0,0,560
3379,200,80,120,80,160,0,640
3380,170,100,80,80,160,0,590
3381,190,80,80,80,0,0,430
3382,250,140,120,160,160,0,830
3383,200,80,120,80,0,0,480
3384,170,60,40,80,160,0,510
3385,200,60,40,0,0,0,300
3386,170,80,80,160,0,0,490
3387,200,140,80,80,160,0,660
3388,220,140,40,80,160,320,960
3389,200,140,80,80,160,0,660
3390,170,100,160,160,160,0,750
3391,210,120,160,80,160,320,1050
3392,230,160,160,160,160,320,1190
3393,200,80,120,160,160,0,720
3394,190,120,120,160,160,0,750
3395,220,80,80,80,160,0,620
3396,170,160,160,160,160,0,810
3397,210,180,200,160,320,320,1390
3398,180,100,80,80,0,0,440
3399,190,60,120,80,160,320,930
3400,170,80,80,80,0,0,410
3401,190,160,120,160,160,320,1110
3402,170,100,40,0,0,0,310
3403,200,120,120,160,0,0,600
3404,220,60,80,160,320,320,1160
3405,190,140,160,160,160,0,810
3406,200,100,40,80,160,320,900
3407,140,80,40,0,0,0,260
3408,210,160,200,320,320,320,1530
3409,180,120,120,160,320,320,1220
3410,180,120,120,80,160,0,660
3411,210,160,160,160,0,0,690
3412,160,60,40,0,0,0,260
3413,180,140,120,160,160,320,1080
3414,200,160,200,160,160,0,880
3415,150,120,120,80,160,0,630
3416,190,100,120,80,0,0,490
3417,230,160,120,0,0,0,510
3418,210,140,120,160,320,320,1270
3419,220,140,120,80,0,0,560
3420,230,80,40,0,0,0,350
3421,200,140,120,160,320,320,1260
3422,210,120,120,80,160,0,690
3423,170,120,120,160,0,0,570
3424,180,160,80,160,160,0,740
3425,180,140,80,0,0,0,400
3426,190,140,120,160,160,0,770
3427,160,200,160,160,160,320,1160
3428,210,160,160,0,0,0,530
3429,190,120,80,0,0,0,390
3430,200,140,160,80,0,0,580
3431,190,120,160,80,0,0,550
3432,210,100,80,0,0,0,390
3433,180,120,80,80,160,0,620
3434,160,60,0,0,0,0,220
3435,220,200,200,240,160,0,1020
3436,200,120,40,80,0,0,440
3437,190,120,160,160,0,0,630
3438,180,80,80,160,160,0,660
3439,190,160,80,0,0,0,430
3440,170,100,40,0,0,0,310
3441,230,160,40,80,160,0,670
3442,170,100,80,80,0,0,430
3443,180,140,80,80,160,320,960
3444,200,160,120,160,320,0,960
3445,160,80,80,80,160,0,560
3446,200,160,120,80,0,0,560
3447,220,80,80,160,160,0,700
3448,190,100,40,80,160,320,890
3449,190,80,80,80,160,0,590
3450,240,160,160,0,0,0,560
3451,180,140,160,160,0,0,640
3452,180,100,120,160,320,320,1200
3453,200,100,80,160,320,0,860
3454,200,80,40,80,160,0,560
3455,210,160,160,160,320,320,1330
3456,200,140,160,240,0,0,740
3457,180,120,200,240,320,0,1060
3458,180,120,200,240,320,0,1060
3459,210,100,80,0,0,0,390
3460,200,200,120,240,160,0,920
3461,220,160,40,0,0,0,420
3462,220,160,160,0,0,0,540
3463,210,200,160,160,160,0,890
3464,150,120,160,80,0,0,510
3465,240,120,120,80,160,0,720
3466,200,60,0,0,0,0,260
3467,180,120,80,80,160,320,940
3468,180,160,120,160,160,0,780
3469,190,140,160,240,160,320,1210
3470,200,200,80,80,160,0,720
3471,150,120,80,160,320,0,830
3472,150,100,120,80,0,0,450
3473,190,100,120,80,0,0,490
3474,200,160,120,80,0,0,560
3475,180,100,80,0,0,0,360
3476,200,140,40,0,0,0,380
3477,170,140,40,80,0,0,430
3478,180,140,160,80,160,0,720
3479,250,140,160,160,160,0,870
3480,220,100,120,0,0,0,440
3481,160,80,40,80,160,0,520
3482,170,140,80,0,0,0,390
3483,190,120,40,0,0,0,350
3484,190,120,120,160,160,0,750
3485,180,100,120,80,0,0,480
3486,220,160,120,80,160,0,740
3487,210,100,40,80,160,0,590
3488,180,100,80,0,0,0,360
3489,210,140,120,80,160,320,1030
3490,200,120,80,80,160,0,640
3491,240,140,120,80,160,0,740
3492,190,120,80,80,160,0,630
3493,190,140,200,240,160,0,930
3494,220,120,160,160,0,0,660
3495,220,140,160,160,0,0,680
3496,190,80,120,160,0,0,550
3497,210,120,120,80,0,0,530
3498,210,120,120,160,0,0,610
3499,200,80,0,0,0,0,280
3500,180,140,160,240,320,320,1360
3501,150,80,40,80,160,320,830
3502,200,140,80,160,320,0,900
3503,180,200,160,0,0,0,540
3504,150,80,40,0,0,0,270
3505,230,140,120,160,0,0,650
3506,220,140,160,160,160,320,1160
3507,180,120,120,80,160,320,980
3508,210,80,80,80,0,0,450
3509,230,160,200,160,0,0,750
3510,220,100,120,80,0,0,520
3511,150,120,120,80,160,0,630
3512,210,100,120,80,160,0,670
3513,180,100,120,160,320,320,1200
3514,180,40,80,80,0,0,380
3515,230,80,120,160,320,320,1230
3516,220,200,160,240,320,320,1460
3517,220,100,80,160,320,0,880
3518,200,140,80,80,160,0,660
3519,200,120,80,0,0,0,400
3520,210,120,120,160,0,0,610
3521,160,80,80,160,320,0,800
3522,180,100,160,160,320,320,1240
3523,180,160,120,240,320,320,1340
3524,200,100,80,160,160,0,700
3525,200,120,160,80,0,0,560
3526,200,140,120,80,0,0,540
3527,180,140,80,80,160,0,640
3528,200,120,120,240,320,0,1000
3529,180,140,120,0,0,0,440
3530,220,100,160,160,160,0,800
3531,180,100,120,160,320,0,880
3532,210,120,120,80,0,0,530
3533,220,100,80,160,0,0,560
3534,190,180,120,80,160,0,730
3535,210,160,120,80,160,0,730
3536,200,180,160,160,160,0,860
3537,160,140,80,80,160,0,620
3538,220,120,160,160,160,0,820
3539,180,100,0,0,0,0,280
3540,180,140,80,160,320,0,880
3541,170,120,160,80,0,0,530
3542,180,100,80,0,0,0,360
3543,210,60,120,0,0,0,390
3544,180,120,120,80,0,0,500
3545,190,80,40,80,0,0,390
3546,210,100,80,0,0,0,390
3547,190,120,200,160,160,0,830
3548,200,120,160,80,160,0,720
3549,210,140,200,320,320,0,1190
3550,230,120,40,80,0,0,470
3551,200,200,160,160,160,0,880
3552,190,120,160,80,0,0,550
3553,190,100,80,80,0,0,450
3554,200,80,160,240,160,0,840
3555,200,140,120,80,160,320,1020
3556,170,120,120,80,0,0,490
3557,200,100,120,160,160,320,1060
3558,190,80,40,80,160,0,550
3559,200,120,120,160,320,0,920
3560,180,140,80,80,160,320,960
3561,170,120,120,160,160,0,730
3562,190,160,160,160,160,0,830
3563,160,80,40,80,160,320,840
3564,230,120,160,160,0,0,670
3565,200,120,80,80,160,0,640
3566,200,120,120,80,160,0,680
3567,210,100,120,160,160,0,750
3568,260,160,80,80,160,320,1060
3569,200,100,120,0,0,0,420
3570,220,100,120,160,160,0,760
3571,190,60,80,80,160,0,570
3572,200,140,80,160,160,0,740
3573,220,120,160,160,0,0,660
3574,220,160,120,80,160,0,740
3575,170,80,80,160,0,0,490
3576,240,140,120,160,160,0,820
3577,240,120,160,160,320,0,1000
3578,200,100,80,160,160,0,700
3579,210,100,80,0,0,0,390
3580,200,100,160,160,160,0,780
3581,210,100,120,160,0,0,590
3582,160,60,80,160,160,0,620
3583,170,80,80,0,0,0,330
3584,220,120,40,0,0,0,380
3585,200,180,80,80,160,320,1020
3586,210,140,160,160,160,0,830
3587,200,80,80,80,0,0,440
3588,220,160,120,80,160,0,740
3589,200,100,80,80,160,320,940
3590,230,100,80,80,0,0,490
3591,200,140,120,0,0,0,460
3592,220,160,160,240,320,0,1100
3593,230,100,80,0,0,0,410
3594,230,80,80,80,160,0,630
3595,220,120,80,80,0,0,500
3596,210,140,80,0,0,0,430
3597,220,200,200,240,320,0,1180
3598,200,140,120,160,160,0,780
3599,200,140,40,0,0,0,380
3600,190,140,80,80,0,0,490
3601,200,60,40,80,160,0,540
3602,180,80,120,160,160,0,700
3603,190,180,160,80,160,0,770
3604,180,140,80,80,160,0,640
3605,190,140,80,80,160,320,970
3606,170,160,80,80,160,0,650
3607,190,120,80,160,320,0,870
3608,230,200,160,80,160,0,830
3609,220,100,120,80,160,0,680
3610,250,120,80,160,160,320,1090
3611,180,60,40,0,0,0,280
3612,220,160,200,80,160,0,820
3613,210,100,120,80,160,0,670
3614,180,100,120,80,160,0,640
3615,200,80,80,80,160,0,600
3616,180,180,160,160,160,0,840
3617,200,140,120,80,160,0,700
3618,230,100,120,80,160,0,690
3619,190,100,40,0,0,0,330
3620,200,120,120,80,160,0,680
3621,190,100,80,80,0,0,450
3622,180,140,120,160,320,0,920
3623,230,140,120,160,0,0,650
3624,220,160,160,80,160,0,780
3625,210,140,40,80,0,0,470
3626,150,120,160,80,160,320,990
3627,230,160,160,80,0,0,630
3628,180,60,40,80,0,0,360
3629,210,120,120,80,0,0,530
3630,180,100,120,240,160,0,800
3631,170,140,200,160,320,320,1310
3632,250,140,120,0,0,0,510
3633,170,120,120,80,0,0,490
3634,200,140,80,80,160,0,660
3635,200,80,80,80,160,0,600
3636,190,120,120,0,0,0,430
3637,180,140,120,160,0,0,600
3638,190,80,40,80,0,0,390
3639,210,160,120,160,0,0,650
3640,250,120,120,80,160,0,730
3641,210,140,200,240,160,0,950
3642,210,80,80,80,0,0,450
3643,160,60,80,80,160,0,540
3644,210,140,160,160,320,0,990
3645,230,160,120,80,0,0,590
3646,200,180,120,80,0,0,580
3647,160,80,40,0,0,0,280
3648,200,120,160,0,0,0,480
3649,180,140,40,80,0,0,440
3650,200,160,120,0,0,0,480
3651,160,80,120,160,160,0,680
3652,170,60,120,80,160,0,590
3653,190,120,120,0,0,0,430
3654,220,180,200,160,320,0,1080
3655,230,100,40,0,0,0,370
3656,220,180,120,80,160,0,760
3657,180,140,120,80,160,0,680
3658,210,120,120,80,0,0,530
3659,200,80,80,160,320,0,840
3660,180,140,120,160,160,0,760
3661,220,140,160,0,0,0,520
3662,220,160,240,160,160,0,940
3663,190,100,120,80,0,0,490
3664,190,120,160,160,160,0,790
3665,180,80,40,80,160,0,540
3666,190,120,120,160,0,0,590
3667,180,120,40,80,160,0,580
3668,200,140,160,80,160,0,740
3669,190,180,200,80,160,0,810
3670,220,100,120,160,160,0,760
3671,190,140,120,160,160,0,770
3672,180,100,80,80,160,320,920
3673,200,80,120,160,160,320,1040
3674,220,140,200,160,320,0,1040
3675,230,100,160,80,0,0,570
3676,180,80,120,80,160,0,620
3677,200,100,120,160,320,0,900
3678,180,100,80,80,160,0,600
3679,160,100,200,160,160,320,1100
3680,200,160,120,80,160,0,720
3681,200,120,80,80,0,0,480
3682,210,160,200,160,0,0,730
3683,180,100,120,160,320,0,880
3684,210,160,160,160,0,0,690
3685,200,140,120,240,160,320,1180
3686,150,80,0,0,0,0,230
3687,230,140,200,80,160,320,1130
3688,170,80,0,0,0,0,250
3689,190,120,40,80,0,0,430
3690,210,140,80,80,160,320,990
3691,210,140,200,80,160,0,790
3692,170,120,80,80,160,320,930
3693,180,80,0,0,0,0,260
3694,160,120,40,80,0,0,400
3695,190,100,40,0,0,0,330
3696,210,140,80,0,0,0,430
3697,180,120,120,160,160,0,740
3698,180,140,80,0,0,0,400
3699,210,60,40,80,160,0,550
3700,180,160,160,80,0,0,580
3701,190,140,80,80,160,320,970
3702,200,80,80,80,0,0,440
3703,200,100,0,0,0,0,300
3704,190,80,80,160,160,320,990
3705,170,120,160,160,160,0,770
3706,170,180,160,160,160,0,830
3707,190,120,80,0,0,0,390
3708,230,220,200,80,0,0,730
3709,190,140,200,80,0,0,610
3710,190,160,160,80,160,0,750
3711,190,120,80,0,0,0,390
3712,160,120,200,160,160,0,800
3713,170,140,200,240,0,0,750
3714,190,100,80,0,0,0,370
3715,160,180,200,80,0,0,620
3716,230,160,160,240,320,0,1110
3717,160,80,80,160,320,0,800
3718,220,180,120,0,0,0,520
3719,230,120,120,80,160,0,710
3720,230,100,80,80,160,0,650
3721,140,120,120,160,0,0,540
3722,180,120,160,240,320,0,1020
3723,200,80,80,80,160,0,600
3724,250,140,120,160,160,0,830
3725,220,140,120,160,160,0,800
3726,190,160,160,240,160,0,910
3727,180,120,120,80,0,0,500
3728,180,60,40,0,0,0,280
3729,190,140,80,80,160,0,650
3730,180,140,120,80,0,0,520
3731,190,140,120,160,160,0,770
3732,150,100,120,80,0,0,450
3733,200,140,120,160,160,0,780
3734,230,140,80,0,0,0,450
3735,190,120,80,160,160,0,710
3736,200,80,80,160,320,0,840
3737,200,120,80,80,0,0,480
3738,230,100,80,80,160,0,650
3739,180,120,160,240,320,320,1340
3740,220,140,160,160,160,0,840
3741,180,140,40,0,0,0,360
3742,160,140,80,80,0,0,460
3743,170,60,80,80,160,0,550
3744,190,40,40,80,160,0,510
3745,180,120,120,80,0,0,500
3746,200,80,40,0,0,0,320
3747,160,60,40,80,160,0,500
3748,200,120,80,80,0,0,480
3749,230,120,120,80,0,0,550
3750,170,120,80,0,0,0,370
3751,200,120,160,160,320,320,1280
3752,230,140,80,80,0,0,530
3753,210,120,120,160,160,320,1090
3754,190,140,120,160,160,0,770
3755,200,120,160,0,0,0,480
3756,170,160,160,80,160,0,730
3757,210,140,200,240,0,0,790
3758,220,160,160,80,160,320,1100
3759,210,140,80,0,0,0,430
3760,200,120,120,80,0,0,520
3761,180,120,80,80,0,0,460
3762,230,60,80,160,160,320,1010
3763,210,180,160,240,160,320,1270
3764,180,100,80,80,160,0,600
3765,170,100,80,0,0,0,350
3766,200,100,120,240,0,0,660
3767,230,140,120,80,160,0,730
3768,170,140,120,80,0,0,510
3769,210,80,120,80,160,0,650
3770,180,140,0,0,0,0,320
3771,210,140,80,160,160,320,1070
3772,210,120,80,0,0,0,410
3773,180,160,120,80,0,0,540
3774,220,120,80,80,0,0,500
3775,200,100,120,80,160,0,660
3776,190,160,120,80,0,0,550
3777,210,100,40,80,0,0,430
3778,180,100,80,80,160,0,600
3779,150,100,80,80,160,0,570
3780,180,120,120,0,0,0,420
3781,210,140,160,240,320,0,1070
3782,250,120,120,80,160,0,730
3783,200,120,80,80,160,0,640
3784,200,80,120,160,160,0,720
3785,200,140,120,160,160,0,780
3786,210,60,120,160,0,0,550
3787,180,100,120,160,160,0,720
3788,160,180,120,160,160,0,780
3789,200,160,80,160,160,0,760
3790,200,180,160,80,160,0,780
3791,210,100,80,80,0,0,470
3792,200,60,0,0,0,0,260
3793,190,100,120,160,160,0,730
3794,210,120,80,160,160,0,730
3795,230,160,40,80,160,0,670
3796,220,120,80,80,160,320,980
3797,160,100,80,0,0,0,340
3798,180,80,80,80,160,0,580
3799,190,140,120,160,160,0,770
3800,180,80,80,80,160,320,900
3801,200,120,80,160,320,320,1200
3802,180,100,120,160,160,0,720
3803,170,120,160,160,320,0,930
3804,200,80,120,160,160,0,720
3805,190,80,160,160,320,0,910
3806,180,100,120,160,160,0,720
3807,190,140,160,80,160,320,1050
3808,170,100,160,80,160,0,670
3809,210,100,160,160,320,0,950
3810,230,120,80,80,160,0,670
3811,220,100,80,80,0,0,480
3812,180,120,120,160,160,0,740
3813,190,140,120,160,0,0,610
3814,180,100,0,0,0,0,280
3815,190,140,160,80,160,0,730
3816,190,120,120,80,0,0,510
3817,200,140,160,80,160,0,740
3818,200,140,120,160,160,0,780
3819,160,120,40,0,0,0,320
3820,180,100,120,160,160,0,720
3821,210,120,80,160,160,0,730
3822,150,120,120,80,160,0,630
3823,190,140,200,80,0,0,610
3824,160,180,160,160,160,0,820
3825,180,100,200,160,0,0,640
3826,170,120,80,0,0,0,370
3827,190,60,40,80,0,0,370
3828,190,160,200,240,160,0,950
3829,180,120,80,160,160,0,700
3830,190,100,120,80,0,0,490
3831,190,100,160,160,160,0,770
3832,210,100,120,160,160,320,1070
3833,190,180,200,160,320,320,1370
3834,190,100,160,160,320,0,930
3835,170,120,160,160,320,0,930
3836,190,80,40,0,0,0,310
3837,180,140,160,160,0,0,640
3838,140,120,120,160,320,320,1180
3839,210,120,80,80,160,0,650
3840,210,100,160,160,160,0,790
3841,200,160,160,80,160,0,760
3842,190,160,120,80,0,0,550
3843,170,120,200,160,160,0,810
3844,210,160,80,80,0,0,530
3845,180,120,80,160,160,0,700
3846,190,180,40,80,0,0,490
3847,220,140,160,240,160,320,1240
3848,200,180,160,160,160,0,860
3849,200,140,80,0,0,0,420
3850,190,120,120,160,320,320,1230
3851,210,180,160,160,320,0,1030
3852,180,120,80,160,160,320,1020
3853,210,120,120,80,0,0,530
3854,200,100,120,80,160,0,660
3855,200,120,80,80,160,0,640
3856,250,160,120,80,160,320,1090
3857,190,120,0,0,0,0,310
3858,220,120,160,80,160,0,740
3859,170,100,120,160,320,320,1190
3860,210,100,160,240,320,0,1030
3861,180,140,80,80,0,0,480
3862,220,140,160,80,160,0,760
3863,190,60,40,80,160,0,530
3864,210,240,160,160,320,0,1090
3865,180,120,40,80,160,0,580
3866,210,140,160,160,160,0,830
3867,240,100,0,0,0,0,340
3868,190,160,160,160,160,0,830
3869,230,100,80,80,160,0,650
3870,190,100,80,160,320,0,850
3871,180,140,160,160,160,0,800
3872,170,100,120,80,160,0,630
3873,230,120,80,160,160,320,1070
3874,180,120,40,80,160,0,580
3875,170,100,40,0,0,0,310
3876,220,80,80,160,160,0,700
3877,160,180,240,160,160,0,900
3878,180,140,80,80,0,0,480
3879,190,60,80,0,0,0,330
3880,220,160,40,0,0,0,420
3881,190,140,80,160,160,0,730
3882,200,160,80,80,0,0,520
3883,190,100,120,0,0,0,410
3884,200,60,80,80,160,0,580
3885,210,160,80,80,0,0,530
3886,170,140,160,0,0,0,470
3887,200,140,80,160,320,320,1220
3888,230,120,120,0,0,0,470
3889,180,140,80,80,0,0,480
3890,170,120,200,240,320,0,1050
3891,190,140,120,80,0,0,530
3892,220,140,120,80,160,0,720
3893,210,100,120,80,160,0,670
3894,180,40,80,80,160,0,540
3895,160,140,80,160,0,0,540
3896,220,100,80,80,160,0,640
3897,220,140,80,0,0,0,440
3898,150,140,120,160,0,0,570
3899,190,140,160,160,320,0,970
3900,190,80,40,80,0,0,390
3901,230,180,200,240,160,0,1010
3902,210,120,40,0,0,0,370
3903,180,120,240,240,320,320,1420
3904,220,140,80,80,160,320,1000
3905,210,100,40,80,0,0,430
3906,210,160,80,80,160,0,690
3907,220,120,40,0,0,0,380
3908,200,100,80,80,160,0,620
3909,220,100,40,0,0,0,360
3910,190,60,40,80,160,0,530
3911,190,80,40,80,160,0,550
3912,190,140,120,160,320,0,930
3913,210,120,80,80,0,0,490
3914,180,100,80,160,320,0,840
3915,210,100,160,80,160,0,710
3916,220,100,40,80,160,0,600
3917,180,140,120,0,0,0,440
3918,170,120,200,80,0,0,570
3919,200,120,120,80,0,0,520
3920,180,100,120,160,160,0,720
3921,210,100,80,0,0,0,390
3922,210,120,160,160,160,320,1130
3923,160,120,160,80,160,0,680
3924,240,100,120,80,160,320,1020
3925,200,160,160,160,160,0,840
3926,200,80,80,0,0,0,360
3927,220,60,120,80,0,0,480
3928,200,120,80,80,0,0,480
3929,150,100,80,80,160,0,570
3930,140,100,120,80,160,0,600
3931,200,160,120,160,160,0,800
3932,200,120,120,160,160,0,760
3933,210,100,80,160,160,0,710
3934,200,140,120,80,160,0,700
3935,200,120,120,0,0,0,440
3936,150,60,40,0,0,0,250
3937,200,80,0,0,0,0,280
3938,200,100,120,160,160,0,740
3939,200,80,40,0,0,0,320
3940,200,100,80,160,160,320,1020
3941,170,80,120,160,160,0,690
3942,210,80,120,80,160,0,650
3943,180,120,80,0,0,0,380
3944,170,120,120,160,160,0,730
3945,160,140,120,160,160,0,740
3946,130,60,40,80,0,0,310
3947,190,160,120,80,160,0,710
3948,230,140,200,160,160,0,890
3949,120,80,40,0,0,0,240
3950,210,140,160,160,0,0,670
3951,190,80,160,160,0,0,590
3952,220,100,120,80,160,0,680
3953,220,120,80,160,0,0,580
3954,160,140,160,240,320,0,1020
3955,220,120,160,80,0,0,580
3956,210,100,120,80,160,320,990
3957,250,100,40,80,160,0,630
3958,170,160,120,160,160,320,1090
3959,220,80,160,160,0,0,620
3960,200,80,80,80,0,0,440
3961,250,160,120,80,160,0,770
3962,210,180,120,80,0,0,590
3963,200,160,120,80,160,320,1040
3964,180,140,80,160,160,0,720
3965,160,120,160,160,160,0,760
3966,220,160,200,160,160,0,900
3967,220,120,160,0,0,0,500
3968,180,140,80,160,160,0,720
3969,190,160,160,240,320,320,1390
3970,190,120,40,80,0,0,430
3971,180,100,120,80,0,0,480
3972,210,140,160,160,160,0,830
3973,240,140,80,160,160,0,780
3974,180,120,160,160,160,0,780
3975,230,100,80,160,320,0,890
3976,180,100,160,0,0,0,440
3977,170,80,80,80,160,0,570
3978,200,140,160,160,160,0,820
3979,190,140,120,0,0,0,450
3980,240,120,160,160,320,0,1000
3981,190,100,120,80,0,0,490
3982,230,120,80,80,160,0,670
3983,230,100,120,160,0,0,610
3984,190,120,120,160,0,0,590
3985,220,120,80,160,160,0,740
3986,210,120,120,80,0,0,530
3987,180,100,80,80,160,0,600
3988,190,120,80,80,0,0,470
3989,190,140,200,160,160,0,850
3990,240,80,80,160,320,0,880
3991,190,80,80,160,320,320,1150
3992,220,100,160,0,0,0,480
3993,190,100,80,80,160,0,610
3994,250,180,80,160,0,0,670
3995,220,100,80,160,160,0,720
3996,180,80,40,0,0,0,300
3997,170,100,120,80,0,0,470
3998,180,100,160,0,0,0,440
3999,180,120,160,240,320,0,1020
4000,200,200,80,80,0,0,560
4001,230,160,120,80,160,0,750
4002,160,160,160,160,160,0,800
4003,140,120,80,160,160,0,660
4004,170,140,120,160,160,0,750
4005,210,100,40,0,0,0,350
4006,180,140,200,80,0,0,600
4007,200,140,160,80,160,0,740
4008,160,140,120,160,160,0,740
4009,200,120,40,80,0,0,440
4010,230,140,120,80,160,0,730
4011,230,140,120,0,0,0,490
4012,180,120,80,80,160,0,620
4013,220,120,40,0,0,0,380
4014,230,140,120,160,160,0,810
4015,230,180,160,80,0,0,650
4016,180,100,80,80,160,0,600
4017,200,120,200,240,0,0,760
4018,190,120,120,80,160,0,670
4019,230,140,200,80,160,0,810
4020,210,160,160,160,160,0,850
4021,180,80,80,80,160,0,580
4022,260,160,160,160,160,0,900
4023,180,100,80,80,0,0,440
4024,210,180,160,80,0,0,630
4025,180,140,80,80,0,0,480
4026,210,180,40,0,0,0,430
4027,240,180,120,80,0,0,620
4028,180,180,80,0,0,0,440
4029,220,180,120,80,160,0,760
4030,190,160,120,0,0,0,470
4031,190,120,40,0,0,0,350
4032,190,60,40,80,160,0,530
4033,210,160,40,0,0,0,410
4034,200,140,120,80,160,0,700
4035,240,160,120,80,0,0,600
4036,200,180,200,240,320,0,1140
4037,250,140,160,160,160,0,870
4038,210,140,160,240,160,320,1230
4039,170,100,120,80,160,0,630
4040,200,120,160,80,0,0,560
4041,200,100,120,160,160,0,740
4042,220,180,240,240,320,0,1200
4043,180,80,80,160,320,0,820
4044,190,160,80,80,0,0,510
4045,180,160,200,160,0,0,700
4046,220,120,120,0,0,0,460
4047,170,120,160,160,160,320,1090
4048,210,120,80,80,0,0,490
4049,190,140,160,160,160,0,810
4050,220,160,120,80,160,320,1060
4051,190,160,80,80,0,0,510
4052,160,100,120,80,0,0,460
4053,220,80,120,240,160,0,820
4054,190,120,80,80,160,0,630
4055,190,100,160,160,160,0,770
4056,150,140,160,240,0,0,690
4057,170,140,120,160,160,320,1070
4058,200,80,120,160,160,0,720
4059,200,180,200,240,0,0,820
4060,230,140,160,80,0,0,610
4061,200,120,120,80,160,0,680
4062,200,100,40,80,160,0,580
4063,210,160,200,160,320,0,1050
4064,220,120,80,160,160,0,740
4065,200,100,80,80,0,0,460
4066,240,100,80,160,160,0,740
4067,210,180,40,80,0,0,510
4068,180,180,200,240,0,0,800
4069,230,120,120,80,160,0,710
4070,200,120,80,80,160,0,640
4071,170,120,80,160,0,0,530
4072,160,80,120,80,160,320,920
4073,220,140,160,160,320,0,1000
4074,160,120,120,80,160,0,640
4075,190,140,80,160,160,320,1050
4076,200,20,40,0,0,0,260
4077,160,160,80,80,0,0,480
4078,160,60,80,80,160,0,540
4079,210,160,120,80,160,0,730
4080,170,160,80,80,160,0,650
4081,190,120,160,240,320,320,1350
4082,230,140,160,160,320,0,1010
4083,120,80,40,0,0,0,240
4084,190,140,120,160,160,0,770
4085,160,140,80,80,160,320,940
4086,240,140,40,0,0,0,420
4087,220,220,120,240,320,320,1440
4088,170,160,200,240,160,0,930
4089,200,140,80,80,0,0,500
4090,170,80,40,0,0,0,290
4091,200,120,80,80,0,0,480
4092,170,120,120,160,160,0,730
4093,210,120,120,80,160,0,690
4094,200,80,120,160,160,0,720
4095,170,140,120,80,160,320,990
4096,210,140,160,160,0,0,670
4097,210,160,120,160,160,0,810
4098,160,120,120,240,160,0,800
4099,200,120,160,160,160,0,800
4100,200,220,120,240,160,0,940
4101,210,140,200,80,160,0,790
4102,130,80,40,80,0,0,330
4103,180,160,120,80,160,0,700
4104,190,100,40,80,0,0,410
4105,190,120,120,160,160,0,750
4106,170,140,160,240,160,320,1190
4107,170,140,160,240,160,0,870
4108,230,160,160,240,0,0,790
4109,200,80,40,0,0,0,320
4110,190,140,120,80,160,0,690
4111,260,120,160,240,0,0,780
4112,170,120,160,80,160,0,690
4113,230,120,120,160,160,0,790
4114,200,80,120,80,0,0,480
4115,180,160,160,160,320,320,1300
4116,160,140,160,160,320,0,940
4117,210,140,120,160,320,0,950
4118,200,160,80,0,0,0,440
4119,180,140,160,240,320,320,1360
4120,240,220,200,80,0,0,740
4121,150,100,160,160,160,320,1050
4122,190,80,120,80,0,0,470
4123,170,140,120,0,0,0,430
4124,230,80,80,160,160,0,710
4125,230,160,160,240,0,0,790
4126,230,100,120,80,160,0,690
4127,200,180,40,80,160,0,660
4128,170,160,160,160,160,0,810
4129,240,100,120,80,160,0,700
4130,170,120,120,80,160,320,970
4131,190,100,160,240,160,320,1170
4132,190,120,40,80,0,0,430
4133,170,120,160,80,0,0,530
4134,210,140,200,0,0,0,550
4135,160,120,120,80,0,0,480
4136,190,140,80,80,160,0,650
4137,190,160,160,80,160,0,750
4138,200,180,120,160,160,0,820
4139,210,140,160,160,160,320,1150
4140,190,160,240,160,160,0,910
4141,180,100,160,240,320,0,1000
4142,190,140,120,160,160,0,770
4143,200,140,120,80,160,0,700
4144,220,140,160,160,160,320,1160
4145,240,140,80,0,0,0,460
4146,160,120,120,80,0,0,480
4147,200,140,120,160,0,0,620
4148,220,120,120,240,320,320,1340
4149,180,100,120,0,0,0,400
4150,220,160,120,160,0,0,660
4151,180,120,120,80,0,0,500
4152,190,120,80,80,160,0,630
4153,170,120,120,160,0,0,570
4154,220,140,80,160,0,0,600
4155,190,100,160,80,160,0,690
4156,220,120,80,80,0,0,500
4157,190,60,40,80,160,0,530
4158,170,100,80,80,160,0,590
4159,200,140,120,160,320,320,1260
4160,190,100,120,80,0,0,490
4161,250,140,40,80,0,0,510
4162,170,200,200,240,320,0,1130
4163,200,160,200,160,320,0,1040
4164,180,120,80,160,0,0,540
4165,170,140,160,240,160,0,870
4166,170,120,80,160,160,0,690
4167,190,120,120,160,0,0,590
4168,190,120,80,160,320,0,870
4169,200,200,200,80,0,0,680
4170,220,140,80,80,0,0,520
4171,180,100,160,160,160,0,760
4172,200,140,80,80,160,0,660
4173,220,140,80,160,0,0,600
4174,190,120,80,80,0,0,470
4175,160,100,120,80,0,0,460
4176,160,140,120,0,0,0,420
4177,180,120,40,80,160,320,900
4178,210,80,120,160,160,0,730
4179,180,100,120,160,0,0,560
4180,170,160,160,160,320,320,1290
4181,150,60,80,80,160,0,530
4182,180,160,120,80,0,0,540
4183,210,180,160,80,0,0,630
4184,230,100,80,0,0,0,410
4185,200,140,160,160,320,320,1300
4186,200,180,120,80,160,320,1060
4187,210,80,80,80,0,0,450
4188,180,100,40,80,160,0,560
4189,180,140,120,160,160,320,1080
4190,220,120,120,80,160,0,700
4191,180,80,80,80,160,0,580
4192,200,100,40,0,0,0,340
4193,210,80,120,240,320,0,970
4194,200,140,40,0,0,0,380
4195,190,80,80,80,160,0,590
4196,200,180,200,240,160,0,980
4197,200,120,80,80,0,0,480
4198,180,140,80,0,0,0,400
4199,150,80,40,0,0,0,270
4200,230,120,40,80,160,0,630
4201,190,80,120,160,320,0,870
4202,260,140,120,160,160,0,840
4203,200,140,80,80,160,0,660
4204,200,120,40,0,0,0,360
4205,150,140,120,80,160,0,650
4206,210,120,120,160,320,0,930
4207,210,120,80,80,0,0,490
4208,210,100,120,160,0,0,590
4209,170,100,120,80,160,0,630
4210,180,60,80,80,0,0,400
4211,190,160,160,160,0,0,670
4212,230,140,160,160,160,0,850
4213,220,140,80,0,0,0,440
4214,230,120,80,80,160,320,990
4215,210,160,120,160,320,0,970
4216,230,160,80,80,0,0,550
4217,200,100,40,80,160,0,580
4218,220,140,160,160,0,0,680
4219,180,140,120,160,0,0,600
4220,220,120,120,80,0,0,540
4221,190,200,120,160,320,0,990
4222,220,100,120,80,0,0,520
4223,180,120,80,80,160,0,620
4224,200,120,160,160,160,0,800
4225,180,140,120,80,160,320,1000
4226,250,160,40,0,0,0,450
4227,160,140,160,240,320,0,1020
4228,190,80,40,0,0,0,310
4229,190,160,120,80,160,0,710
4230,210,100,80,160,0,0,550
4231,170,60,40,0,0,0,270
4232,190,100,120,160,160,0,730
4233,230,140,120,160,320,0,970
4234,180,120,120,80,0,0,500
4235,190,100,120,160,320,0,890
4236,170,40,80,80,0,0,370
4237,170,100,80,80,160,320,910
4238,260,120,160,240,320,320,1420
4239,180,140,160,160,320,0,960
4240,210,140,160,240,160,0,910
4241,210,120,120,160,0,0,610
4242,190,80,0,0,0,0,270
4243,170,120,120,160,160,0,730
4244,200,100,160,160,160,0,780
4245,180,100,120,160,160,0,720
4246,190,160,120,160,320,0,950
4247,190,160,80,80,160,0,670
4248,200,100,80,80,160,0,620
4249,230,160,200,160,160,0,910
4250,220,100,80,80,0,0,480
4251,210,80,160,240,320,0,1010
4252,170,120,120,160,160,320,1050
4253,220,120,160,0,0,0,500
4254,210,100,120,80,0,0,510
4255,230,200,120,160,160,0,870
4256,180,80,160,80,160,0,660
4257,150,80,40,0,0,0,270
4258,180,100,120,80,0,0,480
4259,170,120,80,80,160,0,610
4260,220,100,160,160,320,320,1280
4261,200,120,120,160,160,0,760
4262,210,140,160,160,160,0,830
4263,200,120,120,160,160,0,760
4264,180,120,120,0,0,0,420
4265,200,120,160,80,160,0,720
4266,160,60,120,80,160,0,580
4267,190,80,40,0,0,0,310
4268,200,100,40,0,0,0,340
4269,200,120,80,80,160,320,960
4270,210,160,120,80,160,0,730
4271,130,60,120,80,160,0,550
4272,190,160,160,160,160,0,830
4273,200,120,120,80,160,0,680
4274,160,100,120,80,0,0,460
4275,210,140,120,80,160,0,710
4276,170,100,80,160,160,0,670
4277,150,60,120,240,0,0,570
4278,190,120,80,80,0,0,470
4279,230,100,80,80,0,0,490
4280,210,160,160,160,320,320,1330
4281,210,60,40,80,160,0,550
4282,170,120,160,80,160,0,690
4283,210,60,40,80,160,320,870
4284,140,120,120,160,0,0,540
4285,180,120,120,160,0,0,580
4286,190,100,80,80,160,0,610
4287,180,100,120,80,160,320,960
4288,200,120,120,80,160,0,680
4289,170,140,160,160,160,320,1110
4290,210,160,80,80,160,320,1010
4291,220,160,80,160,160,0,780
4292,240,100,40,80,0,0,460
4293,210,140,120,160,320,0,950
4294,220,100,80,0,0,0,400
4295,250,180,160,80,0,0,670
4296,210,120,120,160,320,320,1250
4297,180,140,80,80,0,0,480
4298,190,120,40,80,160,0,590
4299,170,120,120,240,320,0,970
4300,200,140,120,80,160,0,700
4301,200,160,80,80,160,320,1000
4302,180,100,80,160,320,320,1160
4303,180,100,160,160,160,0,760
4304,180,120,160,160,160,0,780
4305,180,140,120,80,160,320,1000
4306,200,120,160,240,160,0,880
4307,210,100,80,80,160,0,630
4308,210,20,0,0,0,0,230
4309,220,160,160,0,0,0,540
4310,210,140,120,0,0,0,470
4311,210,180,160,80,0,0,630
4312,220,180,200,240,160,0,1000
4313,220,140,80,0,0,0,440
4314,180,140,120,80,160,0,680
4315,220,120,160,160,160,0,820
4316,240,160,120,160,160,0,840
4317,190,40,80,0,0,0,310
4318,160,120,120,80,160,0,640
4319,190,60,40,0,0,0,290
4320,160,120,40,80,0,0,400
4321,220,80,80,80,160,0,620
4322,230,160,120,80,160,0,750
4323,160,120,160,160,160,320,1080
4324,200,140,160,160,160,0,820
4325,150,100,120,80,0,0,450
4326,160,100,80,80,160,0,580
4327,220,100,80,160,160,0,720
4328,210,140,120,0,0,0,470
4329,210,100,80,160,160,0,710
4330,160,100,80,160,160,320,980
4331,220,120,120,160,320,0,940
4332,170,100,80,80,160,0,590
4333,200,140,160,0,0,0,500
4334,190,140,200,160,320,0,1010
4335,180,40,40,80,160,0,500
4336,180,140,160,160,160,0,800
4337,200,140,80,0,0,0,420
4338,190,100,160,240,160,320,1170
4339,200,100,80,160,160,320,1020
4340,150,80,120,80,160,0,590
4341,220,160,40,80,160,0,660
4342,190,140,80,80,160,0,650
4343,210,120,160,80,160,0,730
4344,210,100,120,160,160,0,750
4345,220,100,40,80,0,0,440
4346,170,120,160,0,0,0,450
4347,170,120,80,160,320,0,850
4348,170,100,120,160,160,0,710
4349,180,80,40,80,160,0,540
4350,260,160,160,160,160,0,900
4351,180,100,160,240,160,320,1160
4352,200,140,200,160,160,0,860
4353,170,60,40,0,0,0,270
4354,220,120,120,160,160,0,780
4355,200,80,80,80,0,0,440
4356,180,140,160,160,160,320,1120
4357,210,160,120,0,0,0,490
4358,190,120,120,80,0,0,510
4359,210,160,120,160,160,0,810
4360,160,140,160,80,160,320,1020
4361,160,140,160,80,160,0,700
4362,200,140,160,80,160,0,740
4363,230,80,80,160,320,320,1190
4364,190,140,120,80,160,0,690
4365,240,140,160,160,160,0,860
4366,140,120,120,160,160,320,1020
4367,220,100,40,80,160,0,600
4368,200,100,40,0,0,0,340
4369,220,80,80,80,0,0,460
4370,220,160,160,80,160,0,780
4371,210,140,160,160,320,320,1310
4372,220,160,200,240,320,0,1140
4373,200,100,40,80,160,0,580
4374,190,120,120,160,160,320,1070
4375,190,140,120,240,0,0,690
4376,200,120,160,80,0,0,560
4377,210,120,120,160,160,0,770
4378,190,140,80,160,320,320,1210
4379,220,120,40,0,0,0,380
4380,200,100,80,80,0,0,460
4381,220,140,120,240,320,0,1040
4382,190,100,80,80,160,0,610
4383,170,140,120,80,160,0,670
4384,150,100,120,80,160,0,610
4385,170,120,80,80,160,0,610
4386,230,180,160,160,0,0,730
4387,210,120,80,80,160,0,650
4388,160,60,40,80,160,0,500
4389,230,160,160,0,0,0,550
4390,200,80,120,80,160,0,640
4391,140,100,80,80,0,0,400
4392,160,100,80,80,160,0,580
4393,190,120,80,80,160,0,630
4394,210,140,200,80,160,0,790
4395,150,100,0,0,0,0,250
4396,180,100,160,240,160,320,1160
4397,220,140,40,0,0,0,400
4398,210,160,120,80,160,0,730
4399,230,160,80,0,0,0,470
4400,230,140,120,160,160,0,810
4401,220,160,120,240,320,0,1060
4402,190,140,160,240,320,0,1050
4403,180,120,80,0,0,0,380
4404,170,140,80,0,0,0,390
4405,220,100,120,160,160,0,760
4406,190,140,120,160,160,320,1090
4407,210,200,160,0,0,0,570
4408,210,140,120,80,160,0,710
4409,180,120,80,160,320,320,1180
4410,230,80,0,0,0,0,310
4411,220,160,80,0,0,0,460
4412,200,140,120,80,160,0,700
4413,210,100,120,160,160,0,750
4414,180,100,80,0,0,0,360
4415,170,100,40,0,0,0,310
4416,240,140,160,80,160,0,780
4417,180,60,40,80,160,0,520
4418,190,60,40,80,0,0,370
4419,210,140,120,240,320,0,1030
4420,200,60,40,80,0,0,380
4421,220,100,40,0,0,0,360
4422,220,180,160,160,320,0,1040
4423,190,80,80,80,160,0,590
4424,180,140,80,80,0,0,480
4425,170,140,40,80,160,0,590
4426,200,140,80,160,320,0,900
4427,200,120,80,80,160,0,640
4428,160,160,40,80,160,0,600
4429,210,120,40,0,0,0,370
4430,150,100,120,160,160,0,690
4431,210,120,80,80,160,0,650
4432,170,140,160,80,160,320,1030
4433,180,160,160,80,0,0,580
4434,200,160,120,160,160,320,1120
4435,160,80,40,80,160,320,840
4436,200,120,160,80,0,0,560
4437,200,140,120,160,320,0,940
4438,180,100,40,80,160,0,560
4439,180,100,80,80,160,0,600
4440,200,140,80,80,160,320,980
4441,180,100,80,160,0,0,520
4442,230,140,160,240,320,0,1090
4443,200,140,120,160,160,0,780
4444,230,180,120,160,160,320,1170
4445,190,140,80,160,0,0,570
4446,180,100,160,160,160,0,760
4447,170,80,80,80,160,0,570
4448,200,160,240,80,0,0,680
4449,170,40,80,160,320,0,770
4450,250,140,160,80,160,0,790
4451,180,80,80,160,160,320,980
4452,160,120,120,80,0,0,480
4453,220,160,120,0,0,0,500
4454,210,160,160,240,320,0,1090
4455,170,120,160,80,0,0,530
4456,210,100,40,0,0,0,350
4457,220,120,40,0,0,0,380
4458,200,140,40,0,0,0,380
4459,180,100,160,240,160,320,1160
4460,180,100,40,0,0,0,320
4461,190,160,120,80,160,0,710
4462,190,160,160,160,320,320,1310
4463,220,80,80,80,0,0,460
4464,180,80,160,80,160,320,980
4465,190,100,120,240,160,0,810
4466,150,80,0,0,0,0,230
4467,230,140,200,160,160,0,890
4468,170,100,120,160,160,0,710
4469,220,140,160,160,160,0,840
4470,210,100,120,80,160,0,670
4471,240,160,160,160,160,0,880
4472,210,140,160,240,320,0,1070
4473,200,120,160,80,160,0,720
4474,210,160,160,160,160,0,850
4475,220,120,40,80,0,0,460
4476,220,140,120,240,0,0,720
4477,180,120,160,160,0,0,620
4478,230,100,120,80,0,0,530
4479,230,160,120,80,160,0,750
4480,200,140,80,80,160,0,660
4481,210,80,40,0,0,0,330
4482,200,100,40,80,160,0,580
4483,220,100,40,0,0,0,360
4484,200,100,40,0,0,0,340
4485,210,100,120,80,160,0,670
4486,190,120,120,80,160,0,670
4487,180,100,160,80,160,0,680
4488,200,140,120,160,320,0,940
4489,200,140,120,160,160,0,780
4490,210,80,120,160,320,320,1210
4491,180,120,160,160,320,0,940
4492,200,140,160,240,160,0,900
4493,170,80,80,160,320,320,1130
4494,200,120,120,80,0,0,520
4495,190,140,40,80,160,0,610
4496,260,160,160,160,320,320,1380
4497,220,140,120,160,320,320,1280
4498,190,140,120,240,160,0,850
4499,180,120,120,160,160,0,740
4500,180,140,160,80,0,0,560
4501,210,140,160,80,160,0,750
4502,210,120,120,160,160,320,1090
4503,180,140,120,80,0,0,520
4504,230,100,40,0,0,0,370
4505,230,160,200,160,0,0,750
4506,180,40,80,80,0,0,380
4507,200,100,40,80,0,0,420
4508,150,140,120,160,160,0,730
4509,190,120,80,80,160,0,630
4510,190,160,120,160,160,0,790
4511,160,120,160,160,320,0,920
4512,190,80,40,80,0,0,390
4513,180,100,80,80,0,0,440
4514,200,180,160,80,160,0,780
4515,150,60,40,80,160,0,490
4516,190,120,80,80,160,0,630
4517,210,160,160,80,160,320,1090
4518,190,80,120,80,0,0,470
4519,190,140,160,80,160,0,730
4520,190,140,80,80,160,0,650
4521,180,80,120,160,160,0,700
4522,190,180,160,240,160,320,1250
4523,190,60,0,0,0,0,250
4524,200,100,80,80,160,0,620
4525,270,180,120,0,0,0,570
4526,240,140,40,80,0,0,500
4527,180,100,120,80,160,0,640
4528,200,120,120,160,160,0,760
4529,200,140,160,80,0,0,580
4530,220,140,80,80,0,0,520
4531,210,120,160,80,160,0,730
4532,220,100,80,80,160,0,640
4533,210,160,120,240,160,0,890
4534,220,120,80,80,160,0,660
4535,160,140,120,160,160,0,740
4536,200,120,80,0,0,0,400
4537,210,120,120,80,0,0,530
4538,200,180,80,0,0,0,460
4539,180,160,160,160,160,0,820
4540,170,80,120,0,0,0,370
4541,200,140,160,0,0,0,500
4542,220,120,80,80,0,0,500
4543,210,100,120,160,320,320,1230
4544,170,60,80,80,160,0,550
4545,190,140,160,160,160,320,1130
4546,190,140,200,240,160,0,930
4547,240,100,160,160,320,320,1300
4548,240,160,160,240,320,320,1440
4549,210,100,120,80,0,0,510
4550,170,180,160,160,160,0,830
4551,150,140,80,80,160,0,610
4552,210,120,120,160,0,0,610
4553,210,160,200,80,160,0,810
4554,180,120,120,0,0,0,420
4555,190,180,120,80,0,0,570
4556,240,140,120,160,160,0,820
4557,200,120,120,80,0,0,520
4558,200,120,160,160,320,0,960
4559,180,40,40,0,0,0,260
4560,200,100,40,0,0,0,340
4561,190,80,120,80,160,0,630
4562,200,120,80,80,160,0,640
4563,220,80,40,80,160,0,580
4564,170,80,80,80,0,0,410
4565,190,120,160,160,160,320,1110
4566,210,100,80,80,160,0,630
4567,240,160,120,160,320,0,1000
4568,200,40,0,0,0,0,240
4569,210,160,120,160,160,0,810
4570,180,120,160,80,160,0,700
4571,210,140,120,240,160,0,870
4572,200,80,80,160,160,0,680
4573,180,160,160,80,0,0,580
4574,180,160,120,80,160,0,700
4575,160,100,120,0,0,0,380
4576,240,140,80,0,0,0,460
4577,180,100,120,160,160,0,720
4578,140,120,120,160,160,0,700
4579,210,80,120,80,160,0,650
4580,210,120,120,80,160,320,1010
4581,200,80,120,80,160,0,640
4582,220,100,80,80,160,0,640
4583,160,140,120,80,0,0,500
4584,230,140,80,160,160,0,770
4585,200,200,240,240,160,0,1040
4586,210,180,160,0,0,0,550
4587,230,120,120,160,160,0,790
4588,210,120,40,0,0,0,370
4589,200,140,120,80,0,0,540
4590,170,80,80,80,160,0,570
4591,180,160,160,0,0,0,500
4592,160,120,40,0,0,0,320
4593,170,160,120,80,160,0,690
4594,230,140,120,0,0,0,490
4595,210,140,80,80,0,0,510
4596,160,100,120,0,0,0,380
4597,150,120,120,160,160,320,1030
4598,200,80,80,0,0,0,360
4599,200,160,120,0,0,0,480
4600,230,140,80,80,160,0,690
4601,230,200,120,80,160,0,790
4602,210,120,120,160,320,0,930
4603,200,180,80,160,320,0,940
4604,210,140,120,160,320,320,1270
4605,220,160,160,240,320,320,1420
4606,180,160,160,160,160,0,820
4607,200,120,80,160,320,0,880
4608,170,100,80,160,0,0,510
4609,180,80,120,80,160,0,620
4610,190,120,160,160,320,320,1270
4611,180,80,80,80,160,0,580
4612,210,100,120,160,320,0,910
4613,230,120,160,80,0,0,590
4614,180,120,80,160,160,0,700
4615,200,140,120,160,320,320,1260
4616,200,160,120,0,0,0,480
4617,230,140,0,0,0,0,370
4618,210,140,120,80,160,320,1030
4619,200,160,200,160,160,0,880
4620,170,80,80,80,160,320,890
4621,210,180,160,0,0,0,550
4622,160,120,160,160,320,0,920
4623,180,120,80,80,160,0,620
4624,190,140,80,80,160,0,650
4625,180,100,120,80,160,0,640
4626,200,120,160,160,320,0,960
4627,200,100,120,160,160,0,740
4628,200,140,120,80,0,0,540
4629,190,100,0,0,0,0,290
4630,200,80,40,80,160,0,560
4631,190,140,120,240,160,320,1170
4632,180,140,120,160,320,320,1240
4633,190,100,160,160,160,0,770
4634,210,140,160,160,0,0,670
4635,190,120,120,80,160,0,670
4636,150,80,80,160,0,0,470
4637,190,140,120,80,160,320,1010
4638,190,120,120,160,320,0,910
4639,230,100,80,160,0,0,570
4640,210,120,120,80,0,0,530
4641,200,140,80,160,160,0,740
4642,170,100,80,80,0,0,430
4643,230,80,40,0,0,0,350
4644,180,100,0,0,0,0,280
4645,190,120,160,160,160,0,790
4646,210,160,120,0,0,0,490
4647,210,80,160,0,0,0,450
4648,170,120,160,80,160,0,690
4649,180,120,80,80,160,320,940
4650,200,80,120,80,0,0,480
4651,200,80,160,80,160,0,680
4652,180,120,80,80,0,0,460
4653,210,120,160,240,0,0,730
4654,220,140,160,80,0,0,600
4655,180,100,80,0,0,0,360
4656,250,180,120,80,0,0,630
4657,180,120,40,0,0,0,340
4658,180,140,160,240,0,0,720
4659,210,80,80,80,160,0,610
4660,200,120,120,80,160,0,680
4661,220,160,80,80,160,0,700
4662,190,100,120,80,160,320,970
4663,210,120,120,160,0,0,610
4664,210,140,120,80,160,0,710
4665,190,160,40,0,0,0,390
4666,210,160,160,80,0,0,610
4667,230,60,40,80,160,0,570
4668,160,160,160,80,160,0,720
4669,230,120,120,80,160,0,710
4670,200,100,120,160,0,0,580
4671,180,140,80,80,160,0,640
4672,150,140,80,80,160,0,610
4673,210,140,40,0,0,0,390
4674,180,100,40,0,0,0,320
4675,210,160,120,80,160,320,1050
4676,200,80,40,80,160,320,880
4677,180,120,120,80,0,0,500
4678,210,40,80,0,0,0,330
4679,200,140,80,80,160,320,980
4680,210,140,160,240,160,0,910
4681,220,120,160,240,320,0,1060
4682,190,120,160,80,160,0,710
4683,210,80,40,0,0,0,330
4684,220,120,80,80,160,0,660
4685,170,100,80,160,320,0,830
4686,180,140,120,80,160,0,680
4687,180,100,160,80,160,0,680
4688,190,120,120,160,160,0,750
4689,190,140,120,160,0,0,610
4690,190,80,120,160,160,320,1030
4691,160,120,80,80,0,0,440
4692,220,140,160,160,0,0,680
4693,210,120,160,80,160,0,730
4694,200,140,120,80,160,0,700
4695,190,80,120,160,320,0,870
4696,190,180,80,80,160,0,690
4697,170,140,40,80,160,0,590
4698,200,140,160,160,160,0,820
4699,240,160,120,80,0,0,600
4700,150,80,40,0,0,0,270
4701,230,140,200,160,320,320,1370
4702,180,80,80,160,160,320,980
4703,170,120,120,80,160,0,650
4704,230,100,200,160,160,320,1170
4705,200,120,80,80,0,0,480
4706,200,80,120,240,320,0,960
4707,230,160,120,160,160,0,830
4708,180,100,120,0,0,0,400
4709,190,100,120,160,160,0,730
4710,190,120,80,160,160,0,710
4711,210,120,160,160,0,0,650
4712,180,140,80,80,0,0,480
4713,180,100,160,240,320,0,1000
4714,170,60,80,160,0,0,470
4715,190,80,120,160,0,0,550
4716,210,140,120,160,320,320,1270
4717,150,100,80,160,160,320,970
4718,150,100,40,0,0,0,290
4719,200,140,80,80,0,0,500
4720,210,80,40,0,0,0,330
4721,200,140,120,160,160,0,780
4722,190,120,160,160,160,0,790
4723,220,120,80,80,160,0,660
4724,200,140,120,80,0,0,540
4725,200,160,200,160,160,0,880
4726,200,140,160,160,0,0,660
4727,160,120,160,240,160,320,1160
4728,200,100,120,0,0,0,420
4729,160,100,120,160,320,0,860
4730,170,140,120,0,0,0,430
4731,210,60,80,0,0,0,350
4732,210,80,80,0,0,0,370
4733,160,60,80,80,0,0,380
4734,160,100,80,80,0,0,420
4735,200,140,160,160,160,0,820
4736,200,120,120,160,160,0,760
4737,190,120,80,80,160,320,950
4738,180,160,80,160,160,0,740
4739,190,100,120,80,160,320,970
4740,200,160,120,160,320,320,1280
4741,190,100,80,0,0,0,370
4742,200,120,120,80,0,0,520
4743,240,180,80,160,320,0,980
4744,220,160,80,80,160,320,1020
4745,230,140,120,160,160,0,810
4746,240,100,40,0,0,0,380
4747,220,120,40,0,0,0,380
4748,260,140,120,160,160,320,1160
4749,180,100,40,0,0,0,320
4750,160,140,120,80,0,0,500
4751,200,80,120,160,320,0,880
4752,170,80,40,0,0,0,290
4753,210,120,120,160,320,0,930
4754,220,100,120,80,0,0,520
4755,250,100,80,80,0,0,510
4756,220,100,120,80,0,0,520
4757,170,80,120,160,160,320,1010
4758,190,100,120,160,0,0,570
4759,180,80,80,80,160,320,900
4760,210,120,80,0,0,0,410
4761,210,180,120,160,320,0,990
4762,180,160,0,0,0,0,340
4763,210,80,120,80,160,0,650
4764,190,100,40,0,0,0,330
4765,190,60,80,160,320,320,1130
4766,220,140,0,0,0,0,360
4767,190,180,160,80,0,0,610
4768,210,200,120,160,160,320,1170
4769,170,80,80,80,160,0,570
4770,170,100,120,160,160,0,710
4771,250,100,80,160,320,0,910
4772,230,120,120,80,160,0,710
4773,160,80,40,0,0,0,280
4774,230,140,120,160,160,0,810
4775,210,120,120,80,160,0,690
4776,190,160,80,80,160,0,670
4777,220,120,160,160,0,0,660
4778,210,140,80,80,160,0,670
4779,200,200,120,160,160,0,840
4780,210,140,40,80,160,0,630
4781,230,160,80,80,160,320,1030
4782,170,120,120,160,160,0,730
4783,200,140,80,80,0,0,500
4784,210,120,160,160,160,320,1130
4785,190,140,120,80,160,0,690
4786,200,160,120,240,320,320,1360
4787,190,100,120,80,0,0,490
4788,220,140,80,160,320,0,920
4789,200,140,120,240,320,0,1020
4790,180,120,120,80,0,0,500
4791,190,180,200,160,320,0,1050
4792,210,100,160,160,160,0,790
4793,170,80,40,80,0,0,370
4794,140,100,120,160,160,0,680
4795,170,140,120,80,160,0,670
4796,200,200,200,240,320,320,1480
4797,190,100,120,240,160,0,810
4798,180,140,120,80,160,0,680
4799,230,140,120,80,0,0,570
4800,230,120,120,80,0,0,550
4801,200,120,120,0,0,0,440
4802,190,100,80,80,0,0,450
4803,210,140,160,80,0,0,590
4804,210,100,120,160,160,0,750
4805,170,60,80,160,320,320,1110
4806,190,100,120,160,320,320,1210
4807,210,120,120,160,160,0,770
4808,210,180,160,80,0,0,630
4809,180,100,40,80,160,0,560
4810,240,140,160,80,0,0,620
4811,210,100,80,80,0,0,470
4812,140,80,40,0,0,0,260
4813,220,80,80,80,0,0,460
4814,200,160,80,80,0,0,520
4815,220,120,120,160,0,0,620
4816,200,80,120,80,0,0,480
4817,180,120,160,160,160,0,780
4818,170,120,80,80,160,0,610
4819,180,160,80,0,0,0,420
4820,220,80,40,80,0,0,420
4821,190,100,120,80,160,320,970
4822,170,80,40,0,0,0,290
4823,220,120,160,80,0,0,580
4824,190,140,120,80,160,0,690
4825,220,160,120,240,160,0,900
4826,180,120,200,240,160,0,900
4827,210,100,80,80,0,0,470
4828,210,140,80,80,0,0,510
4829,150,100,120,240,160,0,770
4830,220,160,80,80,160,320,1020
4831,200,120,120,80,160,320,1000
4832,170,140,160,240,160,0,870
4833,180,120,40,80,160,320,900
4834,180,200,160,240,320,0,1100
4835,170,120,80,160,160,0,690
4836,200,140,80,160,160,0,740
4837,170,120,120,80,160,0,650
4838,170,140,120,160,160,0,750
4839,200,140,80,80,0,0,500
4840,200,120,120,160,160,0,760
4841,150,140,160,80,0,0,530
4842,230,200,200,160,320,0,1110
4843,200,100,40,0,0,0,340
4844,180,100,80,80,160,0,600
4845,180,80,40,80,0,0,380
4846,180,100,80,160,160,0,680
4847,130,120,80,80,0,0,410
4848,210,80,40,80,0,0,410
4849,160,160,120,80,0,0,520
4850,220,120,120,80,160,0,700
4851,210,140,80,160,160,0,750
4852,220,120,80,0,0,0,420
4853,180,160,120,80,160,0,700
4854,140,120,120,240,320,0,940
4855,190,160,120,80,0,0,550
4856,230,140,80,0,0,0,450
4857,180,100,160,240,160,0,840
4858,190,100,160,160,160,0,770
4859,190,100,120,160,160,0,730
4860,180,180,120,80,0,0,560
4861,160,120,40,80,160,0,560
4862,200,140,120,160,160,320,1100
4863,160,120,200,240,320,320,1360
4864,200,160,80,80,160,0,680
4865,110,80,80,160,160,320,910
4866,180,160,160,160,0,0,660
4867,210,100,120,80,160,0,670
4868,210,120,120,160,160,0,770
4869,200,80,40,80,160,0,560
4870,160,60,0,0,0,0,220
4871,200,160,160,160,0,0,680
4872,170,140,120,80,160,0,670
4873,220,100,40,0,0,0,360
4874,210,80,40,80,160,0,570
4875,170,100,80,80,0,0,430
4876,180,120,80,160,0,0,540
4877,190,100,160,160,160,0,770
4878,180,100,80,0,0,0,360
4879,200,120,80,0,0,0,400
4880,160,60,40,0,0,0,260
4881,190,80,80,160,160,0,670
4882,170,120,160,240,160,320,1170
4883,150,40,80,80,160,0,510
4884,220,180,160,160,320,0,1040
4885,210,140,120,80,160,0,710
4886,210,120,160,160,160,0,810
4887,200,80,40,80,160,0,560
4888,180,80,80,80,160,0,580
4889,180,100,40,0,0,0,320
4890,180,100,120,80,160,0,640
4891,190,100,40,80,160,0,570
4892,210,160,120,160,160,0,810
4893,180,120,80,80,160,0,620
4894,210,120,200,160,160,0,850
4895,200,200,80,80,0,0,560
4896,210,160,120,80,160,0,730
4897,210,100,120,160,0,0,590
4898,220,180,160,160,160,0,880
4899,170,100,160,160,320,0,910
4900,200,100,40,0,0,0,340
4901,210,120,80,0,0,0,410
4902,230,160,120,160,0,0,670
4903,200,140,120,80,160,0,700
4904,190,120,120,80,160,0,670
4905,200,120,80,80,160,0,640
4906,180,140,120,0,0,0,440
4907,190,120,80,0,0,0,390
4908,160,100,120,160,160,0,700
4909,170,120,80,0,0,0,370
4910,220,120,80,80,160,0,660
4911,200,120,120,80,160,0,680
4912,210,100,80,80,160,0,630
4913,210,100,120,160,160,0,750
4914,190,140,120,80,0,0,530
4915,200,80,40,0,0,0,320
4916,200,120,40,80,160,0,600
4917,180,80,120,160,160,0,700
4918,180,160,120,0,0,0,460
4919,130,120,160,80,160,0,650
4920,210,160,120,160,320,0,970
4921,200,160,120,80,160,0,720
4922,220,140,80,160,160,0,760
4923,230,100,80,80,0,0,490
4924,230,180,160,80,160,320,1130
4925,190,100,40,0,0,0,330
4926,220,100,80,160,320,320,1200
4927,170,140,80,160,0,0,550
4928,220,160,120,80,0,0,580
4929,190,100,40,0,0,0,330
4930,210,160,160,80,160,0,770
4931,200,140,120,80,160,320,1020
4932,240,140,200,160,160,320,1220
4933,170,120,160,160,320,0,930
4934,170,80,80,80,160,0,570
4935,210,160,160,160,160,0,850
4936,170,100,120,80,0,0,470
4937,220,100,120,160,160,0,760
4938,210,140,200,240,320,0,1110
4939,190,180,120,160,160,0,810
4940,200,120,80,80,160,0,640
4941,180,120,80,80,160,0,620
4942,240,180,160,240,320,0,1140
4943,200,100,80,80,160,320,940
4944,200,120,120,160,0,0,600
4945,180,140,160,0,0,0,480
4946,200,160,200,160,320,0,1040
4947,210,120,120,160,160,0,770
4948,200,140,80,80,0,0,500
4949,200,140,120,160,320,0,940
4950,170,60,80,80,160,0,550
4951,180,140,160,80,160,0,720
4952,180,100,120,160,160,0,720
4953,260,140,120,80,0,0,600
4954,230,100,80,80,160,320,970
4955,150,100,120,80,0,0,450
4956,210,120,120,160,0,0,610
4957,170,160,120,240,320,320,1330
4958,170,180,200,240,160,0,950
4959,250,140,120,160,160,0,830
4960,200,100,40,0,0,0,340
4961,180,120,80,80,0,0,460
4962,220,120,80,80,160,0,660
4963,200,120,80,0,0,0,400
4964,200,100,160,240,160,320,1180
4965,190,80,0,0,0,0,270
4966,230,160,160,240,320,0,1110
4967,210,140,200,80,0,0,630
4968,230,120,160,80,0,0,590
4969,220,140,120,160,320,320,1280
4970,180,120,120,80,0,0,500
4971,210,220,160,80,0,0,670
4972,190,80,40,80,160,320,870
4973,240,140,120,80,160,320,1060
4974,170,120,160,80,0,0,530
4975,200,80,80,80,160,0,600
4976,210,120,120,80,160,0,690
4977,190,120,120,0,0,0,430
4978,230,100,160,160,320,0,970
4979,180,160,160,160,160,320,1140
4980,200,80,80,80,160,320,920
4981,200,120,120,80,0,0,520
4982,210,100,120,80,160,0,670
4983,210,120,80,0,0,0,410
4984,190,80,40,0,0,0,310
4985,210,180,120,80,160,0,750
4986,180,120,120,160,160,0,740
4987,220,180,160,80,160,320,1120
4988,210,160,120,80,160,0,730
4989,240,120,120,160,160,0,800
4990,190,100,120,160,320,0,890
4991,190,140,160,160,160,0,810
4992,200,80,40,80,0,0,400
4993,170,60,40,80,160,0,510
4994,210,180,160,240,160,0,950
4995,180,100,120,160,160,0,720
4996,120,60,80,160,160,0,580
4997,190,100,120,160,160,0,730
4998,160,140,120,240,160,320,1140
4999,190,140,120,80,160,320,1010
5000,200,160,160,160,160,0,840
5001,190,140,160,240,0,0,730
5002,210,140,200,240,160,0,950
5003,200,140,80,80,160,0,660
5004,190,140,80,80,0,0,490
5005,200,120,80,0,0,0,400
5006,180,100,40,80,160,320,880
5007,220,140,200,160,160,320,1200
5008,180,140,160,80,160,0,720
5009,150,100,160,80,0,0,490
5010,170,140,120,160,160,0,750
5011,170,100,120,80,160,0,630
5012,160,180,120,160,320,0,940
5013,180,60,40,0,0,0,280
5014,180,160,80,160,160,0,740
5015,170,100,120,160,160,320,1030
5016,190,160,80,160,320,0,910
5017,190,120,120,160,160,0,750
5018,180,100,120,80,160,0,640
5019,190,120,80,80,0,0,470
5020,190,80,80,80,0,0,430
5021,180,140,40,0,0,0,360
5022,210,180,80,80,160,0,710
5023,230,80,80,160,0,0,550
5024,210,140,80,80,160,0,670
5025,200,60,80,160,160,0,660
5026,180,100,120,160,160,0,720
5027,200,140,80,80,0,0,500
5028,180,140,200,80,160,0,760
5029,230,140,120,80,0,0,570
5030,200,120,80,80,0,0,480
5031,180,140,120,240,160,0,840
5032,200,160,120,80,0,0,560
5033,160,140,80,160,0,0,540
5034,130,120,40,80,160,0,530
5035,200,80,80,80,160,0,600
5036,200,80,80,160,160,0,680
5037,220,160,160,80,160,320,1100
5038,190,80,80,80,0,0,430
5039,200,160,160,80,160,320,1080
5040,210,80,80,80,160,0,610
5041,180,140,120,160,320,320,1240
5042,170,100,120,160,160,0,710
5043,190,200,200,240,160,320,1310
5044,250,140,80,160,320,0,950
5045,220,140,120,160,160,0,800
5046,200,180,240,160,160,0,940
5047,240,80,40,80,160,0,600
5048,190,120,160,160,160,0,790
5049,190,120,120,240,160,0,830
5050,260,100,80,0,0,0,440
5051,200,160,80,160,0,0,600
5052,190,120,120,160,0,0,590
5053,190,140,80,160,160,0,730
5054,170,80,80,160,320,320,1130
5055,210,140,160,80,160,0,750
5056,230,160,80,80,160,0,710
5057,190,140,120,80,0,0,530
5058,210,120,160,160,320,320,1290
5059,220,120,0,0,0,0,340
5060,190,40,40,0,0,0,270
5061,240,160,200,80,0,0,680
5062,220,120,40,80,160,0,620
5063,160,120,120,160,160,0,720
5064,210,180,160,160,0,0,710
5065,180,180,200,240,160,0,960
5066,200,120,40,0,0,0,360
5067,180,140,120,160,160,320,1080
5068,180,140,80,80,0,0,480
5069,170,80,120,0,0,0,370
5070,180,80,80,0,0,0,340
5071,230,100,40,80,0,0,450
5072,180,100,120,80,160,0,640
5073,200,100,80,80,160,0,620
5074,200,160,160,160,0,0,680
5075,180,100,80,160,160,0,680
5076,160,120,80,160,160,0,680
5077,210,140,80,0,0,0,430
5078,220,140,160,160,160,0,840
5079,230,120,120,160,160,0,790
5080,230,160,160,160,320,0,1030
5081,180,120,80,80,0,0,460
5082,200,80,80,160,160,0,680
5083,140,140,80,80,0,0,440
5084,230,120,80,0,0,0,430
5085,200,140,120,80,160,0,700
5086,160,120,40,0,0,0,320
5087,190,140,120,80,0,0,530
5088,150,120,120,160,160,0,710
5089,150,80,80,160,160,0,630
5090,190,60,80,80,160,0,570
5091,210,120,160,160,160,0,810
5092,180,100,120,160,160,0,720
5093,200,100,80,160,160,0,700
5094,160,120,80,0,0,0,360
5095,170,100,120,80,160,320,950
5096,190,160,80,160,160,0,750
5097,200,100,80,160,160,0,700
5098,200,120,120,160,160,0,760
5099,210,100,120,160,160,320,1070
5100,180,120,80,0,0,0,380
5101,220,120,120,80,160,320,1020
5102,240,40,40,80,160,320,880
5103,210,140,160,160,160,0,830
5104,190,140,160,80,0,0,570
5105,160,140,120,80,0,0,500
5106,210,140,80,80,0,0,510
5107,190,80,120,0,0,0,390
5108,230,140,80,80,160,0,690
5109,170,100,160,0,0,0,430
5110,170,160,160,160,160,320,1130
5111,220,40,40,0,0,0,300
5112,150,80,120,160,160,0,670
5113,190,140,80,0,0,0,410
5114,210,100,40,80,0,0,430
5115,160,160,120,80,0,0,520
5116,240,160,80,80,0,0,560
5117,170,80,120,160,0,0,530
5118,210,160,120,160,160,0,810
5119,200,140,80,80,160,0,660
5120,200,60,120,240,0,0,620
5121,190,100,80,0,0,0,370
5122,200,100,40,0,0,0,340
5123,190,160,120,0,0,0,470
5124,200,160,200,240,320,0,1120
5125,170,120,120,0,0,0,410
5126,140,80,40,80,160,0,500
5127,180,100,120,80,160,320,960
5128,250,180,80,0,0,0,510
5129,160,120,160,80,0,0,520
5130,200,160,160,80,160,0,760
5131,220,140,120,160,0,0,640
5132,180,100,80,80,160,0,600
5133,210,140,120,160,160,0,790
5134,200,120,40,0,0,0,360
5135,190,160,200,160,0,0,710
5136,190,100,80,160,320,320,1170
5137,220,140,40,80,160,0,640
5138,200,140,80,80,0,0,500
5139,180,160,120,0,0,0,460
5140,190,120,120,80,0,0,510
5141,250,180,160,160,160,320,1230
5142,190,100,0,0,0,0,290
5143,230,180,80,0,0,0,490
5144,180,80,40,0,0,0,300
5145,190,80,80,160,160,0,670
5146,210,100,160,80,160,0,710
5147,190,100,80,160,160,320,1010
5148,200,160,80,80,0,0,520
5149,220,160,120,240,320,0,1060
5150,200,160,120,160,160,0,800
5151,240,80,80,80,160,0,640
5152,200,120,80,80,160,0,640
5153,160,120,40,80,160,0,560
5154,180,120,120,80,0,0,500
5155,190,100,120,160,160,0,730
5156,210,140,120,160,320,320,1270
5157,190,120,80,80,0,0,470
5158,200,160,160,240,160,0,920
5159,190,80,120,80,0,0,470
5160,200,100,120,160,320,0,900
5161,230,180,80,80,0,0,570
5162,210,80,40,80,160,0,570
5163,210,100,120,80,0,0,510
5164,220,140,80,0,0,0,440
5165,190,60,80,160,160,0,650
5166,250,140,160,80,160,0,790
5167,220,180,80,160,160,0,800
5168,180,80,120,160,320,320,1180
5169,190,100,160,80,0,0,530
5170,220,180,120,80,0,0,600
5171,170,140,40,0,0,0,350
5172,180,140,160,80,160,0,720
5173,190,120,160,160,0,0,630
5174,200,120,0,0,0,0,320
5175,190,80,80,80,0,0,430
5176,170,100,40,0,0,0,310
5177,230,120,80,0,0,0,430
5178,170,120,40,80,160,0,570
5179,200,160,160,0,0,0,520
5180,220,140,80,80,160,320,1000
5181,210,160,80,80,0,0,530
5182,230,160,120,80,0,0,590
5183,210,100,80,80,0,0,470
5184,190,100,80,160,320,320,1170
5185,170,140,40,80,160,320,910
5186,220,160,120,160,0,0,660
5187,180,80,80,80,0,0,420
5188,210,140,120,160,160,0,790
5189,210,120,120,80,0,0,530
5190,220,100,80,80,160,0,640
5191,160,140,160,160,160,0,780
5192,200,160,80,0,0,0,440
5193,190,140,120,160,0,0,610
5194,160,120,40,80,160,0,560
5195,190,140,80,80,160,0,650
5196,190,160,120,160,0,0,630
5197,190,100,120,160,160,0,730
5198,210,120,160,240,320,0,1050
5199,200,140,120,160,160,320,1100
5200,190,180,160,160,0,0,690
5201,250,160,120,80,0,0,610
5202,190,120,160,160,0,0,630
5203,200,80,120,80,160,0,640
5204,160,140,80,160,0,0,540
5205,190,140,120,240,160,0,850
5206,170,60,120,80,160,0,590
5207,200,140,120,80,160,0,700
5208,210,160,120,80,0,0,570
5209,220,120,120,0,0,0,460
5210,240,140,80,160,160,0,780
5211,210,100,120,80,160,0,670
5212,170,120,80,160,160,320,1010
5213,160,140,120,160,160,0,740
5214,190,140,120,80,160,0,690
5215,210,100,40,0,0,0,350
5216,200,140,200,160,320,0,1020
5217,190,120,120,80,0,0,510
5218,170,80,80,80,160,0,570
5219,200,120,80,80,160,0,640
5220,230,140,120,80,160,0,730
5221,170,100,80,80,160,0,590
5222,230,120,200,80,0,0,630
5223,170,100,40,0,0,0,310
5224,200,100,80,0,0,0,380
5225,210,140,200,80,160,0,790
5226,230,120,40,0,0,0,390
5227,200,160,120,160,160,0,800
5228,200,160,80,80,0,0,520
5229,180,140,40,80,0,0,440
5230,250,140,40,80,160,320,990
5231,180,120,160,240,320,0,1020
5232,160,60,0,0,0,0,220
5233,200,120,80,80,160,320,960
5234,180,160,80,0,0,0,420
5235,210,60,0,0,0,0,270
5236,160,80,40,80,160,0,520
5237,190,80,80,80,160,0,590
5238,190,60,80,160,160,0,650
5239,180,100,80,80,0,0,440
5240,210,120,120,80,0,0,530
5241,220,120,200,240,320,320,1420
5242,200,140,120,160,160,320,1100
5243,190,140,120,160,320,0,930
5244,220,140,80,0,0,0,440
5245,180,120,80,0,0,0,380
5246,230,120,40,0,0,0,390
5247,170,120,120,80,0,0,490
5248,170,140,200,160,160,0,830
5249,200,180,160,0,0,0,540
5250,190,180,120,80,160,0,730
5251,220,180,120,160,160,0,840
5252,240,160,160,80,160,0,800
5253,200,140,40,0,0,0,380
5254,240,80,40,80,0,0,440
5255,160,100,120,240,160,0,780
5256,200,120,120,160,160,0,760
5257,150,80,80,80,160,0,550
5258,190,140,120,80,160,0,690
5259,190,120,120,80,0,0,510
5260,160,100,120,0,0,0,380
5261,190,60,80,80,160,0,570
5262,220,140,120,160,320,0,960
5263,140,100,120,0,0,0,360
5264,170,60,80,80,0,0,390
5265,180,140,160,160,0,0,640
5266,230,80,120,240,320,0,990
5267,200,100,160,240,320,0,1020
5268,200,140,120,160,320,0,940
5269,190,120,200,80,160,0,750
5270,180,160,40,0,0,0,380
5271,210,140,160,160,160,0,830
5272,200,120,80,80,0,0,480
5273,200,140,80,80,160,0,660
5274,170,140,120,160,0,0,590
5275,220,220,120,80,160,0,800
5276,210,140,160,80,160,0,750
5277,160,80,80,160,320,0,800
5278,200,120,160,160,0,0,640
5279,160,100,120,80,0,0,460
5280,170,100,120,80,0,0,470
5281,210,80,80,80,160,0,610
5282,190,100,120,80,160,0,650
5283,170,140,160,160,160,0,790
5284,210,160,120,0,0,0,490
5285,200,80,80,160,160,0,680
5286,190,120,80,160,160,0,710
5287,180,80,120,0,0,0,380
5288,230,180,80,80,160,0,730
5289,170,60,80,80,160,0,550
5290,210,100,80,80,160,320,950
5291,200,120,40,80,160,320,920
5292,180,100,160,160,320,320,1240
5293,190,100,120,0,0,0,410
5294,190,140,160,80,160,320,1050
5295,180,80,80,0,0,0,340
5296,180,140,160,160,0,0,640
5297,230,100,80,80,0,0,490
5298,210,140,120,240,160,0,870
5299,160,80,80,0,0,0,320
5300,220,180,120,80,0,0,600
5301,160,100,120,160,160,0,700
5302,210,80,120,80,160,0,650
5303,250,180,120,160,160,0,870
5304,170,120,40,80,160,0,570
5305,180,40,40,0,0,0,260
5306,200,160,80,160,160,0,760
5307,210,140,160,240,320,0,1070
5308,220,140,200,240,160,0,960
5309,210,120,40,0,0,0,370
5310,200,80,120,80,160,320,960
5311,200,120,80,160,160,0,720
5312,190,120,80,80,0,0,470
5313,210,160,120,0,0,0,490
5314,200,80,80,80,0,0,440
5315,190,120,120,160,160,0,750
5316,200,60,40,80,0,0,380
5317,220,120,80,160,160,0,740
5318,220,160,120,80,160,0,740
5319,210,100,80,80,160,0,630
5320,180,100,80,160,0,0,520
5321,220,100,40,0,0,0,360
5322,200,100,120,240,320,0,980
5323,190,60,80,80,160,0,570
5324,180,100,80,160,160,0,680
5325,200,160,120,160,0,0,640
5326,150,140,120,160,320,0,890
5327,180,60,80,80,0,0,400
5328,210,60,0,0,0,0,270
5329,160,160,160,160,0,0,640
5330,200,140,80,80,0,0,500
5331,210,180,40,0,0,0,430
5332,230,180,160,160,160,0,890
5333,180,120,120,80,160,0,660
5334,200,180,200,240,320,320,1460
5335,170,160,160,160,160,0,810
5336,210,180,120,80,160,320,1070
5337,160,160,120,160,320,0,920
5338,170,160,120,160,160,0,770
5339,220,160,120,80,160,320,1060
5340,250,180,40,80,0,0,550
5341,230,100,40,80,160,320,930
5342,180,120,80,80,0,0,460
5343,210,180,80,80,0,0,550
5344,190,100,40,0,0,0,330
5345,210,120,40,0,0,0,370
5346,160,120,80,0,0,0,360
5347,220,120,120,80,160,320,1020
5348,210,180,80,160,160,320,1110
5349,200,140,40,0,0,0,380
5350,180,140,80,80,0,0,480
5351,220,120,200,160,160,0,860
5352,240,140,120,0,0,0,500
5353,180,140,80,80,160,0,640
5354,150,120,120,80,160,0,630
5355,200,160,160,240,160,0,920
5356,220,120,80,80,160,320,980
5357,200,140,200,160,160,0,860
5358,190,120,40,80,160,0,590
5359,170,100,80,80,0,0,430
5360,210,120,200,240,0,0,770
5361,230,120,120,160,320,0,950
5362,180,140,200,160,160,0,840
5363,200,140,40,80,160,0,620
5364,220,140,160,80,160,0,760
5365,190,60,40,0,0,0,290
5366,210,140,200,160,160,0,870
5367,210,100,80,80,160,0,630
5368,160,100,0,0,0,0,260
5369,230,80,0,0,0,0,310
5370,210,180,80,160,160,0,790
5371,210,160,160,80,0,0,610
5372,230,80,120,160,160,0,750
5373,210,140,80,80,160,0,670
5374,160,120,80,80,0,0,440
5375,180,100,80,80,0,0,440
5376,140,120,160,80,160,0,660
5377,220,140,160,80,0,0,600
5378,190,180,160,0,0,0,530
5379,190,160,160,160,0,0,670
5380,180,120,120,80,0,0,500
5381,170,120,160,160,160,0,770
5382,190,80,120,160,160,320,1030
5383,190,120,200,80,160,0,750
5384,190,140,120,80,160,0,690
5385,180,120,160,0,0,0,460
5386,220,120,160,160,160,0,820
5387,200,200,160,160,160,0,880
5388,200,140,40,0,0,0,380
5389,210,140,80,0,0,0,430
5390,200,160,120,80,0,0,560
5391,180,140,160,160,320,320,1280
5392,190,140,160,160,160,0,810
5393,190,120,40,80,0,0,430
5394,210,80,80,80,160,0,610
5395,210,180,160,80,160,0,790
5396,130,120,120,160,160,0,690
5397,170,160,120,160,160,0,770
5398,190,140,160,80,0,0,570
5399,230,160,80,80,0,0,550
5400,220,80,0,0,0,0,300
5401,230,180,160,160,320,320,1370
5402,200,160,120,80,0,0,560
5403,200,100,80,80,160,0,620
5404,170,120,80,80,160,0,610
5405,220,120,120,160,160,0,780
5406,180,180,80,0,0,0,440
5407,200,120,80,0,0,0,400
5408,240,120,40,80,160,0,640
5409,200,100,120,160,160,0,740
5410,150,120,160,80,160,0,670
5411,210,100,80,80,0,0,470
5412,180,160,160,240,160,0,900
5413,230,140,80,80,160,0,690
5414,200,160,0,0,0,0,360
5415,220,120,160,240,160,0,900
5416,170,120,40,0,0,0,330
5417,220,120,40,80,160,0,620
5418,190,120,80,160,160,0,710
5419,210,120,40,80,160,0,610
5420,200,120,40,80,0,0,440
5421,190,80,160,160,160,320,1070
5422,140,80,80,80,160,0,540
5423,180,120,120,80,160,0,660
5424,170,120,120,80,160,0,650
5425,200,160,200,160,160,320,1200
5426,180,140,160,160,320,0,960
5427,220,140,80,0,0,0,440
5428,230,120,120,160,160,320,1110
5429,160,140,120,160,320,320,1220
5430,150,100,80,80,0,0,410
5431,220,80,80,80,160,0,620
5432,210,80,40,80,160,0,570
5433,240,120,160,80,160,320,1080
5434,190,100,80,0,0,0,370
5435,200,140,80,80,160,0,660
5436,200,140,120,160,160,0,780
5437,200,160,200,160,160,0,880
5438,220,100,80,80,0,0,480
5439,200,160,80,80,160,0,680
5440,170,140,120,80,160,0,670
5441,240,100,120,80,160,0,700
5442,200,100,40,80,0,0,420
5443,210,120,160,240,0,0,730
5444,220,60,80,160,320,320,1160
5445,210,140,80,80,160,0,670
5446,200,120,160,80,160,0,720
5447,200,120,120,240,320,320,1320
5448,190,160,80,80,160,0,670
5449,200,100,120,160,0,0,580
5450,170,120,120,80,160,0,650
5451,180,140,80,160,0,0,560
5452,170,140,120,80,160,0,670
5453,210,140,80,0,0,0,430
5454,190,140,120,160,0,0,610
5455,200,100,120,80,0,0,500
5456,180,140,120,160,0,0,600
5457,170,160,200,160,160,0,850
5458,220,180,80,0,0,0,480
5459,190,80,120,80,0,0,470
5460,210,160,80,80,160,0,690
5461,210,100,80,80,160,0,630
5462,230,120,120,160,160,320,1110
5463,210,140,160,160,160,0,830
5464,200,80,120,160,0,0,560
5465,170,120,80,0,0,0,370
5466,240,180,160,160,0,0,740
5467,230,160,160,80,160,0,790
5468,200,140,160,80,160,0,740
5469,170,100,120,80,0,0,470
5470,210,140,120,160,160,0,790
5471,230,140,40,80,160,0,650
5472,200,120,80,80,160,320,960
5473,220,120,120,80,0,0,540
5474,160,140,160,160,0,0,620
5475,190,120,0,0,0,0,310
5476,170,160,200,160,320,320,1330
5477,220,120,120,80,0,0,540
5478,180,80,120,80,160,0,620
5479,130,40,40,80,0,0,290
5480,180,80,80,80,0,0,420
5481,170,120,120,80,0,0,490
5482,190,120,120,160,320,0,910
5483,180,180,40,0,0,0,400
5484,200,160,120,240,320,320,1360
5485,180,140,120,160,160,0,760
5486,220,80,80,0,0,0,380
5487,190,100,160,240,320,0,1010
5488,220,100,120,80,0,0,520
5489,180,140,120,80,0,0,520
5490,200,100,160,160,160,0,780
5491,170,100,80,160,320,320,1150
5492,170,140,120,80,160,320,990
5493,180,100,40,80,160,320,880
5494,240,160,160,240,160,0,960
5495,200,100,200,160,0,0,660
5496,220,160,160,160,160,0,860
5497,240,80,80,160,160,0,720
5498,230,180,120,160,160,320,1170
5499,200,140,40,0,0,0,380
5500,230,140,80,0,0,0,450
5501,230,160,120,160,160,0,830
5502,200,160,160,80,160,0,760
5503,200,140,120,160,320,0,940
5504,190,140,120,0,0,0,450
5505,150,80,40,0,0,0,270
5506,190,120,120,80,160,320,990
5507,190,40,40,0,0,0,270
5508,180,140,160,80,0,0,560
5509,180,100,80,160,160,0,680
5510,170,140,40,0,0,0,350
5511,210,180,200,240,320,0,1150
5512,210,100,120,80,160,0,670
5513,190,120,160,160,160,320,1110
5514,190,140,160,160,160,0,810
5515,200,140,120,160,160,0,780
5516,230,100,80,160,0,0,570
5517,150,160,120,240,0,0,670
5518,180,100,80,80,0,0,440
5519,160,140,200,160,0,0,660
5520,180,120,160,80,0,0,540
5521,200,60,80,0,0,0,340
5522,210,140,120,0,0,0,470
5523,220,160,160,160,160,0,860
5524,190,120,40,0,0,0,350
5525,250,140,160,160,320,0,1030
5526,230,200,80,160,320,0,990
5527,180,120,160,80,160,0,700
5528,180,140,160,240,160,0,880
5529,150,40,40,0,0,0,230
5530,180,100,80,80,0,0,440
5531,180,80,40,80,160,320,860
5532,210,100,80,160,320,0,870
5533,220,220,120,160,160,320,1200
5534,240,140,40,80,160,320,980
5535,190,140,160,160,320,320,1290
5536,200,120,80,160,160,320,1040
5537,180,140,80,160,160,320,1040
5538,160,160,120,160,160,320,1080
5539,220,140,120,160,160,0,800
5540,170,120,80,80,0,0,450
5541,230,120,80,0,0,0,430
5542,190,120,120,80,0,0,510
5543,140,80,120,80,160,0,580
5544,170,100,120,160,160,320,1030
5545,230,100,120,80,0,0,530
5546,240,80,120,80,160,0,680
5547,190,140,40,80,160,0,610
5548,240,120,160,80,0,0,600
5549,210,140,40,0,0,0,390
5550,180,140,80,160,160,0,720
5551,180,100,120,80,0,0,480
5552,180,140,80,80,0,0,480
5553,150,100,0,0,0,0,250
5554,200,180,120,80,160,0,740
5555,220,180,120,80,160,0,760
5556,190,120,80,0,0,0,390
5557,170,140,120,80,160,0,670
5558,170,140,80,80,160,0,630
5559,190,120,80,0,0,0,390
5560,200,140,160,160,160,320,1140
5561,220,100,160,160,0,0,640
5562,160,120,80,80,160,320,920
5563,190,160,200,160,160,320,1190
5564,170,120,160,80,160,0,690
5565,250,160,40,0,0,0,450
5566,180,120,120,80,0,0,500
5567,190,120,80,80,0,0,470
5568,160,100,120,0,0,0,380
5569,160,60,40,0,0,0,260
5570,220,160,160,80,160,0,780
5571,220,140,80,160,160,0,760
5572,210,100,80,160,160,0,710
5573,200,100,0,0,0,0,300
5574,170,100,80,80,0,0,430
5575,170,140,120,160,160,0,750
5576,190,200,160,160,160,0,870
5577,200,120,120,0,0,0,440
5578,250,120,80,80,160,0,690
5579,200,140,40,0,0,0,380
5580,160,100,120,160,320,0,860
5581,200,160,160,80,0,0,600
5582,180,100,80,160,160,0,680
5583,200,120,80,80,160,0,640
5584,200,140,200,240,320,0,1100
5585,250,200,120,160,320,0,1050
5586,160,140,80,0,0,0,380
5587,170,140,80,80,160,0,630
5588,230,140,120,80,0,0,570
5589,210,120,80,160,160,0,730
5590,230,160,160,80,160,0,790
5591,180,140,160,160,160,320,1120
5592,180,120,120,160,160,0,740
5593,180,140,120,0,0,0,440
5594,160,60,0,0,0,0,220
5595,180,140,160,240,160,320,1200
5596,170,140,40,0,0,0,350
5597,200,140,80,0,0,0,420
5598,210,180,160,240,160,0,950
5599,220,160,120,80,160,0,740
5600,190,100,80,160,160,0,690
5601,180,120,120,80,160,320,980
5602,220,140,160,160,0,0,680
5603,200,120,160,160,160,0,800
5604,150,140,160,80,0,0,530
5605,220,160,160,80,0,0,620
5606,150,120,80,80,160,320,910
5607,210,180,80,160,160,0,790
5608,190,80,80,80,0,0,430
5609,190,140,120,80,160,0,690
5610,260,160,80,80,160,0,740
5611,200,80,120,160,0,0,560
5612,190,120,40,0,0,0,350
5613,200,160,200,160,160,0,880
5614,220,140,80,80,160,0,680
5615,220,140,120,240,320,320,1360
5616,220,180,80,80,160,0,720
5617,240,80,80,80,160,0,640
5618,200,40,40,80,160,0,520
5619,210,120,160,80,160,0,730
5620,210,140,120,80,160,0,710
5621,190,160,40,0,0,0,390
5622,200,80,80,160,160,0,680
5623,200,160,120,160,0,0,640
5624,180,100,120,160,160,320,1040
5625,200,120,120,160,320,320,1240
5626,190,80,80,0,0,0,350
5627,160,160,120,160,320,320,1240
5628,210,120,80,160,160,0,730
5629,190,120,120,80,0,0,510
5630,170,100,80,80,160,0,590
5631,200,160,160,80,160,0,760
5632,180,180,40,0,0,0,400
5633,230,120,160,160,160,0,830
5634,180,100,120,160,160,0,720
5635,180,80,120,160,160,0,700
5636,230,120,120,0,0,0,470
5637,210,100,40,80,160,0,590
5638,170,80,120,80,160,0,610
5639,170,120,160,160,0,0,610
5640,150,120,160,240,160,0,830
5641,160,120,120,240,160,0,800
5642,230,160,160,80,0,0,630
5643,150,100,120,80,0,0,450
5644,210,120,160,80,0,0,570
5645,210,140,120,160,160,0,790
5646,210,140,120,160,160,0,790
5647,260,160,120,0,0,0,540
5648,210,100,80,160,0,0,550
5649,170,60,40,0,0,0,270
5650,210,140,80,80,160,0,670
5651,150,120,80,80,160,320,910
5652,210,140,120,80,0,0,550
5653,200,100,40,80,160,0,580
5654,210,120,120,80,0,0,530
5655,170,80,80,80,160,0,570
5656,140,100,120,80,160,0,600
5657,200,120,160,160,160,0,800
5658,170,140,40,0,0,0,350
5659,190,100,160,240,320,0,1010
5660,190,180,160,80,160,0,770
5661,200,200,160,80,0,0,640
5662,200,180,120,0,0,0,500
5663,180,100,40,80,160,0,560
5664,200,120,40,0,0,0,360
5665,210,160,80,0,0,0,450
5666,200,20,40,0,0,0,260
5667,200,140,80,80,0,0,500
5668,170,140,120,160,320,0,910
5669,200,120,120,160,160,0,760
5670,160,160,120,160,160,0,760
5671,200,100,120,0,0,0,420
5672,220,140,160,160,160,0,840
5673,200,80,80,160,320,0,840
5674,230,120,160,160,0,0,670
5675,190,120,80,80,160,0,630
5676,180,100,80,80,160,0,600
5677,200,100,80,80,160,320,940
5678,220,100,40,0,0,0,360
5679,160,140,160,80,160,0,700
5680,170,120,80,160,160,0,690
5681,160,100,80,0,0,0,340
5682,250,160,120,160,0,0,690
5683,230,160,160,0,0,0,550
5684,210,140,120,80,160,320,1030
5685,180,140,40,80,160,0,600
5686,180,100,80,80,0,0,440
5687,190,100,120,80,160,0,650
5688,150,80,80,80,0,0,390
5689,200,120,120,80,160,0,680
5690,210,120,120,160,160,0,770
5691,210,120,160,80,160,0,730
5692,190,140,160,160,0,0,650
5693,180,80,40,0,0,0,300
5694,160,80,80,80,160,0,560
5695,180,140,160,160,160,0,800
5696,220,80,40,0,0,0,340
5697,210,160,160,160,160,320,1170
5698,190,160,80,80,0,0,510
5699,180,100,40,0,0,0,320
5700,210,120,80,0,0,0,410
5701,220,160,80,80,0,0,540
5702,200,100,120,160,320,0,900
5703,180,80,80,0,0,0,340
5704,190,80,80,80,0,0,430
5705,230,200,240,160,160,0,990
5706,220,120,120,0,0,0,460
5707,220,100,80,80,0,0,480
5708,160,100,120,160,320,0,860
5709,200,60,80,160,160,0,660
5710,160,120,120,160,320,0,880
5711,220,100,120,80,0,0,520
5712,160,100,0,0,0,0,260
5713,180,80,80,80,0,0,420
5714,190,120,120,80,160,0,670
5715,220,80,80,80,160,0,620
5716,210,140,160,160,160,320,1150
5717,180,100,80,80,160,0,600
5718,220,160,160,0,0,0,540
5719,200,120,160,80,0,0,560
5720,200,80,120,80,0,0,480
5721,220,80,40,0,0,0,340
5722,190,120,120,160,160,0,750
5723,230,140,80,160,160,0,770
5724,200,140,120,0,0,0,460
5725,180,60,120,80,160,0,600
5726,220,100,80,80,160,0,640
5727,190,160,120,160,160,0,790
5728,190,100,80,0,0,0,370
5729,180,140,120,160,320,320,1240
5730,210,80,120,160,160,0,730
5731,230,120,120,80,160,0,710
5732,180,60,0,0,0,0,240
5733,170,60,40,80,160,0,510
5734,170,120,120,80,0,0,490
5735,200,80,40,0,0,0,320
5736,170,120,120,80,160,0,650
5737,160,120,80,80,0,0,440
5738,200,120,120,160,320,0,920
5739,190,60,80,160,320,0,810
5740,220,160,80,160,160,0,780
5741,250,120,80,0,0,0,450
5742,230,100,80,80,160,0,650
5743,210,120,160,80,0,0,570
5744,240,100,120,80,0,0,540
5745,190,120,120,80,0,0,510
5746,190,100,40,0,0,0,330
5747,200,120,160,80,0,0,560
5748,200,120,160,160,0,0,640
5749,240,180,200,240,160,0,1020
5750,260,160,120,160,320,0,1020
5751,250,120,120,80,0,0,570
5752,220,120,120,160,0,0,620
5753,180,180,200,240,160,0,960
5754,210,180,200,80,0,0,670
5755,240,160,160,80,160,0,800
5756,180,80,40,80,160,0,540
5757,170,120,120,80,160,0,650
5758,210,180,120,160,160,320,1150
5759,170,60,40,0,0,0,270
5760,190,180,160,80,0,0,610
5761,220,120,40,0,0,0,380
5762,200,140,40,80,160,0,620
5763,210,140,160,160,0,0,670
5764,210,80,120,0,0,0,410
5765,210,180,80,80,0,0,550
5766,220,140,120,80,160,0,720
5767,110,60,40,0,0,0,210
5768,230,160,80,80,0,0,550
5769,170,60,80,80,0,0,390
5770,180,120,80,160,160,0,700
5771,220,120,40,80,0,0,460
5772,240,120,120,240,320,0,1040
5773,170,80,40,80,160,0,530
5774,200,180,160,240,160,320,1260
5775,180,100,160,240,160,0,840
5776,190,140,80,160,0,0,570
5777,200,100,40,80,0,0,420
5778,210,60,80,80,160,0,590
5779,200,100,120,160,0,0,580
5780,170,100,40,0,0,0,310
5781,230,180,160,80,160,0,810
5782,220,100,120,160,320,320,1240
5783,140,140,160,240,320,0,1000
5784,190,100,120,240,160,0,810
5785,210,120,80,0,0,0,410
5786,230,160,80,160,320,0,950
5787,180,140,200,80,0,0,600
5788,180,120,0,0,0,0,300
5789,180,140,120,80,0,0,520
5790,200,100,80,80,160,0,620
5791,250,180,160,160,160,320,1230
5792,210,160,120,160,160,0,810
5793,140,60,80,80,160,0,520
5794,210,140,160,80,160,320,1070
5795,170,120,120,80,0,0,490
5796,200,140,120,160,320,320,1260
5797,150,140,120,160,160,0,730
5798,240,160,80,80,160,0,720
5799,220,100,80,160,160,0,720
5800,220,100,80,0,0,0,400
5801,180,80,120,80,160,320,940
5802,200,100,120,160,160,0,740
5803,210,160,80,0,0,0,450
5804,200,160,120,160,160,0,800
5805,210,80,40,80,160,0,570
5806,210,120,80,80,160,0,650
5807,170,140,200,80,160,0,750
5808,200,120,120,80,0,0,520
5809,150,120,80,80,160,320,910
5810,200,100,120,240,160,0,820
5811,210,140,120,160,160,0,790
5812,210,160,160,160,160,320,1170
5813,200,160,40,80,0,0,480
5814,220,160,160,80,0,0,620
5815,160,140,160,240,160,320,1180
5816,210,140,80,80,160,0,670
5817,200,100,120,80,0,0,500
5818,210,180,160,160,160,0,870
5819,170,120,120,160,160,0,730
5820,200,100,160,80,160,0,700
5821,190,100,40,80,160,320,890
5822,180,100,120,0,0,0,400
5823,180,100,80,80,160,0,600
5824,180,80,80,160,160,0,660
5825,190,140,120,160,320,0,930
5826,170,100,120,80,0,0,470
5827,170,140,120,80,160,320,990
5828,180,100,80,80,160,0,600
5829,190,100,120,160,160,320,1050
5830,210,180,40,0,0,0,430
5831,150,100,120,160,320,320,1170
5832,200,140,120,160,320,0,940
5833,220,140,160,160,320,0,1000
5834,200,120,160,160,320,0,960
5835,190,160,160,160,160,320,1150
5836,190,100,160,240,320,320,1330
5837,200,160,160,160,160,0,840
5838,210,160,120,80,0,0,570
5839,200,80,80,160,160,0,680
5840,170,80,40,0,0,0,290
5841,210,100,80,160,320,0,870
5842,180,80,80,80,0,0,420
5843,160,80,80,160,0,0,480
5844,200,160,120,80,160,0,720
5845,180,60,80,160,0,0,480
5846,210,60,40,80,160,320,870
5847,210,140,120,80,160,320,1030
5848,220,80,120,0,0,0,420
5849,210,80,40,0,0,0,330
5850,210,160,120,160,0,0,650
5851,180,120,80,0,0,0,380
5852,200,140,120,0,0,0,460
5853,190,160,120,160,320,0,950
5854,200,120,80,80,160,0,640
5855,200,160,120,80,0,0,560
5856,210,120,80,160,160,0,730
5857,180,100,40,80,160,0,560
5858,220,80,40,0,0,0,340
5859,210,140,120,160,160,0,790
5860,230,140,120,160,160,320,1130
5861,210,180,120,0,0,0,510
5862,190,80,160,320,160,0,910
5863,210,120,120,160,0,0,610
5864,200,140,80,80,160,0,660
5865,180,100,80,80,160,0,600
5866,180,140,120,80,0,0,520
5867,190,140,40,80,160,0,610
5868,210,160,160,160,160,0,850
5869,180,120,80,80,0,0,460
5870,190,100,80,0,0,0,370
5871,200,140,160,80,160,0,740
5872,180,140,120,160,320,0,920
5873,170,140,40,80,0,0,430
5874,220,180,160,80,0,0,640
5875,230,180,80,160,320,0,970
5876,210,160,160,160,0,0,690
5877,220,120,160,160,0,0,660
5878,210,120,80,80,160,0,650
5879,200,120,80,0,0,0,400
5880,180,120,160,160,160,320,1100
5881,180,100,120,160,0,0,560
5882,190,60,80,160,0,0,490
5883,170,140,40,80,160,0,590
5884,210,140,80,80,160,0,670
5885,190,160,160,80,160,0,750
5886,200,140,160,80,160,0,740
5887,190,100,120,240,160,0,810
5888,190,180,80,160,160,0,770
5889,210,120,160,240,320,320,1370
5890,240,120,120,160,0,0,640
5891,190,100,120,80,0,0,490
5892,190,120,80,0,0,0,390
5893,190,100,80,0,0,0,370
5894,160,140,120,80,160,0,660
5895,200,180,160,240,160,320,1260
5896,200,100,120,0,0,0,420
5897,170,140,120,80,160,0,670
5898,190,140,120,80,160,320,1010
5899,190,140,40,80,0,0,450
5900,230,200,160,240,160,0,990
5901,160,80,120,80,0,0,440
5902,220,140,80,80,160,0,680
5903,190,140,80,0,0,0,410
5904,220,120,40,80,160,0,620
5905,170,80,80,160,0,0,490
5906,220,160,80,80,0,0,540
5907,230,140,80,80,0,0,530
5908,170,100,120,80,0,0,470
5909,230,180,120,160,160,0,850
5910,200,40,40,0,0,0,280
5911,220,120,80,80,160,0,660
5912,230,200,120,0,0,0,550
5913,210,160,120,80,0,0,570
5914,230,160,80,0,0,0,470
5915,210,180,160,160,320,0,1030
5916,200,140,120,80,0,0,540
5917,250,160,200,240,320,0,1170
5918,150,120,40,80,160,0,550
5919,210,120,80,160,160,0,730
5920,200,80,40,80,0,0,400
5921,220,140,40,0,0,0,400
5922,220,140,40,80,160,0,640
5923,210,100,120,240,320,320,1310
5924,240,200,120,80,160,0,800
5925,220,120,200,240,160,0,940
5926,240,160,160,160,160,0,880
5927,190,100,40,0,0,0,330
5928,220,120,80,80,160,0,660
5929,230,120,120,80,0,0,550
5930,210,160,80,160,0,0,610
5931,210,80,80,80,160,0,610
5932,180,80,40,80,160,0,540
5933,230,140,160,160,320,0,1010
5934,150,120,120,80,160,0,630
5935,180,60,80,160,160,320,960
5936,180,180,160,80,0,0,600
5937,190,140,200,240,320,320,1410
5938,210,120,40,80,160,320,930
5939,180,140,160,160,0,0,640
5940,210,120,120,80,160,0,690
5941,210,120,120,80,160,320,1010
5942,200,80,80,80,0,0,440
5943,180,100,80,0,0,0,360
5944,200,180,120,80,0,0,580
5945,200,140,120,0,0,0,460
5946,190,180,80,80,160,0,690
5947,220,100,80,80,160,0,640
5948,210,200,120,240,160,0,930
5949,200,160,160,80,160,0,760
5950,200,160,80,80,160,0,680
5951,200,120,80,160,160,0,720
5952,170,60,40,80,0,0,350
5953,190,140,0,0,0,0,330
5954,220,160,120,80,160,0,740
5955,170,120,120,160,160,320,1050
5956,200,140,120,160,160,320,1100
5957,180,80,40,80,160,0,540
5958,190,140,160,160,320,0,970
5959,180,160,120,160,160,0,780
5960,200,120,160,80,160,0,720
5961,150,120,160,80,0,0,510
5962,190,140,120,80,0,0,530
5963,210,140,240,240,160,0,990
5964,220,100,80,80,0,0,480
5965,150,120,80,0,0,0,350
5966,210,140,160,160,160,0,830
5967,200,180,120,160,160,0,820
5968,220,100,120,240,320,320,1320
5969,230,140,240,240,320,320,1490
5970,170,80,80,80,0,0,410
5971,180,120,200,240,160,0,900
5972,210,100,120,80,160,0,670
5973,190,140,120,80,160,0,690
5974,150,120,120,160,160,0,710
5975,180,100,80,80,160,0,600
5976,230,180,80,0,0,0,490
5977,190,120,120,80,160,0,670
5978,180,100,160,160,320,320,1240
5979,180,100,120,80,160,0,640
5980,210,120,160,80,0,0,570
5981,170,80,120,80,0,0,450
5982,190,100,120,160,320,0,890
5983,180,100,120,0,0,0,400
5984,200,200,160,160,160,0,880
5985,230,200,40,80,160,0,710
5986,210,80,80,0,0,0,370
5987,170,140,120,80,0,0,510
5988,180,140,120,160,0,0,600
5989,180,120,120,0,0,0,420
5990,190,60,80,80,0,0,410
5991,210,140,40,80,160,0,630
5992,170,140,160,240,160,0,870
5993,170,80,80,80,0,0,410
5994,180,80,120,80,160,320,940
5995,200,140,80,80,0,0,500
5996,170,120,200,80,0,0,570
5997,190,100,0,0,0,0,290
5998,150,100,40,80,160,0,530
5999,200,140,80,80,0,0,500
6000,230,160,120,160,160,0,830
6001,180,100,120,160,160,0,720
6002,200,100,160,160,160,0,780
6003,230,120,80,80,160,0,670
6004,210,80,80,80,160,0,610
6005,190,100,80,80,0,0,450
6006,210,120,80,80,0,0,490
6007,220,100,80,0,0,0,400
6008,230,140,120,80,0,0,570
6009,220,180,40,0,0,0,440
6010,160,140,120,80,0,0,500
6011,200,100,120,80,0,0,500
6012,190,100,40,0,0,0,330
6013,180,60,40,80,160,0,520
6014,230,80,80,80,160,0,630
6015,200,100,80,80,0,0,460
6016,230,180,120,80,160,0,770
6017,120,120,120,0,0,0,360
6018,180,80,80,80,160,0,580
6019,210,100,80,80,160,0,630
6020,170,160,40,0,0,0,370
6021,160,180,120,0,0,0,460
6022,210,100,40,80,0,0,430
6023,190,160,160,160,0,0,670
6024,190,100,80,0,0,0,370
6025,170,120,120,0,0,0,410
6026,160,120,80,80,0,0,440
6027,220,120,80,80,160,0,660
6028,210,140,80,160,160,0,750
6029,180,140,80,80,160,0,640
6030,160,140,160,80,160,0,700
6031,250,80,40,80,160,0,610
6032,200,120,120,80,0,0,520
6033,200,120,160,240,160,0,880
6034,180,100,80,160,160,320,1000
6035,220,120,120,160,160,320,1100
6036,190,120,160,80,160,0,710
6037,220,140,120,160,160,0,800
6038,200,80,80,0,0,0,360
6039,180,40,80,0,0,0,300
6040,190,120,80,160,160,0,710
6041,190,80,80,0,0,0,350
6042,180,140,80,80,0,0,480
6043,180,120,160,160,0,0,620
6044,220,160,120,0,0,0,500
6045,220,180,80,80,160,0,720
6046,180,140,120,160,320,320,1240
6047,200,120,120,80,160,0,680
6048,230,120,0,0,0,0,350
6049,180,120,120,80,160,0,660
6050,190,60,120,80,160,0,610
6051,200,100,80,160,320,0,860
6052,220,160,160,160,320,0,1020
6053,180,160,80,80,160,0,660
6054,150,140,160,160,160,0,770
6055,220,120,160,160,160,0,820
6056,220,160,160,0,0,0,540
6057,200,140,200,80,0,0,620
6058,190,140,120,80,160,0,690
6059,210,120,160,160,320,0,970
6060,220,120,80,80,160,0,660
6061,200,100,200,240,320,0,1060
6062,140,120,160,160,320,320,1220
6063,190,100,40,80,160,0,570
6064,210,200,280,160,160,0,1010
6065,240,120,120,160,160,0,800
6066,180,100,120,240,0,0,640
6067,180,100,80,160,160,0,680
6068,190,120,80,160,320,0,870
6069,200,120,160,240,160,0,880
6070,150,100,80,80,160,0,570
6071,180,140,160,0,0,0,480
6072,210,200,160,240,320,0,1130
6073,190,120,80,160,160,0,710
6074,230,140,120,80,0,0,570
6075,170,120,40,0,0,0,330
6076,200,120,120,80,160,0,680
6077,170,80,40,80,160,0,530
6078,260,120,40,0,0,0,420
6079,210,120,40,0,0,0,370
6080,250,120,120,160,160,0,810
6081,190,120,120,0,0,0,430
6082,210,120,40,0,0,0,370
6083,240,140,160,160,0,0,700
6084,190,160,240,160,0,0,750
6085,200,60,40,80,160,320,860
6086,180,100,120,160,160,0,720
6087,210,120,120,0,0,0,450
6088,210,120,160,80,0,0,570
6089,210,100,80,80,160,0,630
6090,210,140,200,240,320,0,1110
6091,170,140,80,80,0,0,470
6092,210,100,160,160,160,0,790
6093,200,100,80,160,160,0,700
6094,190,80,80,80,160,0,590
6095,170,100,200,240,0,0,710
6096,190,100,120,80,160,320,970
6097,210,120,0,0,0,0,330
6098,180,80,120,0,0,0,380
6099,200,120,120,80,0,0,520
6100,210,140,160,240,0,0,750
6101,220,160,120,0,0,0,500
6102,180,120,160,80,160,0,700
6103,170,80,40,80,0,0,370
6104,240,160,120,80,160,320,1080
6105,250,120,80,80,160,0,690
6106,260,220,120,240,320,320,1480
6107,210,140,80,80,0,0,510
6108,170,120,80,160,160,0,690
6109,200,120,120,80,160,0,680
6110,190,120,120,80,0,0,510
6111,210,160,80,0,0,0,450
6112,160,100,0,0,0,0,260
6113,200,140,40,0,0,0,380
6114,180,120,120,160,0,0,580
6115,210,140,200,160,160,0,870
6116,210,140,120,160,320,0,950
6117,190,100,120,80,160,0,650
6118,190,80,80,0,0,0,350
6119,160,80,80,160,0,0,480
6120,200,180,40,0,0,0,420
6121,220,140,200,160,160,0,880
6122,210,200,200,160,160,0,930
6123,200,180,200,160,160,0,900
6124,200,180,160,80,160,0,780
6125,170,100,120,80,160,0,630
6126,230,180,160,160,160,0,890
6127,160,40,40,80,0,0,320
6128,200,160,120,80,0,0,560
6129,160,140,160,80,160,0,700
6130,230,160,160,80,0,0,630
6131,210,160,80,80,0,0,530
6132,160,120,80,80,160,0,600
6133,200,180,160,160,160,0,860
6134,230,100,120,160,160,320,1090
6135,190,80,40,80,0,0,390
6136,180,100,40,0,0,0,320
6137,230,100,80,80,160,0,650
6138,190,120,160,160,0,0,630
6139,190,200,200,240,160,320,1310
6140,190,160,0,0,0,0,350
6141,170,140,160,160,320,0,950
6142,170,80,0,0,0,0,250
6143,180,60,80,80,160,320,880
6144,200,80,120,80,0,0,480
6145,200,120,40,0,0,0,360
6146,200,140,120,160,160,320,1100
6147,220,140,120,80,160,0,720
6148,210,120,200,160,320,0,1010
6149,200,140,120,80,0,0,540
6150,240,100,80,80,160,0,660
6151,150,140,200,240,320,320,1370
6152,210,180,160,160,160,0,870
6153,170,180,200,160,160,0,870
6154,210,60,40,80,160,320,870
6155,210,160,120,0,0,0,490
6156,190,80,40,0,0,0,310
6157,210,160,200,240,320,0,1130
6158,210,140,40,80,160,0,630
6159,210,120,40,0,0,0,370
6160,200,120,120,0,0,0,440
6161,230,100,120,80,0,0,530
6162,210,100,120,160,160,0,750
6163,170,120,160,160,320,320,1250
6164,170,80,80,80,160,0,570
6165,210,160,200,160,0,0,730
6166,220,180,80,0,0,0,480
6167,180,120,160,240,0,0,700
6168,170,140,120,160,320,320,1230
6169,210,140,160,160,320,0,990
6170,170,120,120,80,0,0,490
6171,220,140,120,160,160,0,800
6172,220,120,160,240,320,0,1060
6173,180,120,80,0,0,0,380
6174,170,120,160,0,0,0,450
6175,200,80,80,0,0,0,360
6176,180,80,40,80,0,0,380
6177,180,180,160,80,0,0,600
6178,170,120,120,160,0,0,570
6179,190,160,160,240,320,0,1070
6180,220,160,160,80,0,0,620
6181,230,160,120,160,0,0,670
6182,230,160,120,80,0,0,590
6183,190,120,120,80,0,0,510
6184,210,140,80,0,0,0,430
6185,140,100,80,160,0,0,480
6186,230,80,80,80,160,0,630
6187,220,100,80,160,0,0,560
6188,210,120,120,80,160,0,690
6189,230,200,40,0,0,0,470
6190,210,120,160,240,160,0,890
6191,190,140,80,0,0,0,410
6192,240,120,40,80,0,0,480
6193,190,140,120,80,160,0,690
6194,220,120,160,240,320,0,1060
6195,240,140,160,80,160,0,780
6196,210,180,160,160,0,0,710
6197,200,120,120,160,160,0,760
6198,190,60,40,0,0,0,290
6199,170,100,120,80,0,0,470
6200,170,120,80,80,0,0,450
6201,230,140,200,80,0,0,650
6202,230,120,80,80,160,0,670
6203,200,120,40,0,0,0,360
6204,200,100,0,0,0,0,300
6205,170,120,80,160,160,0,690
6206,200,80,80,80,160,0,600
6207,240,180,160,80,160,320,1140
6208,190,120,80,80,0,0,470
6209,220,120,40,0,0,0,380
6210,200,120,80,0,0,0,400
6211,220,100,0,0,0,0,320
6212,220,120,160,160,160,0,820
6213,170,140,40,0,0,0,350
6214,210,100,80,80,0,0,470
6215,180,120,80,160,160,0,700
6216,180,120,80,80,160,0,620
6217,190,140,120,160,160,0,770
6218,190,120,120,160,160,0,750
6219,170,120,80,0,0,0,370
6220,200,160,80,160,160,0,760
6221,160,140,120,160,160,0,740
6222,160,80,80,80,0,0,400
6223,220,120,80,160,320,0,900
6224,180,100,80,80,160,0,600
6225,190,160,40,80,160,0,630
6226,220,160,80,160,320,320,1260
6227,200,100,120,80,0,0,500
6228,160,140,120,80,160,0,660
6229,180,140,160,240,160,0,880
6230,190,100,80,160,160,0,690
6231,230,120,120,160,320,0,950
6232,150,100,80,0,0,0,330
6233,190,100,80,0,0,0,370
6234,220,140,40,80,160,320,960
6235,200,80,40,0,0,0,320
6236,190,140,80,0,0,0,410
6237,220,120,160,160,320,0,980
6238,170,120,120,160,320,0,890
6239,190,140,80,80,160,0,650
6240,180,120,80,0,0,0,380
6241,130,80,40,0,0,0,250
6242,220,160,160,160,320,320,1340
6243,220,160,120,80,160,320,1060
6244,200,180,80,160,320,320,1260
6245,210,120,120,160,160,0,770
6246,170,80,40,80,160,0,530
6247,220,180,160,160,160,320,1200
6248,170,120,120,0,0,0,410
6249,150,100,80,80,0,0,410
6250,190,160,120,160,320,0,950
6251,220,100,120,80,160,0,680
6252,210,180,80,80,0,0,550
6253,170,100,120,80,160,320,950
6254,200,120,40,0,0,0,360
6255,240,120,120,80,0,0,560
6256,230,120,120,80,0,0,550
6257,230,160,200,80,0,0,670
6258,210,120,40,80,160,320,930
6259,240,180,120,80,160,0,780
6260,170,120,120,160,160,0,730
6261,190,140,80,80,160,0,650
6262,200,140,120,160,0,0,620
6263,190,120,80,0,0,0,390
6264,230,80,80,160,0,0,550
6265,190,140,160,80,160,320,1050
6266,210,120,40,80,160,0,610
6267,180,160,40,80,160,0,620
6268,180,80,80,0,0,0,340
6269,230,140,120,0,0,0,490
6270,160,60,120,240,320,320,1220
6271,230,180,160,160,160,0,890
6272,190,160,120,160,160,0,790
6273,220,100,120,0,0,0,440
6274,200,200,200,160,320,320,1400
6275,210,160,160,160,0,0,690
6276,210,160,160,80,0,0,610
6277,170,140,120,80,0,0,510
6278,170,120,40,0,0,0,330
6279,210,120,200,160,160,0,850
6280,170,60,120,80,0,0,430
6281,220,120,80,80,0,0,500
6282,180,140,80,0,0,0,400
6283,210,140,80,160,320,0,910
6284,160,60,40,80,160,0,500
6285,170,120,160,0,0,0,450
6286,180,80,120,160,320,320,1180
6287,210,180,160,240,320,320,1430
6288,190,140,120,240,320,320,1330
6289,190,80,40,80,160,0,550
6290,220,140,120,160,160,320,1120
6291,210,100,80,160,160,0,710
6292,210,120,80,0,0,0,410
6293,170,60,40,80,160,320,830
6294,190,60,80,80,160,0,570
6295,200,100,160,0,0,0,460
6296,160,160,160,80,0,0,560
6297,200,120,160,80,0,0,560
6298,180,140,160,240,320,0,1040
6299,190,140,120,0,0,0,450
6300,240,120,120,80,0,0,560
6301,230,180,200,160,160,0,930
6302,160,120,80,0,0,0,360
6303,220,100,80,80,160,0,640
6304,200,100,120,160,0,0,580
6305,200,100,80,160,160,0,700
6306,210,120,80,160,0,0,570
6307,200,100,40,80,160,320,900
6308,230,100,160,160,320,0,970
6309,210,100,80,80,0,0,470
6310,210,140,160,160,160,320,1150
6311,230,100,80,0,0,0,410
6312,200,100,80,160,160,0,700
6313,200,120,80,80,160,0,640
6314,220,100,80,80,160,0,640
6315,230,120,80,160,320,0,910
6316,220,220,200,240,320,320,1520
6317,160,100,160,240,320,320,1300
6318,160,140,120,80,160,0,660
6319,230,80,160,160,160,320,1110
6320,220,100,120,80,0,0,520
6321,170,80,80,80,0,0,410
6322,170,100,120,0,0,0,390
6323,210,180,120,80,160,0,750
6324,220,140,80,80,160,0,680
6325,210,60,40,80,160,0,550
6326,200,160,160,80,0,0,600
6327,190,120,40,80,0,0,430
6328,240,120,40,80,0,0,480
6329,200,100,80,160,160,0,700
6330,200,100,80,80,160,0,620
6331,200,160,160,0,0,0,520
6332,170,100,120,80,160,0,630
6333,230,100,120,80,0,0,530
6334,220,160,160,80,0,0,620
6335,180,120,120,80,0,0,500
6336,190,160,200,240,320,0,1110
6337,170,80,80,160,320,320,1130
6338,200,100,120,80,0,0,500
6339,210,100,160,240,160,320,1190
6340,220,140,200,160,0,0,720
6341,170,80,80,160,160,0,650
6342,170,80,80,80,160,0,570
6343,200,120,120,80,0,0,520
6344,170,100,120,160,160,0,710
6345,210,100,40,80,0,0,430
6346,190,80,120,160,320,320,1190
6347,200,140,160,0,0,0,500
6348,190,160,120,160,320,0,950
6349,210,140,120,80,160,0,710
6350,180,140,160,160,0,0,640
6351,240,120,80,80,0,0,520
6352,170,120,40,80,160,320,890
6353,220,120,120,80,160,0,700
6354,220,100,120,80,160,0,680
6355,190,140,160,240,160,0,890
6356,190,120,160,160,160,0,790
6357,190,120,40,0,0,0,350
6358,220,140,160,80,160,0,760
6359,190,140,120,80,160,0,690
6360,170,120,160,160,0,0,610
6361,150,120,120,240,320,0,950
6362,200,100,40,80,160,320,900
6363,160,160,160,80,160,0,720
6364,200,120,80,160,160,0,720
6365,210,100,120,80,0,0,510
6366,180,120,160,160,160,320,1100
6367,210,140,120,80,0,0,550
6368,170,100,80,160,160,0,670
6369,220,180,120,80,160,320,1080
6370,200,180,120,160,320,0,980
6371,200,120,160,160,160,0,800
6372,200,180,120,160,320,320,1300
6373,180,140,120,80,0,0,520
6374,200,160,120,80,0,0,560
6375,210,100,120,80,160,0,670
6376,170,80,0,0,0,0,250
6377,180,40,0,0,0,0,220
6378,220,180,160,160,160,0,880
6379,220,120,120,80,160,0,700
6380,190,100,120,80,0,0,490
6381,200,120,120,80,160,0,680
6382,210,160,160,80,160,0,770
6383,210,80,80,0,0,0,370
6384,190,160,240,160,160,0,910
6385,210,120,120,160,320,0,930
6386,230,160,80,80,160,0,710
6387,190,100,40,80,160,0,570
6388,200,140,160,160,160,0,820
6389,190,120,40,80,160,0,590
6390,220,140,120,160,0,0,640
6391,220,140,120,240,320,0,1040
6392,180,80,80,160,320,0,820
6393,180,120,120,80,0,0,500
6394,200,140,120,160,160,0,780
6395,240,180,160,160,320,0,1060
6396,250,140,80,0,0,0,470
6397,200,180,160,0,0,0,540
6398,210,120,40,0,0,0,370
6399,200,120,120,80,0,0,520
6400,220,80,80,80,160,0,620
6401,200,140,120,80,160,0,700
6402,220,200,240,160,160,0,980
6403,140,80,40,0,0,0,260
6404,230,120,40,0,0,0,390
6405,150,100,120,0,0,0,370
6406,200,100,80,80,0,0,460
6407,230,100,160,160,160,0,810
6408,170,140,120,80,0,0,510
6409,150,140,160,160,160,320,1090
6410,190,120,120,160,160,0,750
6411,160,80,160,160,320,0,880
6412,210,140,120,160,160,0,790
6413,170,120,160,240,160,0,850
6414,180,80,160,80,160,320,980
6415,210,80,160,0,0,0,450
6416,230,140,160,240,320,0,1090
6417,170,80,80,160,0,0,490
6418,240,180,160,160,320,0,1060
6419,200,160,120,80,0,0,560
6420,160,120,80,160,160,0,680
6421,250,120,80,160,160,0,770
6422,190,120,80,160,160,320,1030
6423,200,100,80,80,160,0,620
6424,230,160,240,240,320,0,1190
6425,220,180,80,0,0,0,480
6426,220,180,160,80,160,0,800
6427,180,120,120,0,0,0,420
6428,160,60,120,160,320,0,820
6429,230,100,120,80,0,0,530
6430,180,160,160,0,0,0,500
6431,200,160,120,80,160,0,720
6432,220,160,120,160,160,0,820
6433,200,140,200,80,160,0,780
6434,200,160,160,160,160,0,840
6435,160,120,160,80,160,0,680
6436,190,60,80,80,0,0,410
6437,210,120,160,160,160,320,1130
6438,190,100,160,80,0,0,530
6439,160,160,80,80,160,0,640
6440,190,140,160,160,320,320,1290
6441,250,200,160,160,160,0,930
6442,200,160,120,160,320,320,1280
6443,190,120,120,160,160,320,1070
6444,190,120,80,0,0,0,390
6445,180,140,160,0,0,0,480
6446,210,120,80,80,160,0,650
6447,220,100,40,80,160,0,600
6448,160,80,80,0,0,0,320
6449,180,160,80,0,0,0,420
6450,200,160,160,160,320,0,1000
6451,180,100,80,0,0,0,360
6452,180,100,160,80,160,0,680
6453,190,100,80,0,0,0,370
6454,170,120,120,80,0,0,490
6455,240,120,80,80,0,0,520
6456,200,140,120,160,320,0,940
6457,200,200,160,160,160,0,880
6458,200,240,80,0,0,0,520
6459,170,120,160,80,0,0,530
6460,190,120,120,160,320,0,910
6461,210,120,80,80,160,0,650
6462,210,140,80,160,160,0,750
6463,240,180,160,240,0,0,820
6464,180,140,120,240,320,0,1000
6465,210,140,160,160,160,0,830
6466,160,100,120,160,160,320,1020
6467,240,140,80,160,320,0,940
6468,160,140,80,160,320,0,860
6469,180,180,120,80,0,0,560
6470,200,140,160,160,160,0,820
6471,120,80,80,160,160,0,600
6472,220,120,120,80,160,0,700
6473,200,140,120,160,320,320,1260
6474,190,60,40,80,160,0,530
6475,170,120,160,240,160,0,850
6476,190,200,200,160,0,0,750
6477,190,140,120,160,160,320,1090
6478,140,120,120,160,320,0,860
6479,190,120,80,80,160,0,630
6480,190,140,200,0,0,0,530
6481,160,80,80,0,0,0,320
6482,210,140,120,160,320,320,1270
6483,190,140,80,80,160,320,970
6484,180,120,80,160,320,320,1180
6485,190,120,160,160,160,0,790
6486,190,120,120,80,0,0,510
6487,190,160,160,80,160,0,750
6488,220,180,120,160,160,0,840
6489,250,140,80,0,0,0,470
6490,200,100,120,160,160,0,740
6491,150,120,160,160,160,0,750
6492,190,120,120,160,160,0,750
6493,210,180,120,80,160,0,750
6494,200,80,80,80,160,0,600
6495,220,160,200,240,320,0,1140
6496,190,120,120,80,0,0,510
6497,170,100,40,0,0,0,310
6498,250,160,120,160,160,0,850
6499,200,100,80,80,160,0,620
6500,150,120,40,80,160,0,550
6501,190,120,160,80,160,0,710
6502,220,60,40,80,160,0,560
6503,220,180,200,80,160,0,840
6504,200,120,200,160,160,0,840
6505,210,140,120,160,320,0,950
6506,190,100,120,0,0,0,410
6507,220,180,120,160,0,0,680
6508,180,120,40,0,0,0,340
6509,180,180,120,160,160,0,800
6510,200,100,40,0,0,0,340
6511,210,100,40,80,160,0,590
6512,170,100,120,160,320,0,870
6513,220,120,80,80,160,0,660
6514,210,80,120,80,160,0,650
6515,200,140,80,80,0,0,500
6516,190,100,80,80,160,320,930
6517,230,140,200,160,160,320,1210
6518,180,120,120,160,160,320,1060
6519,200,160,120,160,320,0,960
6520,160,120,120,160,160,0,720
6521,170,120,120,160,160,320,1050
6522,160,180,120,80,160,320,1020
6523,170,120,160,80,160,0,690
6524,170,140,40,80,160,0,590
6525,220,140,200,80,0,0,640
6526,220,140,80,160,320,0,920
6527,190,100,40,0,0,0,330
6528,180,120,80,80,160,0,620
6529,210,160,80,80,0,0,530
6530,160,140,120,160,320,320,1220
6531,180,140,120,160,160,320,1080
6532,170,100,80,160,160,0,670
6533,210,140,200,160,160,320,1190
6534,180,60,80,160,0,0,480
6535,160,100,160,160,320,320,1220
6536,200,140,160,240,160,0,900
6537,190,100,160,160,160,0,770
6538,230,120,40,0,0,0,390
6539,180,100,120,80,0,0,480
6540,210,140,160,160,160,320,1150
6541,170,120,80,160,160,0,690
6542,140,120,80,80,160,0,580
6543,210,160,120,0,0,0,490
6544,180,60,80,160,160,320,960
6545,220,140,120,160,160,320,1120
6546,200,120,120,80,160,0,680
6547,170,120,120,80,0,0,490
6548,170,160,120,0,0,0,450
6549,210,200,200,0,0,0,610
6550,240,140,40,0,0,0,420
6551,210,120,120,160,0,0,610
6552,190,140,120,80,0,0,530
6553,190,120,120,0,0,0,430
6554,220,140,80,80,160,0,680
6555,180,160,160,80,160,320,1060
6556,240,160,280,160,160,320,1320
6557,180,140,120,160,160,0,760
6558,200,160,160,160,160,320,1160
6559,240,160,80,80,0,0,560
6560,190,140,120,160,320,0,930
6561,170,140,120,160,320,0,910
6562,210,120,80,160,320,320,1210
6563,180,120,80,80,160,0,620
6564,180,140,200,80,0,0,600
6565,200,100,120,80,0,0,500
6566,210,180,120,80,0,0,590
6567,210,80,160,160,0,0,610
6568,170,120,120,160,160,0,730
6569,190,120,200,160,160,0,830
6570,200,80,0,0,0,0,280
6571,190,60,0,0,0,0,250
6572,190,80,80,80,160,0,590
6573,200,60,40,80,0,0,380
6574,190,80,80,160,160,0,670
6575,230,160,120,80,0,0,590
6576,230,140,160,240,320,0,1090
6577,210,100,80,160,160,0,710
6578,200,80,80,80,160,0,600
6579,150,80,80,160,160,0,630
6580,200,160,120,160,320,320,1280
6581,200,140,80,80,0,0,500
6582,200,140,80,80,160,0,660
6583,200,100,40,80,0,0,420
6584,190,140,160,0,0,0,490
6585,240,160,120,0,0,0,520
6586,280,140,200,160,160,0,940
6587,200,100,160,0,0,0,460
6588,190,140,160,160,160,0,810
6589,200,120,160,160,160,320,1120
6590,220,60,40,80,160,320,880
6591,210,120,40,80,160,0,610
6592,180,140,120,80,0,0,520
6593,200,100,40,80,160,0,580
6594,190,100,80,80,160,0,610
6595,230,140,120,0,0,0,490
6596,200,100,120,80,160,0,660
6597,200,80,40,80,160,0,560
6598,190,160,120,160,0,0,630
6599,220,180,160,80,160,0,800
6600,200,140,80,160,160,320,1060
6601,250,60,80,80,160,0,630
6602,180,160,80,80,160,320,980
6603,130,60,80,0,0,0,270
6604,210,180,200,80,0,0,670
6605,230,100,120,80,160,0,690
6606,210,120,80,0,0,0,410
6607,150,100,120,160,320,320,1170
6608,190,80,80,80,0,0,430
6609,180,140,160,240,160,0,880
6610,150,140,160,160,160,0,770
6611,200,180,160,160,0,0,700
6612,220,120,80,80,0,0,500
6613,180,80,0,0,0,0,260
6614,200,120,80,80,0,0,480
6615,170,100,40,80,160,0,550
6616,190,100,80,0,0,0,370
6617,230,120,40,0,0,0,390
6618,160,100,120,160,0,0,540
6619,200,100,120,160,320,0,900
6620,200,160,80,0,0,0,440
6621,180,140,120,160,160,320,1080
6622,160,100,200,160,160,0,780
6623,200,140,80,160,0,0,580
6624,230,80,80,160,160,0,710
6625,190,100,120,160,320,0,890
6626,170,80,40,0,0,0,290
6627,170,120,40,80,0,0,410
6628,220,140,120,160,320,0,960
6629,200,160,80,0,0,0,440
6630,190,140,80,80,160,0,650
6631,210,100,80,0,0,0,390
6632,180,160,80,80,160,0,660
6633,180,120,120,80,0,0,500
6634,190,140,80,160,160,0,730
6635,200,140,120,240,320,0,1020
6636,170,120,80,160,160,0,690
6637,190,120,0,0,0,0,310
6638,220,120,120,240,160,0,860
6639,220,80,0,0,0,0,300
6640,170,80,80,0,0,0,330
6641,180,120,120,80,160,0,660
6642,210,160,120,80,160,0,730
6643,230,160,80,0,0,0,470
6644,180,140,80,0,0,0,400
6645,190,120,120,80,160,0,670
6646,180,120,160,160,0,0,620
6647,240,100,40,0,0,0,380
6648,180,80,120,160,320,0,860
6649,190,140,120,0,0,0,450
6650,180,120,160,240,320,320,1340
6651,180,160,160,240,320,0,1060
6652,160,120,160,240,160,0,840
6653,190,60,40,0,0,0,290
6654,220,140,120,80,160,0,720
6655,200,140,80,160,0,0,580
6656,210,160,40,80,0,0,490
6657,210,120,80,160,320,320,1210
6658,160,120,80,80,0,0,440
6659,180,60,0,0,0,0,240
6660,150,120,120,160,160,0,710
6661,240,100,40,0,0,0,380
6662,170,80,40,0,0,0,290
6663,200,140,160,240,160,0,900
6664,200,100,80,0,0,0,380
6665,210,100,80,80,160,320,950
6666,160,60,0,0,0,0,220
6667,200,160,160,160,160,0,840
6668,250,120,160,240,160,0,930
6669,180,140,80,80,0,0,480
6670,220,140,160,80,160,320,1080
6671,230,140,80,80,160,0,690
6672,170,100,120,160,320,320,1190
6673,200,100,120,240,0,0,660
6674,210,100,120,160,160,320,1070
6675,190,100,80,80,160,0,610
6676,220,180,160,160,160,0,880
6677,200,140,80,160,320,0,900
6678,190,100,120,80,0,0,490
6679,180,160,120,240,160,0,860
6680,160,80,80,80,0,0,400
6681,180,120,80,80,160,0,620
6682,180,120,120,80,0,0,500
6683,210,140,40,80,160,320,950
6684,220,120,160,80,0,0,580
6685,190,120,80,80,0,0,470
6686,240,160,120,160,320,0,1000
6687,150,120,80,160,0,0,510
6688,170,100,80,80,160,0,590
6689,180,140,120,160,160,0,760
6690,170,160,120,80,160,320,1010
6691,160,100,80,0,0,0,340
6692,210,80,120,0,0,0,410
6693,180,120,200,160,320,0,980
6694,170,120,200,240,320,0,1050
6695,230,120,160,80,0,0,590
6696,210,120,80,0,0,0,410
6697,200,120,40,0,0,0,360
6698,220,120,120,160,160,0,780
6699,190,140,120,0,0,0,450
6700,180,100,120,80,0,0,480
6701,200,160,120,80,160,0,720
6702,230,180,160,80,160,320,1130
6703,150,60,40,0,0,0,250
6704,190,180,120,80,0,0,570
6705,230,120,120,160,160,320,1110
6706,180,120,160,80,160,320,1020
6707,230,180,80,80,160,0,730
6708,230,100,120,80,160,320,1010
6709,190,120,160,80,160,0,710
6710,200,140,160,80,0,0,580
6711,200,200,120,160,160,0,840
6712,200,140,160,160,160,0,820
6713,170,100,80,0,0,0,350
6714,170,100,80,80,160,320,910
6715,190,140,80,80,0,0,490
6716,240,100,120,160,160,0,780
6717,210,100,80,0,0,0,390
6718,160,100,120,0,0,0,380
6719,200,120,80,80,160,0,640
6720,200,120,160,240,160,0,880
6721,170,140,120,80,160,0,670
6722,250,140,80,80,160,0,710
6723,190,120,160,80,0,0,550
6724,200,100,80,160,320,0,860
6725,170,80,40,0,0,0,290
6726,180,100,40,0,0,0,320
6727,160,120,160,160,160,0,760
6728,170,100,120,160,160,0,710
6729,180,100,80,0,0,0,360
6730,190,140,160,240,320,320,1370
6731,220,120,120,160,0,0,620
6732,170,120,120,160,320,0,890
6733,160,120,80,0,0,0,360
6734,190,160,120,160,160,320,1110
6735,160,160,120,160,0,0,600
6736,150,120,200,240,160,0,870
6737,210,160,40,80,160,0,650
6738,230,140,120,160,160,0,810
6739,150,160,160,80,160,0,710
6740,220,220,160,240,160,0,1000
6741,220,120,200,80,160,0,780
6742,230,160,80,0,0,0,470
6743,200,100,120,160,160,0,740
6744,210,160,80,0,0,0,450
6745,200,60,80,80,160,0,580
6746,170,140,40,80,0,0,430
6747,210,200,160,160,160,320,1210
6748,180,100,80,160,160,0,680
6749,220,140,120,160,320,320,1280
6750,180,120,80,80,0,0,460
6751,220,180,160,80,0,0,640
6752,200,120,120,80,0,0,520
6753,220,120,160,240,320,0,1060
6754,210,140,80,0,0,0,430
6755,240,80,120,240,160,0,840
6756,230,140,120,160,320,0,970
6757,250,120,120,80,160,0,730
6758,200,60,80,160,160,320,980
6759,210,180,120,80,160,0,750
6760,200,60,120,160,160,0,700
6761,220,120,160,80,0,0,580
6762,160,80,80,80,160,0,560
6763,170,80,40,80,160,0,530
6764,200,80,120,80,0,0,480
6765,240,160,120,80,0,0,600
6766,200,120,80,80,160,0,640
6767,190,100,40,80,160,0,570
6768,170,140,160,80,160,0,710
6769,240,200,80,0,0,0,520
6770,220,80,80,80,160,0,620
6771,210,120,80,80,0,0,490
6772,170,100,120,160,160,0,710
6773,150,140,160,80,160,0,690
6774,210,160,120,160,0,0,650
6775,210,80,80,0,0,0,370
6776,240,140,160,240,160,0,940
6777,220,100,80,80,160,320,960
6778,160,80,120,160,0,0,520
6779,240,160,120,80,0,0,600
6780,220,120,160,160,160,0,820
6781,240,120,200,0,0,0,560
6782,200,120,160,240,320,0,1040
6783,210,180,120,80,0,0,590
6784,190,140,160,240,320,320,1370
6785,190,140,200,160,320,320,1330
6786,230,120,120,160,160,0,790
6787,210,120,80,0,0,0,410
6788,200,140,80,80,160,0,660
6789,190,140,200,160,320,0,1010
6790,210,140,80,160,160,320,1070
6791,210,120,120,80,0,0,530
6792,210,140,80,80,160,0,670
6793,190,120,120,160,160,0,750
6794,170,120,80,80,160,320,930
6795,190,100,80,80,160,0,610
6796,200,80,80,80,0,0,440
6797,210,140,80,0,0,0,430
6798,190,80,120,160,160,0,710
6799,220,160,40,0,0,0,420
6800,190,140,160,160,0,0,650
6801,250,180,120,160,160,0,870
6802,190,120,120,240,160,0,830
6803,180,120,40,0,0,0,340
6804,210,160,160,160,160,0,850
6805,150,100,120,160,320,0,850
6806,200,140,120,80,0,0,540
6807,210,140,200,160,320,320,1350
6808,180,100,120,0,0,0,400
6809,160,100,160,0,0,0,420
6810,180,120,80,80,0,0,460
6811,160,100,80,0,0,0,340
6812,220,120,80,80,0,0,500
6813,180,160,80,0,0,0,420
6814,210,140,120,160,160,0,790
6815,210,140,80,160,320,0,910
6816,210,100,120,160,160,0,750
6817,230,140,160,80,160,0,770
6818,170,100,40,80,0,0,390
6819,150,80,80,0,0,0,310
6820,170,140,80,80,160,0,630
6821,180,80,40,80,160,0,540
6822,190,140,160,80,0,0,570
6823,200,100,160,80,0,0,540
6824,210,140,120,160,320,0,950
6825,190,60,120,80,160,0,610
6826,190,100,160,160,160,0,770
6827,130,60,80,80,160,0,510
6828,190,160,120,80,160,0,710
6829,200,200,160,160,160,0,880
6830,160,140,40,80,160,0,580
6831,200,120,120,80,160,0,680
6832,230,120,120,160,160,0,790
6833,200,120,80,0,0,0,400
6834,180,100,120,160,0,0,560
6835,190,140,40,80,0,0,450
6836,210,120,80,80,160,0,650
6837,140,80,80,80,0,0,380
6838,190,80,40,80,0,0,390
6839,200,120,0,0,0,0,320
6840,200,140,120,160,160,0,780
6841,160,140,160,160,160,320,1100
6842,180,120,160,160,160,320,1100
6843,200,80,80,160,320,0,840
6844,200,100,40,0,0,0,340
6845,170,80,120,80,0,0,450
6846,190,120,80,0,0,0,390
6847,210,100,40,80,0,0,430
6848,180,160,80,160,160,0,740
6849,230,140,120,240,0,0,730
6850,210,140,160,160,320,320,1310
6851,220,120,120,160,160,0,780
6852,200,60,120,0,0,0,380
6853,150,120,160,80,0,0,510
6854,220,100,40,0,0,0,360
6855,220,140,40,0,0,0,400
6856,150,140,160,80,0,0,530
6857,190,120,80,0,0,0,390
6858,180,120,40,80,160,0,580
6859,200,100,80,80,160,0,620
6860,180,100,160,0,0,0,440
6861,200,160,80,160,160,0,760
6862,160,160,160,160,160,0,800
6863,180,120,120,160,320,0,900
6864,230,140,80,160,160,0,770
6865,170,120,120,80,0,0,490
6866,180,100,80,160,160,0,680
6867,210,120,120,80,160,0,690
6868,220,140,120,240,160,0,880
6869,200,100,80,80,0,0,460
6870,220,160,120,80,160,0,740
6871,180,80,120,160,160,0,700
6872,190,100,0,0,0,0,290
6873,140,120,120,160,160,320,1020
6874,190,120,40,0,0,0,350
6875,180,120,120,80,160,320,980
6876,180,80,120,160,160,0,700
6877,120,80,80,80,0,0,360
6878,220,140,120,80,160,0,720
6879,180,140,120,0,0,0,440
6880,210,140,80,160,160,0,750
6881,180,60,40,80,160,0,520
6882,210,80,120,160,0,0,570
6883,210,160,120,160,0,0,650
6884,190,120,80,80,160,0,630
6885,200,120,80,80,0,0,480
6886,230,120,80,80,160,320,990
6887,170,120,40,0,0,0,330
6888,190,140,80,80,0,0,490
6889,210,120,80,0,0,0,410
6890,200,160,120,0,0,0,480
6891,190,180,200,240,160,0,970
6892,200,100,0,0,0,0,300
6893,210,120,120,0,0,0,450
6894,210,80,120,160,0,0,570
6895,220,120,120,160,160,0,780
6896,190,160,160,160,160,0,830
6897,230,120,80,80,0,0,510
6898,200,120,120,80,160,320,1000
6899,210,140,160,160,320,320,1310
6900,190,160,160,160,320,0,990
6901,210,120,160,160,160,320,1130
6902,210,140,120,160,320,320,1270
6903,180,60,80,160,160,320,960
6904,160,120,80,0,0,0,360
6905,180,120,120,160,160,320,1060
6906,210,140,160,240,160,0,910
6907,180,140,80,80,0,0,480
6908,170,80,120,160,0,0,530
6909,160,120,40,0,0,0,320
6910,180,140,80,80,160,0,640
6911,230,180,120,160,320,320,1330
6912,220,140,120,0,0,0,480
6913,170,60,80,80,160,0,550
6914,150,140,160,160,0,0,610
6915,180,80,120,240,160,320,1100
6916,160,120,120,80,0,0,480
6917,190,140,160,160,160,320,1130
6918,190,140,160,160,160,0,810
6919,190,80,80,0,0,0,350
6920,200,100,80,80,160,0,620
6921,220,100,80,160,320,320,1200
6922,180,120,80,0,0,0,380
6923,180,160,120,80,0,0,540
6924,230,120,40,80,0,0,470
6925,170,120,120,80,160,320,970
6926,230,160,120,80,160,0,750
6927,180,140,80,160,320,0,880
6928,180,140,120,160,160,320,1080
6929,240,100,80,80,160,0,660
6930,150,80,80,80,160,320,870
6931,210,200,120,160,160,0,850
6932,200,40,40,80,160,0,520
6933,170,100,80,80,0,0,430
6934,180,120,120,80,160,0,660
6935,210,60,80,0,0,0,350
6936,250,80,80,80,160,0,650
6937,200,100,40,80,160,0,580
6938,200,120,80,80,0,0,480
6939,190,180,120,160,160,0,810
6940,200,80,80,80,0,0,440
6941,170,140,80,80,160,0,630
6942,190,140,120,160,160,0,770
6943,210,160,40,0,0,0,410
6944,220,140,120,0,0,0,480
6945,230,120,80,80,160,320,990
6946,170,160,40,0,0,0,370
6947,160,140,160,160,0,0,620
6948,160,120,200,160,160,0,800
6949,180,120,120,80,0,0,500
6950,230,140,120,160,160,0,810
6951,230,160,80,160,320,320,1270
6952,190,140,40,0,0,0,370
6953,180,80,0,0,0,0,260
6954,210,140,120,160,160,0,790
6955,180,80,40,80,160,0,540
6956,200,100,120,160,160,0,740
6957,180,120,200,160,320,0,980
6958,170,140,0,0,0,0,310
6959,210,40,40,80,160,0,530
6960,210,100,80,160,0,0,550
6961,190,120,120,160,160,0,750
6962,160,120,80,0,0,0,360
6963,150,140,80,80,160,0,610
6964,150,120,120,160,0,0,550
6965,180,160,80,80,160,0,660
6966,180,80,120,160,320,0,860
6967,190,100,40,80,0,0,410
6968,230,200,120,160,160,320,1190
6969,210,80,80,80,160,320,930
6970,220,80,80,160,0,0,540
6971,160,80,80,80,160,0,560
6972,210,140,40,0,0,0,390
6973,180,80,80,80,0,0,420
6974,200,80,80,80,160,320,920
6975,180,60,80,80,0,0,400
6976,190,140,80,160,160,320,1050
6977,200,160,40,0,0,0,400
6978,210,160,200,80,160,0,810
6979,220,40,40,0,0,0,300
6980,190,120,80,80,160,320,950
6981,210,120,80,80,0,0,490
6982,230,140,120,80,0,0,570
6983,210,100,40,0,0,0,350
6984,180,100,120,80,160,0,640
6985,200,140,200,240,0,0,780
6986,200,80,120,80,160,0,640
6987,210,160,120,240,320,320,1370
6988,220,60,40,0,0,0,320
6989,170,160,80,80,0,0,490
6990,210,140,160,160,320,0,990
6991,230,120,80,0,0,0,430
6992,220,160,120,240,320,0,1060
6993,210,80,40,80,160,0,570
6994,200,60,80,80,0,0,420
6995,220,140,80,80,160,320,1000
6996,180,80,80,160,160,0,660
6997,170,80,40,80,0,0,370
6998,210,140,160,240,160,0,910
6999,210,140,120,160,160,0,790
7000,200,160,160,240,160,0,920
7001,210,160,80,80,0,0,530
7002,170,140,160,160,160,0,790
7003,200,140,120,80,160,0,700
7004,200,160,120,160,160,0,800
7005,180,120,120,0,0,0,420
7006,240,60,80,80,0,0,460
7007,180,160,200,160,320,0,1020
7008,210,180,160,80,160,0,790
7009,160,60,120,80,160,0,580
7010,180,120,160,160,160,320,1100
7011,200,160,120,160,0,0,640
7012,180,80,80,0,0,0,340
7013,170,100,120,0,0,0,390
7014,200,100,160,160,160,0,780
7015,190,140,160,80,0,0,570
7016,180,100,120,160,0,0,560
7017,250,140,120,160,160,0,830
7018,190,80,120,80,0,0,470
7019,180,80,80,160,160,0,660
7020,200,120,160,160,160,0,800
7021,200,80,80,80,0,0,440
7022,190,120,80,80,160,0,630
7023,180,40,0,0,0,0,220
7024,210,140,120,80,160,320,1030
7025,160,140,200,240,160,0,900
7026,180,140,80,0,0,0,400
7027,180,140,80,160,320,0,880
7028,180,160,160,80,160,0,740
7029,210,120,40,80,160,0,610
7030,170,100,160,0,0,0,430
7031,210,100,120,160,160,0,750
7032,140,120,80,80,160,320,900
7033,170,60,40,80,0,0,350
7034,190,140,120,80,0,0,530
7035,220,160,120,80,160,0,740
7036,230,140,200,240,320,320,1450
7037,160,180,120,80,0,0,540
7038,160,120,120,160,160,0,720
7039,210,80,160,160,160,0,770
7040,210,140,160,240,320,0,1070
7041,200,40,40,80,160,320,840
7042,160,100,120,80,160,0,620
7043,210,160,160,160,320,320,1330
7044,220,120,200,160,160,320,1180
7045,190,80,120,80,0,0,470
7046,220,120,80,80,160,0,660
7047,210,100,120,80,160,0,670
7048,190,100,120,80,0,0,490
7049,230,180,80,160,0,0,650
7050,180,100,120,160,320,320,1200
7051,200,140,80,0,0,0,420
7052,250,160,160,160,160,0,890
7053,190,120,200,240,0,0,750
7054,230,60,40,80,160,320,890
7055,150,120,80,160,0,0,510
7056,190,120,80,80,160,0,630
7057,190,140,160,160,160,0,810
7058,200,60,120,80,160,320,940
7059,200,80,120,80,0,0,480
7060,220,80,160,80,160,320,1020
7061,140,80,40,0,0,0,260
7062,180,120,120,80,160,0,660
7063,230,160,80,160,0,0,630
7064,220,100,120,160,160,320,1080
7065,220,140,40,0,0,0,400
7066,180,120,80,80,160,320,940
7067,160,120,120,160,320,320,1200
7068,190,80,80,80,160,0,590
7069,220,160,80,160,160,0,780
7070,220,140,80,80,0,0,520
7071,190,120,40,80,0,0,430
7072,220,140,120,160,160,0,800
7073,200,120,80,80,0,0,480
7074,190,120,40,0,0,0,350
7075,190,180,120,160,320,0,970
7076,230,200,160,160,160,0,910
7077,180,160,200,160,320,320,1340
7078,210,160,120,80,0,0,570
7079,200,80,80,0,0,0,360
7080,210,160,120,160,320,0,970
7081,160,80,80,0,0,0,320
7082,200,180,120,0,0,0,500
7083,200,120,200,160,0,0,680
7084,230,180,200,160,160,320,1250
7085,200,180,160,160,160,0,860
7086,150,80,120,160,320,320,1150
7087,240,120,120,80,160,0,720
7088,150,140,120,80,0,0,490
7089,200,80,0,0,0,0,280
7090,190,120,80,80,160,0,630
7091,170,120,120,160,160,0,730
7092,270,180,40,80,0,0,570
7093,190,40,40,80,160,0,510
7094,170,140,80,80,160,0,630
7095,180,160,120,160,160,0,780
7096,200,120,160,160,160,0,800
7097,210,120,120,80,160,0,690
7098,210,120,120,80,0,0,530
7099,170,80,160,160,0,0,570
7100,130,140,120,160,320,320,1190
7101,180,100,80,160,0,0,520
7102,210,180,160,80,0,0,630
7103,190,80,80,80,160,0,590
7104,230,120,120,80,0,0,550
7105,190,100,80,160,320,0,850
7106,220,140,160,160,320,320,1320
7107,210,180,160,80,160,0,790
7108,190,120,120,160,0,0,590
7109,170,180,120,80,160,0,710
7110,180,80,80,160,320,320,1140
7111,200,100,120,160,320,0,900
7112,210,100,80,0,0,0,390
7113,210,140,80,0,0,0,430
7114,230,120,40,80,0,0,470
7115,220,140,120,80,0,0,560
7116,240,160,160,160,320,320,1360
7117,210,80,40,80,0,0,410
7118,190,140,160,160,160,0,810
7119,230,100,120,160,160,0,770
7120,220,100,120,80,160,0,680
7121,170,140,40,80,160,0,590
7122,210,120,160,240,320,0,1050
7123,230,120,80,160,160,0,750
7124,190,120,120,80,160,0,670
7125,170,80,80,80,160,0,570
7126,210,160,160,160,160,0,850
7127,210,140,160,80,0,0,590
7128,180,120,40,0,0,0,340
7129,190,100,80,80,160,0,610
7130,190,100,120,160,160,0,730
7131,160,140,80,80,0,0,460
7132,190,100,80,80,160,320,930
7133,230,180,80,0,0,0,490
7134,170,160,80,80,160,0,650
7135,180,60,0,0,0,0,240
7136,220,220,160,160,320,0,1080
7137,230,140,160,80,160,0,770
7138,220,200,120,160,160,320,1180
7139,180,140,80,80,160,320,960
7140,180,120,160,160,160,0,780
7141,160,160,160,80,160,320,1040
7142,200,80,40,0,0,0,320
7143,200,60,80,160,160,0,660
7144,200,120,80,160,160,0,720
7145,190,80,120,160,320,320,1190
7146,220,180,200,160,160,0,920
7147,130,80,0,0,0,0,210
7148,240,140,120,160,0,0,660
7149,220,200,160,80,160,0,820
7150,210,140,160,80,160,0,750
7151,170,120,120,80,0,0,490
7152,210,120,80,160,160,320,1050
7153,180,100,120,80,0,0,480
7154,170,120,160,160,0,0,610
7155,230,180,160,80,160,0,810
7156,180,100,120,0,0,0,400
7157,190,80,80,160,160,0,670
7158,160,160,120,80,0,0,520
7159,220,120,120,80,160,0,700
7160,230,180,160,160,320,0,1050
7161,170,160,160,160,320,0,970
7162,130,100,0,0,0,0,230
7163,170,60,80,80,0,0,390
7164,220,100,120,160,320,320,1240
7165,160,140,200,160,0,0,660
7166,200,140,120,160,160,0,780
7167,160,40,80,80,160,320,840
7168,180,120,120,160,160,0,740
7169,220,120,120,80,0,0,540
7170,200,80,80,80,160,0,600
7171,180,80,120,160,160,0,700
7172,160,160,200,160,320,0,1000
7173,200,140,120,80,160,0,700
7174,220,180,120,80,0,0,600
7175,190,120,160,80,160,0,710
7176,210,140,80,80,160,0,670
7177,190,100,80,80,160,0,610
7178,220,200,160,0,0,0,580
7179,180,160,200,160,0,0,700
7180,240,160,200,160,0,0,760
7181,180,100,40,80,0,0,400
7182,170,140,160,160,320,0,950
7183,200,120,160,80,160,0,720
7184,220,140,80,80,0,0,520
7185,190,140,80,80,160,0,650
7186,160,140,80,80,0,0,460
7187,210,100,80,160,160,0,710
7188,220,180,120,80,0,0,600
7189,190,120,120,160,320,0,910
7190,190,160,120,160,320,320,1270
7191,210,140,120,0,0,0,470
7192,210,80,80,0,0,0,370
7193,170,100,120,0,0,0,390
7194,160,100,40,0,0,0,300
7195,190,120,120,160,160,0,750
7196,170,160,160,240,160,0,890
7197,200,60,40,80,160,0,540
7198,230,180,160,160,0,0,730
7199,230,100,40,80,160,0,610
7200,160,120,160,160,320,320,1240
7201,160,40,80,80,160,0,520
7202,200,180,160,160,320,0,1020
7203,180,140,80,160,0,0,560
7204,170,140,80,80,160,0,630
7205,190,120,120,0,0,0,430
7206,180,120,120,160,0,0,580
7207,220,240,120,80,160,0,820
7208,130,80,80,160,160,0,610
7209,230,160,200,80,0,0,670
7210,220,140,80,160,160,0,760
7211,210,120,40,0,0,0,370
7212,200,100,80,80,160,0,620
7213,200,180,120,80,0,0,580
7214,210,120,200,240,0,0,770
7215,200,100,80,0,0,0,380
7216,230,60,40,80,0,0,410
7217,160,140,120,0,0,0,420
7218,160,80,120,0,0,0,360
7219,200,80,160,160,0,0,600
7220,210,200,200,80,160,0,850
7221,170,100,40,80,160,0,550
7222,150,80,80,80,160,0,550
7223,170,80,120,160,160,0,690
7224,200,80,80,160,0,0,520
7225,210,120,160,160,0,0,650
7226,190,140,160,80,160,0,730
7227,180,120,120,160,160,0,740
7228,200,140,80,80,160,0,660
7229,230,100,120,80,0,0,530
7230,170,140,40,80,0,0,430
7231,160,140,160,160,320,320,1260
7232,140,80,120,160,0,0,500
7233,180,100,120,160,320,0,880
7234,220,100,40,80,160,0,600
7235,170,140,40,80,0,0,430
7236,210,140,200,240,0,0,790
7237,180,140,160,160,160,0,800
7238,180,100,120,80,160,320,960
7239,220,100,80,0,0,0,400
7240,210,100,120,80,160,320,990
7241,200,120,40,80,0,0,440
7242,240,160,160,160,320,320,1360
7243,220,80,40,0,0,0,340
7244,210,120,120,160,320,0,930
7245,200,180,120,160,320,0,980
7246,190,80,80,160,160,0,670
7247,200,180,80,0,0,0,460
7248,240,120,120,80,160,0,720
7249,180,120,160,160,320,0,940
7250,200,120,160,160,160,0,800
7251,200,100,120,80,160,0,660
7252,200,100,80,80,160,0,620
7253,190,160,120,240,320,0,1030
7254,180,120,160,240,160,0,860
7255,190,120,80,80,160,0,630
7256,190,120,80,80,0,0,470
7257,160,40,80,0,0,0,280
7258,210,140,120,240,320,320,1350
7259,190,120,80,160,160,320,1030
7260,200,100,120,160,160,0,740
7261,230,180,160,80,0,0,650
7262,230,100,40,0,0,0,370
7263,180,120,120,80,160,0,660
7264,210,120,120,160,320,320,1250
7265,210,120,80,160,0,0,570
7266,170,160,160,80,160,0,730
7267,200,140,80,80,0,0,500
7268,210,140,80,80,160,0,670
7269,200,140,80,80,0,0,500
7270,190,100,160,80,160,320,1010
7271,200,140,120,80,160,0,700
7272,210,160,160,80,0,0,610
7273,210,160,240,80,0,0,690
7274,170,120,40,0,0,0,330
7275,220,100,120,80,160,0,680
7276,140,40,40,80,160,0,460
7277,170,200,120,80,160,320,1050
7278,230,140,200,160,320,0,1050
7279,190,160,120,80,160,0,710
7280,190,120,80,80,160,0,630
7281,220,120,40,80,0,0,460
7282,190,120,80,0,0,0,390
7283,180,120,40,0,0,0,340
7284,190,100,40,80,0,0,410
7285,200,140,80,80,0,0,500
7286,180,100,120,160,160,0,720
7287,210,100,120,80,160,320,990
7288,170,120,160,80,160,0,690
7289,190,160,120,240,320,320,1350
7290,190,160,120,160,320,320,1270
7291,180,140,120,160,160,0,760
7292,200,120,160,160,160,320,1120
7293,190,100,40,0,0,0,330
7294,230,120,120,0,0,0,470
7295,190,100,0,0,0,0,290
7296,200,100,40,80,0,0,420
7297,220,180,120,80,160,320,1080
7298,200,100,120,160,160,0,740
7299,200,160,160,80,0,0,600
7300,200,100,120,160,160,0,740
7301,170,80,40,0,0,0,290
7302,130,100,80,80,0,0,390
7303,190,80,80,80,0,0,430
7304,160,80,80,160,160,0,640
7305,230,140,80,80,160,0,690
7306,200,60,80,0,0,0,340
7307,220,160,120,160,160,0,820
7308,250,120,80,0,0,0,450
7309,160,100,40,80,0,0,380
7310,170,100,40,80,160,0,550
7311,190,160,120,0,0,0,470
7312,170,120,120,80,0,0,490
7313,190,120,160,160,320,320,1270
7314,170,120,80,0,0,0,370
7315,210,140,200,240,160,0,950
7316,190,100,40,80,0,0,410
7317,190,160,200,80,160,0,790
7318,180,160,120,80,0,0,540
7319,210,100,80,80,160,0,630
7320,190,160,120,160,0,0,630
7321,190,120,80,80,160,0,630
7322,230,160,120,160,160,0,830
7323,190,160,120,0,0,0,470
7324,200,100,80,80,0,0,460
7325,160,80,40,80,0,0,360
7326,220,140,160,80,0,0,600
7327,190,160,160,80,0,0,590
7328,210,120,120,160,0,0,610
7329,190,140,120,160,0,0,610
7330,200,120,80,80,160,0,640
7331,190,160,200,160,160,320,1190
7332,180,80,0,0,0,0,260
7333,210,160,120,160,160,0,810
7334,190,160,160,0,0,0,510
7335,200,100,80,80,0,0,460
7336,190,180,80,0,0,0,450
7337,150,80,0,0,0,0,230
7338,200,160,200,240,160,0,960
7339,200,180,120,160,320,320,1300
7340,200,140,160,160,160,320,1140
7341,190,100,80,0,0,0,370
7342,220,160,160,80,0,0,620
7343,210,120,160,80,0,0,570
7344,190,80,40,80,0,0,390
7345,170,80,120,80,160,320,930
7346,240,240,120,160,160,0,920
7347,230,160,120,80,160,0,750
7348,160,160,200,160,320,320,1320
7349,200,100,120,80,160,320,980
7350,190,80,80,80,160,0,590
7351,230,160,160,160,160,0,870
7352,220,40,40,80,160,0,540
7353,220,200,200,80,0,0,700
7354,190,160,40,80,160,0,630
7355,230,120,80,80,160,0,670
7356,200,140,120,0,0,0,460
7357,190,120,80,160,160,0,710
7358,190,100,160,240,160,0,850
7359,180,140,120,80,160,0,680
7360,210,100,80,0,0,0,390
7361,170,120,40,0,0,0,330
7362,210,120,120,80,160,0,690
7363,190,140,80,0,0,0,410
7364,170,80,80,80,0,0,410
7365,210,140,80,80,160,0,670
7366,170,120,80,80,0,0,450
7367,220,120,120,80,0,0,540
7368,180,180,160,80,160,0,760
7369,200,100,120,160,160,0,740
7370,190,120,120,80,160,0,670
7371,210,80,40,80,0,0,410
7372,190,140,160,80,0,0,570
7373,220,80,40,80,160,0,580
7374,180,120,120,80,0,0,500
7375,170,80,80,80,160,0,570
7376,160,140,120,160,320,0,900
7377,160,40,80,160,160,0,600
7378,230,140,160,80,160,0,770
7379,240,180,160,160,160,0,900
7380,220,100,120,160,160,0,760
7381,160,100,120,160,160,0,700
7382,190,140,160,80,160,320,1050
7383,170,100,80,0,0,0,350
7384,210,160,120,0,0,0,490
7385,180,140,120,0,0,0,440
7386,150,20,0,0,0,0,170
7387,220,100,160,240,160,0,880
7388,220,120,80,80,0,0,500
7389,210,200,200,160,160,0,930
7390,200,100,160,160,320,320,1260
7391,250,160,160,80,160,0,810
7392,210,120,120,80,0,0,530
7393,200,120,80,80,160,0,640
7394,220,160,80,80,0,0,540
7395,210,120,40,0,0,0,370
7396,210,140,160,160,160,0,830
7397,190,100,120,80,0,0,490
7398,220,100,40,80,0,0,440
7399,210,160,240,240,0,0,850
7400,150,60,120,80,160,0,570
7401,210,160,120,0,0,0,490
7402,240,120,80,160,320,320,1240
7403,190,140,80,160,320,320,1210
7404,170,80,80,160,160,0,650
7405,230,140,120,0,0,0,490
7406,170,140,120,160,320,0,910
7407,180,120,120,160,160,0,740
7408,230,120,120,80,160,0,710
7409,200,100,120,80,160,0,660
7410,220,180,160,240,160,0,960
7411,180,120,160,160,160,0,780
7412,200,140,120,80,160,0,700
7413,170,140,120,80,0,0,510
7414,190,120,80,80,160,0,630
7415,210,100,120,160,160,320,1070
7416,190,100,80,0,0,0,370
7417,200,160,160,160,0,0,680
7418,190,120,160,80,0,0,550
7419,200,180,120,80,160,0,740
7420,160,120,80,0,0,0,360
7421,180,100,80,80,160,0,600
7422,210,120,120,80,160,320,1010
7423,210,100,80,160,160,320,1030
7424,170,140,160,80,0,0,550
7425,200,200,160,240,160,0,960
7426,170,120,80,80,160,0,610
7427,200,120,80,160,160,0,720
7428,210,100,120,80,160,0,670
7429,170,20,40,80,160,0,470
7430,200,140,80,80,0,0,500
7431,220,80,40,80,160,320,900
7432,180,140,160,160,160,0,800
7433,180,80,80,0,0,0,340
7434,200,100,40,80,0,0,420
7435,190,80,80,80,160,0,590
7436,220,80,80,80,160,0,620
7437,210,120,40,80,160,320,930
7438,190,120,160,160,160,0,790
7439,220,120,40,0,0,0,380
7440,200,60,0,0,0,0,260
7441,240,120,80,80,160,0,680
7442,190,100,80,0,0,0,370
7443,200,140,160,160,320,320,1300
7444,190,120,80,0,0,0,390
7445,160,80,80,0,0,0,320
7446,230,120,80,0,0,0,430
7447,190,80,80,80,160,0,590
7448,150,140,80,80,160,0,610
7449,200,120,120,160,0,0,600
7450,200,140,160,160,0,0,660
7451,230,160,120,80,160,0,750
7452,210,180,200,240,320,0,1150
7453,170,100,40,80,160,0,550
7454,210,180,120,160,160,0,830
7455,180,140,120,240,160,0,840
7456,200,100,80,80,160,0,620
7457,160,120,120,80,160,0,640
7458,180,140,80,80,0,0,480
7459,200,140,80,0,0,0,420
7460,190,100,160,160,320,320,1250
7461,180,140,120,80,0,0,520
7462,190,100,80,80,0,0,450
7463,160,80,40,80,160,0,520
7464,220,140,160,160,0,0,680
7465,160,140,80,80,0,0,460
7466,210,140,80,80,160,0,670
7467,220,120,120,0,0,0,460
7468,240,160,120,0,0,0,520
7469,210,160,120,80,160,0,730
7470,210,80,80,0,0,0,370
7471,190,140,80,160,160,0,730
7472,170,140,120,160,160,0,750
7473,220,100,40,0,0,0,360
7474,200,120,120,160,0,0,600
7475,190,80,120,160,160,320,1030
7476,190,240,240,160,0,0,830
7477,190,160,80,80,0,0,510
7478,230,160,200,0,0,0,590
7479,180,140,120,80,0,0,520
7480,190,180,80,0,0,0,450
7481,190,140,160,160,160,320,1130
7482,210,100,40,0,0,0,350
7483,180,100,120,0,0,0,400
7484,190,140,80,80,160,0,650
7485,170,140,160,320,320,0,1110
7486,240,140,160,160,160,0,860
7487,190,0,0,0,0,0,190
7488,170,140,200,160,0,0,670
7489,170,100,80,160,160,0,670
7490,220,100,160,160,0,0,640
7491,230,80,80,80,0,0,470
7492,220,220,160,80,160,0,840
7493,190,160,80,80,160,0,670
7494,200,100,120,0,0,0,420
7495,220,100,0,0,0,0,320
7496,180,40,80,160,160,0,620
7497,210,100,120,240,320,320,1310
7498,200,140,160,80,160,0,740
7499,220,160,200,160,160,320,1220
7500,150,100,120,80,160,0,610
7501,210,180,200,80,0,0,670
7502,210,160,120,80,160,0,730
7503,210,140,160,0,0,0,510
7504,220,160,80,80,160,0,700
7505,200,120,40,80,0,0,440
7506,150,120,80,0,0,0,350
7507,220,160,80,80,0,0,540
7508,210,80,120,160,160,320,1050
7509,180,140,80,0,0,0,400
7510,180,80,40,0,0,0,300
7511,220,160,120,160,160,320,1140
7512,180,100,160,160,160,0,760
7513,210,100,40,0,0,0,350
7514,200,140,120,160,160,320,1100
7515,170,140,160,160,160,0,790
7516,200,100,120,0,0,0,420
7517,190,140,80,80,0,0,490
7518,220,160,80,160,160,0,780
7519,200,100,120,160,160,0,740
7520,180,60,40,80,0,0,360
7521,210,160,200,80,160,0,810
7522,180,60,0,0,0,0,240
7523,240,140,200,80,160,0,820
7524,220,180,80,160,160,0,800
7525,180,120,40,80,160,0,580
7526,210,100,80,160,160,320,1030
7527,180,140,120,80,160,0,680
7528,190,100,80,0,0,0,370
7529,210,160,160,160,160,320,1170
7530,190,120,120,80,160,320,990
7531,180,120,120,80,160,0,660
7532,220,180,80,80,160,0,720
7533,220,60,80,160,320,0,840
7534,220,160,120,0,0,0,500
7535,170,100,80,80,0,0,430
7536,220,160,120,80,160,0,740
7537,230,160,120,160,0,0,670
7538,180,140,120,80,160,0,680
7539,190,120,200,80,0,0,590
7540,210,160,40,0,0,0,410
7541,190,120,120,0,0,0,430
7542,180,80,120,160,160,0,700
7543,250,100,40,80,160,0,630
7544,160,100,0,0,0,0,260
7545,200,120,160,160,320,320,1280
7546,210,140,120,160,160,0,790
7547,180,60,80,80,160,320,880
7548,210,80,40,80,160,0,570
7549,210,100,40,0,0,0,350
7550,170,100,40,0,0,0,310
7551,190,80,40,80,160,320,870
7552,170,160,80,160,160,0,730
7553,240,120,80,80,160,0,680
7554,250,140,80,80,0,0,550
7555,240,160,120,0,0,0,520
7556,200,140,80,80,0,0,500
7557,190,160,160,160,0,0,670
7558,180,60,40,80,160,0,520
7559,160,100,40,80,0,0,380
7560,200,140,120,80,160,0,700
7561,190,120,160,160,160,320,1110
7562,170,120,40,80,0,0,410
7563,220,140,160,160,160,0,840
7564,210,140,120,160,160,0,790
7565,180,160,200,160,160,0,860
7566,170,120,120,80,0,0,490
7567,160,160,160,80,0,0,560
7568,210,100,120,80,160,0,670
7569,200,100,40,0,0,0,340
7570,230,120,120,160,0,0,630
7571,230,160,160,80,160,0,790
7572,180,120,120,80,0,0,500
7573,220,160,120,80,0,0,580
7574,220,160,80,160,160,0,780
7575,200,100,40,0,0,0,340
7576,230,160,120,160,160,0,830
7577,180,120,120,80,160,0,660
7578,220,140,120,80,0,0,560
7579,220,140,120,160,160,320,1120
7580,220,180,120,80,160,0,760
7581,190,120,120,0,0,0,430
7582,180,160,80,80,160,0,660
7583,200,100,160,80,160,0,700
7584,200,120,40,80,160,0,600
7585,190,80,40,80,160,0,550
7586,180,120,0,0,0,0,300
7587,220,140,40,80,160,0,640
7588,150,120,120,160,160,0,710
7589,240,160,160,160,160,0,880
7590,190,100,40,80,160,0,570
7591,210,100,120,160,320,0,910
7592,190,80,80,80,160,0,590
7593,190,100,80,0,0,0,370
7594,230,160,80,0,0,0,470
7595,160,100,160,80,160,0,660
7596,190,140,160,80,160,320,1050
7597,180,180,120,160,0,0,640
7598,200,140,80,80,160,0,660
7599,230,160,120,80,160,0,750
7600,190,160,120,240,160,0,870
7601,190,60,40,80,160,0,530
7602,210,160,160,80,0,0,610
7603,170,120,80,80,160,0,610
7604,200,140,120,160,320,0,940
7605,170,120,160,160,160,0,770
7606,210,80,80,80,160,0,610
7607,230,80,40,0,0,0,350
7608,210,160,80,80,160,320,1010
7609,200,120,160,80,0,0,560
7610,220,140,120,160,160,0,800
7611,210,140,120,0,0,0,470
7612,210,140,80,80,0,0,510
7613,190,60,0,0,0,0,250
7614,180,120,120,160,0,0,580
7615,170,140,80,80,160,0,630
7616,220,120,80,80,0,0,500
7617,220,220,200,240,320,0,1200
7618,170,120,120,160,160,0,730
7619,170,100,120,240,320,320,1270
7620,190,120,120,160,160,0,750
7621,230,160,120,160,160,0,830
7622,200,160,120,160,320,0,960
7623,230,140,80,80,160,0,690
7624,230,200,160,160,320,0,1070
7625,190,120,80,160,320,320,1190
7626,200,180,200,160,160,0,900
7627,150,100,80,80,0,0,410
7628,170,100,160,160,0,0,590
7629,220,120,160,80,0,0,580
7630,140,100,120,80,0,0,440
7631,200,100,40,0,0,0,340
7632,210,100,160,0,0,0,470
7633,180,120,80,0,0,0,380
7634,190,140,160,80,160,320,1050
7635,210,160,200,240,160,0,970
7636,220,160,120,160,320,0,980
7637,190,140,80,160,160,0,730
7638,150,100,80,160,0,0,490
7639,190,120,120,160,160,0,750
7640,150,80,120,80,160,0,590
7641,160,60,80,80,160,0,540
7642,200,100,120,80,0,0,500
7643,220,100,80,80,160,0,640
7644,230,180,200,240,160,0,1010
7645,210,80,80,80,0,0,450
7646,170,120,120,80,0,0,490
7647,240,120,80,160,320,320,1240
7648,190,100,120,80,160,320,970
7649,160,120,120,80,0,0,480
7650,200,60,40,80,0,0,380
7651,220,100,160,80,0,0,560
7652,200,120,80,80,160,0,640
7653,230,140,80,160,320,0,930
7654,180,80,80,160,160,0,660
7655,200,100,120,80,160,320,980
7656,170,120,80,0,0,0,370
7657,170,100,120,0,0,0,390
7658,190,100,120,160,160,0,730
7659,210,120,80,80,0,0,490
7660,180,120,120,160,320,320,1220
7661,180,160,160,160,0,0,660
7662,200,80,160,160,0,0,600
7663,200,100,80,0,0,0,380
7664,200,140,120,80,160,0,700
7665,210,160,160,240,160,0,930
7666,240,140,40,80,160,0,660
7667,200,140,40,80,160,0,620
7668,200,120,120,240,160,0,840
7669,210,160,200,80,0,0,650
7670,170,120,80,80,0,0,450
7671,220,140,80,0,0,0,440
7672,160,160,200,80,160,0,760
7673,190,80,160,80,0,0,510
7674,160,120,160,240,320,0,1000
7675,160,100,40,0,0,0,300
7676,190,160,160,80,0,0,590
7677,210,140,80,0,0,0,430
7678,240,140,80,160,320,0,940
7679,190,140,200,240,160,0,930
7680,180,100,80,160,320,0,840
7681,220,120,120,80,160,0,700
7682,220,120,120,160,160,320,1100
7683,220,160,120,80,160,320,1060
7684,160,40,80,0,0,0,280
7685,190,180,80,80,160,0,690
7686,160,100,80,160,320,320,1140
7687,220,120,120,160,320,320,1260
7688,200,100,80,80,0,0,460
7689,210,120,80,80,0,0,490
7690,180,100,160,80,0,0,520
7691,190,80,120,160,320,320,1190
7692,210,160,120,80,160,0,730
7693,170,160,160,160,320,0,970
7694,220,160,40,0,0,0,420
7695,240,160,80,160,0,0,640
7696,180,140,120,0,0,0,440
7697,190,120,40,80,0,0,430
7698,160,140,120,80,0,0,500
7699,220,120,160,240,160,320,1220
7700,170,80,80,80,0,0,410
7701,230,140,40,0,0,0,410
7702,220,120,160,160,160,0,820
7703,190,80,40,80,160,320,870
7704,180,100,80,80,0,0,440
7705,190,80,0,0,0,0,270
7706,230,120,120,160,160,0,790
7707,200,100,80,160,320,320,1180
7708,200,200,160,240,320,320,1440
7709,210,40,40,0,0,0,290
7710,210,120,160,240,320,0,1050
7711,230,40,80,80,160,0,590
7712,250,140,80,160,160,0,790
7713,150,100,80,160,320,0,810
7714,210,120,120,80,0,0,530
7715,160,80,80,0,0,0,320
7716,180,120,80,80,160,320,940
7717,200,180,160,80,160,320,1100
7718,180,140,120,80,160,0,680
7719,190,120,120,80,0,0,510
7720,190,80,80,0,0,0,350
7721,190,160,120,80,0,0,550
7722,210,160,80,80,160,320,1010
7723,140,80,80,0,0,0,300
7724,160,60,80,80,0,0,380
7725,190,140,120,0,0,0,450
7726,240,100,40,80,160,320,940
7727,200,160,80,80,160,0,680
7728,190,140,120,160,160,0,770
7729,220,60,40,0,0,0,320
7730,180,180,160,160,320,0,1000
7731,220,100,80,80,160,0,640
7732,170,100,80,80,160,0,590
7733,240,120,0,0,0,0,360
7734,180,100,40,0,0,0,320
7735,210,120,120,160,0,0,610
7736,170,120,160,240,320,0,1010
7737,180,120,40,0,0,0,340
7738,200,120,40,80,160,0,600
7739,180,120,80,80,160,0,620
7740,180,100,40,0,0,0,320
7741,200,100,40,0,0,0,340
7742,230,160,200,160,0,0,750
7743,200,140,120,160,0,0,620
7744,190,100,160,80,160,0,690
7745,170,100,80,80,160,0,590
7746,200,140,200,240,320,0,1100
7747,220,180,160,160,160,0,880
7748,210,140,160,80,0,0,590
7749,200,140,160,240,0,0,740
7750,210,80,80,160,160,0,690
7751,250,140,120,80,160,0,750
7752,190,140,200,160,160,0,850
7753,220,100,80,80,160,320,960
7754,250,140,160,160,160,320,1190
7755,180,100,120,160,320,0,880
7756,220,140,40,0,0,0,400
7757,190,120,40,80,160,0,590
7758,200,100,120,160,160,0,740
7759,190,140,160,80,0,0,570
7760,200,140,160,160,160,0,820
7761,190,120,80,160,320,0,870
7762,220,160,160,160,160,0,860
7763,180,140,120,160,320,0,920
7764,200,120,160,80,0,0,560
7765,220,180,160,80,160,0,800
7766,190,100,40,0,0,0,330
7767,200,120,120,80,160,320,1000
7768,170,80,80,160,320,320,1130
7769,220,160,160,0,0,0,540
7770,200,140,120,80,160,0,700
7771,160,80,80,80,160,0,560
7772,150,120,120,160,160,0,710
7773,170,100,80,160,160,320,990
7774,160,80,120,80,160,0,600
7775,210,80,120,80,0,0,490
7776,130,140,80,0,0,0,350
7777,140,100,80,80,160,0,560
7778,200,120,80,80,160,320,960
7779,210,120,120,160,160,320,1090
7780,220,140,80,80,160,320,1000
7781,210,140,80,160,320,0,910
7782,210,200,160,160,160,320,1210
7783,180,80,80,80,160,0,580
7784,230,140,160,160,160,0,850
7785,180,100,80,80,160,0,600
7786,150,140,80,80,160,320,930
7787,200,120,160,80,160,0,720
7788,220,180,120,160,160,0,840
7789,210,120,160,80,0,0,570
7790,190,100,80,80,160,320,930
7791,190,100,120,160,320,320,1210
7792,220,180,80,160,0,0,640
7793,210,140,120,80,160,0,710
7794,170,100,80,160,320,0,830
7795,210,120,120,80,160,0,690
7796,240,120,80,80,160,0,680
7797,190,120,120,160,320,320,1230
7798,180,140,80,160,320,320,1200
7799,200,140,160,160,160,0,820
7800,250,140,80,160,320,0,950
7801,200,140,120,160,160,0,780
7802,240,120,40,0,0,0,400
7803,200,160,80,80,160,0,680
7804,180,80,80,80,160,0,580
7805,170,120,40,80,160,0,570
7806,250,180,120,160,0,0,710
7807,190,100,40,80,160,0,570
7808,190,160,120,80,160,0,710
7809,200,60,40,80,160,0,540
7810,200,80,80,80,160,320,920
7811,200,160,120,80,160,0,720
7812,150,120,40,0,0,0,310
7813,220,120,80,80,160,0,660
7814,170,120,80,0,0,0,370
7815,180,80,80,160,160,0,660
7816,190,120,120,80,0,0,510
7817,200,120,0,0,0,0,320
7818,180,100,120,0,0,0,400
7819,150,100,80,80,0,0,410
7820,210,120,120,160,320,0,930
7821,190,80,0,0,0,0,270
7822,220,160,200,0,0,0,580
7823,210,140,40,0,0,0,390
7824,190,160,160,160,320,0,990
7825,200,140,80,80,160,0,660
7826,230,80,160,80,160,0,710
7827,230,120,160,160,160,0,830
7828,200,80,80,80,0,0,440
7829,180,160,200,80,160,320,1100
7830,230,120,160,80,0,0,590
7831,210,160,80,160,160,0,770
7832,210,140,40,80,160,320,950
7833,170,100,40,80,160,0,550
7834,190,200,120,160,320,0,990
7835,190,180,160,240,320,0,1090
7836,240,100,120,160,160,0,780
7837,180,100,80,160,320,0,840
7838,200,100,160,80,160,0,700
7839,250,160,120,0,0,0,530
7840,150,120,120,160,160,0,710
7841,180,100,120,80,0,0,480
7842,230,200,160,160,160,0,910
7843,220,140,80,80,160,0,680
7844,220,180,120,160,320,0,1000
7845,250,180,80,80,0,0,590
7846,230,140,120,160,160,0,810
7847,220,160,120,160,160,0,820
7848,170,100,160,240,160,0,830
7849,180,100,120,0,0,0,400
7850,180,140,160,240,320,0,1040
7851,210,60,40,80,0,0,390
7852,190,80,80,0,0,0,350
7853,170,140,120,80,160,0,670
7854,200,100,120,160,160,320,1060
7855,180,80,120,160,160,0,700
7856,200,120,120,80,160,0,680
7857,180,80,80,80,160,320,900
7858,170,100,160,80,160,320,990
7859,200,140,80,80,0,0,500
7860,220,100,40,80,160,0,600
7861,180,60,40,0,0,0,280
7862,240,140,40,0,0,0,420
7863,200,160,120,0,0,0,480
7864,170,120,40,80,160,0,570
7865,180,140,120,0,0,0,440
7866,180,160,160,160,160,0,820
7867,210,160,120,160,160,0,810
7868,190,100,40,80,160,0,570
7869,220,80,80,80,160,0,620
7870,220,140,80,80,0,0,520
7871,190,80,40,80,160,0,550
7872,230,120,120,80,160,320,1030
7873,210,140,120,80,160,320,1030
7874,190,80,80,80,160,0,590
7875,190,120,120,160,320,320,1230
7876,200,100,80,80,160,0,620
7877,200,180,200,80,0,0,660
7878,200,140,120,80,160,320,1020
7879,220,100,120,240,320,0,1000
7880,150,80,120,160,160,0,670
7881,190,100,120,160,160,0,730
7882,230,180,120,80,0,0,610
7883,230,120,120,160,320,320,1270
7884,230,160,120,80,160,0,750
7885,230,220,120,80,0,0,650
7886,180,100,120,80,160,0,640
7887,180,80,80,160,160,0,660
7888,200,140,200,80,0,0,620
7889,240,120,40,0,0,0,400
7890,250,180,160,160,320,320,1390
7891,140,120,80,0,0,0,340
7892,180,160,160,240,160,320,1220
7893,170,80,120,160,320,0,850
7894,190,100,120,160,320,0,890
7895,230,140,40,0,0,0,410
7896,180,140,200,80,160,0,760
7897,220,100,40,80,0,0,440
7898,240,200,120,80,0,0,640
7899,210,200,200,160,0,0,770
7900,210,100,120,80,0,0,510
7901,190,60,80,160,320,0,810
7902,180,100,40,80,160,0,560
7903,150,60,120,160,320,320,1130
7904,220,140,80,80,0,0,520
7905,200,60,40,80,160,320,860
7906,190,100,80,160,320,0,850
7907,210,180,160,160,160,0,870
7908,170,80,80,0,0,0,330
7909,220,160,80,80,0,0,540
7910,210,100,120,160,160,0,750
7911,160,100,160,80,0,0,500
7912,190,120,40,80,160,0,590
7913,180,100,80,160,320,0,840
7914,180,120,160,160,320,320,1260
7915,200,100,120,0,0,0,420
7916,160,100,120,160,160,0,700
7917,200,140,80,0,0,0,420
7918,200,120,80,80,160,0,640
7919,200,120,160,240,160,0,880
7920,190,120,120,160,0,0,590
7921,170,80,120,80,160,0,610
7922,200,180,160,80,0,0,620
7923,220,140,120,80,160,0,720
7924,190,120,120,240,160,320,1150
7925,200,180,40,0,0,0,420
7926,200,120,80,0,0,0,400
7927,230,120,40,80,0,0,470
7928,200,140,160,160,320,0,980
7929,220,120,40,80,160,0,620
7930,240,60,120,80,0,0,500
7931,180,140,120,160,0,0,600
7932,140,60,0,0,0,0,200
7933,200,160,120,240,160,0,880
7934,240,140,40,80,160,0,660
7935,180,180,200,160,160,0,880
7936,190,100,120,80,160,0,650
7937,220,100,80,80,0,0,480
7938,210,120,80,80,0,0,490
7939,220,120,120,80,0,0,540
7940,150,100,80,160,160,0,650
7941,180,120,80,0,0,0,380
7942,170,60,40,0,0,0,270
7943,210,60,0,0,0,0,270
7944,190,100,80,160,160,0,690
7945,160,140,160,160,160,0,780
7946,230,120,80,80,160,0,670
7947,200,120,80,0,0,0,400
7948,130,120,120,80,0,0,450
7949,190,100,40,80,160,0,570
7950,170,100,80,80,160,320,910
7951,200,180,160,160,160,0,860
7952,210,120,80,80,0,0,490
7953,230,200,160,80,0,0,670
7954,200,120,120,160,0,0,600
7955,200,160,80,80,0,0,520
7956,190,80,160,160,160,0,750
7957,250,100,80,80,160,0,670
7958,200,120,120,80,160,0,680
7959,180,160,120,160,160,0,780
7960,210,160,120,160,160,320,1130
7961,220,140,120,160,160,0,800
7962,160,120,120,80,160,0,640
7963,170,100,120,160,160,0,710
7964,180,160,80,80,160,0,660
7965,210,100,80,80,0,0,470
7966,160,120,80,0,0,0,360
7967,210,140,40,80,0,0,470
7968,210,120,200,80,160,0,770
7969,180,140,160,160,320,0,960
7970,220,140,80,80,0,0,520
7971,190,180,240,240,0,0,850
7972,210,160,200,160,320,0,1050
7973,190,120,40,80,160,0,590
7974,160,80,80,160,160,0,640
7975,210,160,160,0,0,0,530
7976,230,160,160,0,0,0,550
7977,220,80,40,0,0,0,340
7978,140,80,80,80,0,0,380
7979,200,100,120,80,0,0,500
7980,200,100,80,80,160,0,620
7981,210,220,160,80,160,0,830
7982,220,120,120,80,160,0,700
7983,210,80,80,80,0,0,450
7984,220,120,160,160,320,320,1300
7985,150,80,80,80,160,320,870
7986,180,120,120,0,0,0,420
7987,220,100,120,80,160,0,680
7988,170,100,120,80,0,0,470
7989,200,140,120,160,160,320,1100
7990,190,100,120,80,0,0,490
7991,170,140,120,80,160,320,990
7992,220,120,120,80,160,0,700
7993,170,100,120,80,160,0,630
7994,190,100,120,160,320,0,890
7995,220,140,80,80,160,0,680
7996,200,200,200,0,0,0,600
7997,210,160,160,0,0,0,530
7998,190,120,120,160,0,0,590
7999,210,140,200,160,0,0,710
8000,210,100,120,240,0,0,670
8001,170,60,40,80,160,0,510
8002,160,80,160,80,160,0,640
8003,210,160,160,160,160,0,850
8004,210,140,120,160,160,0,790
8005,210,160,120,160,160,0,810
8006,250,140,80,80,0,0,550
8007,120,60,40,80,160,0,460
8008,170,100,120,80,160,320,950
8009,190,140,80,160,160,320,1050
8010,190,120,120,160,160,0,750
8011,190,140,160,80,0,0,570
8012,210,120,80,80,160,0,650
8013,210,160,200,160,160,0,890
8014,190,140,80,80,160,0,650
8015,200,80,120,160,160,0,720
8016,230,140,120,80,160,0,730
8017,210,140,80,80,0,0,510
8018,190,140,160,240,320,0,1050
8019,160,120,120,160,0,0,560
8020,160,140,80,160,160,0,700
8021,190,140,80,80,160,0,650
8022,230,140,120,80,160,0,730
8023,210,100,80,80,160,320,950
8024,240,160,40,0,0,0,440
8025,200,160,120,0,0,0,480
8026,200,120,80,0,0,0,400
8027,230,180,120,160,160,0,850
8028,230,140,80,160,160,0,770
8029,150,80,80,80,160,0,550
8030,180,140,120,160,0,0,600
8031,200,100,160,80,0,0,540
8032,200,160,120,160,0,0,640
8033,190,100,40,0,0,0,330
8034,210,80,40,80,0,0,410
8035,220,120,160,160,160,320,1140
8036,210,80,120,0,0,0,410
8037,210,160,120,160,160,0,810
8038,180,120,120,80,0,0,500
8039,220,120,40,80,0,0,460
8040,150,120,120,160,160,0,710
8041,140,80,80,160,320,0,780
8042,200,100,40,80,160,320,900
8043,200,160,80,0,0,0,440
8044,190,120,120,160,160,0,750
8045,190,140,160,240,320,0,1050
8046,170,120,160,80,0,0,530
8047,210,140,80,80,160,0,670
8048,220,100,120,80,160,0,680
8049,190,100,80,0,0,0,370
8050,150,80,120,160,320,0,830
8051,180,80,80,80,160,0,580
8052,200,120,120,80,160,0,680
8053,190,120,120,160,0,0,590
8054,190,120,160,80,160,0,710
8055,190,100,0,0,0,0,290
8056,200,140,160,160,160,320,1140
8057,170,200,200,80,0,0,650
8058,170,60,80,80,160,320,870
8059,210,100,40,80,160,0,590
8060,170,100,40,0,0,0,310
8061,200,100,80,80,160,0,620
8062,230,120,80,160,160,0,750
8063,210,160,80,160,320,320,1250
8064,160,120,120,160,160,0,720
8065,190,140,160,80,160,0,730
8066,190,140,120,80,0,0,530
8067,210,80,120,240,160,320,1130
8068,210,160,120,160,160,320,1130
8069,150,80,0,0,0,0,230
8070,200,60,40,0,0,0,300
8071,220,220,160,80,160,0,840
8072,200,140,80,80,160,0,660
8073,190,60,80,0,0,0,330
8074,230,140,120,80,160,0,730
8075,150,60,40,80,160,320,810
8076,150,60,80,80,160,0,530
8077,200,180,200,160,160,0,900
8078,230,100,80,80,160,320,970
8079,180,80,40,0,0,0,300
8080,200,140,120,80,160,0,700
8081,180,180,80,80,0,0,520
8082,230,120,80,80,0,0,510
8083,140,140,120,80,0,0,480
8084,180,160,160,240,160,0,900
8085,230,160,120,160,320,320,1310
8086,170,140,200,160,160,320,1150
8087,170,100,80,80,160,0,590
8088,200,140,40,0,0,0,380
8089,230,140,80,80,0,0,530
8090,170,100,120,240,320,0,950
8091,190,160,80,80,160,0,670
8092,200,120,160,160,320,0,960
8093,210,120,160,240,160,0,890
8094,200,180,160,160,320,0,1020
8095,200,140,160,160,160,0,820
8096,190,160,120,160,160,0,790
8097,170,80,80,80,160,320,890
8098,230,160,80,80,160,0,710
8099,190,120,120,160,0,0,590
8100,190,160,160,160,160,320,1150
8101,170,160,240,240,320,0,1130
8102,170,100,120,80,160,0,630
8103,190,100,80,80,160,320,930
8104,210,100,80,160,320,0,870
8105,170,120,120,160,160,0,730
8106,200,100,120,160,0,0,580
8107,240,100,120,80,0,0,540
8108,200,100,160,160,160,0,780
8109,150,140,160,160,0,0,610
8110,150,80,120,160,320,0,830
8111,170,80,120,0,0,0,370
8112,150,60,0,0,0,0,210
8113,180,160,80,80,160,0,660
8114,220,140,40,80,0,0,480
8115,180,120,80,80,160,0,620
8116,170,120,160,80,160,0,690
8117,150,60,80,80,0,0,370
8118,200,100,160,80,0,0,540
8119,220,100,80,80,0,0,480
8120,190,120,80,80,160,0,630
8121,200,140,120,80,0,0,540
8122,240,160,120,0,0,0,520
8123,160,120,160,80,160,0,680
8124,180,80,80,160,160,0,660
8125,210,180,160,160,160,0,870
8126,210,80,80,80,0,0,450
8127,170,60,80,160,320,0,790
8128,210,100,40,0,0,0,350
8129,190,100,120,80,160,0,650
8130,170,120,120,160,320,320,1210
8131,220,80,120,160,160,0,740
8132,160,120,80,160,0,0,520
8133,200,140,120,0,0,0,460
8134,180,100,80,160,320,0,840
8135,200,100,80,80,0,0,460
8136,210,100,80,160,160,0,710
8137,190,100,40,80,160,0,570
8138,220,140,120,80,160,0,720
8139,150,100,160,80,160,0,650
8140,200,140,160,160,0,0,660
8141,200,100,40,80,0,0,420
8142,210,140,120,80,160,0,710
8143,230,120,120,160,0,0,630
8144,220,160,120,80,160,0,740
8145,190,140,80,160,160,0,730
8146,220,200,120,80,0,0,620
8147,220,140,80,80,160,0,680
8148,190,180,0,0,0,0,370
8149,160,100,120,160,160,0,700
8150,190,120,80,160,0,0,550
8151,180,100,120,80,0,0,480
8152,180,100,80,80,160,320,920
8153,180,140,120,80,160,0,680
8154,200,80,80,80,160,0,600
8155,190,100,0,0,0,0,290
8156,170,100,40,80,160,0,550
8157,220,140,80,0,0,0,440
8158,240,180,160,80,160,320,1140
8159,190,140,80,160,160,0,730
8160,160,100,80,160,0,0,500
8161,220,120,160,160,320,0,980
8162,180,100,40,80,0,0,400
8163,160,100,160,160,160,0,740
8164,220,140,160,160,160,0,840
8165,190,140,80,80,160,0,650
8166,170,80,40,0,0,0,290
8167,230,140,160,240,320,320,1410
8168,170,140,80,80,0,0,470
8169,230,120,120,160,160,0,790
8170,160,120,120,80,160,0,640
8171,170,120,160,160,160,0,770
8172,180,80,80,80,160,0,580
8173,190,140,120,240,160,0,850
8174,230,120,40,0,0,0,390
8175,190,140,200,80,0,0,610
8176,240,200,80,80,0,0,600
8177,180,80,0,0,0,0,260
8178,190,100,120,80,0,0,490
8179,230,180,120,80,0,0,610
8180,250,160,40,0,0,0,450
8181,210,100,120,160,0,0,590
8182,190,200,120,0,0,0,510
8183,150,120,120,80,0,0,470
8184,180,140,80,160,320,0,880
8185,170,140,120,160,160,0,750
8186,190,120,80,160,320,0,870
8187,200,140,160,160,320,320,1300
8188,150,120,160,80,160,320,990
8189,210,80,40,80,160,0,570
8190,210,120,160,160,320,0,970
8191,200,100,120,80,160,0,660
8192,210,120,120,160,320,320,1250
8193,120,100,80,80,0,0,380
8194,190,200,200,160,320,0,1070
8195,170,40,40,80,0,0,330
8196,190,180,80,160,320,0,930
8197,180,160,120,160,160,0,780
8198,210,120,40,0,0,0,370
8199,210,180,40,80,160,0,670
8200,170,140,40,0,0,0,350
8201,220,100,80,0,0,0,400
8202,210,180,160,240,320,320,1430
8203,180,180,200,80,160,320,1120
8204,160,160,160,80,0,0,560
8205,190,140,120,160,0,0,610
8206,220,180,80,80,160,0,720
8207,210,120,160,0,0,0,490
8208,260,140,160,160,0,0,720
8209,210,140,120,160,320,0,950
8210,190,160,80,0,0,0,430
8211,180,100,80,160,0,0,520
8212,230,140,120,160,160,0,810
8213,250,120,80,160,160,0,770
8214,210,160,120,240,160,0,890
8215,200,140,160,80,160,0,740
8216,160,120,120,0,0,0,400
8217,190,120,80,80,160,0,630
8218,220,160,160,240,320,0,1100
8219,240,140,160,240,320,0,1100
8220,210,140,160,240,160,320,1230
8221,220,140,80,0,0,0,440
8222,200,80,80,160,320,0,840
8223,170,100,40,80,160,0,550
8224,170,120,120,0,0,0,410
8225,170,120,120,160,160,0,730
8226,200,80,160,160,320,320,1240
8227,170,140,120,80,160,320,990
8228,150,80,120,80,160,0,590
8229,210,100,40,0,0,0,350
8230,180,100,80,0,0,0,360
8231,230,120,160,240,160,0,910
8232,200,80,160,80,160,0,680
8233,200,120,80,0,0,0,400
8234,230,120,120,160,160,0,790
8235,190,180,160,240,320,0,1090
8236,170,120,120,240,160,0,810
8237,160,80,80,160,160,0,640
8238,200,120,120,160,160,0,760
8239,200,200,80,0,0,0,480
8240,170,60,80,80,160,320,870
8241,200,120,40,80,160,0,600
8242,210,160,120,80,160,0,730
8243,220,140,120,80,160,0,720
8244,180,80,160,0,0,0,420
8245,200,140,80,80,160,0,660
8246,160,140,120,0,0,0,420
8247,210,160,120,80,0,0,570
8248,220,100,40,0,0,0,360
8249,180,120,80,160,160,0,700
8250,200,120,200,160,160,0,840
8251,200,140,120,80,0,0,540
8252,190,120,40,80,160,0,590
8253,200,100,80,80,160,320,940
8254,160,140,200,160,160,0,820
8255,200,120,120,80,160,0,680
8256,200,100,160,80,160,0,700
8257,230,200,80,0,0,0,510
8258,250,100,40,80,0,0,470
8259,200,120,80,80,160,0,640
8260,250,60,40,80,160,320,910
8261,160,120,80,0,0,0,360
8262,230,140,120,160,320,320,1290
8263,200,140,160,160,160,320,1140
8264,140,60,80,80,160,0,520
8265,210,100,160,160,160,0,790
8266,190,160,40,80,0,0,470
8267,180,140,80,80,160,0,640
8268,180,80,80,160,0,0,500
8269,150,80,160,80,160,320,950
8270,210,140,120,80,160,0,710
8271,200,100,120,80,0,0,500
8272,220,100,40,80,160,0,600
8273,190,160,160,160,160,0,830
8274,210,80,120,80,0,0,490
8275,160,80,80,0,0,0,320
8276,200,120,40,80,160,0,600
8277,200,120,80,80,0,0,480
8278,150,100,200,160,160,0,770
8279,190,140,80,160,0,0,570
8280,180,60,40,80,160,0,520
8281,180,140,160,80,160,0,720
8282,200,180,160,160,320,0,1020
8283,190,120,160,160,0,0,630
8284,180,120,120,160,160,0,740
8285,230,140,120,80,0,0,570
8286,210,160,160,160,160,0,850
8287,180,40,0,0,0,0,220
8288,220,100,120,0,0,0,440
8289,250,120,80,80,160,0,690
8290,150,140,160,160,0,0,610
8291,200,160,120,80,0,0,560
8292,250,160,40,0,0,0,450
8293,200,180,160,240,0,0,780
8294,180,60,40,80,160,0,520
8295,170,140,160,160,0,0,630
8296,160,120,120,160,160,320,1040
8297,160,120,160,240,160,0,840
8298,190,160,120,0,0,0,470
8299,160,140,120,80,160,0,660
8300,160,80,120,80,160,320,920
8301,160,100,120,160,160,0,700
8302,180,100,40,0,0,0,320
8303,240,100,80,0,0,0,420
8304,200,40,40,80,160,0,520
8305,190,120,120,160,160,0,750
8306,190,120,80,80,160,0,630
8307,180,80,80,80,160,320,900
8308,190,100,120,160,160,0,730
8309,200,100,120,80,160,0,660
8310,200,100,80,80,160,0,620
8311,180,180,160,160,320,0,1000
8312,190,140,80,160,320,320,1210
8313,190,200,200,240,160,0,990
8314,170,160,120,80,160,0,690
8315,160,140,80,0,0,0,380
8316,160,80,80,80,160,0,560
8317,200,120,160,0,0,0,480
8318,230,100,120,80,160,0,690
8319,170,60,40,80,160,0,510
8320,170,120,120,80,160,320,970
8321,240,180,160,160,160,0,900
8322,180,80,40,0,0,0,300
8323,220,100,40,80,0,0,440
8324,230,200,120,160,0,0,710
8325,190,100,40,80,0,0,410
8326,170,100,40,0,0,0,310
8327,180,120,40,80,160,0,580
8328,250,140,80,80,160,0,710
8329,190,100,80,0,0,0,370
8330,210,140,40,0,0,0,390
8331,230,160,120,160,320,320,1310
8332,190,100,160,240,160,0,850
8333,180,160,120,160,320,0,940
8334,170,160,160,240,160,0,890
8335,230,160,160,0,0,0,550
8336,160,60,80,80,160,0,540
8337,170,100,80,80,160,0,590
8338,190,140,80,160,0,0,570
8339,170,120,120,0,0,0,410
8340,210,140,160,160,320,0,990
8341,200,80,80,0,0,0,360
8342,190,140,160,160,160,0,810
8343,230,120,40,80,160,0,630
8344,170,100,120,80,160,0,630
8345,210,160,80,160,160,320,1090
8346,240,120,80,0,0,0,440
8347,220,100,160,80,160,0,720
8348,210,160,160,240,0,0,770
8349,210,60,40,80,160,0,550
8350,230,120,80,80,0,0,510
8351,210,120,120,0,0,0,450
8352,220,80,80,80,160,0,620
8353,240,200,80,80,160,0,760
8354,160,140,80,80,160,0,620
8355,210,100,120,160,160,320,1070
8356,240,140,120,160,160,0,820
8357,180,80,40,80,0,0,380
8358,170,60,120,80,0,0,430
8359,210,140,200,240,320,0,1110
8360,200,100,120,80,0,0,500
8361,220,140,80,80,160,0,680
8362,220,120,120,160,160,0,780
8363,240,140,120,80,160,0,740
8364,180,100,120,0,0,0,400
8365,190,120,40,80,0,0,430
8366,220,160,160,160,160,0,860
8367,210,120,80,0,0,0,410
8368,200,120,80,80,0,0,480
8369,200,180,160,80,0,0,620
8370,190,120,120,240,160,0,830
8371,200,100,40,80,0,0,420
8372,200,100,0,0,0,0,300
8373,180,140,80,160,160,0,720
8374,190,120,80,0,0,0,390
8375,170,120,120,80,160,0,650
8376,200,120,160,160,0,0,640
8377,190,60,80,0,0,0,330
8378,160,100,120,240,320,0,940
8379,230,80,80,0,0,0,390
8380,200,100,120,80,160,0,660
8381,180,140,40,80,160,0,600
8382,210,160,120,240,160,320,1210
8383,160,100,40,80,0,0,380
8384,200,120,120,80,160,0,680
8385,200,120,120,0,0,0,440
8386,170,140,80,80,160,0,630
8387,160,100,80,160,160,0,660
8388,240,120,40,80,160,0,640
8389,220,140,120,160,320,0,960
8390,200,140,200,240,0,0,780
8391,180,120,80,0,0,0,380
8392,220,140,80,80,0,0,520
8393,190,140,160,160,320,0,970
8394,180,80,120,160,160,0,700
8395,220,140,80,160,160,0,760
8396,220,120,160,240,320,0,1060
8397,190,100,80,0,0,0,370
8398,220,100,160,80,0,0,560
8399,220,80,80,80,160,320,940
8400,240,120,120,160,160,0,800
8401,180,100,120,80,160,0,640
8402,210,100,80,0,0,0,390
8403,200,120,80,80,160,0,640
8404,220,80,80,160,320,0,860
8405,160,120,160,80,160,0,680
8406,230,140,160,240,320,0,1090
8407,170,80,80,80,0,0,410
8408,210,140,120,80,0,0,550
8409,230,140,120,80,0,0,570
8410,190,120,80,80,160,0,630
8411,180,100,40,80,160,0,560
8412,200,140,120,0,0,0,460
8413,160,60,80,80,160,0,540
8414,180,140,200,160,160,320,1160
8415,200,80,40,80,160,0,560
8416,200,140,80,160,160,0,740
8417,200,160,160,160,160,0,840
8418,200,160,120,80,0,0,560
8419,220,120,120,240,320,0,1020
8420,180,100,80,80,160,0,600
8421,160,80,120,160,160,0,680
8422,200,140,160,160,160,0,820
8423,180,120,160,0,0,0,460
8424,220,160,160,160,0,0,700
8425,220,100,80,80,160,0,640
8426,190,140,120,80,0,0,530
8427,140,80,40,80,160,0,500
8428,190,120,120,240,320,0,990
8429,180,120,120,80,160,0,660
8430,190,100,120,80,160,0,650
8431,200,60,40,80,0,0,380
8432,190,140,80,80,160,0,650
8433,210,140,40,80,160,0,630
8434,200,100,80,160,160,0,700
8435,180,160,120,240,160,0,860
8436,200,100,160,240,160,0,860
8437,220,160,80,80,160,0,700
8438,210,240,200,240,160,0,1050
8439,190,100,120,240,160,0,810
8440,230,80,80,0,0,0,390
8441,150,100,80,160,0,0,490
8442,190,40,40,80,160,0,510
8443,230,140,40,80,160,320,970
8444,170,160,160,80,0,0,570
8445,220,120,120,80,160,0,700
8446,230,180,80,80,160,0,730
8447,190,100,80,0,0,0,370
8448,210,160,40,0,0,0,410
8449,210,100,80,80,160,0,630
8450,170,120,120,160,320,0,890
8451,210,120,160,80,0,0,570
8452,150,120,120,160,0,0,550
8453,220,180,200,80,160,0,840
8454,220,140,200,80,160,0,800
8455,220,180,200,160,160,0,920
8456,200,140,80,80,160,0,660
8457,230,140,80,80,160,0,690
8458,180,120,120,160,160,0,740
8459,210,140,120,80,160,0,710
8460,200,80,80,160,0,0,520
8461,230,100,120,160,160,320,1090
8462,210,200,160,80,160,0,810
8463,190,40,40,0,0,0,270
8464,180,100,160,240,160,0,840
8465,160,120,80,80,160,0,600
8466,190,140,200,160,160,320,1170
8467,240,120,160,80,0,0,600
8468,210,100,40,80,160,0,590
8469,180,120,120,160,0,0,580
8470,230,160,200,80,160,0,830
8471,190,120,80,80,160,0,630
8472,220,120,160,240,0,0,740
8473,180,100,80,80,160,320,920
8474,220,120,120,80,160,0,700
8475,200,140,80,160,160,0,740
8476,170,80,40,80,0,0,370
8477,200,120,120,160,320,320,1240
8478,200,100,80,0,0,0,380
8479,180,60,80,0,0,0,320
8480,200,140,80,80,160,320,980
8481,220,180,200,240,320,0,1160
8482,200,140,120,160,0,0,620
8483,200,140,80,80,160,320,980
8484,210,140,160,160,0,0,670
8485,170,120,80,0,0,0,370
8486,170,140,160,160,320,320,1270
8487,190,80,80,80,0,0,430
8488,160,100,40,0,0,0,300
8489,220,60,120,80,160,0,640
8490,200,100,40,80,160,0,580
8491,220,140,160,160,160,0,840
8492,180,120,80,160,320,0,860
8493,210,180,200,160,160,0,910
8494,190,80,120,160,0,0,550
8495,200,100,120,0,0,0,420
8496,210,160,120,160,160,0,810
8497,210,200,160,80,160,0,810
8498,190,140,80,80,160,320,970
8499,200,20,0,0,0,0,220
8500,200,140,80,80,160,320,980
8501,190,100,120,0,0,0,410
8502,180,100,120,160,320,0,880
8503,210,120,120,160,160,0,770
8504,190,180,120,160,0,0,650
8505,190,140,120,160,160,320,1090
8506,180,100,80,160,160,0,680
8507,200,140,160,80,160,0,740
8508,190,100,120,240,320,0,970
8509,220,200,200,160,160,320,1260
8510,180,60,80,160,320,0,800
8511,180,140,160,160,160,320,1120
8512,180,120,80,160,320,0,860
8513,220,120,40,80,160,0,620
8514,200,120,120,0,0,0,440
8515,200,80,80,80,160,0,600
8516,230,160,120,160,320,320,1310
8517,230,120,80,0,0,0,430
8518,250,160,80,0,0,0,490
8519,180,100,120,160,160,0,720
8520,180,180,200,80,160,0,800
8521,220,180,80,80,0,0,560
8522,170,60,40,80,0,0,350
8523,210,120,80,80,0,0,490
8524,170,160,160,240,320,0,1050
8525,180,140,120,80,160,320,1000
8526,170,140,120,160,0,0,590
8527,190,100,80,80,160,0,610
8528,220,80,80,80,160,0,620
8529,230,180,160,0,0,0,570
8530,200,140,40,0,0,0,380
8531,230,100,80,80,160,0,650
8532,190,120,80,80,160,0,630
8533,190,100,120,80,160,320,970
8534,230,120,120,80,0,0,550
8535,210,100,40,80,160,0,590
8536,190,180,120,80,0,0,570
8537,190,140,80,80,0,0,490
8538,180,120,120,160,320,320,1220
8539,170,120,160,0,0,0,450
8540,190,140,200,240,320,320,1410
8541,160,100,120,80,160,320,940
8542,200,120,120,160,160,0,760
8543,180,140,160,160,320,0,960
8544,190,80,80,160,160,0,670
8545,210,80,80,80,0,0,450
8546,200,100,120,240,320,320,1300
8547,200,180,120,0,0,0,500
8548,200,180,200,160,160,0,900
8549,200,140,80,80,0,0,500
8550,170,80,120,80,160,320,930
8551,150,100,80,160,160,0,650
8552,200,180,240,160,160,0,940
8553,210,100,80,80,0,0,470
8554,170,100,120,160,320,320,1190
8555,220,120,120,80,0,0,540
8556,160,120,160,160,320,0,920
8557,180,160,160,240,160,0,900
8558,180,60,40,80,160,0,520
8559,160,100,80,0,0,0,340
8560,200,140,120,240,160,0,860
8561,200,160,80,80,0,0,520
8562,190,140,120,80,160,320,1010
8563,190,100,40,0,0,0,330
8564,180,100,80,80,160,320,920
8565,220,120,80,160,160,0,740
8566,210,100,40,0,0,0,350
8567,240,140,80,160,320,0,940
8568,190,180,200,160,160,0,890
8569,210,120,80,160,160,0,730
8570,160,120,160,160,160,0,760
8571,180,100,80,80,0,0,440
8572,220,140,80,80,160,320,1000
8573,160,100,40,0,0,0,300
8574,190,160,120,160,160,0,790
8575,250,160,200,160,160,0,930
8576,140,160,40,0,0,0,340
8577,220,120,80,80,0,0,500
8578,260,160,120,240,320,0,1100
8579,200,80,120,80,0,0,480
8580,180,100,120,160,160,0,720
8581,230,160,80,160,320,0,950
8582,220,160,200,240,320,320,1460
8583,220,140,80,80,160,0,680
8584,210,100,80,80,0,0,470
8585,230,80,80,80,160,0,630
8586,170,120,120,160,320,320,1210
8587,170,160,160,80,0,0,570
8588,170,160,120,0,0,0,450
8589,210,100,120,240,160,0,830
8590,220,140,80,160,160,0,760
8591,160,80,40,80,160,0,520
8592,220,100,120,160,160,0,760
8593,210,100,80,80,0,0,470
8594,140,140,40,80,0,0,400
8595,250,120,80,160,320,0,930
8596,210,140,160,80,160,0,750
8597,200,60,80,160,160,0,660
8598,210,160,200,160,160,0,890
8599,190,100,120,80,160,320,970
8600,190,120,160,160,160,0,790
8601,200,100,120,80,160,0,660
8602,210,80,120,80,160,0,650
8603,230,140,40,0,0,0,410
8604,180,160,120,80,0,0,540
8605,170,120,160,160,0,0,610
8606,200,160,160,160,160,0,840
8607,180,100,40,80,160,320,880
8608,180,120,160,80,0,0,540
8609,200,100,40,0,0,0,340
8610,210,120,160,80,160,0,730
8611,230,120,160,240,320,0,1070
8612,190,180,120,160,320,0,970
8613,220,140,120,80,160,320,1040
8614,200,120,80,80,160,320,960
8615,160,100,40,80,0,0,380
8616,200,100,120,160,160,0,740
8617,220,140,120,160,0,0,640
8618,230,140,160,160,160,0,850
8619,170,80,80,80,160,320,890
8620,180,60,0,0,0,0,240
8621,210,160,160,80,0,0,610
8622,200,80,80,160,0,0,520
8623,210,140,160,240,0,0,750
8624,210,160,80,80,160,0,690
8625,230,220,160,160,160,0,930
8626,240,160,80,160,320,320,1280
8627,170,100,120,80,0,0,470
8628,200,140,80,80,160,0,660
8629,160,80,40,0,0,0,280
8630,160,140,120,80,160,0,660
8631,220,40,40,0,0,0,300
8632,210,100,80,80,160,0,630
8633,140,80,80,80,160,0,540
8634,210,100,120,80,0,0,510
8635,220,100,80,80,160,0,640
8636,210,80,80,80,160,320,930
8637,220,160,80,160,0,0,620
8638,220,120,120,80,160,0,700
8639,210,140,200,160,320,0,1030
8640,250,100,80,80,160,0,670
8641,200,180,80,0,0,0,460
8642,200,140,160,240,320,0,1060
8643,170,80,80,80,160,0,570
8644,170,80,80,80,0,0,410
8645,210,180,80,0,0,0,470
8646,190,120,80,80,0,0,470
8647,160,140,120,80,0,0,500
8648,190,120,40,80,160,0,590
8649,190,140,80,80,0,0,490
8650,210,120,80,80,0,0,490
8651,200,100,80,160,160,0,700
8652,180,100,80,80,160,0,600
8653,210,120,0,0,0,0,330
8654,190,100,120,80,160,0,650
8655,210,140,40,0,0,0,390
8656,230,100,40,80,160,0,610
8657,180,160,120,80,160,0,700
8658,190,140,160,80,160,320,1050
8659,180,120,80,0,0,0,380
8660,240,140,80,80,0,0,540
8661,170,120,200,160,0,0,650
8662,150,100,120,160,160,0,690
8663,210,140,160,160,160,320,1150
8664,200,100,160,160,160,0,780
8665,210,180,120,160,320,320,1310
8666,200,120,160,80,0,0,560
8667,180,120,120,80,160,0,660
8668,160,80,80,80,160,320,880
8669,170,160,40,0,0,0,370
8670,210,120,120,160,320,0,930
8671,220,60,40,80,160,0,560
8672,180,120,120,0,0,0,420
8673,220,160,160,160,320,0,1020
8674,200,120,80,0,0,0,400
8675,220,100,120,160,320,320,1240
8676,250,160,160,240,320,0,1130
8677,210,160,80,80,160,0,690
8678,240,140,40,0,0,0,420
8679,210,120,120,80,0,0,530
8680,190,80,80,0,0,0,350
8681,230,160,40,80,0,0,510
8682,190,100,120,240,320,0,970
8683,250,180,80,80,160,320,1070
8684,160,40,40,80,0,0,320
8685,210,140,160,80,160,320,1070
8686,210,120,80,80,0,0,490
8687,170,120,80,160,160,0,690
8688,150,100,120,160,160,0,690
8689,210,80,120,80,0,0,490
8690,170,140,160,240,160,320,1190
8691,180,80,40,80,160,0,540
8692,220,200,160,240,320,0,1140
8693,220,160,120,160,160,320,1140
8694,190,80,80,80,0,0,430
8695,170,140,40,0,0,0,350
8696,170,60,40,80,160,0,510
8697,150,120,40,80,160,0,550
8698,150,80,120,80,0,0,430
8699,210,160,80,160,320,320,1250
8700,200,120,80,160,160,0,720
8701,210,140,80,160,160,0,750
8702,180,120,80,160,160,0,700
8703,190,120,40,80,0,0,430
8704,200,120,160,80,160,0,720
8705,150,120,40,80,0,0,390
8706,200,60,80,80,0,0,420
8707,200,120,120,160,320,0,920
8708,220,120,120,160,160,0,780
8709,210,120,80,80,0,0,490
8710,220,120,160,160,320,0,980
8711,210,200,120,160,0,0,690
8712,180,140,120,80,0,0,520
8713,210,140,160,80,0,0,590
8714,200,100,80,160,0,0,540
8715,190,80,80,0,0,0,350
8716,200,100,40,80,0,0,420
8717,200,100,40,80,160,320,900
8718,200,100,40,80,160,0,580
8719,220,160,40,0,0,0,420
8720,170,100,80,80,160,320,910
8721,180,120,80,80,0,0,460
8722,180,100,80,0,0,0,360
8723,240,120,160,80,0,0,600
8724,180,140,80,80,0,0,480
8725,210,120,120,80,160,0,690
8726,200,100,40,0,0,0,340
8727,230,200,200,240,0,0,870
8728,210,100,80,160,320,0,870
8729,170,120,160,80,160,0,690
8730,220,180,120,160,320,0,1000
8731,240,160,120,160,0,0,680
8732,220,140,80,80,160,0,680
8733,200,100,80,80,160,0,620
8734,210,160,80,80,160,0,690
8735,220,120,120,80,0,0,540
8736,200,40,40,80,160,320,840
8737,190,140,40,0,0,0,370
8738,200,120,80,80,0,0,480
8739,210,100,40,80,160,0,590
8740,210,60,80,80,0,0,430
8741,190,60,40,0,0,0,290
8742,170,140,80,0,0,0,390
8743,210,140,120,80,0,0,550
8744,230,160,160,160,320,0,1030
8745,200,160,120,80,0,0,560
8746,210,120,80,80,0,0,490
8747,150,60,40,0,0,0,250
8748,210,120,80,0,0,0,410
8749,200,140,80,80,160,0,660
8750,180,140,200,160,160,0,840
8751,190,80,80,0,0,0,350
8752,180,160,120,80,0,0,540
8753,210,140,200,0,0,0,550
8754,220,120,120,0,0,0,460
8755,170,80,120,160,0,0,530
8756,200,120,120,0,0,0,440
8757,190,160,120,80,160,0,710
8758,220,100,40,80,160,0,600
8759,210,160,120,80,160,0,730
8760,190,100,0,0,0,0,290
8761,170,100,120,80,160,0,630
8762,220,100,80,80,160,0,640
8763,190,100,80,160,0,0,530
8764,230,140,120,80,160,320,1050
8765,230,180,160,80,0,0,650
8766,190,100,40,0,0,0,330
8767,190,100,120,160,160,0,730
8768,170,80,120,160,160,320,1010
8769,170,140,120,160,160,0,750
8770,200,120,160,240,160,0,880
8771,200,140,80,80,160,0,660
8772,190,80,160,160,320,320,1230
8773,190,140,160,160,320,320,1290
8774,220,100,40,80,0,0,440
8775,190,140,120,160,0,0,610
8776,180,140,80,0,0,0,400
8777,170,80,40,0,0,0,290
8778,210,80,80,160,320,0,850
8779,170,140,200,240,320,0,1070
8780,200,120,120,240,320,0,1000
8781,240,80,120,80,0,0,520
8782,200,140,160,240,160,0,900
8783,200,120,160,160,160,0,800
8784,160,60,80,80,0,0,380
8785,230,160,120,0,0,0,510
8786,220,180,160,160,320,0,1040
8787,240,100,40,80,160,0,620
8788,180,140,160,0,0,0,480
8789,190,140,80,160,160,0,730
8790,190,120,120,80,160,0,670
8791,230,100,40,0,0,0,370
8792,220,120,80,80,0,0,500
8793,200,140,80,80,0,0,500
8794,200,120,160,80,160,0,720
8795,190,120,120,160,160,0,750
8796,200,140,120,0,0,0,460
8797,190,120,80,80,160,0,630
8798,220,140,120,240,160,320,1200
8799,210,120,160,240,320,320,1370
8800,170,120,160,160,160,0,770
8801,110,100,80,80,160,0,530
8802,210,160,80,0,0,0,450
8803,190,120,160,160,160,0,790
8804,220,180,160,240,320,320,1440
8805,190,80,40,80,160,0,550
8806,220,100,80,160,160,0,720
8807,200,80,40,80,160,320,880
8808,190,160,80,0,0,0,430
8809,220,100,120,80,160,0,680
8810,170,180,160,80,160,0,750
8811,240,80,40,80,160,0,600
8812,180,160,200,240,320,0,1100
8813,220,140,80,0,0,0,440
8814,180,120,80,160,320,0,860
8815,200,120,120,0,0,0,440
8816,200,180,80,80,160,0,700
8817,220,120,80,160,160,0,740
8818,180,100,80,160,0,0,520
8819,190,100,120,0,0,0,410
8820,230,40,40,80,160,320,870
8821,170,100,120,80,160,0,630
8822,160,100,80,80,0,0,420
8823,210,140,160,160,160,0,830
8824,230,140,160,160,320,320,1330
8825,190,120,160,80,160,0,710
8826,230,140,120,80,0,0,570
8827,170,120,40,0,0,0,330
8828,220,120,80,160,160,0,740
8829,240,120,120,160,320,320,1280
8830,200,120,80,80,160,0,640
8831,230,140,80,0,0,0,450
8832,210,120,120,0,0,0,450
8833,210,140,120,80,160,0,710
8834,170,120,80,0,0,0,370
8835,190,140,40,80,160,0,610
8836,220,160,120,80,0,0,580
8837,200,80,80,80,160,0,600
8838,220,180,120,80,0,0,600
8839,210,140,120,160,0,0,630
8840,180,160,120,160,160,0,780
8841,220,140,80,160,160,0,760
8842,200,100,80,0,0,0,380
8843,190,100,120,80,160,0,650
8844,210,120,120,80,0,0,530
8845,230,160,80,160,320,320,1270
8846,220,160,120,80,160,320,1060
8847,170,80,40,0,0,0,290
8848,150,120,160,160,160,0,750
8849,190,160,120,0,0,0,470
8850,190,160,160,160,160,0,830
8851,190,120,80,80,0,0,470
8852,190,100,120,160,320,0,890
8853,200,120,160,240,160,0,880
8854,160,80,80,80,160,0,560
8855,170,200,160,160,320,320,1330
8856,210,140,80,160,320,320,1230
8857,210,120,120,80,0,0,530
8858,160,100,120,80,160,0,620
8859,180,80,40,80,0,0,380
8860,240,180,240,160,320,320,1460
8861,230,180,200,160,0,0,770
8862,240,120,80,160,160,0,760
8863,200,160,80,0,0,0,440
8864,190,120,120,160,0,0,590
8865,240,120,120,160,320,320,1280
8866,210,160,160,160,160,0,850
8867,190,60,40,80,160,0,530
8868,160,80,80,80,0,0,400
8869,190,80,80,80,160,0,590
8870,230,120,120,160,160,320,1110
8871,200,120,160,80,0,0,560
8872,180,120,120,160,160,0,740
8873,240,120,200,160,160,320,1200
8874,200,140,120,160,320,0,940
8875,200,100,120,0,0,0,420
8876,180,100,120,80,160,0,640
8877,200,100,120,160,320,0,900
8878,210,120,120,80,0,0,530
8879,150,100,120,80,160,0,610
8880,190,100,120,160,160,0,730
8881,200,160,120,160,160,0,800
8882,160,140,160,240,0,0,700
8883,230,100,120,80,160,320,1010
8884,130,120,160,240,320,0,970
8885,160,60,40,0,0,0,260
8886,210,100,120,80,0,0,510
8887,220,80,80,160,320,0,860
8888,200,160,120,160,320,320,1280
8889,170,80,80,160,160,0,650
8890,210,180,80,0,0,0,470
8891,190,100,40,0,0,0,330
8892,190,180,200,160,320,320,1370
8893,230,160,160,160,160,320,1190
8894,220,140,160,80,0,0,600
8895,170,80,80,160,320,0,810
8896,210,100,40,80,160,0,590
8897,170,80,120,0,0,0,370
8898,200,80,40,80,160,0,560
8899,240,80,120,80,160,0,680
8900,210,100,120,160,320,0,910
8901,170,140,120,80,160,320,990
8902,160,100,120,240,160,0,780
8903,210,200,160,160,320,0,1050
8904,190,60,40,80,0,0,370
8905,150,100,80,80,160,0,570
8906,180,140,120,80,160,0,680
8907,160,80,40,80,160,0,520
8908,160,120,120,160,0,0,560
8909,200,100,40,0,0,0,340
8910,220,200,200,160,160,0,940
8911,230,100,120,80,0,0,530
8912,230,120,40,0,0,0,390
8913,220,140,80,80,0,0,520
8914,220,100,80,80,0,0,480
8915,200,200,120,80,0,0,600
8916,230,140,120,80,160,320,1050
8917,200,100,120,80,160,0,660
8918,170,80,40,80,160,0,530
8919,190,160,200,240,320,320,1430
8920,160,100,80,0,0,0,340
8921,210,60,40,80,160,0,550
8922,200,120,160,240,160,0,880
8923,160,160,160,240,160,0,880
8924,190,160,120,160,160,0,790
8925,210,120,120,160,160,0,770
8926,210,160,160,240,320,320,1410
8927,170,140,120,80,160,320,990
8928,160,100,120,160,320,320,1180
8929,180,100,160,240,160,0,840
8930,200,140,160,80,160,0,740
8931,230,180,80,80,160,0,730
8932,180,180,80,80,160,0,680
8933,150,100,80,0,0,0,330
8934,210,160,120,80,160,0,730
8935,210,160,120,80,160,320,1050
8936,220,80,120,160,160,320,1060
8937,170,80,160,80,0,0,490
8938,200,80,120,80,160,0,640
8939,200,120,160,80,0,0,560
8940,210,160,160,160,320,0,1010
8941,200,140,120,0,0,0,460
8942,210,200,80,160,0,0,650
8943,160,100,80,80,160,0,580
8944,210,120,80,0,0,0,410
8945,210,120,80,80,160,0,650
8946,190,60,40,0,0,0,290
8947,180,140,200,160,0,0,680
8948,230,140,80,80,160,0,690
8949,190,60,120,80,160,0,610
8950,170,140,120,160,160,0,750
8951,190,80,40,0,0,0,310
8952,210,160,120,80,160,0,730
8953,220,80,80,160,160,0,700
8954,200,80,40,80,160,0,560
8955,200,120,120,160,160,0,760
8956,210,120,80,80,160,0,650
8957,170,120,80,80,160,0,610
8958,230,100,120,160,320,0,930
8959,170,100,80,0,0,0,350
8960,190,100,120,80,0,0,490
8961,170,120,160,160,160,320,1090
8962,190,140,80,80,160,0,650
8963,200,160,120,160,0,0,640
8964,200,80,120,80,0,0,480
8965,170,120,80,80,0,0,450
8966,200,100,40,0,0,0,340
8967,170,140,40,0,0,0,350
8968,190,160,160,0,0,0,510
8969,180,120,40,0,0,0,340
8970,190,140,40,80,0,0,450
8971,210,180,160,80,0,0,630
8972,220,140,160,160,160,0,840
8973,180,140,120,80,160,0,680
8974,190,120,40,80,0,0,430
8975,190,140,200,80,160,0,770
8976,180,160,160,80,160,320,1060
8977,210,180,200,160,160,0,910
8978,210,160,120,80,160,0,730
8979,190,100,160,240,0,0,690
8980,210,140,80,80,160,0,670
8981,200,140,80,0,0,0,420
8982,190,80,80,160,160,0,670
8983,190,160,120,160,160,0,790
8984,200,120,80,80,0,0,480
8985,180,160,200,160,160,320,1180
8986,200,180,80,80,160,320,1020
8987,210,160,160,0,0,0,530
8988,220,140,160,80,0,0,600
8989,150,120,120,80,0,0,470
8990,200,100,160,160,0,0,620
8991,190,120,120,160,160,0,750
8992,160,60,120,80,160,0,580
8993,210,160,160,160,0,0,690
8994,170,160,80,80,160,320,970
8995,210,140,80,80,0,0,510
8996,200,80,40,80,160,0,560
8997,190,140,80,160,160,320,1050
8998,200,100,80,80,160,0,620
8999,190,120,120,160,0,0,590
9000,180,140,160,160,160,320,1120
9001,220,140,120,80,0,0,560
9002,240,140,80,80,160,0,700
9003,180,140,160,160,160,320,1120
9004,180,100,120,80,160,0,640
9005,210,160,200,240,160,320,1290
9006,200,160,120,80,0,0,560
9007,190,140,40,0,0,0,370
9008,210,160,120,160,320,0,970
9009,200,200,200,160,0,0,760
9010,190,100,80,0,0,0,370
9011,200,80,120,80,160,0,640
9012,200,120,160,160,320,320,1280
9013,180,120,160,240,160,0,860
9014,210,120,160,80,160,0,730
9015,210,100,160,80,160,0,710
9016,200,120,80,0,0,0,400
9017,170,140,80,80,160,320,950
9018,220,120,120,80,0,0,540
9019,180,100,120,0,0,0,400
9020,200,140,120,0,0,0,460
9021,200,100,40,80,160,0,580
9022,150,120,80,80,160,320,910
9023,190,100,120,160,320,0,890
9024,200,140,160,160,320,320,1300
9025,180,160,120,160,160,0,780
9026,210,120,80,80,160,320,970
9027,250,80,80,0,0,0,410
9028,170,80,80,80,160,0,570
9029,220,120,40,80,160,0,620
9030,200,160,80,0,0,0,440
9031,180,140,80,0,0,0,400
9032,180,180,200,160,0,0,720
9033,220,120,0,0,0,0,340
9034,150,160,80,160,0,0,550
9035,190,140,160,160,160,0,810
9036,230,140,40,80,0,0,490
9037,240,120,80,0,0,0,440
9038,200,140,160,160,320,0,980
9039,210,60,80,80,0,0,430
9040,210,160,120,160,160,0,810
9041,210,180,120,80,160,0,750
9042,180,60,40,80,160,0,520
9043,200,160,80,80,160,0,680
9044,210,120,80,80,0,0,490
9045,220,80,80,80,160,0,620
9046,190,140,160,80,160,320,1050
9047,150,160,160,160,0,0,630
9048,210,140,80,80,160,0,670
9049,230,120,200,160,0,0,710
9050,210,120,40,80,160,0,610
9051,220,140,120,80,160,0,720
9052,200,120,80,160,160,0,720
9053,190,100,80,80,0,0,450
9054,200,120,120,80,160,320,1000
9055,160,60,80,160,0,0,460
9056,240,120,80,80,160,0,680
9057,200,100,80,80,160,0,620
9058,170,160,120,160,160,0,770
9059,170,100,120,0,0,0,390
9060,200,120,160,0,0,0,480
9061,240,100,80,80,160,0,660
9062,220,160,160,240,160,0,940
9063,170,160,80,0,0,0,410
9064,210,160,120,160,160,0,810
9065,190,160,200,160,160,0,870
9066,190,100,80,80,160,320,930
9067,170,120,120,80,160,0,650
9068,230,140,160,80,160,0,770
9069,230,160,160,160,160,0,870
9070,210,180,160,160,160,0,870
9071,180,140,120,160,160,0,760
9072,230,120,120,80,0,0,550
9073,230,160,200,80,0,0,670
9074,160,120,80,160,160,320,1000
9075,190,120,80,160,160,0,710
9076,190,120,120,80,0,0,510
9077,220,120,120,160,320,0,940
9078,190,120,120,80,160,320,990
9079,170,120,160,160,160,0,770
9080,140,140,160,160,320,0,920
9081,180,100,120,80,0,0,480
9082,200,160,80,0,0,0,440
9083,200,160,80,0,0,0,440
9084,190,80,80,0,0,0,350
9085,190,100,120,80,160,0,650
9086,200,140,120,160,160,0,780
9087,160,80,80,80,160,0,560
9088,170,60,80,80,0,0,390
9089,200,120,40,0,0,0,360
9090,210,180,160,240,0,0,790
9091,190,180,200,160,160,0,890
9092,180,80,40,80,160,320,860
9093,200,100,80,80,0,0,460
9094,180,180,120,80,160,0,720
9095,180,100,120,80,160,0,640
9096,190,160,120,160,160,0,790
9097,230,120,80,0,0,0,430
9098,210,100,80,160,320,0,870
9099,210,60,80,80,160,320,910
9100,170,160,160,80,160,0,730
9101,150,100,80,0,0,0,330
9102,220,140,160,80,160,320,1080
9103,180,120,80,0,0,0,380
9104,170,120,80,80,160,0,610
9105,190,120,80,80,160,0,630
9106,180,180,120,80,160,0,720
9107,160,140,80,160,320,0,860
9108,180,80,40,0,0,0,300
9109,200,80,40,0,0,0,320
9110,170,100,40,80,160,0,550
9111,170,160,80,160,160,0,730
9112,230,160,40,80,0,0,510
9113,170,160,80,80,160,0,650
9114,220,140,80,80,0,0,520
9115,150,100,120,160,0,0,530
9116,200,180,160,240,160,0,940
9117,230,140,160,80,160,0,770
9118,220,160,120,160,160,0,820
9119,180,100,80,160,160,0,680
9120,190,100,40,0,0,0,330
9121,190,160,120,80,160,0,710
9122,210,80,80,160,160,0,690
9123,200,160,80,80,160,0,680
9124,210,120,120,80,160,0,690
9125,210,100,80,80,160,0,630
9126,180,140,120,80,160,0,680
9127,160,100,80,0,0,0,340
9128,230,140,120,80,160,0,730
9129,210,100,120,160,160,0,750
9130,190,80,120,80,160,320,950
9131,170,120,0,0,0,0,290
9132,220,120,120,160,160,0,780
9133,180,100,0,0,0,0,280
9134,170,100,80,0,0,0,350
9135,220,160,80,80,0,0,540
9136,200,100,80,80,160,0,620
9137,190,120,80,160,160,0,710
9138,230,40,40,0,0,0,310
9139,210,180,80,80,160,0,710
9140,210,140,120,160,160,0,790
9141,200,160,120,80,0,0,560
9142,220,120,120,160,320,320,1260
9143,220,100,0,0,0,0,320
9144,220,120,120,160,160,0,780
9145,170,120,160,160,320,0,930
9146,210,100,40,0,0,0,350
9147,200,140,80,80,160,0,660
9148,170,100,120,160,160,320,1030
9149,220,160,120,80,160,0,740
9150,200,160,40,80,160,0,640
9151,170,120,80,80,0,0,450
9152,180,40,40,80,160,0,500
9153,260,140,80,80,0,0,560
9154,220,160,120,80,0,0,580
9155,160,120,120,80,160,0,640
9156,180,100,120,80,0,0,480
9157,220,100,80,80,0,0,480
9158,220,100,80,160,0,0,560
9159,230,160,120,80,160,0,750
9160,160,140,200,160,320,320,1300
9161,170,140,200,160,0,0,670
9162,190,160,200,80,0,0,630
9163,180,100,0,0,0,0,280
9164,190,80,40,80,160,0,550
9165,210,100,80,160,160,0,710
9166,180,120,200,160,320,0,980
9167,230,100,80,80,160,0,650
9168,190,60,40,0,0,0,290
9169,220,80,40,80,160,0,580
9170,220,80,80,0,0,0,380
9171,220,120,120,80,160,0,700
9172,200,160,40,80,160,0,640
9173,230,140,80,0,0,0,450
9174,140,100,80,160,160,0,640
9175,190,140,160,80,0,0,570
9176,200,80,40,80,0,0,400
9177,170,160,200,160,160,0,850
9178,200,120,80,160,320,0,880
9179,180,80,80,160,160,0,660
9180,190,160,160,160,160,320,1150
9181,180,80,80,80,160,320,900
9182,180,100,80,80,160,0,600
9183,180,100,160,160,160,0,760
9184,180,120,160,160,0,0,620
9185,220,140,40,80,160,320,960
9186,200,100,40,80,160,0,580
9187,220,140,120,80,160,0,720
9188,210,120,80,80,160,0,650
9189,210,140,120,80,0,0,550
9190,210,120,80,80,160,320,970
9191,260,100,120,80,160,0,720
9192,210,140,120,0,0,0,470
9193,180,100,120,80,160,320,960
9194,200,140,160,80,0,0,580
9195,190,160,160,160,160,0,830
9196,190,100,160,80,0,0,530
9197,170,140,200,240,160,0,910
9198,160,60,80,80,0,0,380
9199,200,100,0,0,0,0,300
9200,150,100,40,80,160,0,530
9201,210,180,160,160,160,0,870
9202,180,140,80,80,0,0,480
9203,200,140,160,80,160,0,740
9204,200,120,160,160,0,0,640
9205,210,120,200,160,160,0,850
9206,230,120,80,160,160,0,750
9207,170,100,120,0,0,0,390
9208,180,100,160,80,160,0,680
9209,190,120,120,80,0,0,510
9210,220,140,160,160,160,0,840
9211,250,80,40,0,0,0,370
9212,210,160,80,0,0,0,450
9213,210,140,80,160,0,0,590
9214,220,160,200,160,160,0,900
9215,230,140,120,80,160,0,730
9216,210,140,120,160,320,320,1270
9217,170,160,120,0,0,0,450
9218,190,140,120,160,160,320,1090
9219,190,120,40,0,0,0,350
9220,160,120,80,160,320,0,840
9221,270,220,200,160,160,0,1010
9222,200,60,40,80,0,0,380
9223,200,140,160,160,0,0,660
9224,140,60,120,80,0,0,400
9225,200,140,40,80,0,0,460
9226,180,120,120,160,160,0,740
9227,200,120,40,80,0,0,440
9228,240,160,120,0,0,0,520
9229,210,160,120,160,160,0,810
9230,180,100,40,80,0,0,400
9231,230,140,40,80,0,0,490
9232,190,120,80,0,0,0,390
9233,190,120,120,160,320,0,910
9234,140,140,160,240,160,0,840
9235,190,80,40,80,0,0,390
9236,230,140,120,160,320,0,970
9237,190,80,40,80,0,0,390
9238,210,120,40,0,0,0,370
9239,170,120,80,80,0,0,450
9240,190,100,80,0,0,0,370
9241,190,100,120,240,160,0,810
9242,220,120,120,80,160,0,700
9243,200,60,40,80,160,320,860
9244,200,140,160,240,160,0,900
9245,240,120,80,80,160,320,1000
9246,160,120,80,80,160,0,600
9247,190,140,80,160,320,320,1210
9248,190,60,40,80,0,0,370
9249,210,80,40,0,0,0,330
9250,190,120,160,160,160,320,1110
9251,200,140,120,0,0,0,460
9252,240,140,80,80,0,0,540
9253,170,100,120,160,0,0,550
9254,210,120,160,80,0,0,570
9255,190,120,160,160,0,0,630
9256,190,120,160,160,160,0,790
9257,210,120,40,0,0,0,370
9258,190,180,120,160,320,0,970
9259,210,120,120,0,0,0,450
9260,170,80,40,80,160,0,530
9261,190,160,40,80,160,0,630
9262,220,140,0,0,0,0,360
9263,160,100,120,160,0,0,540
9264,210,80,80,80,160,0,610
9265,190,140,120,80,160,0,690
9266,210,100,80,80,160,0,630
9267,170,120,80,160,160,0,690
9268,180,100,40,80,160,0,560
9269,210,80,120,160,160,320,1050
9270,200,160,120,80,160,0,720
9271,170,120,160,240,320,0,1010
9272,210,100,80,0,0,0,390
9273,180,140,160,240,160,0,880
9274,230,220,160,0,0,0,610
9275,190,140,160,160,160,0,810
9276,200,40,80,80,0,0,400
9277,210,100,80,80,0,0,470
9278,220,140,120,160,160,0,800
9279,200,120,80,0,0,0,400
9280,180,80,120,80,160,0,620
9281,190,100,120,160,0,0,570
9282,190,140,80,160,320,0,890
9283,190,160,120,160,160,0,790
9284,180,200,80,80,0,0,540
9285,170,80,80,80,160,0,570
9286,200,140,160,240,320,0,1060
9287,190,160,120,80,0,0,550
9288,200,100,40,0,0,0,340
9289,170,80,80,80,160,0,570
9290,210,140,40,80,160,0,630
9291,210,160,200,160,160,0,890
9292,190,80,80,160,160,0,670
9293,180,160,200,160,320,320,1340
9294,160,140,160,160,160,0,780
9295,190,160,120,160,320,320,1270
9296,180,140,160,160,160,0,800
9297,220,100,40,80,160,0,600
9298,210,140,40,0,0,0,390
9299,170,100,160,160,0,0,590
9300,170,120,80,160,160,0,690
9301,230,120,80,80,160,0,670
9302,200,140,120,160,160,0,780
9303,210,220,160,160,160,320,1230
9304,210,80,40,0,0,0,330
9305,170,160,160,240,160,0,890
9306,190,160,40,0,0,0,390
9307,210,80,120,160,0,0,570
9308,210,100,160,160,160,0,790
9309,140,140,120,80,160,0,640
9310,200,140,160,240,320,0,1060
9311,170,140,120,0,0,0,430
9312,190,60,40,80,0,0,370
9313,180,100,40,80,160,0,560
9314,160,140,80,160,320,320,1180
9315,210,220,160,160,0,0,750
9316,180,180,40,80,0,0,480
9317,180,140,40,80,0,0,440
9318,220,140,80,80,160,0,680
9319,240,140,160,160,160,0,860
9320,190,120,120,160,160,0,750
9321,190,60,40,0,0,0,290
9322,200,160,200,160,160,0,880
9323,180,140,40,80,160,320,920
9324,210,160,160,80,160,0,770
9325,180,80,120,80,160,0,620
9326,190,100,120,160,0,0,570
9327,180,140,80,160,320,320,1200
9328,170,140,80,80,160,0,630
9329,190,180,160,0,0,0,530
9330,180,120,160,160,160,0,780
9331,160,80,80,80,0,0,400
9332,200,100,80,80,0,0,460
9333,200,120,160,80,0,0,560
9334,210,120,80,160,160,320,1050
9335,160,120,120,160,0,0,560
9336,140,100,80,0,0,0,320
9337,160,120,80,160,160,0,680
9338,160,140,80,80,0,0,460
9339,150,80,80,0,0,0,310
9340,210,120,160,240,320,320,1370
9341,220,160,160,160,320,320,1340
9342,210,80,120,0,0,0,410
9343,200,20,40,80,160,0,500
9344,210,140,200,160,0,0,710
9345,190,160,160,80,160,320,1070
9346,240,120,80,80,160,0,680
9347,190,160,200,240,160,320,1270
9348,220,100,120,160,160,0,760
9349,180,80,80,80,160,0,580
9350,210,160,160,160,320,320,1330
9351,210,120,160,80,0,0,570
9352,250,140,80,80,0,0,550
9353,180,100,120,160,160,0,720
9354,240,160,120,160,320,0,1000
9355,180,80,80,80,0,0,420
9356,170,100,120,160,320,0,870
9357,170,100,40,0,0,0,310
9358,200,100,160,160,160,0,780
9359,200,160,160,80,160,0,760
9360,200,140,120,160,0,0,620
9361,210,80,80,80,160,0,610
9362,220,120,120,80,160,0,700
9363,220,140,80,80,160,320,1000
9364,220,120,80,160,160,0,740
9365,190,120,160,80,160,0,710
9366,200,80,160,160,160,0,760
9367,210,160,200,240,160,0,970
9368,210,160,160,80,160,0,770
9369,190,160,120,0,0,0,470
9370,210,80,80,80,0,0,450
9371,150,120,160,160,320,320,1230
9372,200,120,120,80,160,0,680
9373,200,80,120,160,160,0,720
9374,200,140,80,80,160,0,660
9375,190,160,80,160,160,320,1070
9376,190,120,120,160,160,0,750
9377,200,80,40,0,0,0,320
9378,210,160,120,80,160,320,1050
9379,230,140,80,80,0,0,530
9380,220,140,160,160,160,0,840
9381,220,160,120,160,0,0,660
9382,170,140,120,160,320,0,910
9383,220,160,40,80,160,0,660
9384,200,80,40,0,0,0,320
9385,200,160,200,160,160,0,880
9386,150,80,80,160,160,320,950
9387,220,80,80,160,160,0,700
9388,210,100,120,160,160,320,1070
9389,170,120,80,80,160,0,610
9390,180,100,120,160,320,320,1200
9391,210,100,120,80,0,0,510
9392,190,100,120,80,160,0,650
9393,220,100,40,80,160,0,600
9394,180,120,120,160,0,0,580
9395,190,120,80,80,0,0,470
9396,180,140,160,160,160,0,800
9397,190,140,80,80,160,0,650
9398,220,100,120,0,0,0,440
9399,190,140,80,80,0,0,490
9400,160,100,120,160,160,0,700
9401,160,120,80,80,0,0,440
9402,180,160,160,240,160,0,900
9403,200,100,120,80,160,0,660
9404,150,120,40,0,0,0,310
9405,180,80,120,160,160,320,1020
9406,220,120,80,80,0,0,500
9407,170,100,120,160,160,0,710
9408,180,120,120,0,0,0,420
9409,210,140,120,160,320,0,950
9410,230,160,80,80,160,0,710
9411,220,200,40,0,0,0,460
9412,190,160,0,0,0,0,350
9413,210,160,160,160,320,320,1330
9414,160,100,160,80,0,0,500
9415,190,100,80,80,160,320,930
9416,190,120,40,80,160,0,590
9417,220,160,120,0,0,0,500
9418,190,160,120,80,160,0,710
9419,210,160,160,160,160,0,850
9420,190,80,80,80,160,0,590
9421,200,140,160,80,160,320,1060
9422,140,140,120,80,160,320,960
9423,200,120,120,80,160,0,680
9424,160,40,40,0,0,0,240
9425,220,140,160,160,0,0,680
9426,220,160,120,160,320,0,980
9427,220,140,80,160,0,0,600
9428,180,120,120,160,160,320,1060
9429,160,80,40,0,0,0,280
9430,190,120,120,0,0,0,430
9431,200,160,120,240,160,0,880
9432,170,140,160,240,320,0,1030
9433,180,80,40,80,160,0,540
9434,190,120,120,160,160,0,750
9435,200,140,120,160,160,320,1100
9436,190,80,40,80,160,0,550
9437,230,140,120,80,160,0,730
9438,230,180,160,160,320,0,1050
9439,180,120,40,80,160,0,580
9440,200,100,80,80,0,0,460
9441,200,120,160,240,160,320,1200
9442,230,180,160,160,160,0,890
9443,160,40,40,80,160,0,480
9444,220,100,80,0,0,0,400
9445,200,140,40,80,160,0,620
9446,190,120,80,80,0,0,470
9447,210,80,40,0,0,0,330
9448,210,160,160,160,0,0,690
9449,160,80,80,0,0,0,320
9450,200,80,80,80,160,0,600
9451,200,200,120,160,160,0,840
9452,190,140,80,80,160,0,650
9453,240,140,120,0,0,0,500
9454,170,60,120,0,0,0,350
9455,160,100,40,80,0,0,380
9456,180,160,120,80,160,0,700
9457,200,140,200,240,160,0,940
9458,180,100,120,80,0,0,480
9459,200,120,40,80,160,0,600
9460,200,60,40,80,0,0,380
9461,220,80,80,80,160,0,620
9462,230,80,40,0,0,0,350
9463,210,120,160,80,160,0,730
9464,180,120,40,80,0,0,420
9465,190,120,80,0,0,0,390
9466,200,100,80,80,0,0,460
9467,180,100,80,160,160,0,680
9468,190,100,80,80,160,0,610
9469,150,120,80,80,160,0,590
9470,210,140,120,160,160,0,790
9471,230,120,80,80,0,0,510
9472,240,180,160,160,160,0,900
9473,190,100,120,160,320,0,890
9474,210,120,160,240,320,0,1050
9475,170,100,80,0,0,0,350
9476,220,100,80,160,320,320,1200
9477,170,100,160,160,320,0,910
9478,190,140,120,80,160,0,690
9479,190,120,120,80,160,320,990
9480,200,160,120,80,160,0,720
9481,190,100,80,80,160,0,610
9482,200,120,120,0,0,0,440
9483,210,140,80,0,0,0,430
9484,200,60,120,160,160,320,1020
9485,230,120,80,160,160,0,750
9486,170,120,120,160,160,0,730
9487,190,40,40,80,160,0,510
9488,200,140,120,160,0,0,620
9489,190,120,120,240,160,0,830
9490,170,60,80,80,160,320,870
9491,240,120,160,80,160,0,760
9492,220,180,160,80,160,0,800
9493,210,120,40,0,0,0,370
9494,190,160,40,80,160,0,630
9495,230,80,40,0,0,0,350
9496,240,100,80,160,160,0,740
9497,190,160,120,240,320,0,1030
9498,220,120,80,0,0,0,420
9499,170,80,80,0,0,0,330
9500,190,160,160,80,160,0,750
9501,200,80,40,80,0,0,400
9502,180,120,160,160,160,0,780
9503,190,100,80,160,160,320,1010
9504,180,120,80,160,160,0,700
9505,220,120,120,160,320,0,940
9506,190,120,120,80,160,0,670
9507,170,60,120,160,160,0,670
9508,200,80,80,160,160,0,680
9509,200,160,120,160,0,0,640
9510,190,100,80,80,160,0,610
9511,190,140,80,80,160,0,650
9512,190,100,80,80,160,320,930
9513,160,100,40,80,0,0,380
9514,180,160,160,160,160,320,1140
9515,170,120,80,160,160,0,690
9516,170,140,120,160,160,0,750
9517,200,140,160,80,0,0,580
9518,220,160,200,160,160,0,900
9519,220,80,80,80,0,0,460
9520,210,80,80,80,160,0,610
9521,180,160,120,80,160,0,700
9522,230,160,120,80,160,0,750
9523,190,100,80,80,0,0,450
9524,200,80,80,0,0,0,360
9525,190,100,160,160,160,0,770
9526,170,140,160,0,0,0,470
9527,230,160,120,240,160,0,910
9528,230,120,120,240,320,0,1030
9529,180,100,80,80,0,0,440
9530,190,100,120,160,0,0,570
9531,220,100,80,80,160,0,640
9532,180,120,40,80,0,0,420
9533,230,100,80,0,0,0,410
9534,200,100,120,80,0,0,500
9535,210,160,200,160,320,0,1050
9536,190,140,120,240,160,0,850
9537,210,160,200,80,160,0,810
9538,180,120,80,0,0,0,380
9539,210,100,40,80,160,0,590
9540,190,100,80,80,160,320,930
9541,180,80,80,80,0,0,420
9542,180,160,80,0,0,0,420
9543,210,120,80,80,0,0,490
9544,210,160,160,80,0,0,610
9545,190,80,160,160,0,0,590
9546,170,120,40,0,0,0,330
9547,190,180,120,160,160,0,810
9548,190,160,80,80,160,320,990
9549,170,120,160,160,160,0,770
9550,190,140,80,80,0,0,490
9551,150,100,160,160,160,0,730
9552,200,120,0,0,0,0,320
9553,230,200,160,160,160,320,1230
9554,220,160,120,160,320,0,980
9555,240,100,80,80,160,0,660
9556,210,160,200,160,160,0,890
9557,240,140,40,80,0,0,500
9558,180,120,80,0,0,0,380
9559,180,120,80,80,160,320,940
9560,170,100,120,240,320,320,1270
9561,220,140,80,160,320,0,920
9562,250,180,160,160,0,0,750
9563,180,100,80,160,320,320,1160
9564,180,100,120,160,320,320,1200
9565,200,180,200,240,160,0,980
9566,190,60,40,80,0,0,370
9567,200,100,120,0,0,0,420
9568,210,140,40,0,0,0,390
9569,140,120,160,240,0,0,660
9570,200,100,80,80,0,0,460
9571,240,160,120,80,0,0,600
9572,180,160,160,80,160,0,740
9573,190,140,200,240,160,0,930
9574,180,140,160,160,160,320,1120
9575,170,100,40,80,0,0,390
9576,210,80,160,80,160,0,690
9577,150,180,120,160,160,0,770
9578,170,100,40,0,0,0,310
9579,160,180,120,160,160,0,780
9580,200,100,80,80,0,0,460
9581,240,120,120,240,160,320,1200
9582,170,140,160,240,320,0,1030
9583,170,140,120,160,320,320,1230
9584,170,80,120,80,0,0,450
9585,210,160,120,160,0,0,650
9586,190,160,200,80,160,0,790
9587,170,80,120,80,160,320,930
9588,180,100,160,160,320,320,1240
9589,200,120,80,160,160,0,720
9590,240,180,160,80,160,0,820
9591,220,120,120,160,0,0,620
9592,180,120,80,0,0,0,380
9593,200,180,160,160,160,0,860
9594,200,100,80,0,0,0,380
9595,220,160,40,80,160,0,660
9596,220,100,40,0,0,0,360
9597,180,80,120,160,0,0,540
9598,220,220,200,160,0,0,800
9599,190,80,0,0,0,0,270
9600,220,180,120,160,0,0,680
9601,210,160,0,0,0,0,370
9602,190,80,80,80,0,0,430
9603,200,140,160,80,0,0,580
9604,210,100,80,80,160,0,630
9605,190,140,40,80,160,320,930
9606,160,140,120,160,160,0,740
9607,140,20,40,80,0,0,280
9608,220,80,80,160,160,0,700
9609,180,140,80,80,0,0,480
9610,200,100,120,80,160,0,660
9611,190,60,120,80,160,0,610
9612,190,140,160,80,0,0,570
9613,220,100,80,160,320,320,1200
9614,160,100,160,0,0,0,420
9615,170,120,80,80,0,0,450
9616,190,120,160,240,160,0,870
9617,170,120,120,80,160,0,650
9618,220,160,120,160,320,0,980
9619,230,160,120,0,0,0,510
9620,200,140,80,0,0,0,420
9621,190,100,80,80,160,320,930
9622,200,120,120,160,0,0,600
9623,180,200,200,240,160,0,980
9624,200,120,80,80,160,0,640
9625,220,60,40,80,0,0,400
9626,240,160,120,160,160,0,840
9627,160,60,0,0,0,0,220
9628,180,60,80,160,320,0,800
9629,220,140,120,0,0,0,480
9630,200,60,40,80,160,0,540
9631,170,100,120,160,160,0,710
9632,250,140,80,0,0,0,470
9633,200,140,120,0,0,0,460
9634,210,160,200,80,0,0,650
9635,200,120,120,80,160,0,680
9636,220,120,160,240,0,0,740
9637,240,160,120,160,320,0,1000
9638,190,120,160,160,160,0,790
9639,220,160,120,160,160,320,1140
9640,190,60,80,80,160,0,570
9641,190,80,80,160,160,0,670
9642,180,100,80,0,0,0,360
9643,230,120,120,160,160,0,790
9644,180,120,80,80,0,0,460
9645,210,200,200,240,160,0,1010
9646,190,140,120,160,160,320,1090
9647,220,140,120,80,160,0,720
9648,200,120,120,80,160,320,1000
9649,180,140,160,240,320,320,1360
9650,220,120,120,80,160,0,700
9651,210,160,120,80,0,0,570
9652,210,140,200,0,0,0,550
9653,220,160,120,0,0,0,500
9654,190,140,120,160,320,0,930
9655,190,140,120,160,160,0,770
9656,200,100,40,0,0,0,340
9657,220,80,80,80,0,0,460
9658,250,120,120,160,160,320,1130
9659,200,140,120,240,320,0,1020
9660,270,100,120,80,0,0,570
9661,200,200,200,160,160,0,920
9662,160,100,80,80,160,0,580
9663,180,140,200,240,320,0,1080
9664,160,40,80,80,0,0,360
9665,200,100,80,160,160,320,1020
9666,200,100,80,0,0,0,380
9667,200,120,160,160,160,0,800
9668,190,80,80,80,160,320,910
9669,200,160,120,80,160,0,720
9670,210,100,80,80,0,0,470
9671,170,80,120,160,160,320,1010
9672,200,140,160,80,160,0,740
9673,220,140,120,240,0,0,720
9674,210,160,120,80,160,0,730
9675,210,80,40,0,0,0,330
9676,190,80,80,80,0,0,430
9677,190,80,80,0,0,0,350
9678,200,100,120,80,0,0,500
9679,200,140,0,0,0,0,340
9680,190,120,80,80,160,0,630
9681,180,160,160,160,160,0,820
9682,200,80,120,80,160,0,640
9683,160,160,160,80,160,0,720
9684,220,100,80,80,160,0,640
9685,210,140,200,160,160,0,870
9686,210,100,80,160,160,0,710
9687,160,140,80,80,0,0,460
9688,190,180,80,160,160,0,770
9689,220,140,120,160,320,320,1280
9690,230,140,40,80,160,320,970
9691,160,140,40,0,0,0,340
9692,160,100,120,160,320,0,860
9693,200,160,240,240,320,320,1480
9694,210,140,80,80,160,0,670
9695,180,140,80,80,0,0,480
9696,230,140,80,0,0,0,450
9697,170,140,160,80,0,0,550
9698,170,80,40,0,0,0,290
9699,200,60,80,80,160,0,580
9700,250,100,80,160,160,0,750
9701,210,160,80,80,0,0,530
9702,200,80,80,160,320,0,840
9703,190,100,200,80,160,0,730
9704,210,140,120,80,0,0,550
9705,160,140,160,160,0,0,620
9706,200,100,120,80,160,320,980
9707,190,160,120,160,160,0,790
9708,200,120,160,240,320,320,1360
9709,220,160,160,160,0,0,700
9710,170,120,80,80,0,0,450
9711,180,80,80,80,0,0,420
9712,220,120,160,160,0,0,660
9713,220,120,80,160,0,0,580
9714,220,40,40,0,0,0,300
9715,200,140,160,240,160,0,900
9716,200,140,160,160,320,320,1300
9717,190,160,200,160,160,0,870
9718,200,180,80,80,0,0,540
9719,210,180,120,240,320,0,1070
9720,170,80,80,80,160,0,570
9721,200,100,120,160,320,320,1220
9722,210,140,80,80,0,0,510
9723,160,140,120,80,160,0,660
9724,220,180,160,160,0,0,720
9725,200,100,120,160,160,0,740
9726,160,120,80,80,160,0,600
9727,190,140,40,80,160,0,610
9728,180,80,40,80,160,0,540
9729,180,100,80,160,0,0,520
9730,180,140,160,160,160,0,800
9731,190,80,40,80,160,0,550
9732,190,120,160,160,160,0,790
9733,160,140,200,240,160,0,900
9734,210,100,120,160,320,320,1230
9735,180,60,120,80,160,320,920
9736,210,160,120,80,0,0,570
9737,220,120,80,80,0,0,500
9738,220,140,120,0,0,0,480
9739,210,140,80,160,160,0,750
9740,220,140,120,80,160,0,720
9741,150,120,160,160,160,0,750
9742,190,100,80,160,160,320,1010
9743,230,100,80,80,0,0,490
9744,180,120,120,160,160,0,740
9745,190,120,80,160,160,0,710
9746,230,100,80,80,0,0,490
9747,210,120,80,0,0,0,410
9748,240,80,120,80,160,0,680
9749,180,180,120,80,0,0,560
9750,180,100,120,240,320,0,960
9751,160,100,80,0,0,0,340
9752,230,140,160,160,320,0,1010
9753,190,120,160,160,320,0,950
9754,240,180,80,0,0,0,500
9755,200,120,40,80,0,0,440
9756,180,140,160,160,0,0,640
9757,230,160,120,0,0,0,510
9758,260,100,40,80,160,320,960
9759,190,100,40,0,0,0,330
9760,210,160,80,80,0,0,530
9761,170,100,120,160,160,0,710
9762,210,120,80,160,320,0,890
9763,190,160,120,160,160,320,1110
9764,210,80,120,160,160,320,1050
9765,210,120,80,80,160,0,650
9766,200,120,80,0,0,0,400
9767,200,120,160,160,320,0,960
9768,230,140,80,80,0,0,530
9769,230,140,120,160,160,0,810
9770,170,140,120,160,160,0,750
9771,190,100,120,80,160,0,650
9772,200,60,40,80,160,0,540
9773,220,160,200,80,0,0,660
9774,220,140,120,80,0,0,560
9775,230,160,80,160,160,0,790
9776,180,140,200,80,160,0,760
9777,200,140,120,160,160,0,780
9778,240,120,40,0,0,0,400
9779,230,80,80,160,320,0,870
9780,170,120,80,80,160,0,610
9781,230,120,120,80,0,0,550
9782,190,100,80,160,0,0,530
9783,190,100,120,80,0,0,490
9784,210,160,120,80,160,0,730
9785,210,160,120,160,160,0,810
9786,210,120,200,240,320,0,1090
9787,200,140,120,0,0,0,460
9788,190,120,40,0,0,0,350
9789,220,140,120,0,0,0,480
9790,190,120,80,80,160,320,950
9791,170,140,200,240,160,0,910
9792,200,120,120,160,160,320,1080
9793,220,160,40,80,0,0,500
9794,230,140,120,160,0,0,650
9795,220,100,160,0,0,0,480
9796,190,140,120,160,320,0,930
9797,200,160,160,160,0,0,680
9798,170,140,160,80,0,0,550
9799,220,160,160,160,320,320,1340
9800,170,120,160,80,160,0,690
9801,220,140,160,80,160,0,760
9802,170,120,120,0,0,0,410
9803,150,100,160,160,0,0,570
9804,180,80,40,0,0,0,300
9805,200,160,160,80,0,0,600
9806,190,100,120,80,160,0,650
9807,200,100,40,80,160,0,580
9808,140,60,80,0,0,0,280
9809,190,160,40,0,0,0,390
9810,180,100,80,0,0,0,360
9811,180,100,80,160,160,0,680
9812,220,80,40,80,160,0,580
9813,180,100,40,80,0,0,400
9814,160,100,120,0,0,0,380
9815,180,100,80,80,0,0,440
9816,220,160,120,0,0,0,500
9817,190,80,120,240,320,0,950
9818,200,120,120,160,320,0,920
9819,200,120,160,160,160,0,800
9820,200,120,80,160,320,0,880
9821,160,100,120,80,160,320,940
9822,200,160,160,160,0,0,680
9823,230,120,40,80,160,0,630
9824,220,180,160,160,160,0,880
9825,220,140,80,80,160,0,680
9826,230,160,80,80,160,0,710
9827,210,160,160,160,320,320,1330
9828,210,100,80,80,0,0,470
9829,140,140,80,80,160,0,600
9830,210,140,40,0,0,0,390
9831,220,80,80,80,160,0,620
9832,200,200,240,160,0,0,800
9833,250,160,0,0,0,0,410
9834,200,160,80,80,160,0,680
9835,220,120,40,0,0,0,380
9836,240,160,160,160,160,0,880
9837,180,100,80,80,0,0,440
9838,180,120,120,240,160,0,820
9839,190,100,120,80,160,0,650
9840,180,60,80,160,160,0,640
9841,190,80,80,80,0,0,430
9842,170,100,160,160,320,320,1230
9843,200,100,120,160,320,320,1220
9844,190,100,40,80,160,0,570
9845,220,80,40,0,0,0,340
9846,190,140,120,80,160,0,690
9847,210,80,120,0,0,0,410
9848,210,160,120,80,0,0,570
9849,180,160,80,80,160,0,660
9850,220,140,80,80,160,0,680
9851,250,160,80,160,160,320,1130
9852,210,160,120,80,0,0,570
9853,160,120,80,80,0,0,440
9854,230,140,120,160,160,0,810
9855,180,140,160,240,0,0,720
9856,180,120,160,80,160,0,700
9857,170,80,120,160,0,0,530
9858,220,120,120,80,160,320,1020
9859,210,140,80,80,160,0,670
9860,220,100,80,80,160,0,640
9861,190,100,40,80,0,0,410
9862,200,60,80,0,0,0,340
9863,170,80,40,80,160,0,530
9864,160,120,40,80,160,0,560
9865,150,120,40,80,0,0,390
9866,210,100,120,160,0,0,590
9867,240,160,120,80,160,0,760
9868,220,120,80,80,160,0,660
9869,190,100,40,0,0,0,330
9870,170,140,80,160,160,0,710
9871,190,160,160,160,0,0,670
9872,190,120,40,80,160,0,590
9873,220,120,40,80,160,320,940
9874,210,140,160,240,160,0,910
9875,180,120,120,160,0,0,580
9876,180,100,120,240,320,0,960
9877,180,140,160,80,160,320,1040
9878,180,140,200,160,320,0,1000
9879,200,100,160,80,160,320,1020
9880,200,60,0,0,0,0,260
9881,220,80,40,0,0,0,340
9882,180,120,160,160,160,0,780
9883,220,160,120,0,0,0,500
9884,230,140,40,80,160,320,970
9885,190,120,80,80,160,320,950
9886,220,80,80,0,0,0,380
9887,220,100,40,0,0,0,360
9888,180,80,120,80,160,0,620
9889,200,140,160,160,160,0,820
9890,200,100,120,80,160,0,660
9891,180,140,160,160,160,0,800
9892,230,140,40,0,0,0,410
9893,170,100,80,160,160,0,670
9894,230,160,40,80,160,0,670
9895,190,120,80,80,160,0,630
9896,210,140,160,80,160,320,1070
9897,210,180,160,80,0,0,630
9898,170,160,120,80,0,0,530
9899,230,140,120,80,0,0,570
9900,180,100,80,0,0,0,360
9901,200,100,80,160,160,320,1020
9902,220,100,40,0,0,0,360
9903,190,100,160,160,160,0,770
9904,210,120,120,80,160,0,690
9905,160,120,120,160,320,0,880
9906,190,80,40,0,0,0,310
9907,180,180,0,0,0,0,360
9908,190,120,80,80,0,0,470
9909,200,140,80,80,160,0,660
9910,210,100,120,240,160,0,830
9911,150,160,80,0,0,0,390
9912,200,160,160,160,160,0,840
9913,170,100,160,80,0,0,510
9914,200,120,200,160,160,0,840
9915,210,160,40,80,160,0,650
9916,220,60,40,80,160,0,560
9917,200,100,80,80,160,0,620
9918,200,100,80,0,0,0,380
9919,210,80,80,80,160,0,610
9920,190,120,80,80,160,0,630
9921,220,100,80,80,160,0,640
9922,160,120,80,160,160,320,1000
9923,180,100,80,80,160,0,600
9924,180,180,120,160,160,0,800
9925,180,140,80,160,160,320,1040
9926,170,100,80,80,0,0,430
9927,140,100,80,0,0,0,320
9928,190,80,120,160,160,0,710
9929,220,100,80,80,0,0,480
9930,130,100,160,240,160,0,790
9931,200,120,80,80,0,0,480
9932,210,140,120,80,0,0,550
9933,200,140,160,240,320,320,1380
9934,200,100,40,80,160,320,900
9935,220,140,80,160,0,0,600
9936,180,200,240,160,320,0,1100
9937,220,160,200,80,0,0,660
9938,180,120,80,80,160,320,940
9939,200,140,120,0,0,0,460
9940,200,120,160,160,160,0,800
9941,210,140,120,80,160,320,1030
9942,150,80,80,0,0,0,310
9943,180,100,120,240,160,0,800
9944,180,100,80,80,160,0,600
9945,230,180,160,80,160,0,810
9946,210,160,120,0,0,0,490
9947,180,160,160,80,160,320,1060
9948,190,140,200,160,160,0,850
9949,190,120,40,80,160,0,590
9950,230,180,80,80,160,0,730
9951,210,140,160,160,320,0,990
9952,220,80,80,80,160,0,620
9953,160,100,160,80,0,0,500
9954,160,100,80,80,160,0,580
9955,240,140,120,80,160,0,740
9956,240,120,40,0,0,0,400
9957,230,160,120,80,160,0,750
9958,160,120,40,80,160,0,560
9959,210,140,120,160,160,0,790
9960,180,140,80,80,160,0,640
9961,220,200,160,80,160,0,820
9962,190,80,80,80,0,0,430
9963,220,80,80,80,0,0,460
9964,190,160,40,0,0,0,390
9965,220,100,80,0,0,0,400
9966,200,180,200,160,0,0,740
9967,210,160,120,160,0,0,650
9968,200,120,80,0,0,0,400
9969,210,100,80,80,160,0,630
9970,180,120,40,80,0,0,420
9971,140,60,120,80,0,0,400
9972,180,140,120,160,0,0,600
9973,210,100,80,160,160,0,710
9974,240,140,120,80,160,0,740
9975,150,180,200,160,160,0,850
9976,200,100,80,80,160,0,620
9977,190,100,40,80,160,0,570
9978,220,180,200,80,0,0,680
9979,200,140,120,160,160,0,780
9980,180,120,120,160,320,320,1220
9981,220,120,160,240,160,0,900
9982,190,100,160,160,320,320,1250
9983,210,120,80,80,160,320,970
9984,200,160,80,80,160,0,680
9985,200,180,160,80,160,320,1100
9986,240,180,160,80,160,320,1140
9987,220,180,120,80,160,0,760
9988,190,80,80,160,320,0,830
9989,170,80,40,0,0,0,290
9990,240,100,80,80,160,0,660
9991,170,120,160,160,320,0,930
9992,180,140,120,0,0,0,440
9993,210,100,80,80,160,320,950
9994,210,100,120,160,160,0,750
9995,260,120,120,160,160,0,820
9996,180,80,40,0,0,0,300
9997,170,60,80,80,0,0,390
9998,200,120,80,160,0,0,560
9999,200,140,120,80,160,0,700
10000,160,120,80,80,160,0,600
10001,210,160,160,240,320,0,1090
10002,180,120,160,160,160,0,780
10003,180,100,80,0,0,0,360
10004,170,160,160,240,160,0,890
10005,200,200,200,160,0,0,760
10006,200,120,160,80,160,0,720
10007,190,140,80,0,0,0,410
10008,220,60,40,0,0,0,320
10009,200,80,80,160,160,0,680
10010,230,140,120,80,0,0,570
10011,200,160,40,0,0,0,400
10012,230,160,160,240,0,0,790
10013,200,100,80,80,160,0,620
10014,180,140,200,160,320,320,1320
10015,170,160,80,0,0,0,410
10016,210,100,120,0,0,0,430
10017,180,160,160,80,0,0,580
10018,210,120,80,0,0,0,410
10019,180,100,80,80,160,0,600
10020,220,200,200,0,0,0,620
10021,170,80,80,80,160,0,570
10022,220,160,80,80,0,0,540
10023,210,140,160,240,320,0,1070
10024,170,80,120,80,0,0,450
10025,180,120,120,0,0,0,420
10026,230,60,40,80,160,320,890
10027,220,140,80,160,320,0,920
10028,180,140,160,240,160,0,880
10029,240,120,80,0,0,0,440
10030,220,160,120,80,160,0,740
10031,180,120,40,0,0,0,340
10032,180,60,0,0,0,0,240
10033,210,160,120,80,0,0,570
10034,210,100,80,0,0,0,390
10035,220,120,80,160,160,320,1060
10036,170,120,80,0,0,0,370
10037,210,160,160,80,0,0,610
10038,210,180,200,160,320,320,1390
10039,200,140,40,80,160,0,620
10040,180,100,40,80,0,0,400
10041,200,120,120,80,160,0,680
10042,200,100,40,80,0,0,420
10043,140,100,80,0,0,0,320
10044,220,100,80,80,160,320,960
10045,220,140,120,80,0,0,560
10046,180,140,120,160,320,320,1240
10047,190,120,120,160,320,0,910
10048,220,120,40,0,0,0,380
10049,200,120,160,160,160,0,800
10050,220,100,80,80,0,0,480
10051,200,140,120,160,160,0,780
10052,200,140,80,160,160,0,740
10053,180,100,120,80,0,0,480
10054,170,100,120,160,160,0,710
10055,180,100,40,80,0,0,400
10056,190,160,160,240,160,320,1230
10057,250,160,120,160,320,320,1330
10058,200,80,120,160,160,0,720
10059,230,180,200,160,320,320,1410
10060,180,120,120,160,0,0,580
10061,180,140,120,160,0,0,600
10062,180,140,80,160,160,320,1040
10063,200,100,80,160,160,320,1020
10064,190,200,80,80,160,0,710
10065,200,140,200,80,0,0,620
10066,210,100,40,0,0,0,350
10067,210,140,80,80,0,0,510
10068,190,180,80,0,0,0,450
10069,170,100,80,80,160,0,590
10070,200,140,120,80,160,0,700
10071,190,120,80,0,0,0,390
10072,180,100,160,160,0,0,600
10073,190,80,80,160,160,0,670
10074,170,80,80,0,0,0,330
10075,200,120,80,160,160,0,720
10076,190,180,120,160,0,0,650
10077,200,120,80,160,160,0,720
10078,190,140,80,80,160,0,650
10079,210,120,0,0,0,0,330
10080,170,140,160,160,160,0,790
10081,250,80,40,80,160,0,610
10082,190,80,120,80,0,0,470
10083,210,80,40,80,0,0,410
10084,250,120,120,160,0,0,650
10085,200,100,120,0,0,0,420
10086,200,120,80,0,0,0,400
10087,160,120,160,160,160,320,1080
10088,230,120,80,80,0,0,510
10089,150,120,160,80,160,320,990
10090,150,100,40,0,0,0,290
10091,180,200,120,80,0,0,580
10092,190,120,80,0,0,0,390
10093,190,120,80,160,160,0,710
10094,230,180,80,80,0,0,570
10095,210,120,160,160,320,0,970
10096,180,120,160,160,0,0,620
10097,190,120,80,160,160,0,710
10098,190,100,40,80,160,0,570
10099,170,200,160,80,160,320,1090
10100,240,180,120,160,160,0,860
10101,200,120,120,80,0,0,520
10102,160,120,120,0,0,0,400
10103,150,120,80,160,160,0,670
10104,200,160,200,160,160,0,880
10105,200,140,80,0,0,0,420
10106,210,140,80,0,0,0,430
10107,180,120,40,80,160,0,580
10108,230,120,80,80,160,0,670
10109,180,80,120,80,160,0,620
10110,250,120,80,0,0,0,450
10111,190,160,160,80,0,0,590
10112,210,140,80,0,0,0,430
10113,190,80,80,80,0,0,430
10114,190,100,160,160,0,0,610
10115,190,60,120,80,160,0,610
10116,210,140,80,0,0,0,430
10117,200,100,120,80,0,0,500
10118,150,100,120,160,160,0,690
10119,200,200,160,160,160,0,880
10120,220,140,160,160,160,0,840
10121,180,40,40,0,0,0,260
10122,190,100,40,80,160,0,570
10123,210,120,80,0,0,0,410
10124,240,200,120,160,0,0,720
10125,200,200,160,160,0,0,720
10126,180,80,120,160,0,0,540
10127,170,140,120,160,160,0,750
10128,180,100,40,80,160,0,560
10129,180,80,40,0,0,0,300
10130,180,140,120,160,0,0,600
10131,190,100,120,160,0,0,570
10132,200,140,40,0,0,0,380
10133,210,100,80,80,160,0,630
10134,190,140,160,240,320,0,1050
10135,200,60,40,0,0,0,300
10136,230,180,160,160,160,0,890
10137,190,140,120,160,320,0,930
10138,170,120,160,160,0,0,610
10139,190,160,80,160,0,0,590
10140,180,80,120,160,160,0,700
10141,230,100,80,160,160,0,730
10142,170,120,80,160,160,0,690
10143,210,120,40,80,160,0,610
10144,200,120,120,80,0,0,520
10145,200,180,160,80,0,0,620
10146,220,120,120,80,0,0,540
10147,200,160,160,240,320,0,1080
10148,170,120,80,0,0,0,370
10149,230,140,80,80,160,0,690
10150,220,120,40,0,0,0,380
10151,180,120,80,0,0,0,380
10152,230,180,80,0,0,0,490
10153,210,180,80,80,160,0,710
10154,210,160,80,160,160,0,770
10155,170,120,120,0,0,0,410
10156,210,120,80,160,0,0,570
10157,190,100,120,160,320,0,890
10158,190,100,120,240,320,320,1290
10159,200,120,160,240,160,320,1200
10160,200,160,120,80,160,0,720
10161,160,100,40,80,160,0,540
10162,200,120,160,0,0,0,480
10163,230,180,120,160,160,0,850
10164,170,160,120,0,0,0,450
10165,190,120,80,80,0,0,470
10166,190,140,40,80,160,0,610
10167,200,160,200,160,0,0,720
10168,190,120,120,160,160,0,750
10169,210,80,40,80,160,320,890
10170,190,120,80,0,0,0,390
10171,220,140,80,80,0,0,520
10172,220,140,80,80,0,0,520
10173,250,180,160,160,160,0,910
10174,200,120,40,0,0,0,360
10175,160,20,40,80,160,0,460
10176,220,120,120,80,160,0,700
10177,220,160,200,160,160,0,900
10178,230,160,120,160,160,0,830
10179,190,140,200,160,0,0,690
10180,210,140,120,240,0,0,710
10181,150,180,120,160,0,0,610
10182,200,60,40,80,160,320,860
10183,220,140,80,80,160,0,680
10184,180,120,120,160,160,0,740
10185,190,120,80,0,0,0,390
10186,140,80,120,0,0,0,340
10187,220,160,80,80,0,0,540
10188,210,60,80,80,0,0,430
10189,220,100,120,80,160,320,1000
10190,180,120,40,0,0,0,340
10191,170,80,80,80,160,0,570
10192,230,80,80,0,0,0,390
10193,150,100,80,80,160,0,570
10194,210,100,120,160,320,0,910
10195,180,140,160,240,160,0,880
10196,220,100,40,0,0,0,360
10197,180,80,120,160,320,320,1180
10198,170,100,40,0,0,0,310
10199,190,140,120,160,320,0,930
10200,250,120,80,80,160,0,690
10201,190,120,160,160,160,0,790
10202,190,140,200,160,160,0,850
10203,200,120,40,80,160,0,600
10204,140,80,80,80,160,0,540
10205,220,100,80,80,0,0,480
10206,220,120,120,80,160,0,700
10207,210,160,160,160,160,0,850
10208,200,120,160,80,0,0,560
10209,230,140,160,240,160,0,930
10210,160,100,120,80,0,0,460
10211,180,120,120,80,160,0,660
10212,210,140,80,160,0,0,590
10213,200,140,40,0,0,0,380
10214,180,160,200,160,320,0,1020
10215,210,140,160,160,320,0,990
10216,180,120,160,0,0,0,460
10217,150,60,80,80,0,0,370
10218,200,140,80,160,160,0,740
10219,180,100,120,80,0,0,480
10220,190,120,80,80,160,0,630
10221,200,160,160,160,160,0,840
10222,220,160,40,0,0,0,420
10223,210,120,40,80,160,0,610
10224,180,100,40,80,160,0,560
10225,170,20,0,0,0,0,190
10226,220,160,80,160,320,320,1260
10227,200,80,80,80,160,320,920
10228,220,140,200,160,160,0,880
10229,210,180,80,160,160,0,790
10230,210,160,120,0,0,0,490
10231,180,140,120,160,160,0,760
10232,220,120,120,160,160,0,780
10233,210,140,120,80,0,0,550
10234,220,160,80,80,0,0,540
10235,200,80,80,80,160,0,600
10236,220,120,40,0,0,0,380
10237,240,120,200,160,320,0,1040
10238,210,140,40,0,0,0,390
10239,180,160,80,160,0,0,580
10240,200,80,80,80,160,0,600
10241,170,120,80,160,320,0,850
10242,170,80,40,0,0,0,290
10243,220,60,80,80,160,0,600
10244,200,80,40,0,0,0,320
10245,170,100,120,240,0,0,630
10246,170,120,120,240,320,0,970
10247,180,160,160,0,0,0,500
10248,200,80,120,80,160,320,960
10249,210,60,80,160,160,0,670
10250,210,80,120,160,160,320,1050
10251,230,140,80,80,0,0,530
10252,170,120,80,80,0,0,450
10253,180,140,200,240,160,0,920
10254,180,120,40,0,0,0,340
10255,230,120,40,80,0,0,470
10256,170,160,120,160,160,0,770
10257,190,120,80,160,320,320,1190
10258,260,120,80,0,0,0,460
10259,170,80,120,80,160,320,930
10260,190,120,120,0,0,0,430
10261,190,120,40,80,0,0,430
10262,170,140,160,160,160,0,790
10263,180,40,40,80,160,0,500
10264,220,120,80,160,160,320,1060
10265,170,120,160,160,160,0,770
10266,180,80,80,80,160,0,580
10267,230,180,0,0,0,0,410
10268,160,80,160,80,160,0,640
10269,220,160,120,160,160,320,1140
10270,180,160,80,80,0,0,500
10271,200,160,120,80,160,0,720
10272,170,120,80,80,160,320,930
10273,160,80,40,80,0,0,360
10274,200,40,40,80,160,0,520
10275,170,60,0,0,0,0,230
10276,200,140,120,80,0,0,540
10277,190,120,120,80,160,320,990
10278,210,160,120,0,0,0,490
10279,180,100,80,160,160,0,680
10280,170,120,40,0,0,0,330
10281,200,100,120,0,0,0,420
10282,270,160,160,80,160,0,830
10283,160,60,0,0,0,0,220
10284,210,100,120,160,320,0,910
10285,200,100,120,160,320,0,900
10286,160,60,80,160,160,0,620
10287,190,120,120,80,160,320,990
10288,190,120,120,160,0,0,590
10289,220,100,120,80,160,0,680
10290,180,140,160,80,0,0,560
10291,180,120,80,0,0,0,380
10292,220,160,200,80,160,0,820
10293,190,100,160,240,160,0,850
10294,190,80,120,80,0,0,470
10295,190,120,80,0,0,0,390
10296,190,100,120,80,0,0,490
10297,230,220,40,80,160,0,730
10298,230,120,80,0,0,0,430
10299,200,180,120,80,0,0,580
10300,200,160,120,160,160,320,1120
10301,220,100,40,80,160,0,600
10302,180,140,80,80,160,0,640
10303,160,140,40,0,0,0,340
10304,230,80,160,160,320,320,1270
10305,230,120,80,80,160,320,990
10306,230,140,120,0,0,0,490
10307,210,100,120,80,160,0,670
10308,190,80,120,80,160,320,950
10309,140,80,80,160,160,0,620
10310,190,140,80,160,160,0,730
10311,200,100,120,160,320,0,900
10312,220,80,80,160,320,0,860
10313,200,60,40,0,0,0,300
10314,180,100,80,80,160,0,600
10315,200,120,120,160,160,0,760
10316,170,20,0,0,0,0,190
10317,210,140,120,0,0,0,470
10318,240,100,80,80,0,0,500
10319,180,140,120,160,160,0,760
10320,230,180,240,240,160,0,1050
10321,210,160,200,160,160,0,890
10322,210,180,80,0,0,0,470
10323,200,160,160,160,320,320,1320
10324,230,160,160,80,0,0,630
10325,180,100,120,80,0,0,480
10326,180,80,80,160,160,0,660
10327,240,100,80,160,160,0,740
10328,170,120,80,80,160,0,610
10329,200,140,120,80,160,0,700
10330,220,100,120,160,160,320,1080
10331,170,160,160,160,320,0,970
10332,170,80,80,0,0,0,330
10333,190,100,120,80,160,0,650
10334,190,160,120,160,0,0,630
10335,220,120,80,80,160,0,660
10336,200,100,80,160,320,0,860
10337,180,160,160,160,0,0,660
10338,220,120,120,160,160,0,780
10339,180,100,80,160,320,0,840
10340,240,120,120,80,160,0,720
10341,200,120,200,80,0,0,600
10342,160,100,120,80,0,0,460
10343,220,100,80,80,160,0,640
10344,180,160,80,0,0,0,420
10345,190,80,120,80,160,320,950
10346,170,140,160,160,0,0,630
10347,240,140,160,80,0,0,620
10348,200,160,160,80,160,0,760
10349,220,180,200,80,160,0,840
10350,160,120,80,160,160,0,680
10351,150,80,0,0,0,0,230
10352,130,80,80,80,0,0,370
10353,200,140,40,80,160,0,620
10354,180,80,80,160,160,0,660
10355,180,140,120,240,320,320,1320
10356,190,100,80,80,160,320,930
10357,170,100,160,240,320,0,990
10358,230,140,120,0,0,0,490
10359,210,140,120,160,320,0,950
10360,190,140,80,160,160,320,1050
10361,220,80,120,160,0,0,580
10362,210,140,120,80,160,0,710
10363,210,120,40,0,0,0,370
10364,200,120,80,80,160,0,640
10365,190,80,80,160,160,0,670
10366,180,120,80,80,0,0,460
10367,190,180,160,160,160,0,850
10368,170,120,40,80,160,0,570
10369,230,140,120,160,0,0,650
10370,200,140,160,80,0,0,580
10371,160,80,120,160,160,0,680
10372,190,100,80,0,0,0,370
10373,210,100,160,80,0,0,550
10374,240,120,80,80,160,0,680
10375,220,120,120,160,160,0,780
10376,140,100,80,80,0,0,400
10377,190,60,40,80,160,0,530
10378,160,80,120,160,320,320,1160
10379,200,160,120,160,160,320,1120
10380,190,100,160,160,160,0,770
10381,170,100,120,80,0,0,470
10382,190,120,80,80,0,0,470
10383,200,100,80,0,0,0,380
10384,200,80,80,80,0,0,440
10385,260,180,120,0,0,0,560
10386,190,100,80,80,0,0,450
10387,130,120,120,80,0,0,450
10388,230,100,120,80,160,0,690
10389,190,100,160,80,160,0,690
10390,220,160,120,160,320,320,1300
10391,170,120,80,160,160,0,690
10392,180,120,80,80,160,0,620
10393,230,120,80,80,160,0,670
10394,170,160,120,0,0,0,450
10395,190,140,120,160,160,0,770
10396,210,160,160,160,320,0,1010
10397,250,100,120,160,0,0,630
10398,180,60,0,0,0,0,240
10399,190,120,40,0,0,0,350
10400,210,160,160,80,160,0,770
10401,230,140,40,80,160,0,650
10402,220,160,200,240,160,0,980
10403,160,100,80,80,160,0,580
10404,190,40,80,80,0,0,390
10405,190,140,80,80,160,0,650
10406,170,100,80,160,160,0,670
10407,200,140,120,0,0,0,460
10408,230,140,80,80,160,0,690
10409,210,140,120,160,160,0,790
10410,180,120,80,0,0,0,380
10411,190,100,80,0,0,0,370
10412,200,120,80,160,0,0,560
10413,200,140,160,80,0,0,580
10414,190,120,40,80,160,0,590
10415,190,140,120,80,0,0,530
10416,220,140,120,80,160,0,720
10417,220,100,80,0,0,0,400
10418,220,140,120,0,0,0,480
10419,180,120,120,160,160,320,1060
10420,200,100,40,80,0,0,420
10421,210,120,40,0,0,0,370
10422,180,100,160,160,160,0,760
10423,190,160,120,160,0,0,630
10424,200,120,160,160,160,320,1120
10425,180,100,120,160,320,0,880
10426,210,180,200,240,160,320,1310
10427,230,180,200,80,0,0,690
10428,240,180,40,80,0,0,540
10429,210,140,200,160,0,0,710
10430,170,120,120,80,160,0,650
10431,230,160,80,0,0,0,470
10432,230,140,120,80,0,0,570
10433,170,80,80,0,0,0,330
10434,170,100,160,80,160,0,670
10435,190,60,120,80,0,0,450
10436,210,140,200,240,320,0,1110
10437,180,120,160,160,160,320,1100
10438,190,140,200,160,0,0,690
10439,200,80,80,0,0,0,360
10440,160,80,120,80,160,320,920
10441,190,140,160,80,0,0,570
10442,170,40,80,80,0,0,370
10443,180,60,80,160,160,320,960
10444,230,180,120,160,0,0,690
10445,180,160,160,80,160,0,740
10446,200,160,200,0,0,0,560
10447,140,140,160,160,320,0,920
10448,230,180,120,80,160,0,770
10449,230,180,80,80,160,0,730
10450,170,120,160,80,160,320,1010
10451,190,120,160,160,320,0,950
10452,210,120,120,80,160,0,690
10453,200,80,80,160,160,0,680
10454,220,100,80,0,0,0,400
10455,170,80,40,80,0,0,370
10456,200,160,80,80,160,0,680
10457,220,160,120,160,320,0,980
10458,190,100,80,80,0,0,450
10459,190,120,120,80,160,0,670
10460,200,140,80,160,320,0,900
10461,180,160,80,160,160,320,1060
10462,160,60,80,160,160,0,620
10463,170,140,120,160,160,0,750
10464,190,140,120,80,160,0,690
10465,210,160,120,80,0,0,570
10466,160,80,80,80,160,0,560
10467,230,140,0,0,0,0,370
10468,250,100,80,80,0,0,510
10469,210,100,80,0,0,0,390
10470,230,140,120,160,160,0,810
10471,180,100,120,240,160,320,1120
10472,200,140,160,80,160,0,740
10473,180,120,160,160,160,0,780
10474,220,120,120,80,160,0,700
10475,220,100,120,160,0,0,600
10476,220,160,0,0,0,0,380
10477,220,80,80,160,160,0,700
10478,200,160,120,0,0,0,480
10479,180,120,120,160,320,320,1220
10480,230,80,120,0,0,0,430
10481,180,140,160,240,160,0,880
10482,170,100,80,0,0,0,350
10483,230,160,40,0,0,0,430
10484,140,120,120,80,160,0,620
10485,210,140,120,80,0,0,550
10486,170,80,120,80,0,0,450
10487,190,140,160,160,320,0,970
10488,170,120,0,0,0,0,290
10489,150,60,40,0,0,0,250
10490,210,100,80,80,0,0,470
10491,190,180,160,80,0,0,610
10492,220,80,80,80,160,0,620
10493,150,120,160,80,160,0,670
10494,210,180,40,0,0,0,430
10495,210,140,80,80,160,0,670
10496,140,80,80,160,320,320,1100
10497,160,80,80,0,0,0,320
10498,200,180,160,80,0,0,620
10499,190,120,120,160,320,0,910
10500,240,100,160,160,0,0,660
10501,200,120,80,80,0,0,480
10502,180,140,80,0,0,0,400
10503,170,140,120,80,160,0,670
10504,150,100,40,80,160,320,850
10505,220,140,80,160,160,0,760
10506,240,180,80,80,160,0,740
10507,230,180,120,240,0,0,770
10508,190,100,80,80,160,0,610
10509,180,120,0,0,0,0,300
10510,170,100,120,160,320,0,870
10511,210,60,80,80,160,0,590
10512,210,180,200,160,160,0,910
10513,180,100,120,80,160,0,640
10514,180,120,80,0,0,0,380
10515,160,140,120,240,320,320,1300
10516,200,100,80,160,0,0,540
10517,190,140,120,160,0,0,610
10518,250,140,160,160,320,320,1350
10519,200,120,40,0,0,0,360
10520,210,140,200,160,160,0,870
10521,200,80,40,80,0,0,400
10522,180,140,80,0,0,0,400
10523,150,140,40,80,160,0,570
10524,190,100,40,80,160,0,570
10525,210,120,160,240,320,0,1050
10526,190,100,120,160,320,0,890
10527,180,100,200,160,160,320,1120
10528,170,140,120,80,160,0,670
10529,200,140,160,160,160,0,820
10530,190,140,80,160,160,320,1050
10531,160,60,40,80,160,0,500
10532,170,120,120,160,320,320,1210
10533,220,140,80,80,160,0,680
10534,170,80,80,160,160,0,650
10535,210,140,120,80,160,0,710
10536,220,140,80,80,0,0,520
10537,200,100,80,0,0,0,380
10538,240,140,160,160,160,0,860
10539,180,120,80,160,160,0,700
10540,250,140,200,320,320,0,1230
10541,180,140,80,160,320,320,1200
10542,240,120,40,80,160,0,640
10543,200,160,120,80,160,0,720
10544,220,160,120,80,160,0,740
10545,190,160,200,80,160,320,1110
10546,210,120,80,80,160,0,650
10547,190,120,160,160,160,320,1110
10548,220,100,80,80,160,0,640
10549,210,100,120,80,160,0,670
10550,160,100,80,80,160,0,580
10551,200,60,80,160,320,0,820
10552,200,160,160,160,160,0,840
10553,200,140,120,80,0,0,540
10554,180,120,120,160,320,0,900
10555,190,120,160,160,0,0,630
10556,190,100,120,160,320,320,1210
10557,170,140,80,80,160,0,630
10558,210,120,160,160,160,0,810
10559,240,80,0,0,0,0,320
10560,180,120,120,0,0,0,420
10561,190,140,160,160,160,320,1130
10562,220,160,120,80,160,0,740
10563,210,140,160,80,0,0,590
10564,220,100,80,80,160,0,640
10565,180,120,120,80,0,0,500
10566,190,120,120,80,160,0,670
10567,190,100,40,80,160,0,570
10568,190,160,160,240,320,0,1070
10569,220,100,160,240,320,0,1040
10570,210,120,160,80,160,0,730
10571,150,60,80,160,160,0,610
10572,220,160,80,160,0,0,620
10573,160,140,120,160,320,0,900
10574,200,60,80,80,0,0,420
10575,210,140,0,0,0,0,350
10576,190,100,40,0,0,0,330
10577,140,100,40,0,0,0,280
10578,190,60,120,80,0,0,450
10579,160,120,160,160,160,0,760
10580,210,120,40,0,0,0,370
10581,200,140,40,0,0,0,380
10582,170,120,120,80,160,0,650
10583,190,180,120,80,0,0,570
10584,190,100,120,80,0,0,490
10585,210,160,120,160,160,320,1130
10586,200,80,40,0,0,0,320
10587,150,100,40,80,0,0,370
10588,200,120,40,80,160,320,920
10589,210,120,120,80,0,0,530
10590,200,120,80,160,160,0,720
10591,190,120,120,160,320,320,1230
10592,220,100,40,80,160,0,600
10593,210,160,80,80,160,0,690
10594,210,140,40,80,160,0,630
10595,210,140,120,160,160,0,790
10596,200,120,40,0,0,0,360
10597,210,60,120,0,0,0,390
10598,200,120,120,80,0,0,520
10599,220,140,80,80,0,0,520
10600,180,80,40,0,0,0,300
10601,190,140,120,160,320,0,930
10602,220,80,80,160,320,0,860
10603,190,100,120,80,160,0,650
10604,150,120,160,0,0,0,430
10605,180,160,160,80,160,0,740
10606,230,120,120,160,320,0,950
10607,210,140,120,80,160,0,710
10608,200,120,120,160,160,0,760
10609,220,120,120,160,0,0,620
10610,200,100,80,0,0,0,380
10611,180,120,80,80,160,0,620
10612,230,160,120,160,320,320,1310
10613,190,60,40,80,0,0,370
10614,200,120,80,80,160,0,640
10615,130,120,120,80,160,0,610
10616,210,100,160,0,0,0,470
10617,210,80,80,160,160,0,690
10618,160,80,80,160,160,320,960
10619,200,120,200,240,320,0,1080
10620,190,80,160,80,0,0,510
10621,220,160,160,80,0,0,620
10622,210,120,120,240,320,0,1010
10623,200,160,80,80,0,0,520
10624,200,160,120,80,160,0,720
10625,160,80,120,160,160,0,680
10626,220,140,120,80,160,0,720
10627,150,120,80,160,320,0,830
10628,220,140,160,80,160,0,760
10629,240,100,120,80,0,0,540
10630,210,40,0,0,0,0,250
10631,200,100,40,80,0,0,420
10632,200,140,120,160,160,0,780
10633,190,120,40,80,160,320,910
10634,190,120,80,80,160,0,630
10635,190,120,40,0,0,0,350
10636,170,120,120,160,160,0,730
10637,220,80,40,0,0,0,340
10638,190,180,160,80,0,0,610
10639,200,140,40,0,0,0,380
10640,210,200,200,160,0,0,770
10641,180,140,160,160,320,0,960
10642,200,160,80,160,160,0,760
10643,180,120,120,160,0,0,580
10644,200,80,80,160,0,0,520
10645,230,120,160,80,160,0,750
10646,230,140,160,80,160,0,770
10647,210,140,160,0,0,0,510
10648,220,180,40,0,0,0,440
10649,230,120,160,160,160,0,830
10650,210,160,160,0,0,0,530
10651,210,120,120,160,160,0,770
10652,210,140,160,160,320,0,990
10653,240,180,80,80,0,0,580
10654,200,80,120,240,320,0,960
10655,220,200,280,320,320,320,1660
10656,180,40,40,0,0,0,260
10657,170,160,120,0,0,0,450
10658,170,160,160,80,0,0,570
10659,200,140,80,0,0,0,420
10660,200,80,80,80,160,0,600
10661,220,160,120,80,160,0,740
10662,240,160,120,160,0,0,680
10663,240,140,160,160,0,0,700
10664,190,200,160,160,160,0,870
10665,180,100,120,80,160,0,640
10666,180,100,120,80,0,0,480
10667,200,100,80,80,160,0,620
10668,190,120,160,160,160,0,790
10669,200,160,200,160,160,320,1200
10670,220,160,120,80,0,0,580
10671,190,60,40,0,0,0,290
10672,200,80,80,80,160,0,600
10673,200,120,120,160,160,0,760
10674,210,140,80,160,160,0,750
10675,160,120,120,80,0,0,480
10676,190,180,120,0,0,0,490
10677,160,100,120,80,0,0,460
10678,180,140,160,80,160,0,720
10679,210,140,120,160,0,0,630
10680,170,160,120,160,160,0,770
10681,190,160,80,80,0,0,510
10682,160,80,120,80,0,0,440
10683,230,140,80,160,160,0,770
10684,150,80,120,80,160,0,590
10685,190,100,120,160,160,0,730
10686,160,60,40,0,0,0,260
10687,250,120,40,80,0,0,490
10688,190,60,40,80,160,0,530
10689,220,180,120,80,160,0,760
10690,190,160,160,160,160,0,830
10691,190,100,80,80,160,0,610
10692,240,180,160,160,0,0,740
10693,200,100,120,160,160,320,1060
10694,220,120,160,160,160,0,820
10695,210,140,80,0,0,0,430
10696,250,180,40,0,0,0,470
10697,200,160,120,240,160,0,880
10698,220,180,120,80,160,320,1080
10699,230,180,40,80,0,0,530
10700,180,180,160,80,0,0,600
10701,170,160,240,240,160,320,1290
10702,180,160,200,160,160,0,860
10703,200,140,120,240,160,0,860
10704,190,100,40,0,0,0,330
10705,190,140,40,80,0,0,450
10706,180,80,0,0,0,0,260
10707,170,100,120,160,160,0,710
10708,210,100,40,80,160,0,590
10709,160,100,80,80,160,0,580
10710,140,140,120,160,320,320,1200
10711,220,180,120,80,160,0,760
10712,210,140,160,240,320,0,1070
10713,260,140,80,160,320,320,1280
10714,140,120,160,240,320,0,980
10715,200,100,120,80,160,0,660
10716,180,80,80,80,0,0,420
10717,220,140,200,240,160,320,1280
10718,180,120,160,160,160,0,780
10719,160,160,160,160,160,320,1120
10720,220,120,120,80,160,0,700
10721,160,80,120,160,160,320,1000
10722,150,120,40,80,160,0,550
10723,190,140,120,80,0,0,530
10724,190,100,80,80,160,0,610
10725,190,180,120,80,0,0,570
10726,220,120,80,80,160,320,980
10727,190,140,120,80,0,0,530
10728,210,120,120,240,320,320,1330
10729,180,120,80,0,0,0,380
10730,170,120,120,80,160,0,650
10731,210,100,160,0,0,0,470
10732,170,100,160,80,160,320,990
10733,190,100,120,80,0,0,490
10734,190,160,120,80,160,320,1030
10735,180,100,80,80,0,0,440
10736,220,160,120,80,160,0,740
10737,210,100,120,240,160,0,830
10738,220,160,120,80,160,320,1060
10739,200,160,160,80,160,0,760
10740,220,80,40,80,0,0,420
10741,150,100,120,160,320,320,1170
10742,210,140,120,160,160,0,790
10743,220,180,120,160,160,0,840
10744,150,100,120,160,0,0,530
10745,180,140,200,240,320,0,1080
10746,190,180,200,160,160,0,890
10747,230,100,80,80,0,0,490
10748,190,100,200,160,320,0,970
10749,200,180,120,80,160,0,740
10750,170,80,40,80,160,0,530
10751,220,200,160,80,160,0,820
10752,210,80,40,0,0,0,330
10753,170,140,80,160,160,0,710
10754,210,140,40,80,160,320,950
10755,200,100,120,80,0,0,500
10756,160,100,40,0,0,0,300
10757,190,100,80,80,0,0,450
10758,180,100,80,0,0,0,360
10759,200,140,120,80,0,0,540
10760,210,80,40,80,160,0,570
10761,220,120,40,80,160,0,620
10762,210,200,120,80,160,0,770
10763,190,120,160,80,160,0,710
10764,220,120,120,160,160,0,780
10765,230,160,160,240,160,0,950
10766,190,160,120,80,160,0,710
10767,180,60,80,160,160,0,640
10768,180,140,160,240,320,0,1040
10769,200,100,80,80,160,0,620
10770,190,120,80,160,0,0,550
10771,210,120,120,80,160,0,690
10772,200,100,40,80,160,0,580
10773,200,80,80,80,0,0,440
10774,160,120,40,0,0,0,320
10775,160,100,160,240,0,0,660
10776,200,80,40,0,0,0,320
10777,210,80,80,0,0,0,370
10778,230,140,120,0,0,0,490
10779,200,140,160,160,0,0,660
10780,180,100,120,80,0,0,480
10781,200,160,80,80,160,0,680
10782,180,100,40,80,0,0,400
10783,200,120,120,160,0,0,600
10784,200,140,40,0,0,0,380
10785,210,160,120,0,0,0,490
10786,180,60,40,80,160,0,520
10787,180,100,40,0,0,0,320
10788,230,100,80,80,0,0,490
10789,150,80,40,0,0,0,270
10790,190,120,0,0,0,0,310
10791,170,120,160,160,0,0,610
10792,180,140,160,80,160,0,720
10793,230,160,160,0,0,0,550
10794,180,80,40,80,0,0,380
10795,170,80,80,80,160,320,890
10796,230,80,80,80,160,0,630
10797,190,60,120,160,320,0,850
10798,200,100,40,80,160,0,580
10799,200,160,120,160,320,0,960
10800,180,100,40,0,0,0,320
10801,200,160,40,0,0,0,400
10802,190,140,120,80,0,0,530
10803,200,140,120,240,320,0,1020
10804,200,120,40,0,0,0,360
10805,190,120,80,0,0,0,390
10806,210,160,160,80,0,0,610
10807,210,140,120,160,160,0,790
10808,160,140,80,80,160,320,940
10809,180,160,120,80,160,0,700
10810,140,120,80,160,160,0,660
10811,190,120,80,80,160,0,630
10812,190,140,120,80,160,0,690
10813,170,100,40,80,160,320,870
10814,170,100,120,80,160,0,630
10815,180,140,200,160,0,0,680
10816,160,140,40,0,0,0,340
10817,220,80,120,80,0,0,500
10818,170,180,160,160,0,0,670
10819,180,140,120,160,320,320,1240
10820,180,120,40,80,160,0,580
10821,220,120,120,80,0,0,540
10822,210,100,160,240,160,0,870
10823,160,120,120,160,160,0,720
10824,200,140,160,80,160,0,740
10825,180,140,80,80,160,0,640
10826,220,120,160,160,160,0,820
10827,220,100,0,0,0,0,320
10828,240,120,120,160,160,320,1120
10829,210,140,120,160,0,0,630
10830,140,100,80,80,160,0,560
10831,190,120,160,240,320,0,1030
10832,190,100,0,0,0,0,290
10833,210,140,120,80,0,0,550
10834,160,120,40,80,160,0,560
10835,190,140,160,80,0,0,570
10836,200,120,120,80,160,0,680
10837,170,120,120,80,160,0,650
10838,180,120,120,80,160,320,980
10839,200,100,80,80,160,0,620
10840,200,160,200,240,160,0,960
10841,190,140,120,80,160,0,690
10842,180,120,160,240,160,0,860
10843,200,60,40,0,0,0,300
10844,210,120,80,160,320,320,1210
10845,210,80,80,80,160,0,610
10846,190,100,80,80,160,320,930
10847,180,100,160,240,160,0,840
10848,190,140,160,240,160,0,890
10849,170,180,200,160,160,0,870
10850,200,100,40,0,0,0,340
10851,200,180,40,0,0,0,420
10852,210,140,120,0,0,0,470
10853,210,160,80,160,320,0,930
10854,190,100,80,80,160,320,930
10855,190,100,40,80,0,0,410
10856,170,80,80,160,0,0,490
10857,160,160,80,160,160,0,720
10858,200,120,40,80,0,0,440
10859,190,200,80,80,160,0,710
10860,200,100,120,0,0,0,420
10861,190,80,40,80,160,0,550
10862,170,120,80,80,0,0,450
10863,190,120,160,80,160,0,710
10864,180,100,80,80,0,0,440
10865,210,100,80,160,160,0,710
10866,210,160,160,160,160,0,850
10867,160,120,40,80,0,0,400
10868,160,160,200,80,0,0,600
10869,190,100,160,160,0,0,610
10870,200,140,80,0,0,0,420
10871,170,100,80,80,0,0,430
10872,190,120,160,0,0,0,470
10873,190,120,120,240,160,0,830
10874,240,140,160,160,320,0,1020
10875,190,120,120,160,160,0,750
10876,160,120,200,80,0,0,560
10877,160,120,80,160,160,0,680
10878,170,120,40,80,160,0,570
10879,240,200,80,0,0,0,520
10880,170,80,80,160,160,0,650
10881,190,120,40,80,160,0,590
10882,230,120,80,80,160,320,990
10883,230,160,80,80,160,320,1030
10884,210,100,120,160,160,320,1070
10885,250,220,200,160,0,0,830
10886,180,100,120,160,160,0,720
10887,200,200,120,80,0,0,600
10888,200,180,120,80,160,0,740
10889,200,120,80,0,0,0,400
10890,170,80,80,80,0,0,410
10891,210,100,120,0,0,0,430
10892,230,140,40,80,0,0,490
10893,130,120,40,0,0,0,290
10894,190,120,80,0,0,0,390
10895,160,60,80,0,0,0,300
10896,170,60,120,160,160,0,670
10897,170,140,40,0,0,0,350
10898,170,100,120,240,320,0,950
10899,220,140,80,80,0,0,520
10900,230,180,40,0,0,0,450
10901,180,60,40,0,0,0,280
10902,210,220,80,80,160,0,750
10903,190,60,0,0,0,0,250
10904,170,140,120,80,160,0,670
10905,220,120,80,80,0,0,500
10906,200,120,120,0,0,0,440
10907,150,140,160,240,320,320,1330
10908,140,100,80,80,160,0,560
10909,200,160,160,240,160,320,1240
10910,180,140,120,240,320,0,1000
10911,160,100,0,0,0,0,260
10912,180,160,200,160,160,320,1180
10913,160,120,80,160,320,0,840
10914,180,120,40,0,0,0,340
10915,170,100,40,0,0,0,310
10916,180,60,40,0,0,0,280
10917,170,100,160,240,320,320,1310
10918,190,60,80,0,0,0,330
10919,210,160,160,0,0,0,530
10920,150,120,120,160,160,0,710
10921,180,120,40,80,160,320,900
10922,210,100,40,0,0,0,350
10923,200,120,120,80,160,320,1000
10924,210,160,160,160,160,0,850
10925,200,120,120,160,320,320,1240
10926,150,100,40,80,160,0,530
10927,190,160,120,0,0,0,470
10928,210,160,120,80,0,0,570
10929,200,140,160,160,320,0,980
10930,200,140,120,240,320,320,1340
10931,200,160,120,0,0,0,480
10932,210,140,120,80,0,0,550
10933,230,40,40,0,0,0,310
10934,170,120,80,160,320,320,1170
10935,220,140,160,160,320,0,1000
10936,210,140,120,0,0,0,470
10937,250,140,120,160,320,0,990
10938,210,120,120,0,0,0,450
10939,240,140,160,80,160,0,780
10940,190,120,80,160,0,0,550
10941,220,140,120,80,0,0,560
10942,160,140,160,160,160,320,1100
10943,200,140,160,80,0,0,580
10944,200,120,120,80,0,0,520
10945,180,140,80,80,160,0,640
10946,230,160,120,80,160,0,750
10947,200,120,80,80,160,0,640
10948,190,160,120,80,0,0,550
10949,210,140,160,80,160,0,750
10950,190,140,80,0,0,0,410
10951,190,140,200,80,0,0,610
10952,200,140,80,80,0,0,500
10953,190,140,160,240,160,320,1210
10954,210,140,40,0,0,0,390
10955,230,160,80,0,0,0,470
10956,180,100,120,160,320,320,1200
10957,170,140,120,160,160,0,750
10958,190,120,80,80,0,0,470
10959,220,180,120,80,0,0,600
10960,200,140,120,80,0,0,540
10961,210,160,160,160,320,0,1010
10962,180,100,120,240,0,0,640
10963,180,100,80,0,0,0,360
10964,210,120,160,160,160,0,810
10965,140,100,120,160,0,0,520
10966,210,120,40,80,0,0,450
10967,190,120,200,80,160,0,750
10968,220,180,120,80,0,0,600
10969,160,100,120,240,320,0,940
10970,160,120,120,80,0,0,480
10971,190,120,80,80,160,320,950
10972,210,180,120,80,160,0,750
10973,230,140,80,80,0,0,530
10974,170,100,160,160,160,320,1070
10975,160,100,80,0,0,0,340
10976,220,180,80,80,0,0,560
10977,210,100,80,80,0,0,470
10978,170,140,120,0,0,0,430
10979,210,120,80,80,0,0,490
10980,160,140,160,80,160,0,700
10981,160,80,40,80,160,0,520
10982,220,120,200,240,320,0,1100
10983,160,60,40,80,160,0,500
10984,190,80,80,80,0,0,430
10985,220,120,160,80,160,0,740
10986,190,100,200,240,160,0,890
10987,240,160,120,80,0,0,600
10988,230,140,120,160,160,0,810
10989,190,100,80,0,0,0,370
10990,210,100,160,80,0,0,550
10991,210,140,200,80,0,0,630
10992,180,140,120,160,160,0,760
10993,190,160,120,160,320,0,950
10994,180,100,40,80,160,0,560
10995,230,200,160,160,320,0,1070
10996,220,140,200,240,160,0,960
10997,200,160,80,0,0,0,440
10998,110,80,80,80,0,0,350
10999,190,140,120,0,0,0,450
11000,210,120,80,80,160,320,970
11001,240,120,80,80,160,0,680
11002,220,120,160,160,160,0,820
11003,180,100,80,160,160,320,1000
11004,180,160,160,160,320,0,980
11005,210,180,160,160,160,0,870
11006,220,140,120,160,0,0,640
11007,180,160,120,160,320,320,1260
11008,210,140,120,80,0,0,550
11009,210,140,80,0,0,0,430
11010,180,80,120,240,320,320,1260
11011,190,100,120,240,160,0,810
11012,190,100,120,80,160,0,650
11013,210,160,160,80,0,0,610
11014,210,100,40,80,160,0,590
11015,180,80,120,80,160,320,940
11016,220,160,120,80,0,0,580
11017,160,140,120,80,0,0,500
11018,220,120,80,0,0,0,420
11019,250,160,200,80,160,0,850
11020,190,80,80,80,0,0,430
11021,180,160,120,0,0,0,460
11022,220,120,240,160,0,0,740
11023,190,120,80,80,0,0,470
11024,210,80,80,80,160,320,930
11025,200,140,160,160,160,0,820
11026,160,100,40,80,0,0,380
11027,200,160,120,160,160,320,1120
11028,190,140,120,80,160,0,690
11029,210,80,120,80,0,0,490
11030,190,20,0,0,0,0,210
11031,190,180,120,80,160,0,730
11032,170,160,120,160,160,0,770
11033,170,80,40,80,0,0,370
11034,220,160,160,240,320,320,1420
11035,150,120,120,80,160,0,630
11036,190,180,160,160,0,0,690
11037,210,100,160,80,0,0,550
11038,210,120,80,80,0,0,490
11039,150,140,120,0,0,0,410
11040,210,140,160,160,320,0,990
11041,200,120,40,0,0,0,360
11042,190,80,160,160,0,0,590
11043,180,140,40,80,0,0,440
11044,170,120,160,160,160,0,770
11045,260,160,120,0,0,0,540
11046,160,100,40,0,0,0,300
11047,170,140,80,160,320,320,1190
11048,190,120,120,160,0,0,590
11049,200,140,80,80,160,0,660
11050,190,180,200,160,160,0,890
11051,170,100,120,160,160,0,710
11052,220,140,160,240,160,0,920
11053,240,140,160,0,0,0,540
11054,240,160,120,0,0,0,520
11055,200,160,160,80,160,320,1080
11056,210,140,160,80,0,0,590
11057,200,100,80,80,0,0,460
11058,190,120,120,80,160,0,670
11059,220,120,160,80,0,0,580
11060,230,120,160,80,0,0,590
11061,200,160,80,160,160,0,760
11062,160,120,80,80,160,0,600
11063,190,140,160,160,0,0,650
11064,190,120,40,0,0,0,350
11065,190,160,80,80,0,0,510
11066,200,160,120,80,0,0,560
11067,170,100,160,80,160,0,670
11068,190,120,160,240,0,0,710
11069,210,200,160,0,0,0,570
11070,200,100,80,160,320,0,860
11071,230,140,120,160,0,0,650
11072,210,160,160,80,160,320,1090
11073,220,80,40,0,0,0,340
11074,190,140,160,160,160,0,810
11075,230,100,40,0,0,0,370
11076,180,80,40,0,0,0,300
11077,150,120,120,160,0,0,550
11078,200,100,40,0,0,0,340
11079,260,120,160,80,160,0,780
11080,200,140,0,0,0,0,340
11081,210,160,200,80,0,0,650
11082,210,120,80,0,0,0,410
11083,210,100,40,80,0,0,430
11084,180,60,40,80,0,0,360
11085,190,40,80,160,320,0,790
11086,220,120,160,160,320,0,980
11087,180,100,80,160,160,0,680
11088,200,120,120,160,160,0,760
11089,170,120,120,80,160,0,650
11090,190,100,120,80,160,0,650
11091,210,140,80,160,160,320,1070
11092,220,120,160,240,320,320,1380
11093,180,120,80,80,160,0,620
11094,220,140,80,160,160,320,1080
11095,200,80,80,0,0,0,360
11096,190,140,200,80,160,320,1090
11097,190,100,40,80,160,320,890
11098,190,120,160,160,0,0,630
11099,170,120,160,160,320,0,930
11100,230,100,120,0,0,0,450
11101,190,100,120,160,0,0,570
11102,220,140,120,160,160,0,800
11103,210,160,120,160,0,0,650
11104,180,140,80,160,320,0,880
11105,200,160,160,160,320,0,1000
11106,160,160,120,0,0,0,440
11107,170,120,80,160,0,0,530
11108,210,140,120,80,160,0,710
11109,200,140,160,160,160,0,820
11110,150,140,80,0,0,0,370
11111,210,100,160,240,160,0,870
11112,160,140,160,80,160,320,1020
11113,220,180,120,80,160,0,760
11114,200,100,40,80,160,0,580
11115,210,160,80,80,0,0,530
11116,200,80,80,0,0,0,360
11117,200,80,120,80,160,0,640
11118,160,200,120,80,160,0,720
11119,210,160,200,160,160,0,890
11120,210,180,120,160,160,0,830
11121,200,100,80,160,320,0,860
11122,170,120,120,80,0,0,490
11123,200,160,40,0,0,0,400
11124,230,140,80,80,0,0,530
11125,190,160,120,160,160,0,790
11126,190,140,120,0,0,0,450
11127,210,160,120,0,0,0,490
11128,180,60,80,160,320,0,800
11129,160,120,200,160,160,0,800
11130,220,140,80,80,0,0,520
11131,200,160,80,80,160,0,680
11132,210,140,160,80,160,0,750
11133,230,140,80,80,160,0,690
11134,240,120,80,80,160,0,680
11135,190,80,120,0,0,0,390
11136,180,140,120,160,160,0,760
11137,240,140,120,160,160,0,820
11138,230,140,120,160,320,0,970
11139,200,60,80,0,0,0,340
11140,220,120,120,160,160,0,780
11141,190,120,120,160,320,0,910
11142,220,140,120,80,0,0,560
11143,190,80,80,80,160,0,590
11144,220,40,40,0,0,0,300
11145,210,100,120,160,0,0,590
11146,220,200,240,240,0,0,900
11147,200,100,40,0,0,0,340
11148,200,100,40,80,160,0,580
11149,200,120,160,80,160,0,720
11150,210,120,0,0,0,0,330
11151,190,120,80,0,0,0,390
11152,240,140,80,0,0,0,460
11153,190,140,40,80,0,0,450
11154,220,160,40,80,0,0,500
11155,180,100,0,0,0,0,280
11156,190,60,120,160,160,0,690
11157,190,120,120,240,320,0,990
11158,200,100,40,80,160,320,900
11159,200,160,80,80,0,0,520
11160,160,140,120,80,160,0,660
11161,150,140,120,160,0,0,570
11162,210,140,80,80,0,0,510
11163,190,20,0,0,0,0,210
11164,200,140,120,160,0,0,620
11165,210,120,80,0,0,0,410
11166,160,120,160,160,160,0,760
11167,220,100,80,80,0,0,480
11168,200,100,120,80,0,0,500
11169,190,180,160,160,320,320,1330
11170,190,120,80,80,0,0,470
11171,160,100,160,240,160,320,1140
11172,200,140,160,160,160,0,820
11173,190,120,120,80,0,0,510
11174,210,120,120,80,0,0,530
11175,240,160,120,160,160,0,840
11176,160,140,160,160,160,0,780
11177,200,120,120,80,160,320,1000
11178,180,140,160,160,0,0,640
11179,200,100,120,160,0,0,580
11180,160,80,40,80,160,0,520
11181,190,60,80,80,0,0,410
11182,200,120,40,0,0,0,360
11183,170,100,80,80,160,0,590
11184,210,120,160,80,160,320,1050
11185,220,140,160,160,160,0,840
11186,190,100,80,160,160,0,690
11187,180,120,120,160,320,320,1220
11188,190,140,160,80,160,0,730
11189,200,120,120,80,0,0,520
11190,200,100,80,80,0,0,460
11191,220,160,200,160,320,320,1380
11192,210,160,120,80,0,0,570
11193,200,120,80,80,160,0,640
11194,160,160,80,160,0,0,560
11195,200,100,0,0,0,0,300
11196,190,120,80,80,160,320,950
11197,200,120,160,160,160,0,800
11198,130,40,0,0,0,0,170
11199,180,120,80,0,0,0,380
11200,200,160,120,160,320,0,960
11201,190,140,120,80,160,0,690
11202,190,120,120,160,320,0,910
11203,240,100,160,0,0,0,500
11204,220,180,200,240,160,0,1000
11205,210,140,160,80,0,0,590
11206,190,80,80,80,160,0,590
11207,210,80,80,160,160,0,690
11208,180,100,80,80,160,0,600
11209,190,120,80,80,160,0,630
11210,180,80,120,160,160,320,1020
11211,220,120,160,160,320,0,980
11212,220,100,40,80,160,0,600
11213,220,80,0,0,0,0,300
11214,200,100,40,80,160,0,580
11215,180,100,80,80,160,320,920
11216,170,120,80,160,0,0,530
11217,180,120,80,80,160,0,620
11218,140,100,120,160,0,0,520
11219,190,120,120,160,160,0,750
11220,230,80,40,80,160,320,910
11221,210,220,80,80,160,0,750
11222,210,160,120,240,160,0,890
11223,200,120,120,0,0,0,440
11224,180,160,40,0,0,0,380
11225,190,100,120,160,160,320,1050
11226,200,100,160,80,160,0,700
11227,200,120,120,160,160,0,760
11228,200,160,40,0,0,0,400
11229,220,180,80,80,160,0,720
11230,170,100,40,0,0,0,310
11231,150,80,160,160,160,320,1030
11232,180,140,0,0,0,0,320
11233,190,180,120,0,0,0,490
11234,230,140,120,80,160,0,730
11235,210,100,80,160,0,0,550
11236,230,180,160,240,0,0,810
11237,170,100,40,0,0,0,310
11238,210,100,80,160,160,320,1030
11239,220,160,120,80,160,0,740
11240,200,120,40,80,0,0,440
11241,200,160,40,80,0,0,480
11242,200,100,120,160,320,0,900
11243,210,160,80,80,160,0,690
11244,200,160,120,160,320,320,1280
11245,160,120,120,160,160,0,720
11246,210,140,200,80,0,0,630
11247,180,100,120,80,160,0,640
11248,190,80,120,160,320,0,870
11249,150,100,120,160,320,320,1170
11250,210,120,120,0,0,0,450
11251,200,140,80,80,160,0,660
11252,200,80,80,0,0,0,360
11253,230,160,80,80,160,320,1030
11254,190,140,120,160,320,0,930
11255,180,80,80,0,0,0,340
11256,230,60,40,80,160,0,570
11257,180,80,80,160,160,0,660
11258,210,160,80,160,320,320,1250
11259,170,100,120,160,320,0,870
11260,220,140,200,240,320,320,1440
11261,210,100,120,160,0,0,590
11262,170,140,80,160,160,320,1030
11263,200,140,120,0,0,0,460
11264,200,140,120,0,0,0,460
11265,170,120,80,80,160,0,610
11266,190,140,200,160,160,320,1170
11267,230,140,120,80,160,0,730
11268,180,100,120,80,160,0,640
11269,210,100,80,80,160,0,630
11270,200,140,160,160,160,320,1140
11271,170,120,120,80,160,0,650
11272,250,180,160,160,160,0,910
11273,180,80,40,0,0,0,300
11274,220,140,80,160,0,0,600
11275,190,100,120,80,0,0,490
11276,210,120,80,80,160,0,650
11277,240,160,160,160,0,0,720
11278,210,140,80,80,160,0,670
11279,220,140,120,80,160,0,720
11280,180,80,80,160,160,0,660
11281,190,160,160,160,160,0,830
11282,190,140,120,160,0,0,610
11283,150,140,120,160,160,320,1050
11284,210,100,120,160,0,0,590
11285,180,80,80,0,0,0,340
11286,250,160,120,160,160,320,1170
11287,170,100,120,160,160,0,710
11288,170,120,160,160,320,0,930
11289,180,140,120,80,160,0,680
11290,200,160,200,240,0,0,800
11291,220,100,80,80,160,0,640
11292,200,80,120,80,0,0,480
11293,200,140,120,0,0,0,460
11294,200,100,80,0,0,0,380
11295,200,160,120,80,160,0,720
11296,210,80,120,160,160,320,1050
11297,220,140,80,80,0,0,520
11298,200,40,40,80,160,0,520
11299,250,180,120,160,0,0,710
11300,160,120,80,160,160,0,680
11301,210,80,0,0,0,0,290
11302,220,120,120,160,160,0,780
11303,200,140,80,0,0,0,420
11304,240,80,80,160,160,0,720
11305,220,140,160,160,320,0,1000
11306,210,180,200,240,320,0,1150
11307,210,80,40,0,0,0,330
11308,160,120,120,160,160,0,720
11309,200,160,160,240,160,0,920
11310,250,160,120,80,160,320,1090
11311,210,160,160,80,160,0,770
11312,200,120,120,160,160,320,1080
11313,250,120,80,0,0,0,450
11314,190,100,120,80,0,0,490
11315,190,120,160,160,320,0,950
11316,240,100,120,80,160,0,700
11317,230,140,160,240,320,0,1090
11318,170,100,80,80,0,0,430
11319,200,80,80,160,320,0,840
11320,200,160,120,160,0,0,640
11321,220,140,160,80,160,320,1080
11322,190,100,80,80,160,0,610
11323,190,140,80,80,0,0,490
11324,190,60,40,0,0,0,290
11325,190,140,120,80,160,0,690
11326,200,100,80,80,160,0,620
11327,180,120,120,80,160,0,660
11328,200,140,80,160,320,320,1220
11329,230,120,80,0,0,0,430
11330,200,120,120,80,0,0,520
11331,220,160,120,80,160,0,740
11332,220,160,200,160,320,320,1380
11333,220,140,200,80,0,0,640
11334,220,80,40,80,160,0,580
11335,200,140,120,80,160,0,700
11336,200,80,120,80,0,0,480
11337,210,40,0,0,0,0,250
11338,190,140,200,240,160,0,930
11339,170,120,160,160,160,0,770
11340,220,120,40,0,0,0,380
11341,190,140,160,160,160,0,810
11342,190,100,80,80,0,0,450
11343,200,120,200,160,0,0,680
11344,190,140,160,160,0,0,650
11345,210,100,160,160,160,0,790
11346,220,140,120,80,0,0,560
11347,220,100,80,0,0,0,400
11348,160,80,40,80,160,0,520
11349,210,140,80,80,160,0,670
11350,240,100,120,240,320,0,1020
11351,170,140,120,80,0,0,510
11352,250,100,80,80,160,0,670
11353,210,120,120,160,160,0,770
11354,230,80,80,80,0,0,470
11355,190,120,120,160,320,0,910
11356,210,140,160,160,160,320,1150
11357,180,140,200,0,0,0,520
11358,190,120,80,80,0,0,470
11359,190,140,80,0,0,0,410
11360,200,120,120,80,160,0,680
11361,200,100,120,80,160,0,660
11362,190,140,120,80,0,0,530
11363,180,100,80,80,160,0,600
11364,190,120,120,240,320,0,990
11365,200,100,80,160,0,0,540
11366,180,100,80,160,320,0,840
11367,200,120,160,80,160,0,720
11368,250,160,200,80,160,0,850
11369,170,100,80,80,0,0,430
11370,210,100,80,80,160,0,630
11371,200,140,160,0,0,0,500
11372,180,160,40,0,0,0,380
11373,220,100,120,80,0,0,520
11374,210,100,120,160,160,0,750
11375,170,140,120,160,160,0,750
11376,190,160,40,80,160,0,630
11377,190,120,120,160,320,0,910
11378,220,140,120,80,160,0,720
11379,220,140,80,80,0,0,520
11380,210,160,200,240,160,0,970
11381,190,140,160,160,320,0,970
11382,150,80,80,80,160,0,550
11383,170,60,40,80,0,0,350
11384,180,140,80,80,0,0,480
11385,140,120,80,0,0,0,340
11386,220,140,80,160,160,0,760
11387,180,80,40,80,160,0,540
11388,150,140,120,80,160,0,650
11389,190,40,40,0,0,0,270
11390,170,120,120,80,0,0,490
11391,190,60,80,80,0,0,410
11392,210,120,80,80,160,0,650
11393,210,120,40,0,0,0,370
11394,210,120,160,160,0,0,650
11395,220,140,160,160,160,0,840
11396,210,120,120,0,0,0,450
11397,180,120,120,240,320,0,980
11398,160,80,120,160,160,0,680
11399,160,160,160,240,160,320,1200
11400,220,140,120,80,0,0,560
11401,230,120,80,0,0,0,430
11402,200,80,160,80,160,0,680
11403,180,120,120,160,160,0,740
11404,200,160,120,80,160,320,1040
11405,170,140,40,0,0,0,350
11406,200,100,120,80,0,0,500
11407,250,80,120,160,160,320,1090
11408,220,140,80,80,160,0,680
11409,140,140,80,0,0,0,360
11410,220,120,80,160,320,0,900
11411,190,100,160,240,320,0,1010
11412,200,140,120,0,0,0,460
11413,230,140,160,80,160,0,770
11414,220,120,120,160,160,0,780
11415,190,100,40,0,0,0,330
11416,160,160,120,160,160,320,1080
11417,180,120,120,80,160,0,660
11418,170,60,80,80,160,320,870
11419,210,80,40,80,0,0,410
11420,160,100,40,80,160,0,540
11421,200,180,160,160,320,320,1340
11422,220,200,120,160,160,320,1180
11423,190,140,120,160,320,0,930
11424,170,80,80,80,160,0,570
11425,190,120,120,80,160,0,670
11426,230,180,160,160,0,0,730
11427,180,120,160,160,160,0,780
11428,240,160,80,80,160,0,720
11429,180,120,80,160,320,0,860
11430,210,140,120,160,160,320,1110
11431,180,140,120,160,160,0,760
11432,220,120,80,0,0,0,420
11433,230,120,120,160,320,0,950
11434,140,120,80,0,0,0,340
11435,220,120,160,80,160,0,740
11436,190,100,40,80,160,320,890
11437,190,160,80,80,160,0,670
11438,170,100,40,80,0,0,390
11439,210,80,120,80,160,0,650
11440,220,100,40,80,160,320,920
11441,190,100,0,0,0,0,290
11442,230,80,120,160,160,0,750
11443,170,140,160,80,0,0,550
11444,200,80,40,80,0,0,400
11445,230,120,120,80,160,320,1030
11446,200,140,120,80,160,320,1020
11447,210,140,80,80,160,0,670
11448,260,180,80,80,160,320,1080
11449,200,120,40,0,0,0,360
11450,180,160,160,160,160,0,820
11451,180,60,80,80,0,0,400
11452,190,100,0,0,0,0,290
11453,180,80,80,80,160,0,580
11454,200,120,40,80,160,320,920
11455,170,140,120,80,160,0,670
11456,210,140,80,80,160,0,670
11457,210,100,120,160,320,320,1230
11458,200,100,40,80,160,0,580
11459,190,120,80,0,0,0,390
11460,220,220,120,80,0,0,640
11461,210,140,120,160,160,320,1110
11462,210,80,120,160,320,0,890
11463,210,120,120,160,160,0,770
11464,190,60,80,160,160,0,650
11465,210,100,40,80,160,0,590
11466,210,200,240,320,160,0,1130
11467,200,180,160,80,160,0,780
11468,210,100,160,80,160,0,710
11469,190,100,80,80,160,0,610
11470,190,80,40,80,160,0,550
11471,220,160,120,80,0,0,580
11472,180,120,120,160,0,0,580
11473,230,100,120,160,0,0,610
11474,210,120,80,80,160,0,650
11475,200,160,80,160,160,320,1080
11476,210,120,120,160,320,0,930
11477,180,140,120,160,160,0,760
11478,210,120,120,160,160,0,770
11479,140,120,160,160,160,320,1060
11480,180,140,80,80,0,0,480
11481,180,140,80,0,0,0,400
11482,180,140,80,80,0,0,480
11483,200,120,80,160,320,320,1200
11484,190,160,160,160,160,0,830
11485,220,160,120,80,160,0,740
11486,220,140,80,80,160,0,680
11487,160,180,120,80,160,0,700
11488,160,60,40,80,0,0,340
11489,230,120,120,80,0,0,550
11490,200,80,80,80,160,0,600
11491,240,160,160,160,0,0,720
11492,210,60,40,0,0,0,310
11493,200,180,80,160,160,0,780
11494,170,120,160,160,160,0,770
11495,140,120,40,80,160,0,540
11496,230,140,80,160,320,0,930
11497,220,120,120,80,0,0,540
11498,200,80,80,80,0,0,440
11499,140,80,120,160,0,0,500
11500,180,100,120,160,0,0,560
11501,250,200,200,80,0,0,730
11502,280,140,120,160,160,0,860
11503,140,120,120,80,160,0,620
11504,200,100,40,80,0,0,420
11505,210,100,80,0,0,0,390
11506,190,120,160,240,0,0,710
11507,170,80,80,80,0,0,410
11508,190,120,160,160,160,0,790
11509,210,80,40,0,0,0,330
11510,170,120,160,80,160,0,690
11511,170,80,80,160,320,0,810
11512,200,140,120,80,160,0,700
11513,200,140,120,160,160,0,780
11514,190,120,120,0,0,0,430
11515,190,160,80,0,0,0,430
11516,200,120,120,160,0,0,600
11517,220,140,120,160,160,0,800
11518,190,160,120,80,0,0,550
11519,220,140,80,80,160,320,1000
11520,170,80,80,80,160,0,570
11521,210,120,120,160,320,0,930
11522,220,160,80,80,160,0,700
11523,190,120,120,160,0,0,590
11524,190,100,80,80,160,0,610
11525,230,120,160,240,320,0,1070
11526,200,80,120,160,320,0,880
11527,220,120,160,240,160,0,900
11528,190,60,40,0,0,0,290
11529,180,100,40,80,0,0,400
11530,180,120,120,160,320,0,900
11531,210,160,160,160,0,0,690
11532,220,100,80,80,0,0,480
11533,170,100,120,0,0,0,390
11534,230,140,120,160,320,0,970
11535,200,160,200,160,0,0,720
11536,200,100,40,80,0,0,420
11537,180,120,80,160,160,0,700
11538,220,100,40,80,160,0,600
11539,180,80,80,160,320,320,1140
11540,250,120,120,160,160,0,810
11541,190,100,120,80,160,0,650
11542,160,140,80,0,0,0,380
11543,230,140,120,80,160,0,730
11544,130,60,80,80,160,0,510
11545,220,100,120,0,0,0,440
11546,130,60,40,80,160,0,470
11547,210,80,120,80,0,0,490
11548,190,120,40,80,160,320,910
11549,200,160,120,80,0,0,560
11550,230,140,160,160,320,0,1010
11551,220,160,160,160,160,0,860
11552,260,160,200,160,0,0,780
11553,210,160,160,160,320,0,1010
11554,190,160,120,0,0,0,470
11555,220,140,200,80,0,0,640
11556,200,100,40,0,0,0,340
11557,200,140,160,160,160,0,820
11558,180,100,80,80,160,0,600
11559,190,100,0,0,0,0,290
11560,190,20,40,80,160,0,490
11561,170,120,80,0,0,0,370
11562,200,160,80,0,0,0,440
11563,210,100,80,160,160,320,1030
11564,210,160,200,240,160,0,970
11565,200,160,120,160,0,0,640
11566,220,120,120,80,160,0,700
11567,170,80,80,160,160,0,650
11568,210,160,160,160,160,320,1170
11569,170,120,160,160,320,0,930
11570,210,120,40,0,0,0,370
11571,170,100,80,0,0,0,350
11572,150,140,120,160,160,0,730
11573,200,40,80,80,160,0,560
11574,170,100,120,80,160,320,950
11575,140,80,80,80,160,0,540
11576,200,100,80,0,0,0,380
11577,140,120,120,160,0,0,540
11578,200,100,120,240,320,0,980
11579,200,160,120,80,160,320,1040
11580,180,80,40,80,0,0,380
11581,160,100,120,160,0,0,540
11582,230,140,80,80,160,320,1010
11583,210,140,80,160,320,0,910
11584,200,120,80,80,0,0,480
11585,170,60,80,0,0,0,310
11586,190,120,160,320,160,320,1270
11587,180,100,80,80,160,0,600
11588,190,120,80,0,0,0,390
11589,220,100,160,80,0,0,560
11590,210,120,120,80,0,0,530
11591,170,80,40,80,0,0,370
11592,220,100,80,160,320,0,880
11593,210,80,120,0,0,0,410
11594,180,160,80,0,0,0,420
11595,170,100,120,160,320,0,870
11596,210,120,80,80,160,0,650
11597,200,80,80,80,160,0,600
11598,150,100,80,80,160,0,570
11599,220,120,80,160,160,320,1060
11600,200,80,80,0,0,0,360
11601,180,60,80,160,160,320,960
11602,210,120,120,160,160,0,770
11603,170,140,120,80,0,0,510
11604,220,100,0,0,0,0,320
11605,200,140,120,80,0,0,540
11606,170,140,160,80,160,0,710
11607,210,120,120,160,320,0,930
11608,180,120,120,80,0,0,500
11609,200,120,120,80,0,0,520
11610,160,160,80,80,160,0,640
11611,170,60,80,80,160,0,550
11612,200,160,40,0,0,0,400
11613,200,140,40,0,0,0,380
11614,200,120,80,80,160,0,640
11615,200,160,160,80,0,0,600
11616,240,140,80,80,160,0,700
11617,200,100,120,160,320,0,900
11618,200,120,160,160,160,0,800
11619,160,120,160,80,0,0,520
11620,190,80,120,80,160,320,950
11621,220,120,120,160,160,0,780
11622,210,120,120,80,160,0,690
11623,210,160,160,80,160,0,770
11624,220,100,120,80,160,0,680
11625,190,120,120,160,0,0,590
11626,210,180,160,160,160,0,870
11627,170,140,120,0,0,0,430
11628,200,140,120,160,160,320,1100
11629,240,120,120,80,0,0,560
11630,180,140,80,80,160,0,640
11631,180,120,120,80,160,0,660
11632,220,160,80,0,0,0,460
11633,200,100,80,0,0,0,380
11634,170,120,120,0,0,0,410
11635,190,120,120,80,160,0,670
11636,210,140,80,80,0,0,510
11637,240,140,120,160,160,0,820
11638,220,160,120,0,0,0,500
11639,230,180,80,160,160,0,810
11640,210,120,80,80,160,0,650
11641,200,160,120,80,160,0,720
11642,200,160,120,80,0,0,560
11643,210,160,120,80,160,0,730
11644,260,160,160,160,320,0,1060
11645,250,140,120,80,160,0,750
11646,230,120,80,80,160,0,670
11647,200,120,80,80,0,0,480
11648,240,160,80,80,160,0,720
11649,190,120,120,80,0,0,510
11650,150,120,160,0,0,0,430
11651,180,100,120,160,320,320,1200
11652,190,140,200,80,0,0,610
11653,200,160,120,0,0,0,480
11654,190,80,0,0,0,0,270
11655,230,120,120,160,320,0,950
11656,200,140,80,80,160,0,660
11657,190,120,120,80,0,0,510
11658,170,80,80,160,320,0,810
11659,180,120,120,80,160,0,660
11660,200,140,120,80,160,0,700
11661,180,100,120,80,160,0,640
11662,210,180,200,80,0,0,670
11663,200,140,120,160,320,320,1260
11664,190,120,40,80,0,0,430
11665,170,80,160,160,0,0,570
11666,200,140,200,160,160,0,860
11667,210,160,40,80,0,0,490
11668,140,80,120,160,160,0,660
11669,180,60,80,80,0,0,400
11670,200,160,160,160,160,0,840
11671,240,120,120,160,320,0,960
11672,200,120,120,80,160,0,680
11673,240,160,120,160,160,0,840
11674,200,100,80,80,0,0,460
11675,220,140,160,160,320,0,1000
11676,190,140,160,240,0,0,730
11677,180,120,160,160,0,0,620
11678,210,140,120,80,0,0,550
11679,220,80,120,80,0,0,500
11680,160,100,40,80,160,320,860
11681,190,120,80,160,160,0,710
11682,200,120,200,160,160,0,840
11683,180,140,120,0,0,0,440
11684,190,120,120,160,160,0,750
11685,200,100,120,160,0,0,580
11686,250,100,40,80,160,0,630
11687,200,120,80,80,160,0,640
11688,210,140,80,80,160,0,670
11689,180,100,120,160,0,0,560
11690,210,120,80,80,160,0,650
11691,170,60,120,160,160,0,670
11692,180,80,80,0,0,0,340
11693,180,140,120,0,0,0,440
11694,210,120,0,0,0,0,330
11695,180,120,80,80,0,0,460
11696,180,140,120,80,0,0,520
11697,210,160,120,80,160,320,1050
11698,230,120,120,80,0,0,550
11699,180,120,160,80,160,0,700
11700,220,120,80,80,160,0,660
11701,190,140,160,80,0,0,570
11702,230,80,40,80,160,0,590
11703,190,140,120,160,160,320,1090
11704,150,100,120,160,320,0,850
11705,220,180,200,80,0,0,680
11706,180,120,120,0,0,0,420
11707,160,120,80,160,160,0,680
11708,190,140,200,80,160,0,770
11709,200,120,120,80,160,0,680
11710,190,160,120,160,160,0,790
11711,210,140,200,0,0,0,550
11712,240,100,0,0,0,0,340
11713,170,60,40,0,0,0,270
11714,160,120,80,80,0,0,440
11715,230,120,240,240,160,0,990
11716,200,140,80,80,160,320,980
11717,170,140,80,80,160,0,630
11718,160,80,80,0,0,0,320
11719,160,160,120,160,160,0,760
11720,230,180,120,80,160,0,770
11721,180,100,120,80,160,0,640
11722,180,140,160,160,160,0,800
11723,160,100,120,0,0,0,380
11724,220,80,120,0,0,0,420
11725,170,140,120,240,320,320,1310
11726,200,140,120,160,320,320,1260
11727,230,120,40,80,160,0,630
11728,210,120,40,0,0,0,370
11729,220,120,40,80,160,0,620
11730,190,60,40,0,0,0,290
11731,210,140,80,80,160,0,670
11732,180,160,80,0,0,0,420
11733,190,120,40,80,0,0,430
11734,210,140,80,80,160,0,670
11735,200,60,80,160,320,0,820
11736,230,60,80,0,0,0,370
11737,140,100,120,160,160,0,680
11738,190,140,80,80,0,0,490
11739,190,120,120,0,0,0,430
11740,190,140,120,240,320,0,1010
11741,210,120,80,160,160,0,730
11742,200,120,120,80,0,0,520
11743,200,100,120,80,160,0,660
11744,220,120,80,80,160,0,660
11745,220,220,120,0,0,0,560
11746,180,100,80,0,0,0,360
11747,150,100,80,160,160,320,970
11748,200,120,80,0,0,0,400
11749,190,100,120,160,160,0,730
11750,210,160,80,80,160,0,690
11751,220,60,0,0,0,0,280
11752,180,160,200,160,160,0,860
11753,180,80,120,0,0,0,380
11754,190,200,120,0,0,0,510
11755,200,80,80,160,160,0,680
11756,220,160,120,160,160,0,820
11757,210,120,120,80,160,0,690
11758,130,120,120,160,0,0,530
11759,200,120,120,80,0,0,520
11760,180,160,120,160,320,0,940
11761,230,160,120,0,0,0,510
11762,190,100,40,80,0,0,410
11763,190,140,80,160,320,0,890
11764,170,120,120,80,160,0,650
11765,190,80,40,0,0,0,310
11766,200,180,120,80,160,320,1060
11767,190,120,80,160,160,320,1030
11768,150,160,80,80,160,0,630
11769,220,100,80,160,160,320,1040
11770,210,160,80,80,160,0,690
11771,200,100,160,80,160,0,700
11772,190,160,160,160,0,0,670
11773,180,80,80,0,0,0,340
11774,200,100,80,0,0,0,380
11775,190,140,40,80,160,0,610
11776,200,140,80,160,160,0,740
11777,210,80,120,160,0,0,570
11778,230,140,120,80,160,0,730
11779,210,80,120,160,160,320,1050
11780,180,140,160,160,320,0,960
11781,220,100,160,80,160,0,720
11782,190,140,160,80,160,0,730
11783,170,120,120,0,0,0,410
11784,210,100,80,80,160,320,950
11785,130,60,120,160,320,320,1110
11786,250,160,120,80,160,0,770
11787,200,100,120,160,160,320,1060
11788,200,180,200,80,0,0,660
11789,170,80,80,160,320,0,810
11790,140,80,120,240,160,0,740
11791,210,120,160,160,320,0,970
11792,210,160,80,0,0,0,450
11793,200,120,120,80,0,0,520
11794,190,160,160,80,160,0,750
11795,190,60,40,0,0,0,290
11796,180,120,160,80,160,0,700
11797,210,140,80,80,160,0,670
11798,220,160,80,80,0,0,540
11799,190,100,120,80,160,0,650
11800,190,100,80,80,160,0,610
11801,190,100,120,80,0,0,490
11802,210,140,80,80,160,0,670
11803,190,120,40,0,0,0,350
11804,170,100,120,0,0,0,390
11805,250,120,120,80,160,0,730
11806,140,100,120,160,160,0,680
11807,240,140,120,80,160,320,1060
11808,230,120,120,160,160,320,1110
11809,160,80,0,0,0,0,240
11810,210,140,40,0,0,0,390
11811,210,60,120,80,0,0,470
11812,230,120,160,80,0,0,590
11813,200,120,80,80,160,0,640
11814,180,160,240,80,160,0,820
11815,200,80,80,0,0,0,360
11816,180,140,160,80,160,320,1040
11817,200,140,120,160,160,320,1100
11818,240,120,80,80,160,0,680
11819,230,180,160,80,0,0,650
11820,200,120,120,80,0,0,520
11821,230,140,80,80,160,0,690
11822,180,140,120,80,0,0,520
11823,190,100,120,80,160,0,650
11824,200,120,200,240,0,0,760
11825,220,100,120,160,160,0,760
11826,220,100,80,80,160,0,640
11827,220,160,160,240,0,0,780
11828,210,120,40,0,0,0,370
11829,240,220,160,240,160,0,1020
11830,220,140,160,160,160,0,840
11831,190,120,80,80,0,0,470
11832,220,160,160,160,320,320,1340
11833,170,120,40,0,0,0,330
11834,180,120,160,80,0,0,540
11835,200,100,160,80,0,0,540
11836,180,60,0,0,0,0,240
11837,240,140,120,160,160,320,1140
11838,230,120,80,80,160,0,670
11839,220,80,80,160,160,0,700
11840,190,120,120,80,0,0,510
11841,200,120,160,80,160,0,720
11842,200,120,80,0,0,0,400
11843,200,160,160,80,0,0,600
11844,180,140,80,0,0,0,400
11845,160,140,120,160,0,0,580
11846,160,100,40,0,0,0,300
11847,220,120,80,0,0,0,420
11848,210,160,80,80,0,0,530
11849,190,100,0,0,0,0,290
11850,230,140,160,240,160,320,1250
11851,160,140,160,80,160,0,700
11852,190,160,160,160,160,0,830
11853,200,100,120,160,160,0,740
11854,190,60,0,0,0,0,250
11855,130,60,80,0,0,0,270
11856,190,120,120,160,0,0,590
11857,190,120,120,80,160,0,670
11858,180,160,80,80,160,320,980
11859,200,140,160,160,0,0,660
11860,230,140,80,80,160,320,1010
11861,220,160,120,160,160,0,820
11862,190,140,160,240,320,0,1050
11863,190,100,200,80,0,0,570
11864,190,180,160,240,160,0,930
11865,230,200,80,80,0,0,590
11866,220,140,80,80,0,0,520
11867,200,160,160,160,160,0,840
11868,210,100,120,160,160,0,750
11869,210,100,120,80,0,0,510
11870,180,120,160,80,0,0,540
11871,180,180,80,160,0,0,600
11872,240,160,120,80,160,320,1080
11873,210,140,80,160,160,0,750
11874,190,160,40,0,0,0,390
11875,210,100,80,0,0,0,390
11876,170,80,120,80,0,0,450
11877,210,100,120,160,160,0,750
11878,190,80,120,160,320,0,870
11879,220,120,120,80,0,0,540
11880,180,140,160,160,0,0,640
11881,200,120,120,160,160,0,760
11882,200,140,160,0,0,0,500
11883,200,140,120,80,160,0,700
11884,180,140,120,240,160,0,840
11885,190,160,160,160,160,0,830
11886,160,80,40,0,0,0,280
11887,220,60,120,80,0,0,480
11888,200,140,80,80,160,0,660
11889,190,80,120,160,160,0,710
11890,200,140,120,80,160,0,700
11891,170,100,80,80,160,0,590
11892,190,100,120,80,160,320,970
11893,220,100,80,0,0,0,400
11894,190,140,80,80,160,0,650
11895,190,100,80,0,0,0,370
11896,200,140,40,0,0,0,380
11897,200,60,0,0,0,0,260
11898,230,100,120,80,0,0,530
11899,190,200,200,160,160,0,910
11900,190,100,160,160,320,320,1250
11901,170,160,160,160,160,0,810
11902,180,100,80,160,160,320,1000
11903,180,140,120,160,0,0,600
11904,200,140,80,160,160,0,740
11905,200,120,80,160,160,0,720
11906,210,140,120,0,0,0,470
11907,200,100,120,160,160,320,1060
11908,210,80,80,160,320,0,850
11909,210,120,120,80,0,0,530
11910,220,140,160,240,160,0,920
11911,190,140,40,80,160,0,610
11912,180,80,80,80,160,0,580
11913,210,100,120,240,160,0,830
11914,200,100,80,80,160,0,620
11915,200,120,120,160,160,320,1080
11916,190,80,40,80,160,0,550
11917,220,120,40,80,160,0,620
11918,190,60,40,80,160,0,530
11919,170,120,40,0,0,0,330
11920,160,140,80,80,0,0,460
11921,200,100,160,160,160,320,1100
11922,200,120,120,240,160,0,840
11923,200,60,80,80,160,0,580
11924,200,120,40,0,0,0,360
11925,190,100,120,80,0,0,490
11926,190,140,200,80,160,0,770
11927,170,80,120,80,0,0,450
11928,190,120,160,240,320,0,1030
11929,170,140,160,160,160,0,790
11930,200,120,80,160,0,0,560
11931,190,80,120,160,160,0,710
11932,200,140,120,80,160,0,700
11933,190,120,160,240,320,0,1030
11934,230,140,120,160,0,0,650
11935,180,160,160,160,160,0,820
11936,180,120,120,80,0,0,500
11937,200,80,80,0,0,0,360
11938,190,80,160,160,160,0,750
11939,220,140,80,80,160,320,1000
11940,180,80,80,0,0,0,340
11941,220,160,160,160,160,0,860
11942,190,100,120,240,160,0,810
11943,220,80,0,0,0,0,300
11944,190,100,80,80,0,0,450
11945,190,140,80,0,0,0,410
11946,150,100,120,160,160,0,690
11947,200,160,80,80,0,0,520
11948,220,120,120,160,160,0,780
11949,200,140,120,160,0,0,620
11950,220,100,40,0,0,0,360
11951,210,140,240,160,160,0,910
11952,190,80,80,160,160,0,670
11953,220,140,160,240,160,320,1240
11954,230,160,240,240,320,0,1190
11955,190,180,200,160,160,0,890
11956,190,100,120,80,160,320,970
11957,210,140,0,0,0,0,350
11958,200,140,120,160,0,0,620
11959,160,120,80,160,160,320,1000
11960,210,100,40,80,160,0,590
11961,220,120,80,160,160,0,740
11962,150,100,120,80,160,0,610
11963,230,160,120,80,0,0,590
11964,270,180,120,160,160,0,890
11965,210,160,200,160,0,0,730
11966,200,100,120,240,160,320,1140
11967,170,140,160,160,160,320,1110
11968,180,80,80,160,160,0,660
11969,220,160,120,160,160,0,820
11970,210,100,80,0,0,0,390
11971,200,140,120,80,160,0,700
11972,210,120,120,80,160,0,690
11973,160,140,120,80,160,320,980
11974,200,60,40,80,0,0,380
11975,170,120,120,80,0,0,490
11976,180,60,80,80,0,0,400
11977,200,140,80,80,0,0,500
11978,190,100,120,80,160,320,970
11979,180,140,120,160,160,0,760
11980,180,160,200,80,0,0,620
11981,190,120,120,160,0,0,590
11982,240,180,200,160,160,0,940
11983,220,140,80,80,0,0,520
11984,240,160,80,80,0,0,560
11985,250,140,40,0,0,0,430
11986,210,100,120,160,0,0,590
11987,190,160,160,160,0,0,670
11988,200,180,120,0,0,0,500
11989,190,160,200,240,320,320,1430
11990,180,100,120,80,0,0,480
11991,240,180,120,80,0,0,620
11992,190,60,40,80,0,0,370
11993,190,60,120,80,160,0,610
11994,210,100,80,80,0,0,470
11995,160,140,120,240,0,0,660
11996,200,160,120,160,320,0,960
11997,210,140,40,80,160,0,630
11998,200,120,80,80,160,320,960
11999,200,160,80,160,160,0,760
12000,210,180,120,240,320,320,1390
12001,200,120,120,160,160,320,1080
12002,190,140,200,160,0,0,690
12003,190,120,80,80,160,0,630
12004,230,160,160,80,160,0,790
12005,150,80,120,80,160,0,590
12006,200,120,120,240,160,0,840
12007,170,100,120,80,160,0,630
12008,190,80,80,80,160,0,590
12009,160,140,80,0,0,0,380
12010,200,120,160,240,160,0,880
12011,170,80,40,80,160,0,530
12012,180,100,40,0,0,0,320
12013,160,100,160,80,0,0,500
12014,170,140,120,80,160,0,670
12015,250,180,120,240,320,320,1430
12016,160,120,80,0,0,0,360
12017,220,80,80,0,0,0,380
12018,200,100,120,240,0,0,660
12019,200,100,80,80,160,0,620
12020,170,140,160,240,160,0,870
12021,190,160,120,160,0,0,630
12022,190,120,40,80,0,0,430
12023,180,160,80,80,160,0,660
12024,180,100,80,0,0,0,360
12025,180,80,0,0,0,0,260
12026,180,80,40,80,160,0,540
12027,180,140,40,80,0,0,440
12028,180,120,120,160,0,0,580
12029,200,100,80,80,0,0,460
12030,220,140,160,160,320,0,1000
12031,180,160,120,0,0,0,460
12032,170,100,40,0,0,0,310
12033,210,120,40,80,0,0,450
12034,180,160,160,240,160,0,900
12035,170,80,0,0,0,0,250
12036,220,160,120,80,0,0,580
12037,210,120,80,80,0,0,490
12038,190,180,120,0,0,0,490
12039,190,100,80,80,0,0,450
12040,160,100,80,80,160,0,580
12041,210,120,80,80,160,0,650
12042,190,120,80,80,0,0,470
12043,200,120,40,80,0,0,440
12044,180,120,120,80,0,0,500
12045,200,140,120,80,0,0,540
12046,240,100,160,0,0,0,500
12047,210,120,80,0,0,0,410
12048,230,160,80,0,0,0,470
12049,200,160,200,80,160,320,1120
12050,180,160,160,160,320,0,980
12051,180,140,120,80,160,320,1000
12052,220,160,80,0,0,0,460
12053,170,100,80,80,160,0,590
12054,200,120,120,160,320,0,920
12055,200,60,0,0,0,0,260
12056,190,80,80,0,0,0,350
12057,230,140,80,0,0,0,450
12058,220,120,160,160,160,0,820
12059,210,160,80,80,160,0,690
12060,210,120,160,160,320,0,970
12061,180,80,120,80,160,0,620
12062,200,140,160,160,160,320,1140
12063,230,140,80,160,160,0,770
12064,200,100,80,160,320,0,860
12065,190,120,80,160,0,0,550
12066,210,100,80,80,0,0,470
12067,240,120,120,0,0,0,480
12068,190,100,160,160,320,320,1250
12069,220,120,120,80,160,0,700
12070,160,100,120,0,0,0,380
12071,210,120,120,160,160,0,770
12072,170,120,160,80,160,0,690
12073,200,80,120,240,320,0,960
12074,220,80,80,80,160,0,620
12075,190,100,120,160,320,0,890
12076,200,120,120,160,0,0,600
12077,200,120,80,80,160,0,640
12078,150,180,160,80,0,0,570
12079,180,140,120,160,0,0,600
12080,270,140,120,80,160,0,770
12081,160,140,160,80,160,0,700
12082,220,180,160,160,320,0,1040
12083,190,140,120,160,160,0,770
12084,210,100,120,160,160,0,750
12085,180,120,160,160,160,320,1100
12086,190,160,160,80,0,0,590
12087,180,120,120,80,160,0,660
12088,170,120,80,160,160,0,690
12089,190,140,120,80,160,0,690
12090,220,160,160,240,0,0,780
12091,150,100,80,80,160,0,570
12092,220,100,40,80,0,0,440
12093,220,100,160,160,320,0,960
12094,190,120,80,160,160,0,710
12095,210,120,120,160,320,320,1250
12096,200,160,120,80,160,0,720
12097,170,120,160,80,160,0,690
12098,170,120,0,0,0,0,290
12099,160,100,120,160,160,0,700
12100,150,100,40,0,0,0,290
12101,200,120,80,0,0,0,400
12102,180,140,80,160,0,0,560
12103,180,100,120,240,0,0,640
12104,220,160,80,160,160,320,1100
12105,210,160,200,160,160,0,890
12106,260,160,120,80,160,0,780
12107,200,120,80,160,160,0,720
12108,250,140,80,80,160,0,710
12109,200,160,120,240,320,0,1040
12110,190,100,80,160,160,0,690
12111,190,140,80,160,320,0,890
12112,200,180,80,80,160,0,700
12113,190,100,80,80,0,0,450
12114,200,100,80,80,160,0,620
12115,140,100,80,80,0,0,400
12116,180,140,200,160,160,0,840
12117,190,120,160,160,160,0,790
12118,180,40,40,80,160,320,820
12119,200,120,120,160,160,0,760
12120,190,120,80,80,0,0,470
12121,170,140,160,80,0,0,550
12122,210,100,120,160,320,0,910
12123,190,100,120,0,0,0,410
12124,160,100,80,0,0,0,340
12125,210,120,80,80,160,0,650
12126,150,60,120,80,160,320,890
12127,200,140,40,0,0,0,380
12128,180,60,40,0,0,0,280
12129,210,80,40,80,0,0,410
12130,170,100,80,160,320,320,1150
12131,200,120,120,80,160,0,680
12132,220,140,160,80,0,0,600
12133,220,120,80,160,160,0,740
12134,270,200,80,160,320,320,1350
12135,210,160,120,80,0,0,570
12136,170,120,120,160,320,320,1210
12137,220,120,80,0,0,0,420
12138,200,160,80,0,0,0,440
12139,190,80,160,0,0,0,430
12140,180,80,120,160,160,0,700
12141,190,120,80,80,160,0,630
12142,190,120,80,0,0,0,390
12143,200,80,80,80,0,0,440
12144,200,140,120,80,0,0,540
12145,190,140,80,80,160,0,650
12146,180,120,120,160,320,320,1220
12147,180,120,80,160,160,0,700
12148,180,140,120,80,160,320,1000
12149,180,100,120,80,160,0,640
12150,120,120,120,160,160,320,1000
12151,180,120,80,80,0,0,460
12152,210,100,40,80,160,0,590
12153,180,60,40,0,0,0,280
12154,210,140,120,80,0,0,550
12155,180,120,80,80,0,0,460
12156,200,140,80,160,0,0,580
12157,170,140,40,80,160,0,590
12158,180,180,120,240,160,0,880
12159,220,80,40,80,160,0,580
12160,210,160,120,240,320,0,1050
12161,180,120,160,160,320,320,1260
12162,220,120,80,0,0,0,420
12163,200,100,80,80,160,0,620
12164,180,100,80,0,0,0,360
12165,200,140,0,0,0,0,340
12166,190,100,120,240,320,320,1290
12167,220,120,80,80,160,320,980
12168,200,120,160,80,160,0,720
12169,160,60,40,80,0,0,340
12170,210,120,120,160,160,0,770
12171,190,120,120,0,0,0,430
12172,190,80,80,80,160,0,590
12173,200,120,120,160,160,0,760
12174,170,140,120,160,160,0,750
12175,160,100,120,240,160,0,780
12176,180,100,40,80,0,0,400
12177,210,80,80,80,160,0,610
12178,190,140,120,160,160,0,770
12179,220,200,120,80,0,0,620
12180,180,120,80,80,160,0,620
12181,190,140,80,80,160,320,970
12182,210,200,160,80,0,0,650
12183,200,140,120,160,160,320,1100
12184,180,140,120,80,160,0,680
12185,230,80,80,160,160,0,710
12186,200,60,80,80,0,0,420
12187,210,120,160,160,160,0,810
12188,230,160,120,0,0,0,510
12189,180,140,120,0,0,0,440
12190,190,80,120,80,160,320,950
12191,200,140,120,160,160,0,780
12192,180,100,80,0,0,0,360
12193,180,160,80,160,160,0,740
12194,190,80,80,80,160,0,590
12195,170,120,120,80,0,0,490
12196,170,160,120,80,0,0,530
12197,210,140,80,160,160,320,1070
12198,180,140,120,80,0,0,520
12199,210,100,40,80,160,0,590
12200,250,140,160,80,0,0,630
12201,170,60,80,0,0,0,310
12202,200,120,80,80,160,0,640
12203,190,160,120,80,160,0,710
12204,180,120,80,80,0,0,460
12205,230,120,80,0,0,0,430
12206,200,100,40,0,0,0,340
12207,210,140,120,160,160,0,790
12208,200,60,40,0,0,0,300
12209,190,100,120,80,0,0,490
12210,200,120,120,80,160,0,680
12211,230,120,120,0,0,0,470
12212,180,100,80,80,160,0,600
12213,180,140,120,80,160,320,1000
12214,180,140,160,160,160,0,800
12215,170,160,120,160,0,0,610
12216,200,160,80,0,0,0,440
12217,240,160,80,80,160,0,720
12218,230,80,80,160,160,0,710
12219,220,140,80,0,0,0,440
12220,200,80,80,80,0,0,440
12221,200,100,160,160,160,0,780
12222,210,100,160,160,160,0,790
12223,200,100,80,0,0,0,380
12224,220,200,120,160,160,0,860
12225,180,200,120,80,160,320,1060
12226,180,140,120,160,0,0,600
12227,220,140,80,80,0,0,520
12228,190,120,120,80,0,0,510
12229,160,160,80,80,160,0,640
12230,210,160,120,80,0,0,570
12231,190,120,80,80,160,0,630
12232,170,140,40,80,0,0,430
12233,210,180,160,80,0,0,630
12234,190,140,80,0,0,0,410
12235,220,160,200,160,160,0,900
12236,210,140,120,0,0,0,470
12237,180,120,40,80,160,0,580
12238,180,100,120,80,0,0,480
12239,170,140,160,160,320,0,950
12240,130,100,80,160,160,0,630
12241,200,180,200,160,160,0,900
12242,230,120,80,80,160,320,990
12243,210,160,160,80,160,0,770
12244,190,100,80,0,0,0,370
12245,210,140,40,80,160,0,630
12246,170,140,120,80,160,0,670
12247,220,100,80,0,0,0,400
12248,170,140,160,160,160,0,790
12249,210,120,80,80,160,0,650
12250,190,120,80,0,0,0,390
12251,200,160,120,80,160,0,720
12252,190,120,120,160,160,320,1070
12253,190,60,0,0,0,0,250
12254,230,140,160,160,160,0,850
12255,210,120,160,240,160,0,890
12256,170,80,80,0,0,0,330
12257,170,100,120,160,0,0,550
12258,200,100,80,160,160,0,700
12259,180,140,160,80,160,0,720
12260,160,100,120,80,0,0,460
12261,200,100,160,80,160,0,700
12262,160,140,200,160,0,0,660
12263,190,140,80,80,0,0,490
12264,180,140,80,0,0,0,400
12265,240,180,120,160,320,0,1020
12266,190,120,40,0,0,0,350
12267,210,160,120,160,0,0,650
12268,240,140,160,80,160,0,780
12269,250,180,200,80,0,0,710
12270,180,60,40,80,160,0,520
12271,210,160,120,160,0,0,650
12272,190,120,120,80,0,0,510
12273,180,140,80,80,160,0,640
12274,210,180,160,240,0,0,790
12275,190,120,120,160,0,0,590
12276,180,180,200,80,160,320,1120
12277,220,140,160,160,160,320,1160
12278,200,120,200,80,160,320,1080
12279,180,140,120,80,160,320,1000
12280,240,80,80,80,160,0,640
12281,180,100,40,80,160,320,880
12282,200,200,40,80,160,0,680
12283,170,120,120,160,320,0,890
12284,180,120,120,80,160,0,660
12285,190,100,160,80,160,320,1010
12286,190,100,80,80,0,0,450
12287,200,160,160,240,160,320,1240
12288,190,100,80,0,0,0,370
12289,170,100,80,160,160,0,670
12290,180,100,120,160,0,0,560
12291,230,160,160,160,160,0,870
12292,160,160,160,240,160,0,880
12293,230,140,40,0,0,0,410
12294,180,100,120,160,160,0,720
12295,230,220,160,80,0,0,690
12296,230,120,80,160,160,0,750
12297,240,200,160,160,160,320,1240
12298,230,160,160,240,160,0,950
12299,210,120,40,80,160,0,610
12300,220,80,120,80,160,0,660
12301,190,160,160,240,160,320,1230
12302,250,160,120,80,160,0,770
12303,160,100,120,160,160,320,1020
12304,180,60,80,160,160,0,640
12305,160,80,0,0,0,0,240
12306,200,160,160,240,320,0,1080
12307,230,180,200,80,160,0,850
12308,190,80,80,80,160,320,910
12309,210,140,40,0,0,0,390
12310,170,80,80,160,160,0,650
12311,170,80,80,80,160,0,570
12312,190,120,160,160,320,320,1270
12313,190,120,80,80,160,0,630
12314,160,100,40,80,160,320,860
12315,160,140,80,160,160,0,700
12316,200,80,40,0,0,0,320
12317,200,120,120,0,0,0,440
12318,190,160,80,160,320,0,910
12319,220,180,120,80,0,0,600
12320,210,160,120,160,160,320,1130
12321,190,140,40,80,0,0,450
12322,160,100,40,80,160,320,860
12323,210,200,80,80,0,0,570
12324,200,140,40,0,0,0,380
12325,190,160,80,0,0,0,430
12326,240,80,80,0,0,0,400
12327,160,140,120,160,160,0,740
12328,180,80,80,160,160,0,660
12329,210,100,160,240,320,320,1350
12330,200,100,40,0,0,0,340
12331,200,80,0,0,0,0,280
12332,190,100,120,160,320,320,1210
12333,180,160,120,160,160,0,780
12334,180,100,80,80,0,0,440
12335,180,100,40,80,160,320,880
12336,200,160,80,160,160,0,760
12337,220,180,160,80,160,320,1120
12338,260,140,160,80,160,0,800
12339,190,140,160,160,160,0,810
12340,230,100,80,160,160,0,730
12341,210,180,160,80,160,0,790
12342,200,120,80,80,160,0,640
12343,190,120,120,80,0,0,510
12344,180,120,120,160,160,0,740
12345,130,120,80,160,160,0,650
12346,210,120,120,80,0,0,530
12347,200,140,160,80,0,0,580
12348,240,120,120,160,320,0,960
12349,170,120,120,80,160,0,650
12350,190,160,120,160,0,0,630
12351,200,40,40,0,0,0,280
12352,180,100,80,160,160,320,1000
12353,210,180,240,160,0,0,790
12354,240,140,120,160,320,0,980
12355,160,140,160,160,0,0,620
12356,190,120,80,80,0,0,470
12357,150,60,0,0,0,0,210
12358,220,60,80,80,160,0,600
12359,210,120,120,80,0,0,530
12360,220,200,200,160,160,320,1260
12361,170,100,120,80,160,320,950
12362,180,120,160,80,0,0,540
12363,180,120,80,160,160,0,700
12364,200,120,80,80,0,0,480
12365,190,120,160,160,320,320,1270
12366,200,120,0,0,0,0,320
12367,190,140,120,80,160,0,690
12368,190,140,80,80,0,0,490
12369,160,100,120,160,320,320,1180
12370,190,140,160,240,320,0,1050
12371,170,160,80,80,0,0,490
12372,190,120,120,160,0,0,590
12373,200,120,120,80,0,0,520
12374,210,180,160,160,160,0,870
12375,220,60,40,0,0,0,320
12376,210,140,120,160,0,0,630
12377,220,160,120,160,160,0,820
12378,190,140,80,80,160,0,650
12379,200,100,160,80,160,0,700
12380,160,120,120,240,160,0,800
12381,180,120,80,80,0,0,460
12382,180,100,40,0,0,0,320
12383,180,120,80,80,160,320,940
12384,190,140,120,160,320,0,930
12385,250,180,160,160,0,0,750
12386,170,80,80,0,0,0,330
12387,170,100,160,240,0,0,670
12388,220,200,160,160,320,0,1060
12389,210,120,120,160,160,0,770
12390,170,60,0,0,0,0,230
12391,200,100,80,80,160,0,620
12392,200,120,80,160,160,0,720
12393,180,60,80,160,160,0,640
12394,190,120,160,240,160,0,870
12395,210,60,80,80,160,0,590
12396,180,180,200,160,160,320,1200
12397,160,80,80,80,0,0,400
12398,170,80,120,240,160,0,770
12399,190,140,160,80,0,0,570
12400,160,100,80,80,0,0,420
12401,200,100,120,160,160,0,740
12402,140,100,80,160,320,0,800
12403,220,140,120,80,160,0,720
12404,220,160,120,160,0,0,660
12405,180,180,200,160,160,0,880
12406,150,120,80,160,160,0,670
12407,200,200,160,80,160,0,800
12408,210,160,120,0,0,0,490
12409,200,160,160,240,160,0,920
12410,200,140,160,240,160,0,900
12411,200,140,120,80,160,0,700
12412,170,80,40,0,0,0,290
12413,210,120,160,80,160,0,730
12414,230,80,0,0,0,0,310
12415,210,120,120,80,160,0,690
12416,210,120,80,80,160,0,650
12417,190,140,160,160,0,0,650
12418,180,140,80,80,160,0,640
12419,180,60,80,80,160,0,560
12420,210,140,160,240,160,0,910
12421,210,120,160,80,160,0,730
12422,170,120,160,0,0,0,450
12423,170,140,80,80,160,0,630
12424,260,140,80,0,0,0,480
12425,200,80,80,80,0,0,440
12426,190,80,120,160,160,0,710
12427,190,120,80,80,160,0,630
12428,150,140,80,80,0,0,450
12429,180,140,120,0,0,0,440
12430,160,140,200,160,160,0,820
12431,180,140,80,80,160,320,960
12432,210,100,40,80,0,0,430
12433,240,140,80,160,160,0,780
12434,190,120,160,240,160,0,870
12435,210,140,120,80,0,0,550
12436,170,160,200,80,0,0,610
12437,180,60,80,0,0,0,320
12438,240,160,200,80,160,0,840
12439,170,100,40,80,160,0,550
12440,230,100,40,0,0,0,370
12441,200,180,160,160,160,0,860
12442,210,160,120,160,320,0,970
12443,190,140,40,0,0,0,370
12444,150,100,80,160,0,0,490
12445,170,140,200,160,320,320,1310
12446,180,100,120,80,160,0,640
12447,190,120,80,80,160,0,630
12448,190,120,80,0,0,0,390
12449,260,140,160,160,0,0,720
12450,210,120,120,80,0,0,530
12451,170,100,80,80,160,0,590
12452,190,140,160,80,160,0,730
12453,180,100,80,80,0,0,440
12454,250,120,80,80,0,0,530
12455,160,120,120,80,160,0,640
12456,230,80,40,80,160,320,910
12457,200,80,120,160,320,0,880
12458,200,140,120,160,0,0,620
12459,220,120,120,240,320,0,1020
12460,210,160,80,0,0,0,450
12461,170,160,200,160,320,320,1330
12462,180,100,120,160,160,0,720
12463,180,160,120,160,320,320,1260
12464,190,140,120,160,160,0,770
12465,190,120,160,160,320,320,1270
12466,190,120,120,160,160,320,1070
12467,190,160,240,240,160,0,990
12468,200,140,120,0,0,0,460
12469,210,140,160,160,320,320,1310
12470,190,120,120,80,0,0,510
12471,220,80,80,80,0,0,460
12472,200,100,120,160,0,0,580
12473,160,160,120,160,160,0,760
12474,180,100,80,160,320,0,840
12475,210,180,160,80,160,320,1110
12476,210,100,80,160,160,0,710
12477,250,100,40,80,160,0,630
12478,180,140,120,240,160,0,840
12479,180,140,120,80,160,0,680
12480,180,100,40,0,0,0,320
12481,230,140,80,0,0,0,450
12482,190,100,120,0,0,0,410
12483,160,80,80,80,160,0,560
12484,190,120,160,240,160,320,1190
12485,210,180,120,0,0,0,510
12486,170,120,80,160,160,0,690
12487,190,100,120,80,160,0,650
12488,190,120,160,80,0,0,550
12489,230,160,80,0,0,0,470
12490,210,120,120,80,160,0,690
12491,180,100,80,80,160,0,600
12492,190,120,160,240,0,0,710
12493,170,80,80,160,160,0,650
12494,180,100,80,160,160,320,1000
12495,170,100,40,80,160,0,550
12496,180,100,40,80,0,0,400
12497,170,200,160,80,0,0,610
12498,170,60,40,0,0,0,270
12499,240,120,80,160,320,320,1240
12500,210,100,120,80,160,0,670
12501,240,140,200,240,0,0,820
12502,170,120,120,80,160,320,970
12503,210,100,40,0,0,0,350
12504,200,160,120,160,320,0,960
12505,180,60,40,80,160,0,520
12506,180,120,120,80,160,0,660
12507,200,100,80,160,160,0,700
12508,230,160,200,160,320,0,1070
12509,210,140,80,80,0,0,510
12510,140,40,80,160,160,0,580
12511,220,120,160,80,0,0,580
12512,210,140,120,0,0,0,470
12513,180,100,120,0,0,0,400
12514,180,80,40,80,160,0,540
12515,140,100,80,80,160,0,560
12516,220,120,80,80,0,0,500
12517,180,100,40,0,0,0,320
12518,180,120,80,80,0,0,460
12519,210,140,80,80,160,0,670
12520,220,180,120,80,0,0,600
12521,220,160,160,160,320,0,1020
12522,180,120,160,160,160,320,1100
12523,220,100,40,0,0,0,360
12524,180,140,120,80,160,0,680
12525,190,140,120,160,160,0,770
12526,210,120,120,80,160,0,690
12527,210,120,120,0,0,0,450
12528,190,180,160,160,160,0,850
12529,170,100,120,240,320,0,950
12530,180,100,80,160,160,0,680
12531,170,140,80,160,160,320,1030
12532,170,200,40,0,0,0,410
12533,180,100,120,160,160,0,720
12534,190,140,80,160,320,0,890
12535,160,80,120,0,0,0,360
12536,190,80,120,160,320,0,870
12537,210,160,200,240,0,0,810
12538,140,160,160,160,0,0,620
12539,190,160,80,80,0,0,510
12540,210,140,160,240,160,0,910
12541,200,120,80,80,160,0,640
12542,210,160,120,160,160,320,1130
12543,180,80,80,0,0,0,340
12544,180,120,80,80,160,0,620
12545,170,120,120,240,160,0,810
12546,200,100,120,0,0,0,420
12547,140,100,120,80,160,0,600
12548,170,80,80,80,160,0,570
12549,200,140,160,240,320,320,1380
12550,170,140,120,160,160,0,750
12551,210,100,160,160,160,0,790
12552,220,140,40,80,0,0,480
12553,230,100,80,80,160,0,650
12554,200,120,160,160,160,0,800
12555,180,140,120,80,0,0,520
12556,190,120,160,160,320,0,950
12557,200,120,120,80,0,0,520
12558,160,160,200,240,320,0,1080
12559,230,160,120,160,0,0,670
12560,190,80,40,0,0,0,310
12561,210,140,120,0,0,0,470
12562,220,220,120,80,0,0,640
12563,210,120,80,0,0,0,410
12564,180,80,80,80,0,0,420
12565,200,140,80,80,160,0,660
12566,200,160,160,80,160,0,760
12567,160,100,120,160,160,0,700
12568,180,160,160,0,0,0,500
12569,230,160,160,160,160,0,870
12570,210,60,40,80,160,0,550
12571,180,100,40,0,0,0,320
12572,190,100,160,80,160,0,690
12573,160,120,120,160,320,0,880
12574,220,80,80,160,160,0,700
12575,230,100,40,0,0,0,370
12576,180,140,120,80,160,0,680
12577,180,120,80,80,0,0,460
12578,190,120,160,0,0,0,470
12579,180,120,120,160,160,320,1060
12580,190,200,200,160,320,0,1070
12581,170,100,120,240,0,0,630
12582,160,100,80,80,160,320,900
12583,200,80,120,160,160,0,720
12584,220,140,120,160,160,320,1120
12585,190,140,160,160,320,0,970
12586,220,80,120,0,0,0,420
12587,200,100,80,0,0,0,380
12588,200,120,120,80,0,0,520
12589,180,120,120,160,160,0,740
12590,240,160,120,80,160,0,760
12591,190,200,200,240,160,0,990
12592,180,120,80,80,160,0,620
12593,230,120,120,80,160,320,1030
12594,170,140,120,160,160,0,750
12595,230,160,80,80,0,0,550
12596,220,100,120,160,160,0,760
12597,190,100,40,0,0,0,330
12598,240,100,80,80,0,0,500
12599,200,140,80,80,160,0,660
12600,170,40,0,0,0,0,210
12601,190,100,40,80,160,0,570
12602,170,80,80,80,160,320,890
12603,200,120,160,0,0,0,480
12604,200,60,120,80,160,0,620
12605,190,120,80,80,160,0,630
12606,210,120,120,160,160,0,770
12607,230,120,160,80,0,0,590
12608,160,140,120,0,0,0,420
12609,200,140,80,0,0,0,420
12610,210,100,120,160,160,320,1070
12611,180,80,80,80,160,0,580
12612,220,160,160,80,0,0,620
12613,180,80,80,80,160,0,580
12614,200,200,160,240,320,0,1120
12615,180,160,80,80,0,0,500
12616,200,120,120,80,0,0,520
12617,180,120,200,240,320,0,1060
12618,170,140,120,80,160,0,670
12619,260,80,40,80,160,0,620
12620,190,100,120,160,160,0,730
12621,230,180,160,80,160,0,810
12622,180,60,80,0,0,0,320
12623,170,100,0,0,0,0,270
12624,210,140,40,0,0,0,390
12625,190,60,40,0,0,0,290
12626,220,120,80,0,0,0,420
12627,220,140,40,80,160,0,640
12628,200,120,80,80,160,320,960
12629,200,120,160,160,160,0,800
12630,180,80,80,160,160,0,660
12631,200,120,160,240,0,0,720
12632,180,120,120,160,0,0,580
12633,170,120,40,0,0,0,330
12634,210,120,40,0,0,0,370
12635,210,140,80,80,0,0,510
12636,230,180,160,80,160,0,810
12637,220,100,80,80,160,0,640
12638,140,80,120,240,160,0,740
12639,190,100,80,80,0,0,450
12640,200,140,160,160,160,0,820
12641,220,120,120,160,160,0,780
12642,180,80,40,0,0,0,300
12643,240,120,160,240,160,0,920
12644,180,140,120,80,0,0,520
12645,220,140,120,80,160,0,720
12646,160,120,160,160,320,0,920
12647,220,60,80,80,0,0,440
12648,200,200,240,160,320,0,1120
12649,220,120,120,80,0,0,540
12650,200,140,160,80,0,0,580
12651,210,120,120,160,160,0,770
12652,220,160,120,160,0,0,660
12653,200,60,0,0,0,0,260
12654,160,140,120,160,0,0,580
12655,210,80,120,240,160,0,810
12656,180,100,0,0,0,0,280
12657,180,100,40,80,160,0,560
12658,250,120,80,80,0,0,530
12659,180,160,120,160,320,320,1260
12660,210,120,80,80,160,0,650
12661,220,80,80,160,0,0,540
12662,210,120,160,80,0,0,570
12663,220,200,160,160,0,0,740
12664,170,100,40,0,0,0,310
12665,190,120,80,0,0,0,390
12666,200,180,120,160,160,320,1140
12667,210,80,80,0,0,0,370
12668,150,120,80,80,160,320,910
12669,200,120,80,80,160,0,640
12670,210,140,160,160,160,0,830
12671,180,140,200,240,160,320,1240
12672,200,120,160,80,0,0,560
12673,200,60,120,160,160,320,1020
12674,210,180,160,80,160,0,790
12675,220,120,160,160,160,320,1140
12676,170,80,80,80,0,0,410
12677,220,120,80,80,160,0,660
12678,200,100,40,0,0,0,340
12679,210,180,120,160,160,0,830
12680,210,160,240,80,160,0,850
12681,200,120,80,80,160,0,640
12682,190,120,120,160,160,0,750
12683,220,140,40,80,160,0,640
12684,210,60,80,160,160,0,670
12685,200,120,120,0,0,0,440
12686,220,180,160,80,0,0,640
12687,190,80,160,160,0,0,590
12688,260,140,80,80,0,0,560
12689,150,80,80,80,0,0,390
12690,190,160,160,160,160,0,830
12691,200,140,120,80,160,0,700
12692,220,140,120,80,0,0,560
12693,160,80,80,80,160,0,560
12694,210,140,120,0,0,0,470
12695,190,120,120,160,160,0,750
12696,200,160,120,80,160,320,1040
12697,210,80,40,80,160,0,570
12698,190,100,80,80,160,320,930
12699,230,140,160,80,0,0,610
12700,210,80,40,80,160,0,570
12701,190,100,120,0,0,0,410
12702,190,140,120,80,160,320,1010
12703,190,100,120,80,0,0,490
12704,190,100,40,80,160,0,570
12705,200,100,120,80,160,0,660
12706,200,140,120,80,160,0,700
12707,170,120,40,80,160,0,570
12708,180,100,80,0,0,0,360
12709,180,120,120,80,0,0,500
12710,190,120,40,80,160,0,590
12711,160,120,120,240,320,0,960
12712,160,100,120,160,160,0,700
12713,180,60,40,80,160,0,520
12714,160,80,80,0,0,0,320
12715,220,120,80,80,160,0,660
12716,210,100,120,80,160,0,670
12717,210,120,80,80,0,0,490
12718,190,120,160,80,160,0,710
12719,200,140,80,0,0,0,420
12720,200,120,80,80,0,0,480
12721,230,180,80,160,320,0,970
12722,180,60,40,0,0,0,280
12723,240,120,80,0,0,0,440
12724,200,120,80,80,0,0,480
12725,220,180,80,160,320,320,1280
12726,170,80,80,160,320,0,810
12727,190,140,80,80,0,0,490
12728,210,120,120,160,0,0,610
12729,170,100,120,160,0,0,550
12730,190,140,120,160,320,320,1250
12731,200,140,160,80,0,0,580
12732,220,160,120,160,160,0,820
12733,220,140,120,80,0,0,560
12734,160,140,120,160,160,0,740
12735,200,120,80,0,0,0,400
12736,180,100,120,160,160,0,720
12737,240,120,80,80,160,0,680
12738,220,140,120,80,160,320,1040
12739,200,100,120,160,160,0,740
12740,200,100,80,0,0,0,380
12741,220,160,160,160,160,320,1180
12742,160,120,80,0,0,0,360
12743,230,120,80,160,160,0,750
12744,250,140,40,80,0,0,510
12745,230,180,120,160,0,0,690
12746,170,100,80,160,160,0,670
12747,170,140,120,160,160,320,1070
12748,190,140,160,160,160,0,810
12749,190,100,120,80,160,0,650
12750,240,140,160,80,160,0,780
12751,220,160,80,80,0,0,540
12752,190,60,40,0,0,0,290
12753,240,160,120,160,0,0,680
12754,190,120,80,160,160,0,710
12755,180,140,160,80,0,0,560
12756,200,160,160,240,160,320,1240
12757,230,100,120,160,160,0,770
12758,210,140,80,80,0,0,510
12759,230,140,80,80,160,320,1010
12760,240,160,80,80,0,0,560
12761,200,140,200,240,320,0,1100
12762,190,100,160,80,0,0,530
12763,190,100,40,80,0,0,410
12764,210,100,80,0,0,0,390
12765,170,140,120,160,320,320,1230
12766,230,140,200,80,160,0,810
12767,180,120,80,80,160,320,940
12768,210,160,120,160,160,0,810
12769,180,120,120,80,160,0,660
12770,210,180,200,160,160,0,910
12771,220,100,80,0,0,0,400
12772,220,120,40,80,160,0,620
12773,230,120,80,0,0,0,430
12774,150,60,40,80,160,0,490
12775,200,160,80,160,160,0,760
12776,260,160,80,80,160,0,740
12777,200,140,160,160,320,0,980
12778,210,100,40,80,160,0,590
12779,170,140,160,160,160,0,790
12780,180,140,160,240,160,320,1200
12781,200,120,80,0,0,0,400
12782,150,60,80,80,0,0,370
12783,160,140,120,160,320,320,1220
12784,200,140,120,80,160,320,1020
12785,170,120,80,160,160,0,690
12786,210,100,80,0,0,0,390
12787,210,160,120,160,160,0,810
12788,170,120,80,160,160,0,690
12789,160,180,200,160,0,0,700
12790,200,140,200,160,160,0,860
12791,220,160,120,160,160,0,820
12792,190,140,160,240,160,0,890
12793,180,120,80,80,160,0,620
12794,210,80,120,160,0,0,570
12795,230,160,120,160,160,0,830
12796,210,120,80,160,320,320,1210
12797,180,60,80,0,0,0,320
12798,200,160,80,160,160,0,760
12799,220,140,120,160,160,320,1120
12800,170,120,120,0,0,0,410
12801,250,180,160,80,0,0,670
12802,220,100,120,160,0,0,600
12803,150,80,80,80,160,0,550
12804,170,100,80,80,0,0,430
12805,210,180,120,80,0,0,590
12806,240,180,160,240,160,0,980
12807,190,120,80,80,160,0,630
12808,160,100,120,80,160,320,940
12809,190,120,40,80,160,0,590
12810,170,160,160,240,320,0,1050
12811,210,140,120,0,0,0,470
12812,230,100,40,80,0,0,450
12813,190,100,120,80,160,0,650
12814,150,120,120,240,320,320,1270
12815,210,120,80,160,320,320,1210
12816,220,120,160,80,160,0,740
12817,190,100,80,80,160,0,610
12818,180,100,80,80,160,320,920
12819,180,80,160,80,160,0,660
12820,170,160,40,0,0,0,370
12821,230,100,80,80,160,0,650
12822,200,180,160,160,160,0,860
12823,180,120,120,80,160,320,980
12824,200,60,40,0,0,0,300
12825,180,100,120,0,0,0,400
12826,210,100,120,160,160,0,750
12827,160,60,80,160,320,0,780
12828,180,80,0,0,0,0,260
12829,210,120,160,240,160,320,1210
12830,170,60,0,0,0,0,230
12831,170,120,120,240,320,0,970
12832,210,140,40,0,0,0,390
12833,180,100,80,0,0,0,360
12834,170,120,80,160,160,0,690
12835,170,100,80,80,160,0,590
12836,190,120,120,160,320,0,910
12837,220,120,80,80,160,0,660
12838,190,60,80,0,0,0,330
12839,180,140,120,0,0,0,440
12840,220,140,160,0,0,0,520
12841,210,120,0,0,0,0,330
12842,200,160,160,240,320,0,1080
12843,200,160,160,160,160,0,840
12844,240,120,120,80,0,0,560
12845,200,120,80,80,0,0,480
12846,220,180,40,0,0,0,440
12847,220,120,120,80,160,0,700
12848,170,140,80,0,0,0,390
12849,200,120,80,80,160,0,640
12850,210,180,160,80,160,0,790
12851,210,140,40,0,0,0,390
12852,220,120,160,240,160,0,900
12853,190,140,120,160,160,320,1090
12854,200,120,80,80,160,0,640
12855,200,120,120,80,0,0,520
12856,220,120,80,80,160,0,660
12857,220,180,200,160,320,320,1400
12858,190,140,200,160,320,0,1010
12859,170,100,120,80,160,0,630
12860,220,160,80,0,0,0,460
12861,220,80,120,160,320,0,900
12862,150,60,80,80,160,0,530
12863,160,40,0,0,0,0,200
12864,230,120,80,80,160,0,670
12865,170,160,80,160,160,0,730
12866,200,120,80,0,0,0,400
12867,190,120,120,80,160,0,670
12868,190,100,40,80,160,0,570
12869,220,140,80,80,160,0,680
12870,160,100,40,0,0,0,300
12871,240,120,80,80,160,0,680
12872,200,140,40,0,0,0,380
12873,190,120,120,80,0,0,510
12874,190,100,120,80,160,0,650
12875,160,120,160,80,160,0,680
12876,230,140,160,0,0,0,530
12877,190,100,120,80,0,0,490
12878,190,100,80,80,0,0,450
12879,200,180,200,160,160,320,1220
12880,200,120,80,160,0,0,560
12881,180,100,120,80,0,0,480
12882,250,160,120,80,160,0,770
12883,220,180,160,160,320,0,1040
12884,200,120,80,80,160,320,960
12885,220,100,160,80,0,0,560
12886,170,180,120,160,160,0,790
12887,190,120,160,160,160,0,790
12888,210,60,40,80,160,0,550
12889,160,80,40,80,0,0,360
12890,190,80,80,160,320,320,1150
12891,230,100,120,80,160,0,690
12892,220,160,40,0,0,0,420
12893,210,120,160,80,160,0,730
12894,200,160,160,160,0,0,680
12895,190,180,160,80,0,0,610
12896,190,200,120,80,0,0,590
12897,190,200,280,80,0,0,750
12898,210,140,80,160,160,0,750
12899,180,40,80,80,160,0,540
12900,200,160,200,160,160,0,880
12901,200,140,40,0,0,0,380
12902,220,160,120,160,0,0,660
12903,210,100,80,80,0,0,470
12904,200,120,120,240,320,320,1320
12905,190,120,80,160,160,0,710
12906,180,80,80,160,160,0,660
12907,230,100,80,80,160,0,650
12908,200,80,80,80,0,0,440
12909,220,80,80,80,0,0,460
12910,200,60,80,0,0,0,340
12911,220,140,120,160,160,0,800
12912,190,120,40,0,0,0,350
12913,200,160,160,160,0,0,680
12914,190,120,80,80,160,320,950
12915,230,180,80,0,0,0,490
12916,170,140,80,80,160,0,630
12917,160,100,120,160,160,320,1020
12918,210,160,160,160,160,0,850
12919,180,80,0,0,0,0,260
12920,180,80,80,80,0,0,420
12921,220,160,120,80,0,0,580
12922,190,100,40,80,160,0,570
12923,210,160,40,0,0,0,410
12924,210,100,120,160,160,0,750
12925,220,180,160,240,160,320,1280
12926,170,100,40,80,160,320,870
12927,190,120,160,160,160,0,790
12928,260,160,160,160,160,0,900
12929,200,140,120,160,160,0,780
12930,150,160,120,0,0,0,430
12931,190,80,120,160,160,0,710
12932,230,140,120,80,160,0,730
12933,150,100,160,80,160,0,650
12934,220,120,160,80,160,0,740
12935,210,100,80,0,0,0,390
12936,200,120,40,0,0,0,360
12937,200,160,80,160,320,320,1240
12938,210,180,80,80,160,0,710
12939,220,100,80,0,0,0,400
12940,150,100,40,0,0,0,290
12941,220,120,80,80,0,0,500
12942,220,100,120,160,160,0,760
12943,180,140,120,160,160,320,1080
12944,230,100,120,160,160,0,770
12945,180,40,80,80,0,0,380
12946,230,180,160,160,160,0,890
12947,170,100,120,0,0,0,390
12948,180,80,120,80,160,0,620
12949,190,120,120,160,160,0,750
12950,200,120,40,0,0,0,360
12951,240,160,80,80,0,0,560
12952,210,100,120,80,0,0,510
12953,170,120,120,160,160,0,730
12954,230,160,80,80,0,0,550
12955,210,60,40,80,160,0,550
12956,230,80,80,80,160,0,630
12957,180,60,40,80,160,0,520
12958,220,100,120,80,0,0,520
12959,200,160,120,80,160,0,720
12960,230,120,120,240,320,0,1030
12961,170,120,120,160,320,0,890
12962,190,80,40,0,0,0,310
12963,160,120,160,160,160,0,760
12964,200,100,120,80,160,0,660
12965,160,60,80,80,160,0,540
12966,170,80,40,80,0,0,370
12967,210,120,120,80,0,0,530
12968,210,160,80,80,160,0,690
12969,210,160,120,0,0,0,490
12970,200,80,160,0,0,0,440
12971,190,120,80,160,320,0,870
12972,240,140,80,80,160,0,700
12973,240,100,0,0,0,0,340
12974,220,120,160,240,160,0,900
12975,190,120,80,80,160,0,630
12976,200,100,40,80,160,0,580
12977,180,140,160,160,320,0,960
12978,190,100,80,80,160,0,610
12979,230,160,160,160,320,0,1030
12980,220,60,80,80,0,0,440
12981,180,140,120,80,160,0,680
12982,190,100,120,160,160,0,730
12983,190,80,40,0,0,0,310
12984,240,160,160,80,0,0,640
12985,230,140,40,80,160,0,650
12986,170,100,80,80,160,0,590
12987,190,140,40,0,0,0,370
12988,220,160,40,0,0,0,420
12989,180,60,80,80,160,0,560
12990,200,100,80,0,0,0,380
12991,200,100,160,160,160,0,780
12992,210,120,120,160,160,0,770
12993,260,180,120,80,160,320,1120
12994,180,100,160,160,320,0,920
12995,200,100,40,0,0,0,340
12996,210,140,160,160,160,0,830
12997,190,140,40,0,0,0,370
12998,230,160,160,80,160,0,790
12999,160,100,80,160,160,0,660
13000,200,100,80,80,160,0,620
13001,210,80,80,80,160,0,610
13002,190,140,120,0,0,0,450
13003,180,140,120,80,160,0,680
13004,220,140,160,160,160,0,840
13005,190,140,40,0,0,0,370
13006,180,140,120,160,320,320,1240
13007,190,120,200,240,320,320,1390
13008,200,140,80,80,0,0,500
13009,200,120,160,80,160,0,720
13010,210,160,120,0,0,0,490
13011,200,120,0,0,0,0,320
13012,220,80,40,0,0,0,340
13013,210,160,80,80,160,320,1010
13014,190,120,160,80,0,0,550
13015,170,120,120,80,160,0,650
13016,200,60,80,0,0,0,340
13017,180,120,120,0,0,0,420
13018,170,160,160,80,160,0,730
13019,200,60,40,80,160,0,540
13020,200,120,160,80,160,320,1040
13021,190,160,0,0,0,0,350
13022,160,120,80,80,160,0,600
13023,240,160,80,0,0,0,480
13024,220,140,120,80,0,0,560
13025,190,80,80,80,0,0,430
13026,240,160,160,160,160,320,1200
13027,210,100,160,160,160,0,790
13028,210,140,120,160,160,0,790
13029,190,120,160,160,160,0,790
13030,240,160,120,80,160,0,760
13031,230,100,160,160,320,0,970
13032,200,140,80,80,160,320,980
13033,210,100,80,80,160,0,630
13034,200,80,120,0,0,0,400
13035,200,180,200,240,160,0,980
13036,190,120,80,0,0,0,390
13037,210,140,120,160,320,320,1270
13038,150,100,120,80,160,0,610
13039,210,80,120,160,160,0,730
13040,180,120,80,0,0,0,380
13041,240,120,120,160,320,0,960
13042,180,100,80,0,0,0,360
13043,180,120,80,0,0,0,380
13044,220,100,80,160,160,0,720
13045,230,120,40,80,160,320,950
13046,220,160,80,80,0,0,540
13047,190,180,120,0,0,0,490
13048,160,80,40,0,0,0,280
13049,220,160,120,80,0,0,580
13050,190,100,120,80,160,0,650
13051,200,100,120,0,0,0,420
13052,250,120,120,160,0,0,650
13053,200,140,120,160,0,0,620
13054,230,140,80,80,0,0,530
13055,180,100,80,160,320,320,1160
13056,220,100,120,160,160,0,760
13057,190,100,40,0,0,0,330
13058,200,120,80,80,160,0,640
13059,190,120,80,80,160,0,630
13060,210,60,80,80,0,0,430
13061,180,80,80,160,160,0,660
13062,170,120,80,160,160,0,690
13063,210,100,120,80,160,320,990
13064,200,120,120,160,160,0,760
13065,200,140,80,160,160,0,740
13066,180,80,40,80,160,0,540
13067,190,200,160,80,160,0,790
13068,190,140,120,160,320,0,930
13069,210,60,80,80,0,0,430
13070,160,60,40,80,0,0,340
13071,220,180,80,80,160,0,720
13072,200,120,120,160,0,0,600
13073,190,120,120,160,160,0,750
13074,220,120,40,0,0,0,380
13075,190,140,160,240,0,0,730
13076,180,160,80,80,160,0,660
13077,200,120,120,80,160,0,680
13078,210,140,160,160,0,0,670
13079,210,120,160,80,0,0,570
13080,210,100,160,160,160,0,790
13081,200,80,120,0,0,0,400
13082,160,120,40,0,0,0,320
13083,220,100,120,0,0,0,440
13084,210,140,120,0,0,0,470
13085,180,100,40,80,0,0,400
13086,210,160,40,0,0,0,410
13087,210,200,80,80,0,0,570
13088,190,80,80,160,160,0,670
13089,160,80,120,160,0,0,520
13090,180,120,160,160,160,320,1100
13091,200,120,120,160,160,0,760
13092,200,160,160,80,0,0,600
13093,200,140,160,80,0,0,580
13094,180,160,160,80,0,0,580
13095,220,100,120,80,160,0,680
13096,200,100,80,80,160,0,620
13097,200,120,200,160,160,0,840
13098,210,180,160,240,160,0,950
13099,210,140,80,80,160,0,670
13100,260,140,160,160,160,0,880
13101,240,160,160,160,320,0,1040
13102,170,100,80,160,160,0,670
13103,200,120,120,160,0,0,600
13104,230,180,160,0,0,0,570
13105,140,120,120,80,0,0,460
13106,210,140,120,160,320,320,1270
13107,190,60,80,0,0,0,330
13108,170,120,80,80,160,0,610
13109,220,80,120,80,0,0,500
13110,210,120,160,160,160,0,810
13111,230,120,80,160,160,0,750
13112,200,120,160,240,160,0,880
13113,190,100,80,80,160,0,610
13114,170,80,120,80,160,0,610
13115,190,100,40,80,160,320,890
13116,170,100,160,160,160,0,750
13117,230,120,120,80,0,0,550
13118,200,140,80,80,160,0,660
13119,220,140,80,80,160,0,680
13120,190,100,80,160,160,0,690
13121,140,100,80,80,160,320,880
13122,200,80,80,80,160,0,600
13123,150,100,120,240,320,0,930
13124,230,100,120,80,160,320,1010
13125,190,120,80,80,160,0,630
13126,180,100,80,80,0,0,440
13127,190,120,80,160,320,320,1190
13128,180,120,120,80,160,320,980
13129,190,120,160,160,0,0,630
13130,190,140,80,80,0,0,490
13131,190,140,80,160,160,0,730
13132,190,180,160,240,0,0,770
13133,210,100,160,160,160,320,1110
13134,210,60,80,80,160,0,590
13135,150,100,120,160,320,0,850
13136,210,180,160,160,160,0,870
13137,180,100,40,0,0,0,320
13138,210,140,80,0,0,0,430
13139,200,100,40,80,160,0,580
13140,210,160,120,80,0,0,570
13141,190,100,160,240,160,0,850
13142,210,120,80,160,160,0,730
13143,210,120,160,80,0,0,570
13144,180,160,160,160,320,0,980
13145,230,80,120,80,160,0,670
13146,180,120,120,160,160,0,740
13147,210,120,40,0,0,0,370
13148,220,120,80,80,0,0,500
13149,190,140,160,160,0,0,650
13150,210,100,120,80,160,0,670
13151,170,120,80,0,0,0,370
13152,200,100,80,80,0,0,460
13153,210,100,120,80,160,0,670
13154,180,120,120,80,0,0,500
13155,190,140,80,80,160,320,970
13156,220,140,40,0,0,0,400
13157,190,100,80,0,0,0,370
13158,240,140,160,160,160,0,860
13159,210,180,160,80,160,0,790
13160,150,140,120,160,160,0,730
13161,230,140,80,80,0,0,530
13162,170,100,120,80,160,320,950
13163,210,60,0,0,0,0,270
13164,220,140,120,160,320,320,1280
13165,250,160,160,160,160,0,890
13166,170,120,80,0,0,0,370
13167,210,100,120,240,320,320,1310
13168,170,100,120,160,320,0,870
13169,210,140,120,0,0,0,470
13170,180,100,80,0,0,0,360
13171,210,80,120,80,0,0,490
13172,170,100,80,80,160,0,590
13173,210,140,160,80,160,0,750
13174,230,100,120,160,160,320,1090
13175,190,180,200,80,160,0,810
13176,210,140,80,80,0,0,510
13177,170,120,120,80,160,0,650
13178,200,120,120,80,160,320,1000
13179,210,120,80,0,0,0,410
13180,160,100,120,80,160,320,940
13181,210,120,40,0,0,0,370
13182,180,140,40,80,160,320,920
13183,210,100,80,160,320,320,1190
13184,210,140,160,80,0,0,590
13185,200,100,80,160,160,0,700
13186,210,140,200,240,160,0,950
13187,220,100,80,80,160,0,640
13188,200,100,40,0,0,0,340
13189,240,120,160,160,0,0,680
13190,240,100,40,80,160,0,620
13191,200,100,40,80,160,0,580
13192,180,120,120,160,0,0,580
13193,230,120,120,80,0,0,550
13194,190,140,40,0,0,0,370
13195,200,140,40,80,160,0,620
13196,220,140,160,160,160,0,840
13197,190,120,40,80,0,0,430
13198,190,140,80,80,0,0,490
13199,210,120,80,80,160,0,650
13200,210,100,40,80,160,320,910
13201,230,140,160,160,0,0,690
13202,140,80,80,80,160,320,860
13203,190,160,120,160,320,320,1270
13204,170,80,120,240,160,0,770
13205,210,100,40,80,0,0,430
13206,200,120,120,160,0,0,600
13207,190,100,120,160,160,0,730
13208,230,180,120,0,0,0,530
13209,210,80,40,0,0,0,330
13210,220,120,80,160,160,0,740
13211,190,60,80,80,160,0,570
13212,220,120,160,160,160,320,1140
13213,170,140,160,80,0,0,550
13214,200,140,120,80,160,320,1020
13215,190,140,80,80,0,0,490
13216,180,60,80,80,160,0,560
13217,160,120,200,160,160,0,800
13218,170,80,80,0,0,0,330
13219,240,140,80,0,0,0,460
13220,190,80,80,160,160,0,670
13221,170,120,40,0,0,0,330
13222,160,60,40,0,0,0,260
13223,190,80,40,0,0,0,310
13224,180,80,40,80,160,0,540
13225,170,100,40,80,0,0,390
13226,190,120,200,160,320,320,1310
13227,240,100,40,0,0,0,380
13228,210,120,120,80,0,0,530
13229,170,140,160,240,0,0,710
13230,220,160,80,0,0,0,460
13231,190,100,80,0,0,0,370
13232,190,100,80,0,0,0,370
13233,220,120,120,160,160,0,780
13234,190,120,120,240,320,0,990
13235,200,100,120,240,320,320,1300
13236,180,100,40,80,160,0,560
13237,180,80,40,80,0,0,380
13238,190,160,160,80,0,0,590
13239,190,40,40,0,0,0,270
13240,220,80,80,0,0,0,380
13241,180,140,80,80,160,0,640
13242,160,60,80,160,320,0,780
13243,220,140,160,160,0,0,680
13244,190,140,0,0,0,0,330
13245,200,100,80,80,160,0,620
13246,200,120,120,80,0,0,520
13247,170,80,80,0,0,0,330
13248,190,100,120,0,0,0,410
13249,210,80,40,0,0,0,330
13250,190,120,120,80,160,0,670
13251,250,140,120,160,160,0,830
13252,220,160,200,80,160,0,820
13253,170,140,160,160,160,0,790
13254,200,120,80,160,160,0,720
13255,190,120,200,80,160,0,750
13256,220,120,160,160,0,0,660
13257,160,100,160,80,0,0,500
13258,250,160,120,160,160,0,850
13259,170,80,120,80,160,0,610
13260,220,100,80,80,160,0,640
13261,210,80,40,80,160,0,570
13262,160,100,40,80,0,0,380
13263,210,120,40,0,0,0,370
13264,180,140,120,160,320,0,920
13265,150,140,240,80,0,0,610
13266,190,120,120,160,160,0,750
13267,190,120,120,160,0,0,590
13268,210,100,40,0,0,0,350
13269,200,120,40,80,160,0,600
13270,190,100,120,160,160,0,730
13271,210,100,40,80,160,0,590
13272,220,140,160,240,320,320,1400
13273,230,120,80,0,0,0,430
13274,180,100,40,80,0,0,400
13275,190,140,0,0,0,0,330
13276,190,140,80,0,0,0,410
13277,200,100,160,0,0,0,460
13278,210,100,80,80,160,0,630
13279,220,100,120,160,160,0,760
13280,220,160,120,160,160,0,820
13281,190,140,160,240,320,0,1050
13282,230,160,120,160,320,0,990
13283,200,80,40,80,160,0,560
13284,210,100,120,80,160,0,670
13285,210,120,120,160,0,0,610
13286,180,80,120,240,320,0,940
13287,180,120,160,160,160,0,780
13288,180,60,40,0,0,0,280
13289,200,180,200,160,160,320,1220
13290,220,100,120,0,0,0,440
13291,200,100,40,80,160,320,900
13292,170,80,120,160,160,0,690
13293,130,80,120,80,160,0,570
13294,190,140,80,80,160,320,970
13295,240,180,120,80,160,320,1100
13296,200,140,80,0,0,0,420
13297,220,140,120,80,0,0,560
13298,190,160,120,80,0,0,550
13299,200,80,120,160,0,0,560
13300,250,160,80,80,0,0,570
13301,200,120,80,160,0,0,560
13302,230,160,120,80,0,0,590
13303,160,100,120,160,0,0,540
13304,180,100,40,80,0,0,400
13305,170,140,160,160,320,0,950
13306,200,100,80,0,0,0,380
13307,180,80,40,80,0,0,380
13308,220,200,200,240,320,0,1180
13309,180,140,120,0,0,0,440
13310,230,120,120,80,160,0,710
13311,200,120,80,80,0,0,480
13312,220,120,120,80,160,0,700
13313,200,140,40,80,160,0,620
13314,190,200,120,80,160,0,750
13315,150,100,120,80,160,0,610
13316,170,140,120,160,320,320,1230
13317,180,120,160,160,160,0,780
13318,220,160,200,160,0,0,740
13319,210,160,200,240,320,320,1450
13320,180,100,120,160,0,0,560
13321,210,160,80,160,320,0,930
13322,200,160,160,240,160,0,920
13323,230,140,120,80,0,0,570
13324,210,120,120,80,160,0,690
13325,190,120,80,80,0,0,470
13326,240,180,80,0,0,0,500
13327,200,160,120,160,320,320,1280
13328,200,120,0,0,0,0,320
13329,180,100,80,80,160,0,600
13330,190,160,40,0,0,0,390
13331,220,100,80,0,0,0,400
13332,210,120,160,160,160,0,810
13333,210,140,120,80,160,320,1030
13334,200,120,80,0,0,0,400
13335,210,120,120,160,160,0,770
13336,190,160,80,160,160,0,750
13337,210,140,160,80,0,0,590
13338,200,120,120,80,160,320,1000
13339,140,100,120,160,0,0,520
13340,200,140,80,80,0,0,500
13341,180,140,160,80,160,0,720
13342,220,140,120,80,160,0,720
13343,220,160,160,160,0,0,700
13344,190,120,40,80,160,320,910
13345,190,100,80,0,0,0,370
13346,170,160,120,160,320,0,930
13347,210,100,80,80,160,0,630
13348,230,140,120,80,0,0,570
13349,220,180,120,160,160,0,840
13350,150,80,80,80,0,0,390
13351,140,100,80,80,160,0,560
13352,170,120,120,80,160,0,650
13353,170,160,120,80,0,0,530
13354,240,120,80,80,0,0,520
13355,150,120,200,160,160,0,790
13356,180,100,80,80,160,0,600
13357,180,100,40,80,0,0,400
13358,160,120,80,80,160,0,600
13359,200,60,40,80,160,0,540
13360,210,160,120,0,0,0,490
13361,210,120,80,0,0,0,410
13362,190,120,40,80,160,0,590
13363,210,140,80,0,0,0,430
13364,190,120,80,80,0,0,470
13365,150,120,80,80,160,0,590
13366,190,120,120,160,320,0,910
13367,200,120,120,80,160,320,1000
13368,230,60,80,160,160,0,690
13369,210,80,40,80,160,320,890
13370,250,160,160,0,0,0,570
13371,190,120,80,80,160,0,630
13372,200,80,120,80,0,0,480
13373,180,140,80,160,160,320,1040
13374,200,140,160,160,160,0,820
13375,180,120,120,160,320,0,900
13376,200,100,120,80,0,0,500
13377,190,140,160,80,160,0,730
13378,220,180,40,0,0,0,440
13379,220,100,120,80,0,0,520
13380,200,120,120,160,160,0,760
13381,200,160,200,160,0,0,720
13382,190,180,120,0,0,0,490
13383,160,80,0,0,0,0,240
13384,190,100,80,160,160,0,690
13385,190,140,200,160,160,0,850
13386,190,160,120,0,0,0,470
13387,160,100,120,160,0,0,540
13388,200,140,160,0,0,0,500
13389,170,140,120,160,160,0,750
13390,190,120,120,160,160,320,1070
13391,190,140,160,80,160,0,730
13392,200,140,160,240,160,0,900
13393,200,100,80,80,160,0,620
13394,180,120,160,160,320,0,940
13395,220,100,80,80,160,0,640
13396,220,100,80,80,0,0,480
13397,190,120,120,240,160,0,830
13398,190,140,40,0,0,0,370
13399,200,140,120,160,160,0,780
13400,180,120,80,80,160,0,620
13401,210,200,120,80,0,0,610
13402,210,120,160,160,320,0,970
13403,180,140,80,160,320,0,880
13404,220,160,160,160,0,0,700
13405,230,140,80,0,0,0,450
13406,180,120,80,80,160,0,620
13407,200,80,40,80,160,0,560
13408,190,160,160,160,160,0,830
13409,210,160,80,80,160,0,690
13410,200,120,120,240,320,320,1320
13411,200,140,80,80,0,0,500
13412,180,140,80,80,0,0,480
13413,200,120,200,160,0,0,680
13414,190,120,160,160,0,0,630
13415,220,120,80,80,160,0,660
13416,170,100,80,0,0,0,350
13417,190,60,80,0,0,0,330
13418,160,100,120,240,320,0,940
13419,170,80,80,0,0,0,330
13420,240,100,120,0,0,0,460
13421,140,140,80,160,160,0,680
13422,180,120,80,160,160,0,700
13423,210,100,40,80,160,0,590
13424,230,120,40,80,160,0,630
13425,190,140,120,80,160,0,690
13426,220,100,80,80,160,0,640
13427,170,80,80,0,0,0,330
13428,210,200,160,160,320,0,1050
13429,180,100,80,80,160,320,920
13430,180,120,40,0,0,0,340
13431,150,120,160,0,0,0,430
13432,240,120,40,80,0,0,480
13433,150,140,80,160,160,0,690
13434,180,120,80,80,160,0,620
13435,200,140,200,160,0,0,700
13436,220,140,120,80,160,0,720
13437,210,120,40,80,0,0,450
13438,200,100,160,240,160,0,860
13439,150,80,80,80,160,320,870
13440,200,140,160,80,160,0,740
13441,220,120,160,160,320,320,1300
13442,200,140,160,160,160,0,820
13443,230,120,120,80,160,0,710
13444,220,140,40,80,160,0,640
13445,220,120,120,80,0,0,540
13446,230,80,80,80,160,0,630
13447,190,120,120,80,160,320,990
13448,180,80,40,80,160,0,540
13449,190,160,200,80,160,0,790
13450,190,120,80,80,160,320,950
13451,150,60,80,160,160,0,610
13452,180,140,80,0,0,0,400
13453,240,140,80,80,0,0,540
13454,200,100,120,240,320,320,1300
13455,220,180,80,80,160,320,1040
13456,210,80,80,160,160,0,690
13457,230,80,80,0,0,0,390
13458,220,100,40,80,0,0,440
13459,220,140,200,160,0,0,720
13460,210,140,160,0,0,0,510
13461,170,100,120,160,320,0,870
13462,200,140,160,80,160,320,1060
13463,190,120,120,160,0,0,590
13464,200,160,160,160,160,0,840
13465,210,120,120,80,0,0,530
13466,220,80,0,0,0,0,300
13467,150,100,80,160,160,0,650
13468,260,180,200,320,320,320,1600
13469,210,100,120,160,160,0,750
13470,220,140,160,160,320,0,1000
13471,190,120,120,0,0,0,430
13472,180,120,160,160,160,0,780
13473,180,100,120,80,160,0,640
13474,150,120,160,80,160,0,670
13475,200,140,40,80,0,0,460
13476,170,80,160,160,160,0,730
13477,200,100,120,160,160,0,740
13478,190,80,80,0,0,0,350
13479,180,140,120,80,0,0,520
13480,190,120,200,80,160,0,750
13481,200,160,160,80,0,0,600
13482,230,140,80,160,0,0,610
13483,180,60,40,0,0,0,280
13484,200,140,120,160,160,0,780
13485,170,120,120,80,0,0,490
13486,200,120,120,160,320,0,920
13487,220,120,120,0,0,0,460
13488,150,140,120,160,160,0,730
13489,210,160,120,160,160,0,810
13490,180,120,160,160,0,0,620
13491,170,100,120,160,320,0,870
13492,180,100,40,0,0,0,320
13493,230,80,120,160,160,320,1070
13494,190,120,40,0,0,0,350
13495,200,80,40,80,160,0,560
13496,220,120,80,160,160,0,740
13497,230,180,120,80,160,0,770
13498,140,140,80,160,0,0,520
13499,200,160,80,160,0,0,600
13500,200,140,160,160,160,320,1140
13501,210,100,80,0,0,0,390
13502,210,140,120,160,160,0,790
13503,180,120,120,80,160,0,660
13504,230,160,120,160,160,320,1150
13505,180,120,160,160,160,0,780
13506,230,100,80,80,0,0,490
13507,180,80,40,80,160,0,540
13508,210,160,120,160,160,0,810
13509,190,100,40,0,0,0,330
13510,210,160,80,80,0,0,530
13511,130,100,80,80,160,0,550
13512,150,140,120,80,160,0,650
13513,150,100,80,160,320,0,810
13514,200,100,40,80,160,0,580
13515,190,120,80,80,160,0,630
13516,210,100,40,0,0,0,350
13517,180,180,160,80,0,0,600
13518,240,100,80,160,160,0,740
13519,200,160,80,160,320,320,1240
13520,190,140,120,80,160,0,690
13521,200,160,200,160,0,0,720
13522,210,120,80,80,0,0,490
13523,190,100,120,240,160,0,810
13524,240,180,160,240,320,0,1140
13525,210,100,160,160,160,0,790
13526,200,160,200,160,0,0,720
13527,270,100,120,160,320,0,970
13528,180,140,120,80,160,0,680
13529,240,60,0,0,0,0,300
13530,210,120,80,80,160,0,650
13531,210,120,120,80,160,0,690
13532,210,180,160,80,0,0,630
13533,190,140,80,80,160,0,650
13534,210,180,80,80,0,0,550
13535,230,120,120,160,320,0,950
13536,190,120,120,80,160,320,990
13537,230,180,160,80,160,0,810
13538,220,80,120,160,160,0,740
13539,190,140,40,0,0,0,370
13540,180,60,0,0,0,0,240
13541,170,80,120,0,0,0,370
13542,160,160,120,0,0,0,440
13543,230,180,120,0,0,0,530
13544,220,160,120,0,0,0,500
13545,170,140,120,80,160,0,670
13546,210,100,80,80,0,0,470
13547,170,80,80,80,160,320,890
13548,200,100,40,0,0,0,340
13549,190,120,80,80,0,0,470
13550,180,100,80,80,0,0,440
13551,200,180,120,160,160,0,820
13552,200,120,200,160,160,0,840
13553,210,120,40,0,0,0,370
13554,220,80,120,160,320,0,900
13555,190,80,40,80,160,0,550
13556,200,120,80,160,320,0,880
13557,170,120,80,160,320,320,1170
13558,180,120,120,80,160,0,660
13559,210,140,40,0,0,0,390
13560,210,120,160,240,320,0,1050
13561,170,140,120,80,160,0,670
13562,190,80,80,80,0,0,430
13563,190,80,80,80,160,0,590
13564,180,40,40,80,0,0,340
13565,180,140,80,160,160,0,720
13566,190,60,80,0,0,0,330
13567,210,160,80,160,160,0,770
13568,230,140,120,240,320,0,1050
13569,200,100,80,0,0,0,380
13570,190,100,80,80,0,0,450
13571,190,160,200,160,0,0,710
13572,230,140,40,80,160,0,650
13573,210,140,80,80,0,0,510
13574,190,160,160,80,0,0,590
13575,210,100,80,0,0,0,390
13576,220,140,160,80,160,0,760
13577,190,100,160,240,160,0,850
13578,210,80,0,0,0,0,290
13579,180,100,80,80,0,0,440
13580,180,140,120,160,160,320,1080
13581,200,120,120,240,0,0,680
13582,220,120,40,0,0,0,380
13583,200,120,40,80,160,320,920
13584,180,140,80,80,160,0,640
13585,220,140,120,80,160,320,1040
13586,200,160,80,160,160,320,1080
13587,210,100,160,160,160,0,790
13588,210,120,120,80,160,0,690
13589,210,160,120,80,160,320,1050
13590,190,140,120,0,0,0,450
13591,190,140,120,160,160,0,770
13592,180,140,80,0,0,0,400
13593,190,160,160,0,0,0,510
13594,200,160,160,240,320,0,1080
13595,180,120,200,80,160,0,740
13596,190,100,160,80,160,0,690
13597,200,120,80,80,0,0,480
13598,210,60,40,80,0,0,390
13599,200,80,120,80,160,0,640
13600,220,100,80,80,0,0,480
13601,220,120,40,80,160,0,620
13602,220,140,80,80,160,0,680
13603,210,120,80,80,160,0,650
13604,220,80,80,160,320,320,1180
13605,220,160,120,160,0,0,660
13606,190,100,80,80,160,0,610
13607,170,100,80,160,160,0,670
13608,180,100,80,80,160,0,600
13609,180,80,80,80,160,0,580
13610,220,140,80,0,0,0,440
13611,200,140,120,80,160,0,700
13612,200,140,120,160,160,0,780
13613,240,140,160,160,0,0,700
13614,230,180,120,160,160,0,850
13615,210,140,120,160,0,0,630
13616,200,60,80,80,0,0,420
13617,180,140,120,80,0,0,520
13618,230,80,120,240,160,320,1150
13619,200,140,120,160,160,320,1100
13620,200,120,40,80,160,0,600
13621,220,100,80,80,160,320,960
13622,190,80,120,160,160,0,710
13623,200,100,80,80,160,0,620
13624,200,120,40,0,0,0,360
13625,180,120,80,0,0,0,380
13626,170,80,120,80,160,0,610
13627,170,80,40,0,0,0,290
13628,230,120,80,80,0,0,510
13629,180,160,80,80,0,0,500
13630,190,80,120,80,160,0,630
13631,190,140,80,80,0,0,490
13632,160,100,80,80,0,0,420
13633,170,160,160,160,160,0,810
13634,150,80,80,0,0,0,310
13635,210,140,40,0,0,0,390
13636,160,140,120,0,0,0,420
13637,210,120,120,160,320,320,1250
13638,200,120,40,80,160,0,600
13639,200,140,160,80,0,0,580
13640,190,140,120,80,160,0,690
13641,180,100,40,80,160,0,560
13642,210,160,80,160,160,0,770
13643,220,180,200,160,160,0,920
13644,170,80,80,80,160,0,570
13645,210,100,120,160,0,0,590
13646,160,100,40,80,160,0,540
13647,200,100,160,160,160,0,780
13648,200,100,120,0,0,0,420
13649,170,80,0,0,0,0,250
13650,170,100,80,80,160,0,590
13651,220,160,120,160,320,320,1300
13652,200,120,80,80,160,0,640
13653,150,140,200,240,320,0,1050
13654,180,120,120,240,160,0,820
13655,160,120,80,80,160,0,600
13656,180,80,80,80,160,0,580
13657,200,100,120,80,160,0,660
13658,230,160,120,160,160,320,1150
13659,200,120,40,0,0,0,360
13660,200,180,120,160,0,0,660
13661,180,100,80,80,0,0,440
13662,190,120,80,160,160,0,710
13663,210,160,160,160,160,0,850
13664,210,160,200,160,160,0,890
13665,200,80,120,160,160,0,720
13666,210,200,160,80,0,0,650
13667,230,100,120,0,0,0,450
13668,210,120,80,0,0,0,410
13669,170,100,80,80,160,0,590
13670,200,140,200,80,160,0,780
13671,190,140,40,0,0,0,370
13672,190,140,80,80,0,0,490
13673,200,160,160,160,160,0,840
13674,200,120,40,80,0,0,440
13675,240,140,160,160,320,320,1340
13676,220,80,120,80,160,0,660
13677,220,160,160,160,160,0,860
13678,230,80,80,160,160,0,710
13679,200,140,120,160,160,320,1100
13680,180,100,160,160,0,0,600
13681,190,100,40,80,160,0,570
13682,200,160,160,80,160,0,760
13683,200,160,160,160,160,320,1160
13684,170,100,80,80,160,0,590
13685,240,180,160,80,160,320,1140
13686,210,120,40,80,0,0,450
13687,230,60,40,0,0,0,330
13688,180,100,80,160,160,0,680
13689,190,140,40,80,0,0,450
13690,240,120,40,80,0,0,480
13691,210,80,160,160,160,0,770
13692,250,140,120,0,0,0,510
13693,180,160,40,0,0,0,380
13694,160,140,120,160,160,0,740
13695,180,80,120,160,160,0,700
13696,210,120,40,80,0,0,450
13697,240,140,80,160,320,0,940
13698,170,160,200,240,160,0,930
13699,200,120,80,160,160,0,720
13700,170,100,120,0,0,0,390
13701,190,140,160,80,0,0,570
13702,150,120,160,80,0,0,510
13703,220,160,120,240,160,0,900
13704,170,100,80,0,0,0,350
13705,190,120,120,160,0,0,590
13706,210,120,80,80,160,0,650
13707,220,80,40,80,160,0,580
13708,140,140,80,80,0,0,440
13709,160,140,80,0,0,0,380
13710,230,120,120,80,0,0,550
13711,220,160,160,80,160,0,780
13712,190,100,120,160,160,320,1050
13713,190,120,80,160,320,320,1190
13714,200,140,160,240,320,320,1380
13715,240,140,80,0,0,0,460
13716,210,120,80,0,0,0,410
13717,220,140,160,240,320,0,1080
13718,200,120,120,80,0,0,520
13719,230,140,120,0,0,0,490
13720,150,140,160,160,320,320,1250
13721,150,120,80,80,160,0,590
13722,210,160,80,80,0,0,530
13723,210,100,80,80,0,0,470
13724,190,160,200,160,320,320,1350
13725,230,140,120,160,160,320,1130
13726,170,140,40,0,0,0,350
13727,220,180,80,80,160,0,720
13728,180,120,80,160,320,0,860
13729,190,100,80,80,160,0,610
13730,190,140,160,160,160,320,1130
13731,150,120,80,0,0,0,350
13732,200,140,120,80,160,0,700
13733,200,160,80,80,0,0,520
13734,170,120,120,80,0,0,490
13735,160,60,40,0,0,0,260
13736,210,120,80,80,160,0,650
13737,220,160,160,160,160,320,1180
13738,190,140,160,240,320,0,1050
13739,190,100,120,160,0,0,570
13740,190,140,120,160,160,0,770
13741,240,200,160,160,320,0,1080
13742,170,100,40,80,0,0,390
13743,220,160,160,240,160,0,940
13744,180,100,80,160,160,0,680
13745,230,160,120,80,160,0,750
13746,180,60,40,80,160,0,520
13747,220,100,120,80,160,0,680
13748,170,160,160,160,160,320,1130
13749,220,160,80,80,160,0,700
13750,140,120,120,160,320,320,1180
13751,170,80,120,80,160,0,610
13752,230,140,160,240,320,0,1090
13753,170,60,120,160,320,0,830
13754,190,120,80,160,160,0,710
13755,180,100,120,0,0,0,400
13756,210,120,120,0,0,0,450
13757,180,80,80,160,160,0,660
13758,240,140,120,0,0,0,500
13759,240,140,120,80,0,0,580
13760,180,140,160,160,160,0,800
13761,230,140,80,160,0,0,610
13762,200,80,120,80,160,0,640
13763,180,100,80,80,160,0,600
13764,200,100,40,0,0,0,340
13765,210,120,120,160,160,0,770
13766,190,140,160,240,0,0,730
13767,190,100,80,0,0,0,370
13768,190,160,120,160,160,0,790
13769,220,180,160,160,160,0,880
13770,230,140,80,160,320,0,930
13771,170,120,120,80,160,320,970
13772,230,160,80,80,0,0,550
13773,210,80,120,80,0,0,490
13774,160,80,80,80,160,0,560
13775,210,120,80,80,160,0,650
13776,170,140,120,80,160,0,670
13777,180,140,160,80,160,0,720
13778,190,140,80,160,0,0,570
13779,180,140,160,160,320,0,960
13780,210,120,80,160,0,0,570
13781,160,80,80,80,160,0,560
13782,200,120,200,160,320,0,1000
13783,210,100,120,80,160,0,670
13784,180,120,80,80,160,0,620
13785,170,80,80,0,0,0,330
13786,200,140,80,0,0,0,420
13787,180,160,80,80,0,0,500
13788,170,100,80,0,0,0,350
13789,210,140,80,80,160,320,990
13790,180,100,80,80,0,0,440
13791,210,100,40,80,160,320,910
13792,140,140,160,160,320,0,920
13793,250,160,120,160,160,0,850
13794,230,120,120,160,160,0,790
13795,170,140,120,80,160,320,990
13796,160,100,120,0,0,0,380
13797,200,160,120,0,0,0,480
13798,210,100,120,80,160,0,670
13799,200,100,40,80,160,320,900
13800,210,120,120,0,0,0,450
13801,230,100,40,0,0,0,370
13802,210,100,80,80,0,0,470
13803,180,100,80,80,0,0,440
13804,200,140,120,160,160,320,1100
13805,230,120,120,160,160,0,790
13806,200,180,80,80,0,0,540
13807,210,140,160,160,320,0,990
13808,190,140,120,160,160,0,770
13809,200,120,120,160,160,0,760
13810,240,120,40,0,0,0,400
13811,150,60,80,80,160,320,850
13812,180,120,160,0,0,0,460
13813,190,120,40,0,0,0,350
13814,200,80,40,0,0,0,320
13815,160,100,160,160,320,0,900
13816,210,140,160,160,0,0,670
13817,220,120,80,160,320,320,1220
13818,240,140,160,80,0,0,620
13819,200,100,160,160,160,0,780
13820,180,140,160,240,320,0,1040
13821,190,120,120,80,160,0,670
13822,180,200,160,160,160,0,860
13823,170,80,40,0,0,0,290
13824,210,100,80,80,0,0,470
13825,210,160,80,80,160,0,690
13826,180,140,160,0,0,0,480
13827,190,140,200,80,160,320,1090
13828,160,160,120,80,160,0,680
13829,210,140,120,0,0,0,470
13830,200,120,120,160,160,0,760
13831,200,140,120,80,160,0,700
13832,220,100,120,160,160,0,760
13833,240,120,160,240,160,0,920
13834,200,140,80,80,160,0,660
13835,200,140,120,160,160,0,780
13836,160,80,80,0,0,0,320
13837,210,140,80,160,160,0,750
13838,220,120,120,0,0,0,460
13839,220,120,160,0,0,0,500
13840,210,140,160,80,160,0,750
13841,210,200,280,0,0,0,690
13842,200,180,40,0,0,0,420
13843,210,100,160,160,0,0,630
13844,200,140,120,240,0,0,700
13845,180,140,80,80,160,0,640
13846,160,180,160,80,160,0,740
13847,220,160,120,160,160,0,820
13848,150,120,40,80,160,0,550
13849,230,140,160,160,320,0,1010
13850,180,160,120,80,160,0,700
13851,230,160,160,160,160,320,1190
13852,170,140,200,160,160,0,830
13853,200,120,40,0,0,0,360
13854,210,160,240,160,0,0,770
13855,200,80,40,0,0,0,320
13856,190,120,120,80,160,0,670
13857,220,160,160,80,160,0,780
13858,190,80,40,0,0,0,310
13859,230,120,80,0,0,0,430
13860,210,100,0,0,0,0,310
13861,160,80,120,80,160,0,600
13862,180,120,80,80,0,0,460
13863,190,120,80,160,160,0,710
13864,200,180,80,0,0,0,460
13865,200,100,160,240,320,0,1020
13866,180,80,40,80,160,0,540
13867,170,120,0,0,0,0,290
13868,180,40,80,80,160,0,540
13869,220,120,120,160,320,320,1260
13870,220,140,120,80,160,0,720
13871,210,160,120,80,0,0,570
13872,160,120,120,160,160,0,720
13873,250,200,160,160,320,320,1410
13874,220,120,80,80,160,0,660
13875,250,160,200,240,160,320,1330
13876,200,120,120,160,0,0,600
13877,190,80,120,160,160,0,710
13878,180,80,120,160,160,0,700
13879,240,200,160,160,0,0,760
13880,160,80,80,160,0,0,480
13881,190,100,80,80,0,0,450
13882,210,100,40,80,160,320,910
13883,210,120,80,0,0,0,410
13884,170,120,160,240,160,0,850
13885,200,100,160,80,0,0,540
13886,190,120,120,240,160,0,830
13887,200,160,160,160,320,0,1000
13888,230,140,80,80,0,0,530
13889,150,80,40,0,0,0,270
13890,230,140,80,80,160,0,690
13891,200,140,120,160,160,0,780
13892,190,140,120,80,160,0,690
13893,220,140,80,80,160,0,680
13894,160,140,80,80,160,320,940
13895,150,80,80,0,0,0,310
13896,170,120,80,160,160,0,690
13897,190,40,40,80,160,320,830
13898,210,100,80,160,160,0,710
13899,230,140,120,160,320,0,970
13900,170,80,80,160,160,0,650
13901,210,160,120,160,0,0,650
13902,160,80,160,160,320,0,880
13903,190,100,80,80,0,0,450
13904,220,80,40,0,0,0,340
13905,180,160,120,80,160,0,700
13906,210,100,120,80,0,0,510
13907,220,100,40,0,0,0,360
13908,200,100,160,160,160,320,1100
13909,200,140,120,240,320,320,1340
13910,220,100,120,160,160,0,760
13911,180,100,120,240,320,320,1280
13912,180,120,120,80,160,0,660
13913,170,140,200,240,320,320,1390
13914,230,140,80,80,160,0,690
13915,140,80,40,0,0,0,260
13916,160,100,160,0,0,0,420
13917,230,140,200,160,160,0,890
13918,230,160,80,80,160,0,710
13919,200,140,120,160,160,0,780
13920,240,140,160,160,160,320,1180
13921,190,60,40,80,160,0,530
13922,230,80,40,80,0,0,430
13923,210,80,120,80,0,0,490
13924,210,120,160,80,0,0,570
13925,170,80,120,80,160,320,930
13926,210,120,40,80,0,0,450
13927,220,80,80,160,160,320,1020
13928,190,100,80,80,160,0,610
13929,230,140,120,0,0,0,490
13930,220,160,160,80,160,0,780
13931,170,120,120,160,160,0,730
13932,170,160,160,80,160,0,730
13933,210,180,120,0,0,0,510
13934,190,100,120,160,160,0,730
13935,220,160,200,160,160,0,900
13936,220,140,80,80,0,0,520
13937,240,60,80,160,160,0,700
13938,180,100,80,80,0,0,440
13939,180,140,80,80,160,0,640
13940,240,120,160,160,0,0,680
13941,180,100,80,80,160,0,600
13942,270,200,40,0,0,0,510
13943,180,80,160,160,0,0,580
13944,180,140,120,160,0,0,600
13945,200,120,160,80,160,320,1040
13946,190,200,200,80,0,0,670
13947,240,140,120,80,160,0,740
13948,190,140,80,160,160,0,730
13949,240,120,80,80,160,0,680
13950,200,100,160,160,160,0,780
13951,200,60,120,80,0,0,460
13952,220,200,120,160,0,0,700
13953,210,100,80,0,0,0,390
13954,190,120,120,160,160,0,750
13955,190,140,120,160,160,0,770
13956,220,160,160,160,160,0,860
13957,200,180,160,80,0,0,620
13958,210,100,80,160,160,0,710
13959,240,200,200,160,160,0,960
13960,210,100,80,0,0,0,390
13961,150,100,120,0,0,0,370
13962,180,160,160,80,160,0,740
13963,180,120,160,240,160,0,860
13964,180,100,40,80,160,0,560
13965,220,120,80,0,0,0,420
13966,190,160,160,160,160,0,830
13967,220,160,120,240,160,0,900
13968,200,160,160,160,320,0,1000
13969,240,160,160,160,0,0,720
13970,200,140,40,0,0,0,380
13971,200,120,120,160,160,0,760
13972,190,180,200,240,0,0,810
13973,170,80,40,0,0,0,290
13974,190,140,80,160,320,0,890
13975,200,120,120,80,160,0,680
13976,210,100,120,80,160,0,670
13977,180,160,40,0,0,0,380
13978,210,120,80,80,160,0,650
13979,210,120,120,0,0,0,450
13980,210,140,120,240,320,0,1030
13981,230,100,40,80,160,0,610
13982,230,120,40,80,0,0,470
13983,180,80,120,80,160,0,620
13984,190,120,120,0,0,0,430
13985,210,100,120,160,160,0,750
13986,210,140,40,0,0,0,390
13987,210,160,80,160,160,0,770
13988,220,160,160,80,160,0,780
13989,220,120,160,240,160,0,900
13990,190,80,0,0,0,0,270
13991,200,120,120,0,0,0,440
13992,180,120,120,160,320,0,900
13993,180,120,120,0,0,0,420
13994,190,120,120,0,0,0,430
13995,190,100,160,160,160,0,770
13996,210,140,80,80,0,0,510
13997,170,80,40,0,0,0,290
13998,190,160,120,160,160,320,1110
13999,240,40,40,80,0,0,400
14000,220,140,120,80,0,0,560
14001,170,100,40,80,160,0,550
14002,180,60,80,0,0,0,320
14003,200,80,0,0,0,0,280
14004,180,140,160,80,0,0,560
14005,220,140,40,0,0,0,400
14006,190,100,120,160,160,0,730
14007,200,180,120,160,160,0,820
14008,200,140,160,240,160,0,900
14009,170,60,40,80,0,0,350
14010,150,100,80,80,160,0,570
14011,170,40,0,0,0,0,210
14012,160,140,80,80,0,0,460
14013,190,120,80,160,320,320,1190
14014,220,160,200,160,160,0,900
14015,150,100,160,160,160,0,730
14016,210,140,80,0,0,0,430
14017,220,120,160,80,160,0,740
14018,210,140,120,80,160,0,710
14019,200,120,160,160,0,0,640
14020,150,100,80,80,160,0,570
14021,170,100,120,160,160,0,710
14022,150,80,120,80,0,0,430
14023,180,80,80,80,0,0,420
14024,200,140,160,160,160,0,820
14025,210,80,40,0,0,0,330
14026,220,100,120,0,0,0,440
14027,180,120,160,240,160,0,860
14028,210,120,80,80,160,0,650
14029,190,160,120,80,0,0,550
14030,200,180,80,80,160,0,700
14031,160,100,80,80,160,0,580
14032,190,140,80,0,0,0,410
14033,220,140,80,160,160,0,760
14034,210,160,200,160,160,0,890
14035,180,160,120,80,0,0,540
14036,190,100,80,80,0,0,450
14037,210,200,80,80,0,0,570
14038,200,180,80,80,0,0,540
14039,180,140,120,80,0,0,520
14040,180,80,120,160,320,0,860
14041,200,140,120,80,0,0,540
14042,180,120,40,0,0,0,340
14043,240,160,200,160,0,0,760
14044,180,160,80,80,160,0,660
14045,190,140,200,160,160,320,1170
14046,190,100,80,80,160,0,610
14047,210,120,120,0,0,0,450
14048,220,100,40,0,0,0,360
14049,200,140,120,80,160,0,700
14050,150,60,40,80,160,0,490
14051,200,180,120,80,160,0,740
14052,220,180,160,160,160,0,880
14053,200,80,80,80,160,0,600
14054,190,140,160,160,320,0,970
14055,170,60,40,0,0,0,270
14056,190,160,120,160,160,0,790
14057,220,120,160,240,320,0,1060
14058,200,100,80,80,160,0,620
14059,220,140,120,80,0,0,560
14060,200,140,200,160,160,0,860
14061,200,140,160,80,160,0,740
14062,200,80,80,0,0,0,360
14063,210,100,80,80,160,0,630
14064,200,160,80,80,0,0,520
14065,190,80,80,80,160,0,590
14066,170,140,80,80,160,0,630
14067,160,100,40,80,160,0,540
14068,210,120,120,160,0,0,610
14069,180,140,120,160,320,0,920
14070,220,80,120,0,0,0,420
14071,220,160,80,160,320,0,940
14072,220,160,80,0,0,0,460
14073,190,120,160,0,0,0,470
14074,180,80,40,80,160,0,540
14075,190,140,200,240,160,0,930
14076,210,120,80,0,0,0,410
14077,230,180,80,0,0,0,490
14078,220,140,120,160,160,0,800
14079,240,140,200,160,160,0,900
14080,170,80,40,80,0,0,370
14081,190,80,80,0,0,0,350
14082,200,180,120,80,0,0,580
14083,180,140,120,160,0,0,600
14084,230,160,80,80,160,0,710
14085,230,120,40,0,0,0,390
14086,250,180,80,80,0,0,590
14087,180,100,120,0,0,0,400
14088,180,120,80,0,0,0,380
14089,180,140,80,160,160,0,720
14090,210,100,80,80,0,0,470
14091,170,120,160,80,160,0,690
14092,200,120,200,160,160,0,840
14093,210,120,80,0,0,0,410
14094,180,120,120,240,320,320,1300
14095,200,100,80,80,0,0,460
14096,180,100,120,80,160,0,640
14097,190,140,120,80,0,0,530
14098,220,120,120,160,0,0,620
14099,220,120,80,160,160,320,1060
14100,180,100,160,0,0,0,440
14101,210,80,120,160,160,0,730
14102,190,100,40,0,0,0,330
14103,210,120,40,80,160,0,610
14104,200,100,80,80,160,320,940
14105,180,100,160,80,160,0,680
14106,190,160,160,160,160,0,830
14107,220,120,40,0,0,0,380
14108,220,120,120,80,0,0,540
14109,180,100,80,80,160,0,600
14110,190,140,120,160,160,0,770
14111,180,120,120,160,320,0,900
14112,220,140,80,160,320,0,920
14113,190,100,120,160,160,0,730
14114,190,80,80,160,160,0,670
14115,200,100,160,160,160,0,780
14116,230,140,160,160,160,0,850
14117,200,120,80,160,160,0,720
14118,180,140,80,80,160,0,640
14119,180,120,40,80,0,0,420
14120,230,80,80,0,0,0,390
14121,200,80,80,0,0,0,360
14122,220,100,80,160,320,0,880
14123,180,100,40,0,0,0,320
14124,200,80,80,160,160,0,680
14125,200,140,120,240,160,0,860
14126,180,80,80,0,0,0,340
14127,210,140,160,240,160,320,1230
14128,210,100,120,80,160,0,670
14129,190,80,120,80,160,320,950
14130,190,80,80,160,0,0,510
14131,200,120,160,80,160,0,720
14132,220,140,80,80,160,320,1000
14133,210,120,80,160,0,0,570
14134,190,120,160,80,160,0,710
14135,200,140,80,80,160,0,660
14136,190,120,80,160,320,0,870
14137,210,80,120,160,160,0,730
14138,240,120,160,80,160,0,760
14139,220,80,40,0,0,0,340
14140,140,120,120,160,160,0,700
14141,190,120,120,80,160,0,670
14142,170,160,0,0,0,0,330
14143,200,100,40,0,0,0,340
14144,170,100,120,160,160,0,710
14145,190,100,40,80,160,0,570
14146,170,120,200,160,160,0,810
14147,170,180,120,160,160,0,790
14148,190,100,120,80,160,0,650
14149,180,140,120,160,160,0,760
14150,210,160,160,160,320,320,1330
14151,210,160,80,80,160,0,690
14152,210,160,120,0,0,0,490
14153,150,120,160,160,160,0,750
14154,180,120,80,80,160,0,620
14155,200,180,80,0,0,0,460
14156,140,80,40,0,0,0,260
14157,150,140,160,160,320,320,1250
14158,200,120,80,80,0,0,480
14159,200,120,160,160,0,0,640
14160,230,160,240,240,160,0,1030
14161,200,120,160,80,0,0,560
14162,190,140,160,80,160,0,730
14163,170,140,120,80,160,0,670
14164,230,120,120,80,160,0,710
14165,220,100,40,0,0,0,360
14166,210,160,160,80,160,0,770
14167,170,60,80,0,0,0,310
14168,220,140,80,160,0,0,600
14169,210,180,120,80,160,0,750
14170,190,100,40,80,0,0,410
14171,190,80,160,240,160,320,1150
14172,220,140,200,160,160,0,880
14173,220,160,120,240,320,0,1060
14174,220,100,120,80,160,0,680
14175,240,120,80,80,160,0,680
14176,220,60,40,80,160,0,560
14177,190,100,80,80,160,0,610
14178,190,120,40,0,0,0,350
14179,180,140,40,80,160,320,920
14180,160,100,40,80,160,0,540
14181,200,140,120,80,160,320,1020
14182,210,180,160,160,160,0,870
14183,190,100,160,160,160,0,770
14184,240,100,120,240,320,0,1020
14185,210,180,200,80,160,0,830
14186,190,140,120,160,0,0,610
14187,180,140,120,80,160,0,680
14188,210,160,240,240,160,0,1010
14189,190,180,80,80,160,0,690
14190,190,100,40,80,0,0,410
14191,200,80,120,240,160,0,800
14192,220,140,160,160,160,0,840
14193,220,80,40,0,0,0,340
14194,180,100,40,80,160,0,560
14195,210,160,120,80,160,0,730
14196,180,140,80,160,0,0,560
14197,170,120,120,80,0,0,490
14198,180,80,80,80,160,0,580
14199,200,140,120,80,160,0,700
14200,200,180,240,0,0,0,620
14201,200,120,80,80,0,0,480
14202,220,140,80,0,0,0,440
14203,180,60,40,80,160,0,520
14204,170,120,160,160,160,0,770
14205,190,80,80,80,0,0,430
14206,190,120,40,80,160,0,590
14207,200,100,120,80,160,0,660
14208,230,160,80,0,0,0,470
14209,230,140,120,0,0,0,490
14210,220,80,80,0,0,0,380
14211,200,80,80,80,160,0,600
14212,250,160,120,80,160,320,1090
14213,190,160,80,80,160,0,670
14214,210,160,160,240,320,320,1410
14215,200,120,40,80,0,0,440
14216,230,120,80,0,0,0,430
14217,190,180,160,160,0,0,690
14218,170,120,120,160,320,0,890
14219,220,120,160,80,160,0,740
14220,130,60,0,0,0,0,190
14221,230,200,160,240,0,0,830
14222,190,140,120,160,0,0,610
14223,190,160,160,160,160,0,830
14224,210,100,120,160,160,320,1070
14225,210,160,40,0,0,0,410
14226,210,180,160,80,0,0,630
14227,210,160,120,80,160,0,730
14228,180,120,40,80,160,0,580
14229,150,80,40,80,160,320,830
14230,210,120,120,160,160,0,770
14231,160,120,80,80,0,0,440
14232,190,100,80,80,160,0,610
14233,220,180,120,160,160,0,840
14234,170,80,80,160,160,320,970
14235,160,100,120,80,160,0,620
14236,180,120,120,80,160,0,660
14237,190,160,120,80,160,320,1030
14238,190,100,80,80,0,0,450
14239,210,100,80,160,160,0,710
14240,250,140,160,160,160,0,870
14241,200,160,80,160,320,320,1240
14242,220,160,120,80,0,0,580
14243,230,140,160,0,0,0,530
14244,240,200,120,160,160,0,880
14245,180,40,80,80,160,0,540
14246,190,60,0,0,0,0,250
14247,180,80,120,160,160,320,1020
14248,180,120,120,80,0,0,500
14249,140,80,120,80,0,0,420
14250,210,120,160,80,160,0,730
14251,160,100,120,160,320,0,860
14252,180,120,80,160,160,320,1020
14253,230,140,40,80,0,0,490
14254,170,100,160,80,160,320,990
14255,160,80,80,0,0,0,320
14256,190,80,80,80,0,0,430
14257,180,120,120,80,160,0,660
14258,200,140,240,160,160,0,900
14259,240,120,80,160,160,0,760
14260,180,180,160,80,160,0,760
14261,230,160,160,80,0,0,630
14262,210,80,80,160,0,0,530
14263,210,120,80,80,0,0,490
14264,190,80,40,80,160,0,550
14265,220,140,80,80,160,0,680
14266,160,100,80,80,160,0,580
14267,230,140,160,160,160,0,850
14268,180,80,80,0,0,0,340
14269,180,120,120,240,320,320,1300
14270,170,100,40,80,0,0,390
14271,190,140,120,80,160,0,690
14272,220,120,80,160,0,0,580
14273,180,160,160,240,160,0,900
14274,170,120,80,0,0,0,370
14275,180,160,80,80,160,0,660
14276,200,180,120,80,0,0,580
14277,170,120,160,240,160,0,850
14278,200,160,160,240,320,0,1080
14279,230,80,0,0,0,0,310
14280,120,120,120,80,160,0,600
14281,190,60,80,80,160,320,890
14282,160,120,120,160,0,0,560
14283,230,140,80,80,160,0,690
14284,160,100,80,160,160,0,660
14285,220,80,40,0,0,0,340
14286,200,100,40,0,0,0,340
14287,240,140,40,0,0,0,420
14288,220,160,200,160,160,320,1220
14289,190,160,80,160,160,0,750
14290,190,180,160,160,0,0,690
14291,210,160,120,160,160,0,810
14292,190,120,40,80,160,0,590
14293,210,180,120,0,0,0,510
14294,160,120,200,0,0,0,480
14295,210,160,120,80,160,0,730
14296,180,100,120,80,160,0,640
14297,200,120,120,80,0,0,520
14298,250,160,160,240,160,320,1290
14299,180,140,120,160,160,0,760
14300,170,80,120,80,0,0,450
14301,210,100,40,80,160,320,910
14302,190,120,120,80,0,0,510
14303,200,160,200,160,160,320,1200
14304,230,120,120,80,0,0,550
14305,130,120,120,160,160,0,690
14306,160,120,160,240,160,320,1160
14307,210,140,80,80,160,0,670
14308,180,100,120,80,160,0,640
14309,210,120,160,160,320,320,1290
14310,210,120,120,0,0,0,450
14311,210,100,120,80,160,0,670
14312,190,100,80,80,0,0,450
14313,180,140,120,80,0,0,520
14314,180,140,80,160,160,320,1040
14315,200,120,80,0,0,0,400
14316,200,120,120,80,160,0,680
14317,170,100,120,80,0,0,470
14318,200,120,80,0,0,0,400
14319,220,140,80,80,0,0,520
14320,190,60,40,80,0,0,370
14321,180,80,80,80,160,0,580
14322,230,140,160,240,320,320,1410
14323,210,180,120,80,0,0,590
14324,210,80,120,80,160,0,650
14325,180,60,80,0,0,0,320
14326,150,80,40,0,0,0,270
14327,180,80,80,80,160,0,580
14328,170,60,40,80,0,0,350
14329,180,120,160,160,160,0,780
14330,170,160,200,240,320,320,1410
14331,180,100,80,160,0,0,520
14332,220,80,80,80,160,0,620
14333,190,120,120,80,160,0,670
14334,190,160,160,80,160,0,750
14335,200,100,120,80,160,0,660
14336,200,60,80,80,0,0,420
14337,190,160,160,160,0,0,670
14338,190,180,200,160,160,0,890
14339,210,180,160,160,160,320,1190
14340,220,100,40,0,0,0,360
14341,230,140,80,80,0,0,530
14342,180,120,120,160,0,0,580
14343,220,200,80,0,0,0,500
14344,230,160,80,160,0,0,630
14345,190,100,160,80,0,0,530
14346,190,80,120,0,0,0,390
14347,200,120,160,160,160,0,800
14348,180,60,0,0,0,0,240
14349,150,140,160,80,160,0,690
14350,180,100,80,80,0,0,440
14351,200,100,120,80,0,0,500
14352,220,100,120,80,160,0,680
14353,230,200,160,160,320,320,1390
14354,180,80,40,0,0,0,300
14355,170,120,120,0,0,0,410
14356,200,140,200,160,160,0,860
14357,220,120,80,80,0,0,500
14358,150,80,120,240,160,0,750
14359,230,160,120,80,0,0,590
14360,180,120,40,80,160,0,580
14361,170,80,80,0,0,0,330
14362,190,120,120,240,320,320,1310
14363,180,80,120,80,160,320,940
14364,200,120,120,0,0,0,440
14365,250,180,120,80,160,0,790
14366,210,120,200,160,160,0,850
14367,200,120,160,160,160,0,800
14368,220,160,120,160,160,0,820
14369,190,140,160,240,320,0,1050
14370,150,120,120,160,320,320,1190
14371,200,100,40,80,0,0,420
14372,170,120,80,80,160,0,610
14373,250,180,120,80,160,0,790
14374,200,80,120,80,160,0,640
14375,200,140,80,80,160,0,660
14376,190,120,120,80,0,0,510
14377,180,120,120,240,320,0,980
14378,210,160,200,240,160,0,970
14379,230,120,120,80,0,0,550
14380,250,100,160,240,0,0,750
14381,190,60,80,80,160,320,890
14382,200,120,120,80,160,0,680
14383,210,100,120,80,0,0,510
14384,180,100,120,160,320,0,880
14385,200,160,120,80,0,0,560
14386,210,140,80,80,160,320,990
14387,210,180,120,160,0,0,670
14388,230,200,160,80,160,0,830
14389,180,80,80,0,0,0,340
14390,200,140,80,80,0,0,500
14391,200,120,120,240,320,0,1000
14392,160,80,120,160,320,0,840
14393,190,80,80,80,0,0,430
14394,270,100,80,0,0,0,450
14395,180,120,160,80,0,0,540
14396,220,160,160,240,160,0,940
14397,190,180,120,80,160,320,1050
14398,180,120,120,0,0,0,420
14399,170,80,160,80,0,0,490
14400,190,120,160,80,160,0,710
14401,250,160,200,80,0,0,690
14402,200,180,40,80,160,320,980
14403,200,180,80,160,160,0,780
14404,230,100,40,80,160,0,610
14405,200,140,40,80,160,0,620
14406,170,80,120,160,0,0,530
14407,180,100,80,160,160,320,1000
14408,190,120,200,160,160,0,830
14409,190,100,80,80,160,0,610
14410,200,120,120,0,0,0,440
14411,170,20,40,80,160,0,470
14412,210,80,120,160,160,0,730
14413,210,120,80,0,0,0,410
14414,230,120,40,80,160,0,630
14415,180,120,40,80,160,320,900
14416,220,180,120,240,320,0,1080
14417,190,60,40,80,0,0,370
14418,230,160,160,160,160,0,870
14419,190,160,80,80,0,0,510
14420,210,120,80,160,160,0,730
14421,230,100,120,160,320,320,1250
14422,190,160,160,160,320,0,990
14423,190,120,80,160,320,320,1190
14424,180,120,40,0,0,0,340
14425,250,220,120,160,160,0,910
14426,190,80,40,80,160,0,550
14427,220,100,40,0,0,0,360
14428,200,120,0,0,0,0,320
14429,240,180,80,160,160,0,820
14430,170,120,120,80,160,320,970
14431,180,140,0,0,0,0,320
14432,200,140,40,80,160,0,620
14433,200,120,80,80,0,0,480
14434,200,100,80,160,160,0,700
14435,190,60,80,0,0,0,330
14436,210,120,80,80,160,0,650
14437,190,120,160,240,160,320,1190
14438,200,100,80,0,0,0,380
14439,180,160,80,160,0,0,580
14440,160,160,200,80,160,0,760
14441,200,120,160,80,0,0,560
14442,190,140,80,80,0,0,490
14443,200,100,80,80,160,0,620
14444,170,140,120,80,160,0,670
14445,230,180,80,0,0,0,490
14446,190,100,40,0,0,0,330
14447,190,120,80,80,160,0,630
14448,180,80,80,0,0,0,340
14449,180,120,120,80,160,0,660
14450,190,100,80,160,320,0,850
14451,170,160,160,80,0,0,570
14452,220,100,120,160,0,0,600
14453,200,120,40,80,160,0,600
14454,190,140,40,80,160,0,610
14455,130,120,160,160,160,0,730
14456,190,140,40,80,0,0,450
14457,190,80,120,160,320,0,870
14458,190,120,120,160,160,320,1070
14459,220,120,80,80,0,0,500
14460,180,100,160,160,160,0,760
14461,210,200,120,0,0,0,530
14462,190,120,80,80,160,0,630
14463,190,180,120,0,0,0,490
14464,170,140,120,160,160,320,1070
14465,180,140,80,80,0,0,480
14466,190,80,80,80,0,0,430
14467,210,40,40,0,0,0,290
14468,240,100,160,80,0,0,580
14469,210,120,200,80,160,0,770
14470,200,100,160,160,160,0,780
14471,190,120,80,80,160,0,630
14472,180,120,120,80,160,0,660
14473,220,60,80,0,0,0,360
14474,240,120,120,80,160,0,720
14475,210,120,0,0,0,0,330
14476,240,140,120,240,320,0,1060
14477,150,120,120,0,0,0,390
14478,160,100,120,80,0,0,460
14479,200,200,120,0,0,0,520
14480,170,60,80,0,0,0,310
14481,240,180,80,80,160,0,740
14482,220,140,200,240,320,0,1120
14483,200,120,80,160,0,0,560
14484,240,120,120,80,160,0,720
14485,210,100,160,160,160,0,790
14486,190,160,120,80,0,0,550
14487,200,60,0,0,0,0,260
14488,200,120,40,0,0,0,360
14489,160,140,40,0,0,0,340
14490,210,120,120,80,160,0,690
14491,200,140,120,160,0,0,620
14492,180,120,160,160,160,0,780
14493,200,80,40,0,0,0,320
14494,240,100,80,160,160,0,740
14495,190,140,160,80,0,0,570
14496,210,100,40,80,160,0,590
14497,190,100,40,80,160,0,570
14498,210,140,120,80,160,0,710
14499,170,140,160,80,160,320,1030
14500,190,120,120,80,0,0,510
14501,220,120,160,160,160,0,820
14502,180,100,80,160,160,0,680
14503,170,40,80,0,0,0,290
14504,220,180,80,80,160,0,720
14505,200,100,120,80,0,0,500
14506,220,160,160,0,0,0,540
14507,240,200,200,80,0,0,720
14508,160,100,120,240,160,0,780
14509,220,180,160,240,160,320,1280
14510,180,100,40,80,0,0,400
14511,190,100,120,160,320,0,890
14512,160,120,120,160,160,0,720
14513,170,140,120,160,160,320,1070
14514,230,140,160,160,160,320,1170
14515,170,100,80,160,160,320,990
14516,200,180,80,0,0,0,460
14517,210,180,160,240,160,0,950
14518,220,120,160,160,160,0,820
14519,200,140,240,160,0,0,740
14520,200,160,160,80,0,0,600
14521,190,160,80,80,0,0,510
14522,200,120,80,80,160,0,640
14523,200,180,80,80,160,0,700
14524,210,140,120,80,0,0,550
14525,200,120,80,80,0,0,480
14526,180,100,40,0,0,0,320
14527,140,80,80,80,160,0,540
14528,190,120,120,80,160,0,670
14529,230,120,120,160,320,0,950
14530,190,160,160,80,0,0,590
14531,170,80,120,160,160,320,1010
14532,210,140,0,0,0,0,350
14533,200,180,120,160,0,0,660
14534,160,100,120,80,160,320,940
14535,230,100,120,80,160,0,690
14536,240,140,160,0,0,0,540
14537,200,120,80,80,160,0,640
14538,160,120,40,0,0,0,320
14539,210,180,120,80,160,0,750
14540,180,140,120,160,160,320,1080
14541,200,60,0,0,0,0,260
14542,190,80,160,160,160,0,750
14543,180,100,160,160,320,320,1240
14544,200,100,80,80,160,0,620
14545,200,120,160,80,160,0,720
14546,220,120,120,160,0,0,620
14547,200,120,40,80,0,0,440
14548,190,120,160,80,160,0,710
14549,230,140,120,0,0,0,490
14550,240,120,120,0,0,0,480
14551,180,100,80,0,0,0,360
14552,180,40,80,80,160,0,540
14553,240,140,160,80,160,320,1100
14554,230,140,120,80,160,0,730
14555,230,140,120,80,160,0,730
14556,200,140,120,160,160,0,780
14557,130,120,80,0,0,0,330
14558,220,120,160,160,160,0,820
14559,200,100,120,240,160,0,820
14560,200,80,80,80,0,0,440
14561,210,120,120,160,160,320,1090
14562,220,140,80,160,160,0,760
14563,200,120,40,0,0,0,360
14564,220,120,80,80,160,0,660
14565,230,180,160,80,160,0,810
14566,180,160,120,80,160,0,700
14567,180,140,120,160,0,0,600
14568,160,80,120,80,0,0,440
14569,160,100,80,80,160,0,580
14570,180,140,120,240,160,0,840
14571,180,80,40,0,0,0,300
14572,200,120,120,0,0,0,440
14573,210,180,200,160,160,0,910
14574,220,100,120,80,160,0,680
14575,240,140,160,160,320,0,1020
14576,170,80,120,240,320,320,1250
14577,200,160,120,160,320,320,1280
14578,210,120,120,160,320,0,930
14579,160,120,80,0,0,0,360
14580,210,140,160,240,320,0,1070
14581,210,120,40,80,160,0,610
14582,200,140,40,80,0,0,460
14583,190,140,120,160,160,0,770
14584,200,80,40,0,0,0,320
14585,160,100,80,80,0,0,420
14586,170,120,120,80,0,0,490
14587,220,120,120,80,0,0,540
14588,200,120,160,80,0,0,560
14589,230,180,120,80,160,320,1090
14590,210,120,80,80,0,0,490
14591,180,120,80,160,160,0,700
14592,200,120,120,80,160,0,680
14593,200,60,80,160,0,0,500
14594,190,140,160,240,160,0,890
14595,180,160,120,80,160,0,700
14596,230,200,200,160,160,0,950
14597,210,100,120,80,160,0,670
14598,190,100,120,240,160,0,810
14599,190,100,120,160,160,0,730
14600,210,120,40,80,0,0,450
14601,200,180,120,160,160,0,820
14602,210,120,80,80,0,0,490
14603,210,140,120,160,320,0,950
14604,220,120,80,80,0,0,500
14605,230,160,80,0,0,0,470
14606,190,140,120,160,320,0,930
14607,170,120,200,160,160,0,810
14608,180,40,40,80,160,0,500
14609,170,120,120,160,320,0,890
14610,230,100,80,160,0,0,570
14611,200,140,160,80,160,0,740
14612,220,100,40,0,0,0,360
14613,190,120,160,80,0,0,550
14614,160,140,120,0,0,0,420
14615,200,100,120,0,0,0,420
14616,200,160,80,80,160,0,680
14617,230,100,40,80,160,0,610
14618,210,120,80,160,320,0,890
14619,220,120,160,80,160,0,740
14620,170,80,160,240,320,0,970
14621,230,200,160,80,160,0,830
14622,200,160,160,160,0,0,680
14623,230,120,120,160,160,0,790
14624,210,160,160,160,160,0,850
14625,170,100,120,80,160,0,630
14626,190,80,40,0,0,0,310
14627,190,60,40,80,160,0,530
14628,200,140,80,160,320,0,900
14629,180,60,40,80,0,0,360
14630,190,100,120,80,160,0,650
14631,200,120,160,240,160,0,880
14632,180,120,40,80,0,0,420
14633,170,60,80,80,160,0,550
14634,200,180,160,80,0,0,620
14635,160,60,80,80,0,0,380
14636,240,140,160,80,160,320,1100
14637,180,60,40,80,160,0,520
14638,180,120,120,0,0,0,420
14639,200,140,120,80,160,0,700
14640,200,160,40,0,0,0,400
14641,200,100,80,80,160,0,620
14642,230,160,80,80,160,0,710
14643,240,140,120,240,0,0,740
14644,200,140,160,160,160,320,1140
14645,200,120,120,80,160,0,680
14646,180,140,160,80,0,0,560
14647,190,120,80,160,0,0,550
14648,210,120,160,240,320,320,1370
14649,200,120,120,80,0,0,520
14650,170,100,120,80,160,0,630
14651,210,80,80,160,160,0,690
14652,190,120,0,0,0,0,310
14653,210,140,160,80,0,0,590
14654,150,80,120,80,0,0,430
14655,180,140,80,0,0,0,400
14656,200,160,160,80,160,0,760
14657,180,100,120,160,160,320,1040
14658,180,160,160,80,0,0,580
14659,190,140,80,80,160,0,650
14660,200,120,80,80,0,0,480
14661,200,120,80,0,0,0,400
14662,170,100,120,160,0,0,550
14663,180,100,120,160,0,0,560
14664,200,120,160,160,0,0,640
14665,260,160,120,80,0,0,620
14666,210,100,80,80,0,0,470
14667,180,60,80,160,160,0,640
14668,190,120,80,80,160,0,630
14669,180,160,160,80,0,0,580
14670,250,120,80,160,160,0,770
14671,150,100,120,80,160,320,930
14672,170,140,40,0,0,0,350
14673,200,100,80,80,0,0,460
14674,220,140,120,160,160,320,1120
14675,200,160,160,80,160,320,1080
14676,200,160,160,80,160,0,760
14677,220,80,40,80,160,0,580
14678,190,80,80,160,320,320,1150
14679,220,120,40,80,160,0,620
14680,220,160,160,160,0,0,700
14681,200,140,160,0,0,0,500
14682,210,100,80,0,0,0,390
14683,190,140,40,80,160,0,610
14684,200,120,80,0,0,0,400
14685,180,180,200,240,320,0,1120
14686,210,160,120,80,0,0,570
14687,190,80,40,80,160,0,550
14688,230,140,160,160,160,0,850
14689,220,180,160,160,160,0,880
14690,210,160,80,80,0,0,530
14691,200,80,120,80,160,0,640
14692,200,180,80,80,160,0,700
14693,210,180,160,80,160,0,790
14694,190,140,160,80,0,0,570
14695,220,140,80,80,160,320,1000
14696,180,120,120,80,0,0,500
14697,210,60,120,160,0,0,550
14698,220,100,80,0,0,0,400
14699,190,160,160,160,0,0,670
14700,170,100,40,80,160,0,550
14701,200,140,80,80,160,0,660
14702,160,160,120,80,160,0,680
14703,190,100,160,240,160,320,1170
14704,180,180,120,0,0,0,480
14705,180,80,80,0,0,0,340
14706,170,120,120,160,160,0,730
14707,180,100,80,160,160,0,680
14708,190,120,200,160,320,320,1310
14709,180,60,80,80,160,0,560
14710,160,120,120,160,320,0,880
14711,200,140,40,80,160,0,620
14712,180,120,80,0,0,0,380
14713,180,100,120,80,0,0,480
14714,160,80,120,160,320,320,1160
14715,180,80,80,80,0,0,420
14716,220,60,80,160,320,320,1160
14717,190,120,160,160,160,0,790
14718,160,100,120,80,160,0,620
14719,190,160,120,80,160,0,710
14720,250,120,80,160,320,0,930
14721,190,100,160,80,160,320,1010
14722,200,120,120,160,320,320,1240
14723,190,120,40,0,0,0,350
14724,210,140,120,160,160,0,790
14725,240,140,80,80,160,0,700
14726,190,120,160,80,0,0,550
14727,190,140,80,160,320,0,890
14728,160,120,80,80,0,0,440
14729,190,80,40,80,160,0,550
14730,160,140,120,160,160,320,1060
14731,190,140,120,80,160,0,690
14732,200,140,120,160,160,0,780
14733,170,140,80,80,160,320,950
14734,190,80,40,0,0,0,310
14735,230,120,40,0,0,0,390
14736,210,160,200,160,160,0,890
14737,200,120,120,160,0,0,600
14738,170,180,160,160,320,0,990
14739,240,120,120,160,160,0,800
14740,230,180,120,80,160,0,770
14741,180,140,40,0,0,0,360
14742,170,80,40,80,160,0,530
14743,180,140,80,80,0,0,480
14744,160,160,40,80,160,0,600
14745,190,120,160,160,320,0,950
14746,180,160,40,80,160,0,620
14747,190,120,120,80,0,0,510
14748,160,80,80,80,0,0,400
14749,240,120,120,80,0,0,560
14750,230,120,120,0,0,0,470
14751,220,160,80,80,160,0,700
14752,190,100,120,160,320,0,890
14753,220,160,120,160,160,0,820
14754,170,40,40,0,0,0,250
14755,180,60,80,80,0,0,400
14756,210,140,80,80,0,0,510
14757,190,120,200,160,160,0,830
14758,210,120,80,80,160,320,970
14759,180,100,120,160,320,0,880
14760,150,160,160,160,160,320,1110
14761,210,140,120,160,320,0,950
14762,220,140,40,80,160,0,640
14763,180,160,120,80,0,0,540
14764,190,100,120,240,320,320,1290
14765,180,60,80,80,160,0,560
14766,190,80,40,0,0,0,310
14767,240,120,80,80,160,320,1000
14768,200,120,0,0,0,0,320
14769,190,120,120,160,0,0,590
14770,190,160,80,80,160,0,670
14771,210,120,80,0,0,0,410
14772,180,80,120,160,160,320,1020
14773,190,120,120,160,160,0,750
14774,190,80,40,80,160,0,550
14775,140,100,40,80,0,0,360
14776,210,80,120,80,160,0,650
14777,190,180,80,0,0,0,450
14778,210,140,120,160,160,0,790
14779,190,140,80,160,160,0,730
14780,210,160,120,80,160,0,730
14781,240,120,120,80,160,0,720
14782,240,200,120,160,160,0,880
14783,200,160,160,160,160,320,1160
14784,200,100,80,80,160,0,620
14785,190,140,80,80,160,0,650
14786,210,100,120,80,160,0,670
14787,230,120,120,160,160,320,1110
14788,180,120,40,80,0,0,420
14789,200,140,80,80,160,0,660
14790,170,120,40,0,0,0,330
14791,180,80,40,0,0,0,300
14792,200,80,80,80,0,0,440
14793,200,100,120,160,160,320,1060
14794,160,120,120,160,320,320,1200
14795,180,120,40,80,160,0,580
14796,170,80,80,80,160,0,570
14797,200,100,120,80,0,0,500
14798,200,180,80,80,0,0,540
14799,190,120,120,160,160,320,1070
14800,160,140,160,80,0,0,540
14801,210,100,80,160,320,0,870
14802,220,100,80,80,160,0,640
14803,200,180,160,160,0,0,700
14804,210,120,120,80,160,0,690
14805,200,140,160,80,160,0,740
14806,180,120,160,80,160,0,700
14807,210,160,160,80,0,0,610
14808,220,100,80,160,160,320,1040
14809,250,160,120,0,0,0,530
14810,210,120,160,80,160,0,730
14811,210,140,120,160,0,0,630
14812,220,120,120,80,160,0,700
14813,180,120,120,240,320,0,980
14814,170,80,120,80,160,0,610
14815,190,160,120,80,0,0,550
14816,170,200,160,240,160,0,930
14817,230,120,40,80,160,320,950
14818,150,140,160,80,160,0,690
14819,190,160,200,160,160,0,870
14820,200,80,80,160,160,320,1000
14821,210,180,200,160,160,0,910
14822,200,120,120,160,160,0,760
14823,220,40,80,160,160,0,660
14824,210,120,80,0,0,0,410
14825,210,120,160,0,0,0,490
14826,180,60,0,0,0,0,240
14827,190,120,80,160,0,0,550
14828,170,100,80,80,160,0,590
14829,150,80,80,0,0,0,310
14830,180,100,80,80,0,0,440
14831,170,140,240,80,160,0,790
14832,160,160,120,160,320,0,920
14833,180,100,120,160,320,320,1200
14834,190,140,120,80,160,0,690
14835,190,80,120,80,0,0,470
14836,230,120,80,80,0,0,510
14837,180,80,120,160,0,0,540
14838,210,120,80,80,0,0,490
14839,210,160,160,80,0,0,610
14840,180,100,80,80,0,0,440
14841,210,100,40,0,0,0,350
14842,200,160,160,240,160,0,920
14843,210,140,160,240,160,0,910
14844,190,80,80,160,320,0,830
14845,230,160,120,80,160,0,750
14846,200,140,200,80,160,0,780
14847,210,160,120,160,0,0,650
14848,200,120,120,80,0,0,520
14849,230,160,120,160,320,0,990
14850,180,120,0,0,0,0,300
14851,200,180,160,160,0,0,700
14852,220,140,200,80,160,0,800
14853,220,100,80,80,160,0,640
14854,190,180,160,80,160,0,770
14855,250,160,120,80,160,320,1090
14856,230,80,80,160,160,0,710
14857,200,80,0,0,0,0,280
14858,180,100,80,80,0,0,440
14859,210,120,80,80,0,0,490
14860,180,100,120,80,160,0,640
14861,240,120,40,0,0,0,400
14862,190,140,120,0,0,0,450
14863,160,120,160,80,160,0,680
14864,200,80,80,80,0,0,440
14865,180,140,160,160,160,0,800
14866,170,80,40,80,160,0,530
14867,150,120,120,160,320,0,870
14868,180,100,80,80,0,0,440
14869,160,100,40,80,160,0,540
14870,190,120,80,80,160,0,630
14871,180,160,120,80,160,0,700
14872,240,160,160,240,160,320,1280
14873,180,120,40,80,160,0,580
14874,160,80,80,160,320,320,1120
14875,210,140,160,160,320,320,1310
14876,170,100,40,0,0,0,310
14877,210,180,120,80,0,0,590
14878,220,100,120,80,160,320,1000
14879,190,180,160,80,160,0,770
14880,210,160,80,80,0,0,530
14881,220,100,120,160,320,0,920
14882,220,120,160,80,160,320,1060
14883,180,40,0,0,0,0,220
14884,190,140,160,160,160,0,810
14885,190,140,160,80,160,0,730
14886,160,140,120,240,160,320,1140
14887,210,120,0,0,0,0,330
14888,210,140,80,80,160,0,670
14889,200,140,120,160,0,0,620
14890,190,60,40,0,0,0,290
14891,220,120,120,80,160,0,700
14892,210,100,0,0,0,0,310
14893,180,120,80,80,160,0,620
14894,200,100,80,80,160,0,620
14895,270,140,120,160,0,0,690
14896,210,100,120,80,160,0,670
14897,240,120,120,80,160,320,1040
14898,200,60,40,0,0,0,300
14899,190,120,160,80,160,0,710
14900,200,140,120,160,160,0,780
14901,180,100,80,80,160,0,600
14902,200,160,160,80,160,320,1080
14903,260,140,40,0,0,0,440
14904,220,120,160,160,0,0,660
14905,210,120,120,160,320,320,1250
14906,210,120,120,80,0,0,530
14907,160,140,80,80,0,0,460
14908,180,120,160,160,0,0,620
14909,200,80,120,160,320,0,880
14910,200,140,160,240,160,0,900
14911,200,160,120,80,0,0,560
14912,160,120,120,160,320,0,880
14913,200,140,120,160,160,0,780
14914,190,160,120,0,0,0,470
14915,210,140,120,80,0,0,550
14916,210,100,160,160,0,0,630
14917,220,100,120,80,0,0,520
14918,170,80,80,160,160,0,650
14919,190,100,80,160,320,0,850
14920,220,160,160,80,160,0,780
14921,250,60,80,80,160,0,630
14922,180,120,120,80,160,0,660
14923,180,120,160,160,160,320,1100
14924,210,140,120,160,160,320,1110
14925,210,160,120,160,160,0,810
14926,180,120,160,80,160,0,700
14927,150,60,40,80,0,0,330
14928,200,140,80,0,0,0,420
14929,210,120,120,160,320,0,930
14930,230,160,160,160,160,0,870
14931,170,100,80,0,0,0,350
14932,150,60,80,80,160,0,530
14933,210,120,120,160,320,320,1250
14934,180,100,80,0,0,0,360
14935,210,120,120,240,160,320,1170
14936,210,120,120,80,160,0,690
14937,170,160,160,240,160,0,890
14938,190,100,120,80,160,0,650
14939,150,120,120,80,0,0,470
14940,180,120,120,160,0,0,580
14941,170,60,40,80,160,0,510
14942,190,120,120,80,0,0,510
14943,190,120,80,80,160,320,950
14944,190,100,40,80,0,0,410
14945,200,120,80,160,160,0,720
14946,220,100,120,160,160,0,760
14947,200,60,120,160,0,0,540
14948,210,180,120,160,320,0,990
14949,220,140,80,80,0,0,520
14950,170,100,40,80,0,0,390
14951,200,120,80,80,0,0,480
14952,190,120,120,80,160,0,670
14953,190,120,80,160,320,320,1190
14954,180,100,40,80,160,320,880
14955,200,100,80,80,0,0,460
14956,190,120,120,160,0,0,590
14957,190,100,80,0,0,0,370
14958,170,100,120,80,160,0,630
14959,230,120,120,80,160,0,710
14960,170,120,80,160,160,0,690
14961,200,120,160,240,320,0,1040
14962,200,120,120,160,0,0,600
14963,190,80,80,80,160,0,590
14964,180,120,80,80,160,0,620
14965,180,140,40,0,0,0,360
14966,220,40,40,0,0,0,300
14967,180,140,120,160,160,320,1080
14968,170,100,80,160,160,0,670
14969,180,100,80,80,0,0,440
14970,180,120,40,80,0,0,420
14971,190,140,80,80,160,320,970
14972,170,140,120,80,160,320,990
14973,240,60,40,80,160,0,580
14974,190,140,80,0,0,0,410
14975,210,180,80,0,0,0,470
14976,220,120,80,80,160,320,980
14977,230,180,160,80,0,0,650
14978,200,140,120,160,0,0,620
14979,220,120,120,160,320,320,1260
14980,170,80,80,160,160,0,650
14981,200,100,40,80,160,0,580
14982,180,140,80,80,160,0,640
14983,200,160,40,80,0,0,480
14984,150,120,120,160,0,0,550
14985,180,140,80,80,0,0,480
14986,180,140,160,160,160,0,800
14987,200,100,80,80,0,0,460
14988,210,100,80,0,0,0,390
14989,200,120,160,0,0,0,480
14990,230,100,80,160,160,0,730
14991,190,60,0,0,0,0,250
14992,200,180,160,80,160,0,780
14993,220,160,80,80,160,0,700
14994,170,120,40,80,160,0,570
14995,240,140,40,80,0,0,500
14996,190,80,40,80,160,0,550
14997,180,80,40,0,0,0,300
14998,190,180,160,160,0,0,690
14999,210,200,200,240,320,0,1170
15000,210,80,40,80,160,320,890
15001,200,180,200,160,160,0,900
15002,180,100,40,80,0,0,400
15003,170,100,120,240,320,320,1270
15004,230,80,0,0,0,0,310
15005,210,140,200,80,160,0,790
15006,180,100,120,80,160,0,640
15007,130,80,80,80,160,0,530
15008,190,100,120,0,0,0,410
15009,180,40,40,80,0,0,340
15010,240,160,160,80,0,0,640
15011,180,100,120,80,160,320,960
15012,220,120,120,0,0,0,460
15013,210,120,40,0,0,0,370
15014,180,120,120,160,160,0,740
15015,260,140,160,160,0,0,720
15016,160,100,120,80,0,0,460
15017,200,140,120,80,160,0,700
15018,210,80,120,160,160,0,730
15019,180,120,160,160,0,0,620
15020,180,100,80,160,160,0,680
15021,190,100,80,80,0,0,450
15022,220,80,40,80,160,0,580
15023,190,140,160,80,160,320,1050
15024,200,80,80,80,160,0,600
15025,220,120,120,80,0,0,540
15026,240,120,120,80,160,320,1040
15027,220,100,80,80,160,0,640
15028,210,160,160,80,160,320,1090
15029,230,80,40,0,0,0,350
15030,180,160,160,80,160,0,740
15031,250,160,160,160,320,0,1050
15032,200,160,120,160,160,0,800
15033,190,100,120,80,0,0,490
15034,200,120,80,160,320,320,1200
15035,190,140,160,80,0,0,570
15036,250,180,160,160,160,0,910
15037,210,100,120,80,160,320,990
15038,180,100,160,80,160,0,680
15039,170,180,160,240,160,0,910
15040,190,100,80,80,160,0,610
15041,220,120,80,80,160,0,660
15042,210,140,160,80,160,320,1070
15043,200,100,160,80,160,0,700
15044,220,80,120,240,160,0,820
15045,230,80,0,0,0,0,310
15046,180,100,80,160,160,0,680
15047,220,120,120,80,160,320,1020
15048,200,180,120,80,0,0,580
15049,170,140,120,160,160,0,750
15050,210,140,120,160,320,0,950
15051,190,100,40,0,0,0,330
15052,190,120,80,80,0,0,470
15053,220,120,40,0,0,0,380
15054,180,160,120,80,0,0,540
15055,210,140,120,0,0,0,470
15056,190,160,160,80,0,0,590
15057,190,120,80,0,0,0,390
15058,220,100,120,80,160,0,680
15059,220,160,160,240,160,0,940
15060,210,120,120,80,0,0,530
15061,240,120,80,0,0,0,440
15062,180,80,40,0,0,0,300
15063,130,80,120,80,0,0,410
15064,220,120,160,160,320,0,980
15065,230,120,40,80,160,0,630
15066,200,160,200,240,160,0,960
15067,190,80,40,0,0,0,310
15068,200,120,80,80,0,0,480
15069,170,120,200,80,0,0,570
15070,200,120,160,80,0,0,560
15071,220,60,0,0,0,0,280
15072,200,140,160,160,0,0,660
15073,180,160,160,160,0,0,660
15074,210,160,160,240,160,0,930
15075,170,100,120,160,0,0,550
15076,180,80,120,80,160,0,620
15077,200,120,120,160,160,0,760
15078,190,160,160,80,0,0,590
15079,230,160,120,160,320,320,1310
15080,240,120,160,80,160,0,760
15081,220,120,40,0,0,0,380
15082,210,100,80,80,0,0,470
15083,210,140,160,160,160,0,830
15084,190,40,40,80,0,0,350
15085,240,220,120,0,0,0,580
15086,170,100,120,80,160,320,950
15087,210,120,0,0,0,0,330
15088,200,160,80,80,160,0,680
15089,210,100,160,80,0,0,550
15090,190,180,80,80,160,0,690
15091,140,80,120,160,0,0,500
15092,150,80,40,0,0,0,270
15093,180,120,80,0,0,0,380
15094,240,60,80,80,160,0,620
15095,190,140,40,0,0,0,370
15096,190,120,120,160,160,0,750
15097,210,80,120,160,160,0,730
15098,200,80,40,0,0,0,320
15099,200,120,200,160,0,0,680
15100,210,100,120,80,160,0,670
15101,260,180,160,80,160,0,840
15102,130,80,80,160,160,0,610
15103,240,140,120,80,0,0,580
15104,180,120,120,160,320,0,900
15105,200,100,80,80,0,0,460
15106,220,100,80,160,160,0,720
15107,230,120,80,0,0,0,430
15108,210,160,120,0,0,0,490
15109,210,140,160,240,320,320,1390
15110,150,100,120,160,160,320,1010
15111,200,140,200,240,160,0,940
15112,200,160,240,160,160,320,1240
15113,230,100,160,160,0,0,650
15114,180,80,40,0,0,0,300
15115,180,140,160,160,0,0,640
15116,190,80,40,80,160,0,550
15117,160,160,160,80,0,0,560
15118,190,100,80,80,160,0,610
15119,170,120,160,240,160,320,1170
15120,220,160,160,160,160,0,860
15121,210,80,80,160,160,0,690
15122,180,140,160,80,160,0,720
15123,190,120,160,240,320,0,1030
15124,170,140,40,80,160,0,590
15125,170,80,80,80,160,0,570
15126,180,140,40,80,160,0,600
15127,210,160,80,160,160,0,770
15128,220,160,120,160,160,0,820
15129,200,140,120,0,0,0,460
15130,200,140,80,160,160,0,740
15131,200,120,80,160,160,0,720
15132,190,60,120,80,160,0,610
15133,160,100,40,80,160,0,540
15134,220,180,80,0,0,0,480
15135,220,200,160,160,160,0,900
15136,190,100,80,160,160,0,690
15137,150,120,160,160,320,0,910
15138,200,80,80,80,0,0,440
15139,210,120,40,80,160,0,610
15140,190,120,120,80,160,0,670
15141,210,120,80,0,0,0,410
15142,210,140,120,160,160,320,1110
15143,210,160,80,80,0,0,530
15144,220,160,120,80,160,0,740
15145,220,120,80,80,160,0,660
15146,180,120,80,80,160,0,620
15147,200,120,160,80,160,0,720
15148,220,160,80,80,160,0,700
15149,160,80,120,80,0,0,440
15150,170,120,160,80,160,0,690
15151,190,140,80,80,0,0,490
15152,170,100,80,80,160,0,590
15153,170,120,120,0,0,0,410
15154,240,160,120,160,160,0,840
15155,190,100,120,0,0,0,410
15156,190,140,80,160,160,0,730
15157,170,120,80,80,160,0,610
15158,160,60,80,0,0,0,300
15159,220,180,200,160,160,0,920
15160,190,120,160,80,0,0,550
15161,200,100,120,160,160,0,740
15162,200,160,160,0,0,0,520
15163,220,120,160,80,160,320,1060
15164,200,80,0,0,0,0,280
15165,180,60,80,160,160,0,640
15166,230,80,80,160,160,320,1030
15167,200,120,120,80,160,0,680
15168,160,100,80,160,160,0,660
15169,200,180,40,0,0,0,420
15170,200,80,80,80,0,0,440
15171,180,80,120,160,320,0,860
15172,190,120,120,160,160,0,750
15173,180,140,160,80,160,320,1040
15174,220,140,160,160,0,0,680
15175,180,140,80,160,160,0,720
15176,210,140,200,80,0,0,630
15177,240,120,120,160,160,0,800
15178,210,120,120,80,0,0,530
15179,210,100,80,160,160,0,710
15180,180,140,120,160,160,0,760
15181,200,120,160,160,160,0,800
15182,210,160,160,240,160,0,930
15183,170,80,80,160,160,0,650
15184,210,180,120,240,160,320,1230
15185,190,200,160,0,0,0,550
15186,220,140,80,80,0,0,520
15187,170,120,160,240,160,0,850
15188,220,80,80,160,160,0,700
15189,200,200,200,160,0,0,760
15190,180,80,80,160,160,0,660
15191,170,160,80,80,0,0,490
15192,180,140,120,0,0,0,440
15193,190,180,200,80,160,0,810
15194,210,140,120,160,160,320,1110
15195,230,120,160,80,160,0,750
15196,210,120,40,0,0,0,370
15197,250,160,160,160,160,0,890
15198,220,60,120,80,0,0,480
15199,210,100,120,0,0,0,430
15200,170,180,160,160,0,0,670
15201,250,120,80,160,320,0,930
15202,210,80,0,0,0,0,290
15203,140,80,80,80,160,0,540
15204,220,120,80,160,160,0,740
15205,190,140,40,80,160,320,930
15206,170,160,160,160,0,0,650
15207,190,120,80,80,0,0,470
15208,160,80,80,80,160,0,560
15209,190,120,80,160,160,0,710
15210,190,80,80,80,160,0,590
15211,200,140,80,80,0,0,500
15212,210,160,120,160,320,320,1290
15213,200,100,40,0,0,0,340
15214,250,140,120,80,160,0,750
15215,210,160,120,80,160,0,730
15216,180,100,80,160,0,0,520
15217,220,160,120,80,0,0,580
15218,210,120,160,0,0,0,490
15219,180,140,160,160,0,0,640
15220,190,100,120,80,0,0,490
15221,200,140,200,320,320,0,1180
15222,210,160,160,240,160,0,930
15223,180,120,120,80,160,0,660
15224,200,180,80,160,320,320,1260
15225,220,100,80,0,0,0,400
15226,200,160,160,160,160,0,840
15227,200,120,120,0,0,0,440
15228,210,140,120,240,320,0,1030
15229,200,140,120,80,0,0,540
15230,160,140,120,160,160,0,740
15231,250,160,200,80,0,0,690
15232,170,100,120,160,160,0,710
15233,190,120,80,80,160,0,630
15234,250,140,160,160,160,0,870
15235,200,160,120,80,0,0,560
15236,180,140,160,160,160,0,800
15237,190,160,120,160,160,0,790
15238,180,140,40,0,0,0,360
15239,200,80,120,160,160,0,720
15240,230,160,240,160,160,0,950
15241,210,140,80,80,160,0,670
15242,180,80,40,0,0,0,300
15243,180,120,120,80,0,0,500
15244,210,180,200,160,160,0,910
15245,150,60,80,80,160,0,530
15246,190,100,120,80,0,0,490
15247,210,80,80,0,0,0,370
15248,160,120,120,80,0,0,480
15249,170,140,40,0,0,0,350
15250,190,80,120,160,0,0,550
15251,230,120,120,80,0,0,550
15252,200,100,160,240,0,0,700
15253,200,120,120,80,0,0,520
15254,210,140,120,160,320,320,1270
15255,180,160,120,160,0,0,620
15256,250,140,80,80,0,0,550
15257,190,140,160,80,0,0,570
15258,200,140,160,80,160,0,740
15259,170,100,80,80,160,320,910
15260,180,100,80,160,160,320,1000
15261,250,100,40,0,0,0,390
15262,250,180,80,80,0,0,590
15263,180,120,160,160,160,0,780
15264,240,160,120,160,160,0,840
15265,200,140,200,160,160,320,1180
15266,150,80,120,160,160,0,670
15267,220,120,120,160,160,0,780
15268,220,140,160,160,160,0,840
15269,220,180,120,160,160,0,840
15270,190,100,0,0,0,0,290
15271,210,100,80,80,0,0,470
15272,210,120,160,160,160,320,1130
15273,220,160,120,80,160,0,740
15274,220,140,120,80,0,0,560
15275,160,140,120,160,160,0,740
15276,200,120,80,160,320,0,880
15277,200,120,120,160,160,0,760
15278,190,120,120,80,160,0,670
15279,220,120,80,80,160,0,660
15280,220,120,120,80,160,0,700
15281,180,100,80,80,0,0,440
15282,180,160,200,160,160,0,860
15283,170,140,120,0,0,0,430
15284,220,120,80,80,160,0,660
15285,210,120,120,160,320,320,1250
15286,190,140,120,80,160,0,690
15287,220,180,160,160,320,0,1040
15288,170,100,120,80,160,0,630
15289,210,160,160,80,160,320,1090
15290,160,100,40,0,0,0,300
15291,190,140,120,160,160,320,1090
15292,200,120,80,80,160,320,960
15293,170,100,120,160,0,0,550
15294,210,200,120,80,0,0,610
15295,190,100,80,80,0,0,450
15296,240,140,80,160,320,0,940
15297,180,60,80,80,160,0,560
15298,200,100,80,160,0,0,540
15299,220,100,40,80,0,0,440
15300,170,100,40,80,0,0,390
15301,170,120,80,160,160,0,690
15302,210,80,120,80,160,0,650
15303,170,140,120,160,0,0,590
15304,180,160,120,160,0,0,620
15305,240,160,120,80,160,320,1080
15306,200,80,80,80,160,320,920
15307,190,140,80,80,160,0,650
15308,190,80,40,0,0,0,310
15309,230,200,40,0,0,0,470
15310,210,140,40,80,0,0,470
15311,180,140,120,160,0,0,600
15312,200,60,40,0,0,0,300
15313,180,120,80,80,160,0,620
15314,190,120,80,80,160,0,630
15315,200,160,160,160,0,0,680
15316,180,160,80,80,0,0,500
15317,160,180,120,0,0,0,460
15318,210,140,120,240,320,320,1350
15319,230,120,160,240,160,0,910
15320,230,160,120,160,160,0,830
15321,160,140,120,80,160,0,660
15322,180,60,40,0,0,0,280
15323,200,120,160,160,160,0,800
15324,160,120,160,240,320,0,1000
15325,170,120,40,80,160,0,570
15326,190,140,120,80,160,320,1010
15327,200,140,120,160,160,0,780
15328,210,100,160,80,0,0,550
15329,220,120,120,160,0,0,620
15330,220,120,80,160,0,0,580
15331,220,100,80,0,0,0,400
15332,230,140,160,80,160,0,770
15333,190,80,120,80,160,0,630
15334,190,140,120,80,160,0,690
15335,220,100,80,160,320,0,880
15336,190,200,200,160,320,0,1070
15337,190,160,200,160,320,320,1350
15338,200,160,40,0,0,0,400
15339,230,180,200,80,0,0,690
15340,240,180,120,80,0,0,620
15341,190,80,80,80,0,0,430
15342,210,140,80,80,160,0,670
15343,200,100,40,80,160,0,580
15344,170,140,200,160,320,0,990
15345,190,100,120,160,0,0,570
15346,180,160,120,80,160,0,700
15347,220,160,120,240,320,0,1060
15348,190,60,80,80,160,320,890
15349,180,100,120,160,320,0,880
15350,220,180,200,160,160,320,1240
15351,200,140,160,160,160,0,820
15352,180,140,160,160,0,0,640
15353,210,160,80,80,160,0,690
15354,210,160,120,80,0,0,570
15355,220,160,120,80,0,0,580
15356,180,140,200,160,0,0,680
15357,210,160,160,160,320,320,1330
15358,210,160,160,80,0,0,610
15359,180,80,40,80,160,0,540
15360,220,140,200,160,160,320,1200
15361,190,140,160,80,160,320,1050
15362,200,120,120,0,0,0,440
15363,160,100,80,0,0,0,340
15364,210,100,120,160,0,0,590
15365,260,60,80,160,320,320,1200
15366,170,100,40,80,0,0,390
15367,200,160,120,80,160,0,720
15368,170,100,120,160,160,0,710
15369,240,160,80,0,0,0,480
15370,190,100,120,80,160,0,650
15371,150,80,80,0,0,0,310
15372,200,160,120,160,0,0,640
15373,180,100,80,80,160,0,600
15374,160,180,200,160,160,0,860
15375,190,180,160,160,160,320,1170
15376,210,160,120,80,160,0,730
15377,200,140,120,160,160,0,780
15378,210,140,120,80,0,0,550
15379,200,120,120,160,0,0,600
15380,160,80,80,80,160,320,880
15381,210,120,0,0,0,0,330
15382,240,140,120,80,0,0,580
15383,200,140,160,80,0,0,580
15384,130,100,80,80,0,0,390
15385,210,140,80,160,0,0,590
15386,200,80,40,80,160,0,560
15387,180,120,80,160,160,0,700
15388,180,120,80,80,160,0,620
15389,180,120,40,80,160,0,580
15390,170,60,40,80,0,0,350
15391,170,120,40,0,0,0,330
15392,200,80,40,80,160,320,880
15393,200,140,120,80,160,0,700
15394,220,120,80,80,160,0,660
15395,190,160,160,80,160,0,750
15396,200,120,120,80,160,0,680
15397,210,120,40,80,160,0,610
15398,210,100,40,80,0,0,430
15399,190,160,160,160,160,0,830
15400,190,60,40,0,0,0,290
15401,180,60,40,80,160,0,520
15402,210,140,80,160,160,0,750
15403,200,120,160,80,160,0,720
15404,190,80,40,80,160,0,550
15405,170,140,160,160,160,0,790
15406,200,100,120,160,320,320,1220
15407,240,160,120,160,0,0,680
15408,200,140,80,80,160,320,980
15409,160,80,120,160,160,0,680
15410,190,120,160,80,160,0,710
15411,220,160,80,80,160,0,700
15412,180,120,80,160,320,0,860
15413,210,100,40,80,0,0,430
15414,180,160,200,160,160,0,860
15415,180,140,160,80,0,0,560
15416,160,180,200,240,320,0,1100
15417,200,160,160,80,0,0,600
15418,190,200,160,160,160,0,870
15419,180,120,160,80,160,0,700
15420,220,180,120,160,160,0,840
15421,190,80,40,80,0,0,390
15422,210,120,80,160,160,320,1050
15423,210,100,40,80,160,320,910
15424,210,120,80,0,0,0,410
15425,170,160,120,80,160,0,690
15426,160,140,40,0,0,0,340
15427,140,60,40,0,0,0,240
15428,180,100,40,0,0,0,320
15429,210,100,40,0,0,0,350
15430,180,80,40,0,0,0,300
15431,200,60,80,160,0,0,500
15432,210,180,40,0,0,0,430
15433,200,180,80,160,0,0,620
15434,220,160,200,80,160,0,820
15435,200,140,120,0,0,0,460
15436,220,140,80,80,160,320,1000
15437,160,100,120,240,320,320,1260
15438,160,80,80,0,0,0,320
15439,200,120,120,0,0,0,440
15440,230,140,120,160,160,0,810
15441,190,140,120,160,160,320,1090
15442,200,160,120,240,320,320,1360
15443,190,120,40,80,0,0,430
15444,150,60,120,80,0,0,410
15445,200,140,120,80,0,0,540
15446,180,160,160,80,0,0,580
15447,180,120,80,160,320,0,860
15448,180,120,120,80,160,0,660
15449,170,80,80,80,160,0,570
15450,190,100,120,160,0,0,570
15451,200,120,40,80,160,0,600
15452,180,120,80,160,160,0,700
15453,230,100,80,80,160,0,650
15454,210,160,80,80,0,0,530
15455,180,100,0,0,0,0,280
15456,140,60,120,240,160,0,720
15457,190,100,120,80,160,0,650
15458,190,40,40,0,0,0,270
15459,160,100,120,160,0,0,540
15460,230,180,120,160,0,0,690
15461,190,120,160,80,0,0,550
15462,220,120,120,0,0,0,460
15463,180,60,80,80,160,0,560
15464,240,140,200,160,160,320,1220
15465,230,120,120,160,160,0,790
15466,240,140,80,0,0,0,460
15467,150,140,120,160,0,0,570
15468,170,100,40,0,0,0,310
15469,150,120,80,0,0,0,350
15470,200,120,120,80,0,0,520
15471,170,100,120,160,160,320,1030
15472,210,140,80,80,160,0,670
15473,230,120,160,160,160,0,830
15474,200,80,160,160,0,0,600
15475,200,80,80,80,160,0,600
15476,180,160,120,160,160,0,780
15477,160,120,80,80,0,0,440
15478,210,120,40,80,0,0,450
15479,210,140,200,160,160,0,870
15480,210,180,80,80,160,0,710
15481,200,140,80,80,160,0,660
15482,200,120,40,80,160,0,600
15483,190,80,120,80,160,0,630
15484,170,60,0,0,0,0,230
15485,210,140,200,160,0,0,710
15486,150,100,160,80,160,320,970
15487,150,140,80,0,0,0,370
15488,210,160,80,80,160,320,1010
15489,190,100,80,80,0,0,450
15490,180,160,120,80,160,0,700
15491,180,120,120,80,0,0,500
15492,190,80,160,240,160,0,830
15493,170,120,120,80,160,0,650
15494,190,80,80,80,0,0,430
15495,210,160,120,80,0,0,570
15496,170,100,80,0,0,0,350
15497,180,100,120,160,320,320,1200
15498,180,120,120,160,160,0,740
15499,180,120,160,240,160,0,860
15500,160,40,80,160,160,320,920
15501,180,120,160,240,160,0,860
15502,220,140,200,240,160,320,1280
15503,190,100,120,160,160,320,1050
15504,190,120,160,240,160,0,870
15505,170,140,160,240,0,0,710
15506,190,160,200,240,320,0,1110
15507,200,140,120,80,0,0,540
15508,170,120,160,80,160,0,690
15509,210,160,120,80,160,0,730
15510,190,160,200,160,160,0,870
15511,180,100,160,0,0,0,440
15512,180,120,160,160,160,0,780
15513,240,120,0,0,0,0,360
15514,190,80,80,0,0,0,350
15515,150,80,80,80,0,0,390
15516,170,140,120,80,160,0,670
15517,190,120,80,80,0,0,470
15518,140,80,40,80,0,0,340
15519,180,100,160,240,0,0,680
15520,190,140,80,160,160,0,730
15521,200,140,160,160,160,0,820
15522,160,140,120,80,0,0,500
15523,210,120,40,80,160,0,610
15524,180,140,120,160,0,0,600
15525,220,120,120,0,0,0,460
15526,210,120,80,0,0,0,410
15527,210,120,80,160,320,0,890
15528,190,60,80,80,0,0,410
15529,190,120,160,160,320,320,1270
15530,210,100,80,160,160,0,710
15531,220,120,120,0,0,0,460
15532,200,80,40,80,160,0,560
15533,230,180,80,0,0,0,490
15534,200,160,80,80,0,0,520
15535,150,140,200,80,160,0,730
15536,190,160,120,80,0,0,550
15537,190,140,160,160,160,0,810
15538,150,60,80,160,160,0,610
15539,190,180,200,160,320,0,1050
15540,230,140,40,0,0,0,410
15541,170,100,120,80,0,0,470
15542,230,140,80,80,160,0,690
15543,210,140,40,80,160,0,630
15544,260,220,80,160,0,0,720
15545,230,120,80,80,160,0,670
15546,220,100,0,0,0,0,320
15547,160,120,80,0,0,0,360
15548,210,160,80,160,320,0,930
15549,230,100,120,160,160,0,770
15550,250,160,160,0,0,0,570
15551,170,80,40,0,0,0,290
15552,150,120,120,80,0,0,470
15553,220,160,120,80,160,0,740
15554,220,160,120,80,160,320,1060
15555,220,140,80,0,0,0,440
15556,160,100,80,160,160,0,660
15557,180,120,40,80,160,0,580
15558,220,120,80,160,160,0,740
15559,220,100,120,160,320,0,920
15560,200,120,160,160,160,0,800
15561,210,160,160,160,160,0,850
15562,210,100,80,160,160,0,710
15563,240,140,80,80,160,0,700
15564,170,100,160,160,160,0,750
15565,210,140,120,80,0,0,550
15566,190,140,80,80,0,0,490
15567,220,120,40,0,0,0,380
15568,190,120,120,160,320,0,910
15569,200,140,160,160,160,0,820
15570,230,100,40,0,0,0,370
15571,160,120,120,80,0,0,480
15572,180,40,40,80,0,0,340
15573,100,80,120,160,320,320,1100
15574,230,120,80,80,0,0,510
15575,210,180,160,160,320,320,1350
15576,200,140,80,80,160,0,660
15577,170,100,120,80,160,0,630
15578,220,100,80,80,160,0,640
15579,220,140,200,240,320,0,1120
15580,220,100,80,80,160,0,640
15581,190,80,40,80,160,0,550
15582,210,80,80,80,160,0,610
15583,190,40,80,80,160,0,550
15584,230,100,160,240,160,0,890
15585,190,140,200,160,160,0,850
15586,190,160,120,160,0,0,630
15587,220,120,160,80,160,320,1060
15588,210,140,80,80,160,0,670
15589,230,160,80,160,0,0,630
15590,210,120,120,80,0,0,530
15591,200,120,120,80,160,0,680
15592,200,140,120,80,160,320,1020
15593,180,160,120,80,160,320,1020
15594,180,120,80,0,0,0,380
15595,190,140,200,160,320,320,1330
15596,200,140,120,0,0,0,460
15597,210,120,120,80,160,320,1010
15598,180,80,120,160,160,0,700
15599,230,120,160,160,160,0,830
15600,180,100,120,80,160,0,640
15601,200,80,80,0,0,0,360
15602,200,60,80,0,0,0,340
15603,150,40,80,160,160,0,590
15604,180,120,120,240,320,0,980
15605,220,140,80,160,320,0,920
15606,240,160,160,80,160,0,800
15607,190,140,80,160,160,0,730
15608,210,100,40,80,0,0,430
15609,210,180,160,160,160,0,870
15610,190,100,80,160,160,0,690
15611,210,100,80,80,160,0,630
15612,210,100,120,0,0,0,430
15613,190,120,120,160,160,0,750
15614,160,100,120,0,0,0,380
15615,220,100,120,80,0,0,520
15616,210,100,80,0,0,0,390
15617,200,80,120,160,160,0,720
15618,190,100,80,0,0,0,370
15619,180,180,120,160,160,0,800
15620,180,80,80,80,160,0,580
15621,180,80,80,80,160,0,580
15622,210,80,80,80,0,0,450
15623,210,140,80,80,160,320,990
15624,170,80,80,160,320,320,1130
15625,180,60,40,80,160,320,840
15626,180,100,120,80,0,0,480
15627,220,80,40,0,0,0,340
15628,240,100,120,160,160,0,780
15629,160,80,80,80,0,0,400
15630,200,120,160,80,0,0,560
15631,200,80,80,80,0,0,440
15632,210,100,80,80,160,0,630
15633,210,140,200,160,160,320,1190
15634,230,140,160,160,0,0,690
15635,190,80,80,80,0,0,430
15636,220,160,160,160,160,320,1180
15637,220,120,80,80,160,0,660
15638,170,100,80,0,0,0,350
15639,160,140,160,80,160,0,700
15640,170,100,40,0,0,0,310
15641,210,120,120,160,160,320,1090
15642,200,160,120,240,160,0,880
15643,200,80,160,240,160,0,840
15644,220,160,160,80,0,0,620
15645,160,100,120,240,320,0,940
15646,220,100,40,80,160,0,600
15647,200,100,80,80,0,0,460
15648,190,160,120,160,0,0,630
15649,170,100,80,80,0,0,430
15650,210,140,200,160,320,0,1030
15651,210,60,80,0,0,0,350
15652,240,120,80,80,0,0,520
15653,210,100,40,80,160,320,910
15654,210,180,160,240,160,0,950
15655,200,100,40,0,0,0,340
15656,180,140,160,80,0,0,560
15657,160,80,80,0,0,0,320
15658,160,80,40,0,0,0,280
15659,160,100,120,80,160,0,620
15660,170,80,80,80,0,0,410
15661,220,180,200,80,160,0,840
15662,210,120,40,80,160,0,610
15663,180,100,120,240,160,0,800
15664,210,80,120,160,0,0,570
15665,220,140,80,80,160,0,680
15666,220,140,80,80,160,0,680
15667,200,80,80,0,0,0,360
15668,200,120,120,80,0,0,520
15669,190,120,80,80,160,0,630
15670,210,180,160,240,160,0,950
15671,220,100,80,80,160,320,960
15672,190,100,80,0,0,0,370
15673,150,140,120,0,0,0,410
15674,230,100,120,80,160,0,690
15675,190,120,40,80,0,0,430
15676,210,160,120,80,160,320,1050
15677,220,180,160,0,0,0,560
15678,210,120,40,0,0,0,370
15679,180,160,120,160,320,0,940
15680,190,120,40,80,0,0,430
15681,210,120,120,80,0,0,530
15682,180,80,40,80,160,320,860
15683,170,100,80,80,0,0,430
15684,240,160,120,80,160,0,760
15685,200,160,80,80,0,0,520
15686,200,180,160,160,160,0,860
15687,200,120,80,0,0,0,400
15688,210,160,160,240,160,0,930
15689,210,120,40,80,160,0,610
15690,210,120,120,80,160,0,690
15691,190,100,80,80,160,0,610
15692,230,140,120,80,160,0,730
15693,240,120,120,160,160,0,800
15694,150,100,40,0,0,0,290
15695,210,120,40,0,0,0,370
15696,180,160,160,160,160,0,820
15697,210,120,120,160,0,0,610
15698,170,120,80,0,0,0,370
15699,190,120,80,80,0,0,470
15700,220,120,160,160,0,0,660
15701,210,120,160,80,160,320,1050
15702,220,160,160,160,160,320,1180
15703,220,120,120,80,0,0,540
15704,190,120,120,80,0,0,510
15705,230,160,40,0,0,0,430
15706,180,120,40,0,0,0,340
15707,160,120,120,0,0,0,400
15708,120,80,120,160,0,0,480
15709,210,120,120,160,320,320,1250
15710,180,120,40,80,0,0,420
15711,180,100,80,80,160,0,600
15712,260,140,120,80,0,0,600
15713,190,100,120,160,160,0,730
15714,230,140,120,160,320,320,1290
15715,220,100,80,0,0,0,400
15716,190,100,40,80,160,0,570
15717,180,140,160,80,160,0,720
15718,190,100,120,80,160,0,650
15719,180,120,80,160,0,0,540
15720,210,60,40,0,0,0,310
15721,190,120,120,80,160,0,670
15722,200,120,80,80,0,0,480
15723,180,80,120,160,0,0,540
15724,200,120,80,80,160,320,960
15725,200,140,160,160,160,320,1140
15726,210,140,200,160,160,0,870
15727,190,100,40,0,0,0,330
15728,180,140,160,80,0,0,560
15729,180,80,80,0,0,0,340
15730,180,140,120,80,0,0,520
15731,210,200,160,80,160,0,810
15732,220,140,120,80,160,0,720
15733,170,100,80,0,0,0,350
15734,200,60,40,0,0,0,300
15735,160,80,80,80,0,0,400
15736,200,120,80,80,160,0,640
15737,220,140,200,320,320,0,1200
15738,190,140,80,0,0,0,410
15739,170,100,80,80,160,0,590
15740,200,140,160,160,0,0,660
15741,180,100,80,80,0,0,440
15742,210,160,80,0,0,0,450
15743,180,120,160,80,160,0,700
15744,210,120,120,80,0,0,530
15745,200,120,200,240,320,0,1080
15746,220,140,160,160,160,320,1160
15747,190,120,40,80,160,320,910
15748,220,120,80,80,160,0,660
15749,180,80,80,80,160,0,580
15750,230,120,120,160,160,320,1110
15751,190,160,120,80,160,0,710
15752,170,140,120,80,160,0,670
15753,190,140,160,240,320,0,1050
15754,200,120,40,80,0,0,440
15755,200,120,80,80,0,0,480
15756,140,160,160,80,160,0,700
15757,200,120,120,80,160,0,680
15758,190,100,80,160,320,320,1170
15759,210,160,160,160,160,0,850
15760,230,140,120,80,160,0,730
15761,200,140,120,160,0,0,620
15762,210,160,80,80,0,0,530
15763,200,160,80,80,0,0,520
15764,210,140,160,160,160,0,830
15765,200,80,0,0,0,0,280
15766,220,120,80,160,160,0,740
15767,200,140,120,160,320,0,940
15768,170,120,120,80,160,0,650
15769,210,140,120,0,0,0,470
15770,190,140,80,0,0,0,410
15771,240,120,40,80,0,0,480
15772,200,100,40,80,160,0,580
15773,240,240,200,240,320,0,1240
15774,210,60,80,0,0,0,350
15775,200,160,120,80,160,0,720
15776,200,140,80,0,0,0,420
15777,200,100,80,80,0,0,460
15778,190,80,80,160,0,0,510
15779,170,80,120,80,0,0,450
15780,200,140,160,160,160,0,820
15781,170,120,120,160,160,320,1050
15782,220,100,40,80,0,0,440
15783,180,140,120,80,160,0,680
15784,190,80,80,0,0,0,350
15785,200,140,120,160,160,0,780
15786,220,160,200,240,320,0,1140
15787,220,180,120,160,160,0,840
15788,220,160,200,160,0,0,740
15789,200,60,80,80,160,0,580
15790,170,100,80,0,0,0,350
15791,200,180,120,80,160,0,740
15792,210,40,0,0,0,0,250
15793,190,80,80,160,160,0,670
15794,190,80,40,80,160,0,550
15795,200,100,40,80,0,0,420
15796,190,140,200,240,160,0,930
15797,200,140,200,240,160,0,940
15798,220,120,120,160,160,320,1100
15799,210,140,160,80,0,0,590
15800,200,120,80,160,320,320,1200
15801,170,80,120,80,0,0,450
15802,180,80,120,80,160,0,620
15803,180,100,80,80,160,0,600
15804,180,100,80,80,0,0,440
15805,200,140,80,0,0,0,420
15806,190,160,160,80,0,0,590
15807,190,80,120,160,160,0,710
15808,200,140,240,240,160,320,1300
15809,210,160,120,80,0,0,570
15810,240,140,80,80,160,0,700
15811,180,140,120,240,320,0,1000
15812,210,160,160,80,0,0,610
15813,190,120,80,0,0,0,390
15814,190,40,0,0,0,0,230
15815,180,180,200,80,160,0,800
15816,190,120,80,80,0,0,470
15817,180,100,80,80,0,0,440
15818,140,160,40,80,160,0,580
15819,120,100,120,80,0,0,420
15820,200,160,80,160,160,320,1080
15821,230,120,40,80,0,0,470
15822,200,140,120,160,160,0,780
15823,170,120,120,240,0,0,650
15824,200,140,120,160,320,0,940
15825,180,100,120,80,0,0,480
15826,190,120,80,0,0,0,390
15827,210,120,80,80,0,0,490
15828,230,180,40,80,160,0,690
15829,180,140,160,240,320,0,1040
15830,200,120,80,0,0,0,400
15831,230,140,120,0,0,0,490
15832,220,160,80,80,160,0,700
15833,170,100,120,240,160,0,790
15834,170,140,160,160,320,0,950
15835,220,160,80,80,0,0,540
15836,220,160,80,80,160,0,700
15837,160,120,80,80,160,0,600
15838,170,160,40,80,160,0,610
15839,230,140,120,0,0,0,490
15840,190,100,40,80,0,0,410
15841,210,120,120,240,0,0,690
15842,180,140,120,160,0,0,600
15843,170,120,160,160,0,0,610
15844,210,140,160,160,160,0,830
15845,240,140,80,80,0,0,540
15846,210,100,40,80,160,0,590
15847,190,100,160,80,160,320,1010
15848,190,140,120,0,0,0,450
15849,190,80,120,80,0,0,470
15850,180,140,120,80,160,0,680
15851,200,140,200,80,0,0,620
15852,200,160,120,0,0,0,480
15853,170,100,0,0,0,0,270
15854,210,160,120,80,0,0,570
15855,200,140,120,80,160,0,700
15856,230,160,120,160,160,0,830
15857,200,140,120,160,160,0,780
15858,180,100,80,80,0,0,440
15859,200,180,200,160,0,0,740
15860,230,160,120,80,0,0,590
15861,200,120,40,80,0,0,440
15862,180,100,80,80,160,0,600
15863,210,120,200,240,0,0,770
15864,140,120,120,160,160,0,700
15865,200,100,120,160,160,0,740
15866,220,120,40,0,0,0,380
15867,220,100,40,80,160,320,920
15868,200,80,80,0,0,0,360
15869,180,80,40,80,160,0,540
15870,220,100,80,0,0,0,400
15871,190,160,40,80,0,0,470
15872,220,140,80,80,0,0,520
15873,220,160,200,0,0,0,580
15874,190,180,160,80,0,0,610
15875,190,120,40,80,160,0,590
15876,180,120,120,160,320,0,900
15877,200,100,80,80,160,0,620
15878,220,140,120,240,320,320,1360
15879,160,120,160,240,160,0,840
15880,200,100,120,80,0,0,500
15881,170,140,120,160,160,0,750
15882,200,160,200,240,160,0,960
15883,200,180,160,240,320,320,1420
15884,210,140,160,0,0,0,510
15885,180,160,40,80,0,0,460
15886,210,160,160,240,320,320,1410
15887,160,140,120,0,0,0,420
15888,160,140,160,160,160,0,780
15889,160,140,160,160,320,320,1260
15890,180,100,80,80,0,0,440
15891,160,100,120,160,0,0,540
15892,150,100,40,80,160,0,530
15893,230,120,40,80,160,0,630
15894,190,100,80,80,0,0,450
15895,180,100,120,160,160,0,720
15896,220,120,80,0,0,0,420
15897,190,120,80,0,0,0,390
15898,190,140,120,80,160,0,690
15899,190,100,40,0,0,0,330
15900,170,80,40,80,160,0,530
15901,200,160,80,0,0,0,440
15902,190,100,120,80,160,0,650
15903,190,120,80,160,160,0,710
15904,220,80,40,80,160,320,900
15905,200,140,80,80,160,0,660
15906,250,120,120,240,160,0,890
15907,200,120,160,160,160,320,1120
15908,220,140,80,80,160,0,680
15909,180,80,80,80,160,320,900
15910,200,120,120,80,160,0,680
15911,190,100,40,80,0,0,410
15912,190,100,120,160,160,0,730
15913,170,80,80,80,0,0,410
15914,190,80,0,0,0,0,270
15915,160,120,80,160,160,320,1000
15916,220,160,160,240,320,0,1100
15917,200,120,40,0,0,0,360
15918,210,120,0,0,0,0,330
15919,200,100,120,160,160,320,1060
15920,190,60,40,80,0,0,370
15921,190,120,120,160,0,0,590
15922,190,80,80,80,160,0,590
15923,200,140,160,240,320,0,1060
15924,210,160,200,240,160,0,970
15925,170,80,40,80,160,320,850
15926,220,80,120,160,0,0,580
15927,260,180,40,80,160,320,1040
15928,220,120,120,160,0,0,620
15929,240,140,160,80,0,0,620
15930,210,100,80,80,160,0,630
15931,210,140,160,160,0,0,670
15932,190,100,80,160,160,0,690
15933,210,160,120,80,0,0,570
15934,240,140,120,80,160,0,740
15935,190,120,40,80,160,0,590
15936,210,120,120,160,160,0,770
15937,200,140,200,240,160,0,940
15938,190,140,80,0,0,0,410
15939,180,100,160,80,160,0,680
15940,220,160,120,160,160,320,1140
15941,220,140,160,80,160,0,760
15942,190,120,120,0,0,0,430
15943,160,80,40,0,0,0,280
15944,200,120,120,160,160,320,1080
15945,160,100,40,0,0,0,300
15946,170,120,120,240,160,0,810
15947,240,160,200,240,320,0,1160
15948,250,180,160,240,320,0,1150
15949,210,140,120,240,320,0,1030
15950,210,140,120,80,160,0,710
15951,230,140,80,80,160,0,690
15952,200,180,200,240,320,320,1460
15953,150,100,160,240,320,0,970
15954,160,140,120,160,160,0,740
15955,180,120,80,0,0,0,380
15956,210,120,40,80,160,0,610
15957,170,160,120,80,160,0,690
15958,160,100,40,0,0,0,300
15959,230,180,120,160,160,0,850
15960,170,100,80,160,320,0,830
15961,200,100,40,80,0,0,420
15962,180,100,80,160,160,320,1000
15963,220,160,160,160,0,0,700
15964,170,120,80,0,0,0,370
15965,220,140,120,0,0,0,480
15966,160,100,120,160,0,0,540
15967,170,80,160,160,160,0,730
15968,210,200,160,160,160,0,890
15969,190,160,160,80,160,0,750
15970,140,60,40,0,0,0,240
15971,180,180,80,80,160,0,680
15972,160,100,80,80,0,0,420
15973,140,140,120,80,0,0,480
15974,230,160,160,160,0,0,710
15975,180,80,120,80,160,0,620
15976,170,140,80,80,160,0,630
15977,160,100,80,80,160,0,580
15978,220,120,80,80,160,0,660
15979,220,140,160,80,160,320,1080
15980,220,100,80,80,0,0,480
15981,160,140,80,160,160,0,700
15982,180,100,80,0,0,0,360
15983,200,120,80,0,0,0,400
15984,240,140,80,80,160,320,1020
15985,210,140,160,160,160,0,830
15986,170,180,120,160,0,0,630
15987,180,60,40,0,0,0,280
15988,180,60,0,0,0,0,240
15989,180,80,120,160,160,0,700
15990,220,140,160,0,0,0,520
15991,230,120,80,160,160,0,750
15992,220,160,160,80,0,0,620
15993,170,140,120,240,320,0,990
15994,230,120,120,160,0,0,630
15995,190,100,80,160,0,0,530
15996,210,140,120,80,160,0,710
15997,200,180,160,160,0,0,700
15998,210,140,160,160,320,320,1310
15999,230,140,160,240,320,320,1410
16000,220,140,40,0,0,0,400
16001,200,100,120,0,0,0,420
16002,190,140,120,0,0,0,450
16003,220,100,120,80,0,0,520
16004,180,100,80,160,160,320,1000
16005,190,160,80,80,160,0,670
16006,220,180,160,80,160,0,800
16007,210,140,160,80,160,0,750
16008,180,120,120,160,160,0,740
16009,210,180,120,160,160,0,830
16010,180,160,120,80,0,0,540
16011,180,160,160,240,320,320,1380
16012,200,100,80,80,160,0,620
16013,230,160,120,80,0,0,590
16014,200,120,120,80,160,320,1000
16015,230,200,240,240,160,0,1070
16016,210,100,120,80,160,0,670
16017,180,100,80,80,0,0,440
16018,210,180,160,80,160,320,1110
16019,220,120,80,80,160,0,660
16020,180,120,80,0,0,0,380
16021,200,140,80,160,160,0,740
16022,160,120,80,80,160,0,600
16023,190,120,120,160,160,0,750
16024,150,80,80,80,160,320,870
16025,180,140,160,160,160,0,800
16026,160,100,80,80,160,0,580
16027,200,100,160,240,320,0,1020
16028,200,100,80,80,160,0,620
16029,180,120,40,80,160,0,580
16030,180,120,80,160,0,0,540
16031,180,120,160,80,0,0,540
16032,180,140,80,80,0,0,480
16033,200,160,120,160,0,0,640
16034,230,120,120,160,0,0,630
16035,220,180,160,160,320,0,1040
16036,170,140,160,240,320,320,1350
16037,240,180,80,0,0,0,500
16038,220,80,40,0,0,0,340
16039,240,120,160,160,160,0,840
16040,170,100,80,80,160,0,590
16041,220,180,200,160,160,0,920
16042,210,120,80,80,160,0,650
16043,180,100,80,80,0,0,440
16044,190,80,80,160,0,0,510
16045,240,100,160,80,0,0,580
16046,190,120,120,80,0,0,510
16047,170,100,40,80,0,0,390
16048,160,120,120,80,0,0,480
16049,150,140,120,80,160,0,650
16050,180,160,120,80,160,320,1020
16051,220,140,120,160,160,0,800
16052,210,120,200,80,160,320,1090
16053,200,80,80,80,160,0,600
16054,140,100,80,80,160,0,560
16055,210,100,80,0,0,0,390
16056,160,100,120,80,160,0,620
16057,180,180,200,240,160,0,960
16058,200,80,160,0,0,0,440
16059,210,100,80,0,0,0,390
16060,180,160,200,80,160,0,780
16061,220,60,80,0,0,0,360
16062,210,100,80,0,0,0,390
16063,170,160,80,80,160,0,650
16064,240,160,160,160,160,0,880
16065,180,80,120,160,160,0,700
16066,210,140,200,160,0,0,710
16067,210,120,80,160,160,0,730
16068,220,120,160,0,0,0,500
16069,190,140,80,0,0,0,410
16070,210,140,80,0,0,0,430
16071,190,120,120,80,160,0,670
16072,190,80,0,0,0,0,270
16073,200,100,120,80,0,0,500
16074,170,120,120,80,0,0,490
16075,180,100,80,160,160,0,680
16076,200,160,160,160,320,320,1320
16077,220,100,80,0,0,0,400
16078,150,60,40,80,160,0,490
16079,240,120,80,0,0,0,440
16080,180,140,120,80,160,0,680
16081,200,160,120,160,160,0,800
16082,180,120,120,80,160,0,660
16083,220,100,40,80,160,0,600
16084,160,80,40,80,0,0,360
16085,240,80,80,0,0,0,400
16086,210,140,40,80,160,0,630
16087,170,100,120,80,0,0,470
16088,170,140,160,80,160,0,710
16089,180,140,120,160,320,0,920
16090,210,100,80,0,0,0,390
16091,210,180,80,160,0,0,630
16092,230,100,160,160,160,0,810
16093,200,160,160,160,160,0,840
16094,190,100,120,160,320,320,1210
16095,180,120,80,80,160,0,620
16096,170,60,120,80,0,0,430
16097,250,140,80,80,160,0,710
16098,220,160,160,80,160,0,780
16099,230,160,160,80,0,0,630
16100,170,120,160,240,320,0,1010
16101,220,100,40,80,160,0,600
16102,160,100,80,80,0,0,420
16103,250,160,120,160,160,0,850
16104,150,60,40,80,0,0,330
16105,170,160,160,80,160,0,730
16106,180,80,80,80,160,0,580
16107,210,160,120,80,0,0,570
16108,220,100,80,80,0,0,480
16109,220,140,80,80,160,0,680
16110,220,120,80,80,160,0,660
16111,210,100,120,80,160,0,670
16112,180,140,80,160,320,0,880
16113,180,40,0,0,0,0,220
16114,190,120,40,0,0,0,350
16115,210,160,160,240,160,0,930
16116,190,60,80,80,0,0,410
16117,180,120,0,0,0,0,300
16118,190,100,80,80,160,0,610
16119,190,100,80,80,160,0,610
16120,220,160,80,0,0,0,460
16121,170,140,120,80,0,0,510
16122,190,120,120,0,0,0,430
16123,200,160,160,80,0,0,600
16124,200,120,120,80,0,0,520
16125,200,60,80,160,160,0,660
16126,210,120,160,160,320,0,970
16127,190,160,160,160,0,0,670
16128,210,120,120,0,0,0,450
16129,190,140,120,80,0,0,530
16130,180,120,120,160,160,0,740
16131,220,120,120,0,0,0,460
16132,200,160,120,80,0,0,560
16133,150,120,120,80,160,0,630
16134,260,140,120,160,0,0,680
16135,190,80,80,80,160,0,590
16136,150,120,160,80,160,320,990
16137,220,140,120,80,0,0,560
16138,180,100,200,80,160,320,1040
16139,190,140,80,160,160,0,730
16140,220,80,120,160,320,320,1220
16141,150,80,80,160,160,0,630
16142,180,40,40,80,160,0,500
16143,160,120,40,0,0,0,320
16144,170,40,40,80,160,320,810
16145,200,160,200,240,160,0,960
16146,180,180,120,0,0,0,480
16147,210,160,200,240,160,0,970
16148,200,120,160,160,160,320,1120
16149,190,40,40,80,0,0,350
16150,200,80,120,80,0,0,480
16151,180,100,80,80,0,0,440
16152,170,80,120,160,320,0,850
16153,190,100,80,0,0,0,370
16154,250,120,80,160,0,0,610
16155,180,160,120,0,0,0,460
16156,170,100,80,80,0,0,430
16157,180,100,120,160,160,320,1040
16158,220,140,160,160,160,0,840
16159,170,80,120,80,160,0,610
16160,200,140,120,160,320,0,940
16161,200,100,120,80,0,0,500
16162,200,200,120,0,0,0,520
16163,200,160,120,160,160,0,800
16164,200,180,120,160,160,0,820
16165,210,120,120,80,0,0,530
16166,190,120,80,0,0,0,390
16167,220,60,120,80,0,0,480
16168,200,140,160,160,0,0,660
16169,200,160,120,240,320,0,1040
16170,200,160,160,160,160,0,840
16171,180,120,120,80,160,0,660
16172,220,100,120,160,160,320,1080
16173,170,140,160,160,0,0,630
16174,210,120,80,80,160,0,650
16175,220,100,120,160,160,0,760
16176,200,120,120,0,0,0,440
16177,220,200,160,80,0,0,660
16178,180,120,80,0,0,0,380
16179,190,120,160,160,160,320,1110
16180,200,180,160,160,160,0,860
16181,170,160,160,160,160,0,810
16182,160,80,40,80,0,0,360
16183,210,140,160,160,320,0,990
16184,200,180,80,160,160,0,780
16185,180,80,80,160,160,0,660
16186,190,140,0,0,0,0,330
16187,230,140,120,0,0,0,490
16188,200,140,160,160,160,0,820
16189,170,160,120,240,320,0,1010
16190,180,140,120,240,160,0,840
16191,180,140,160,80,160,0,720
16192,170,140,120,80,160,0,670
16193,190,140,120,160,160,0,770
16194,220,160,80,160,320,0,940
16195,200,100,120,160,160,320,1060
16196,180,140,160,240,320,0,1040
16197,150,60,120,160,160,0,650
16198,220,100,80,0,0,0,400
16199,200,140,160,240,0,0,740
16200,170,120,120,80,160,0,650
16201,170,100,40,0,0,0,310
16202,170,120,120,80,160,0,650
16203,170,140,80,80,0,0,470
16204,230,140,80,80,160,0,690
16205,150,80,40,0,0,0,270
16206,190,80,80,160,320,320,1150
16207,180,120,120,160,160,0,740
16208,180,100,80,160,160,0,680
16209,200,140,80,80,160,0,660
16210,180,120,160,0,0,0,460
16211,150,120,200,240,160,320,1190
16212,150,140,160,240,320,0,1010
16213,190,140,160,160,320,0,970
16214,190,80,120,160,160,0,710
16215,230,140,120,160,160,0,810
16216,190,100,80,160,160,0,690
16217,160,80,80,80,0,0,400
16218,180,80,40,0,0,0,300
16219,190,120,120,80,160,0,670
16220,190,120,120,160,0,0,590
16221,200,160,120,0,0,0,480
16222,240,120,120,160,160,0,800
16223,190,160,160,80,0,0,590
16224,240,180,120,160,320,320,1340
16225,210,200,200,160,160,0,930
16226,180,80,80,80,160,0,580
16227,150,60,0,0,0,0,210
16228,180,120,120,0,0,0,420
16229,200,100,120,80,160,0,660
16230,230,140,80,80,0,0,530
16231,190,160,120,160,0,0,630
16232,250,160,120,160,160,0,850
16233,190,100,120,160,160,0,730
16234,210,200,160,0,0,0,570
16235,210,100,80,80,160,320,950
16236,180,80,40,0,0,0,300
16237,190,160,200,160,0,0,710
16238,180,100,40,0,0,0,320
16239,230,200,80,80,160,0,750
16240,220,140,200,240,160,0,960
16241,210,160,160,160,160,320,1170
16242,170,100,80,80,160,0,590
16243,200,100,40,80,0,0,420
16244,200,140,160,160,160,0,820
16245,210,160,120,80,160,0,730
16246,220,100,120,80,0,0,520
16247,180,60,80,80,160,0,560
16248,210,140,200,160,0,0,710
16249,220,140,200,80,160,0,800
16250,220,140,120,80,160,0,720
16251,200,120,120,0,0,0,440
16252,160,140,120,160,0,0,580
16253,180,120,40,80,160,0,580
16254,170,120,80,80,160,0,610
16255,190,140,120,80,160,0,690
16256,160,120,160,160,0,0,600
16257,190,100,80,80,160,320,930
16258,190,100,40,0,0,0,330
16259,150,120,160,160,160,0,750
16260,200,140,80,80,0,0,500
16261,220,100,120,160,160,0,760
16262,190,140,120,160,160,0,770
16263,180,100,120,0,0,0,400
16264,190,100,120,160,0,0,570
16265,200,100,120,240,160,320,1140
16266,160,120,120,160,160,0,720
16267,210,120,160,160,160,0,810
16268,220,120,160,80,0,0,580
16269,190,140,120,160,320,320,1250
16270,200,100,120,80,160,0,660
16271,220,160,40,0,0,0,420
16272,200,120,80,80,0,0,480
16273,210,100,80,80,0,0,470
16274,210,140,80,80,160,0,670
16275,190,120,120,80,160,0,670
16276,150,120,160,80,0,0,510
16277,230,180,120,240,160,0,930
16278,200,160,120,80,160,0,720
16279,190,60,80,160,160,0,650
16280,160,80,40,80,160,0,520
16281,160,100,80,0,0,0,340
16282,220,100,40,0,0,0,360
16283,200,160,160,160,320,0,1000
16284,170,120,40,80,0,0,410
16285,220,100,120,160,160,0,760
16286,160,100,120,240,160,320,1100
16287,170,80,40,80,0,0,370
16288,210,140,120,80,0,0,550
16289,160,100,80,0,0,0,340
16290,180,60,80,80,0,0,400
16291,240,120,120,80,160,0,720
16292,230,120,40,80,160,0,630
16293,210,120,80,160,160,0,730
16294,200,140,40,80,160,0,620
16295,230,180,160,160,160,0,890
16296,170,100,80,80,160,0,590
16297,170,140,160,240,160,0,870
16298,140,80,120,160,160,0,660
16299,180,120,80,80,160,0,620
16300,170,120,80,80,160,320,930
16301,240,120,160,0,0,0,520
16302,200,140,120,160,320,320,1260
16303,220,120,120,160,160,0,780
16304,180,160,160,240,320,0,1060
16305,200,100,80,80,160,0,620
16306,230,100,80,80,0,0,490
16307,220,120,120,80,0,0,540
16308,180,180,40,0,0,0,400
16309,170,140,120,80,160,0,670
16310,200,120,40,0,0,0,360
16311,190,100,40,0,0,0,330
16312,220,160,120,240,320,0,1060
16313,220,160,80,160,160,0,780
16314,160,140,120,80,0,0,500
16315,180,160,120,80,0,0,540
16316,190,120,200,160,160,0,830
16317,200,120,120,160,0,0,600
16318,230,200,120,160,0,0,710
16319,170,100,160,80,0,0,510
16320,150,80,80,80,160,0,550
16321,210,140,80,80,160,320,990
16322,200,100,40,0,0,0,340
16323,230,140,160,160,160,320,1170
16324,170,80,80,80,0,0,410
16325,210,120,80,80,160,0,650
16326,170,80,80,80,160,320,890
16327,190,100,160,160,160,320,1090
16328,190,100,120,0,0,0,410
16329,230,180,160,160,160,0,890
16330,160,80,120,160,0,0,520
16331,200,120,120,80,160,0,680
16332,210,160,80,160,320,320,1250
16333,180,140,160,160,320,0,960
16334,180,120,120,80,0,0,500
16335,200,80,80,160,160,0,680
16336,180,100,80,160,160,0,680
16337,210,80,80,80,160,0,610
16338,220,80,40,80,160,0,580
16339,190,160,120,80,160,0,710
16340,150,80,80,80,0,0,390
16341,220,140,40,80,160,320,960
16342,220,160,120,80,160,0,740
16343,240,120,40,80,0,0,480
16344,200,100,120,80,160,0,660
16345,160,100,80,80,160,0,580
16346,190,160,120,160,160,0,790
16347,170,120,80,0,0,0,370
16348,150,60,120,80,0,0,410
16349,200,120,120,160,320,0,920
16350,190,180,160,240,160,0,930
16351,230,180,160,0,0,0,570
16352,230,120,40,80,160,0,630
16353,160,140,80,0,0,0,380
16354,240,180,120,160,160,0,860
16355,170,100,80,80,160,0,590
16356,160,120,80,0,0,0,360
16357,230,120,120,0,0,0,470
16358,140,100,80,80,160,0,560
16359,180,100,120,160,320,0,880
16360,200,60,40,80,160,0,540
16361,200,140,80,0,0,0,420
16362,160,120,160,80,0,0,520
16363,180,140,160,0,0,0,480
16364,170,80,120,80,0,0,450
16365,210,80,40,0,0,0,330
16366,170,100,40,0,0,0,310
16367,180,120,120,160,320,320,1220
16368,180,140,120,160,0,0,600
16369,160,100,80,160,0,0,500
16370,170,80,80,0,0,0,330
16371,160,120,160,160,0,0,600
16372,190,120,120,0,0,0,430
16373,190,120,120,160,160,320,1070
16374,190,100,120,0,0,0,410
16375,240,120,120,160,160,0,800
16376,240,100,160,80,160,0,740
16377,180,120,200,80,0,0,580
16378,180,120,120,160,0,0,580
16379,190,80,80,0,0,0,350
16380,210,140,200,80,160,320,1110
16381,180,100,80,80,160,0,600
16382,170,100,40,80,160,0,550
16383,220,140,160,240,160,0,920
16384,200,80,120,80,0,0,480
16385,230,120,200,160,0,0,710
16386,210,160,120,80,0,0,570
16387,200,140,160,80,0,0,580
16388,200,120,160,160,160,320,1120
16389,190,100,40,0,0,0,330
16390,230,80,120,160,160,320,1070
16391,200,120,80,80,0,0,480
16392,160,140,120,160,160,0,740
16393,160,80,80,160,160,0,640
16394,180,100,80,80,160,0,600
16395,150,140,160,160,0,0,610
16396,140,140,160,0,0,0,440
16397,200,160,80,160,160,0,760
16398,200,200,200,160,320,0,1080
16399,240,80,80,80,160,320,960
16400,220,160,160,80,160,0,780
16401,200,120,160,80,160,0,720
16402,180,100,120,80,0,0,480
16403,220,120,120,160,160,0,780
16404,200,80,40,0,0,0,320
16405,190,120,120,160,160,0,750
16406,190,100,40,0,0,0,330
16407,170,100,120,80,0,0,470
16408,150,60,80,80,0,0,370
16409,170,80,80,80,160,0,570
16410,190,160,80,80,160,320,990
16411,200,180,160,160,320,320,1340
16412,170,80,40,80,160,0,530
16413,210,80,40,80,160,0,570
16414,170,100,80,80,0,0,430
16415,210,60,40,0,0,0,310
16416,200,120,80,80,0,0,480
16417,200,80,40,80,0,0,400
16418,200,100,80,80,160,0,620
16419,210,200,120,0,0,0,530
16420,200,120,120,160,160,0,760
16421,200,160,160,240,0,0,760
16422,220,120,80,80,160,0,660
16423,210,120,0,0,0,0,330
16424,200,100,160,160,320,320,1260
16425,190,120,120,160,160,0,750
16426,140,120,120,240,160,0,780
16427,200,100,120,80,160,0,660
16428,210,140,200,240,320,0,1110
16429,180,100,40,0,0,0,320
16430,200,100,80,80,160,0,620
16431,190,100,40,0,0,0,330
16432,140,120,160,80,0,0,500
16433,230,140,120,0,0,0,490
16434,180,100,120,160,0,0,560
16435,230,200,120,160,160,0,870
16436,200,60,0,0,0,0,260
16437,200,120,160,160,160,0,800
16438,200,140,120,160,320,320,1260
16439,160,140,160,160,320,320,1260
16440,200,180,120,160,160,0,820
16441,250,140,160,160,160,0,870
16442,230,200,200,160,320,0,1110
16443,220,120,80,0,0,0,420
16444,170,60,80,80,0,0,390
16445,200,120,80,80,160,0,640
16446,190,60,0,0,0,0,250
16447,200,120,120,160,160,0,760
16448,170,120,40,80,160,0,570
16449,180,120,0,0,0,0,300
16450,180,80,120,240,320,0,940
16451,220,160,80,160,160,0,780
16452,190,80,80,80,0,0,430
16453,170,120,80,80,160,0,610
16454,180,120,80,80,160,0,620
16455,190,120,40,80,0,0,430
16456,220,60,40,0,0,0,320
16457,220,100,80,80,160,0,640
16458,180,120,80,80,160,0,620
16459,160,120,200,160,320,0,960
16460,200,160,200,80,0,0,640
16461,200,100,120,160,160,0,740
16462,200,160,160,160,160,0,840
16463,200,200,160,240,160,320,1280
16464,210,100,80,0,0,0,390
16465,190,120,120,160,0,0,590
16466,140,120,120,160,160,0,700
16467,180,160,200,80,160,320,1100
16468,180,80,120,80,0,0,460
16469,210,120,160,160,160,320,1130
16470,210,100,120,240,320,320,1310
16471,160,140,120,0,0,0,420
16472,220,120,80,160,320,0,900
16473,130,100,120,160,320,0,830
16474,200,140,80,80,0,0,500
16475,180,80,120,240,320,0,940
16476,170,20,40,80,0,0,310
16477,220,100,160,160,0,0,640
16478,200,140,120,160,0,0,620
16479,190,80,80,80,160,0,590
16480,220,100,160,160,160,0,800
16481,190,140,160,80,0,0,570
16482,180,120,120,160,160,0,740
16483,260,80,40,80,160,0,620
16484,200,160,160,160,160,0,840
16485,170,100,40,0,0,0,310
16486,200,180,160,80,160,320,1100
16487,230,140,120,240,160,0,890
16488,160,140,120,80,160,0,660
16489,230,140,40,0,0,0,410
16490,190,100,80,80,160,0,610
16491,180,100,120,80,160,0,640
16492,180,120,80,0,0,0,380
16493,170,120,240,80,0,0,610
16494,200,100,120,0,0,0,420
16495,190,100,80,80,0,0,450
16496,230,100,80,0,0,0,410
16497,160,100,120,80,160,320,940
16498,180,60,80,160,320,0,800
16499,210,140,120,80,160,0,710
16500,200,100,80,80,160,0,620
16501,200,100,80,80,160,0,620
16502,190,160,200,320,160,0,1030
16503,250,140,80,0,0,0,470
16504,170,120,80,80,0,0,450
16505,180,160,120,160,320,0,940
16506,210,140,160,160,160,0,830
16507,200,160,120,80,0,0,560
16508,190,140,40,0,0,0,370
16509,200,120,80,80,0,0,480
16510,220,120,120,80,160,0,700
16511,200,120,120,80,160,0,680
16512,150,100,120,160,160,0,690
16513,190,140,80,80,0,0,490
16514,200,140,80,80,160,320,980
16515,220,100,120,80,160,320,1000
16516,190,160,40,0,0,0,390
16517,210,60,80,160,160,0,670
16518,200,120,160,160,0,0,640
16519,170,160,160,160,160,0,810
16520,260,140,160,160,160,320,1200
16521,170,60,40,80,0,0,350
16522,190,120,120,0,0,0,430
16523,200,180,40,80,160,0,660
16524,200,160,80,160,160,0,760
16525,220,160,80,160,160,0,780
16526,190,120,80,0,0,0,390
16527,170,120,120,160,160,0,730
16528,170,120,120,160,160,0,730
16529,190,140,200,80,0,0,610
16530,200,100,120,160,0,0,580
16531,220,100,80,80,0,0,480
16532,220,140,120,0,0,0,480
16533,180,120,80,80,160,0,620
16534,150,60,80,160,160,0,610
16535,160,160,80,80,160,0,640
16536,190,80,120,80,0,0,470
16537,180,120,80,80,0,0,460
16538,230,140,80,160,320,0,930
16539,190,100,0,0,0,0,290
16540,190,80,160,0,0,0,430
16541,220,140,80,80,160,0,680
16542,190,60,40,0,0,0,290
16543,170,120,120,80,0,0,490
16544,270,220,160,0,0,0,650
16545,180,160,40,0,0,0,380
16546,200,120,80,80,0,0,480
16547,220,140,40,0,0,0,400
16548,180,80,120,160,160,0,700
16549,240,120,120,80,160,320,1040
16550,240,180,80,80,160,0,740
16551,190,100,40,0,0,0,330
16552,160,80,80,80,0,0,400
16553,240,100,120,80,160,0,700
16554,220,100,120,80,160,0,680
16555,180,140,120,80,0,0,520
16556,210,120,120,0,0,0,450
16557,200,120,40,80,160,320,920
16558,190,100,120,160,160,0,730
16559,280,100,120,160,160,0,820
16560,220,140,80,160,160,0,760
16561,190,80,80,160,160,0,670
16562,210,160,120,160,160,0,810
16563,190,120,40,0,0,0,350
16564,210,180,200,240,160,0,990
16565,220,140,40,80,160,320,960
16566,170,120,120,160,160,0,730
16567,170,120,80,80,160,0,610
16568,190,80,40,0,0,0,310
16569,210,120,120,0,0,0,450
16570,210,180,160,160,160,0,870
16571,210,120,120,160,160,320,1090
16572,160,120,160,160,0,0,600
16573,170,60,80,160,320,0,790
16574,190,120,40,80,160,0,590
16575,220,140,40,80,160,0,640
16576,200,160,160,0,0,0,520
16577,190,140,80,160,0,0,570
16578,240,160,120,0,0,0,520
16579,200,100,80,0,0,0,380
16580,210,140,120,80,0,0,550
16581,190,120,80,80,160,0,630
16582,210,100,120,160,160,0,750
16583,160,160,200,0,0,0,520
16584,210,120,80,160,160,0,730
16585,220,160,80,0,0,0,460
16586,180,140,80,80,0,0,480
16587,190,100,120,80,0,0,490
16588,200,100,80,80,160,0,620
16589,200,200,160,80,160,320,1120
16590,200,120,80,0,0,0,400
16591,190,120,160,80,160,0,710
16592,180,120,120,160,0,0,580
16593,170,80,0,0,0,0,250
16594,200,120,80,0,0,0,400
16595,200,160,160,160,160,0,840
16596,200,80,160,80,160,0,680
16597,190,120,120,80,0,0,510
16598,200,140,160,80,0,0,580
16599,170,140,120,80,160,0,670
16600,220,100,120,160,320,320,1240
16601,220,140,120,160,160,0,800
16602,180,160,120,80,0,0,540
16603,160,100,80,80,160,0,580
16604,180,80,80,0,0,0,340
16605,200,80,40,0,0,0,320
16606,150,100,120,160,160,0,690
16607,180,140,80,160,160,0,720
16608,180,140,120,160,0,0,600
16609,170,100,160,80,0,0,510
16610,240,160,160,160,160,0,880
16611,220,160,120,80,0,0,580
16612,280,140,80,0,0,0,500
16613,180,100,40,80,0,0,400
16614,210,100,120,160,160,0,750
16615,190,120,40,0,0,0,350
16616,230,200,120,80,160,0,790
16617,190,160,120,80,0,0,550
16618,150,40,40,0,0,0,230
16619,210,160,120,240,320,320,1370
16620,180,100,40,80,160,0,560
16621,220,160,120,80,0,0,580
16622,190,160,80,0,0,0,430
16623,230,100,120,160,160,320,1090
16624,190,160,200,160,0,0,710
16625,210,120,160,80,0,0,570
16626,170,60,40,80,160,0,510
16627,180,120,80,80,160,320,940
16628,180,120,120,160,0,0,580
16629,220,180,200,160,160,0,920
16630,190,160,160,160,160,0,830
16631,240,120,80,80,0,0,520
16632,160,100,80,80,160,0,580
16633,160,100,120,80,160,0,620
16634,220,80,120,160,320,0,900
16635,180,120,120,80,160,0,660
16636,200,160,120,160,160,0,800
16637,210,80,40,80,0,0,410
16638,210,120,120,80,160,0,690
16639,180,100,120,160,320,0,880
16640,220,100,120,80,0,0,520
16641,170,80,80,160,320,320,1130
16642,200,160,200,80,0,0,640
16643,220,160,200,0,0,0,580
16644,180,80,40,0,0,0,300
16645,220,180,80,0,0,0,480
16646,190,100,120,80,160,320,970
16647,220,80,80,80,160,0,620
16648,200,60,80,160,0,0,500
16649,190,60,80,160,160,0,650
16650,210,160,120,80,160,0,730
16651,170,140,200,80,160,0,750
16652,170,100,80,80,0,0,430
16653,180,80,40,80,0,0,380
16654,220,120,120,80,160,0,700
16655,180,100,80,160,0,0,520
16656,170,80,120,80,0,0,450
16657,210,140,160,240,160,320,1230
16658,160,140,160,160,160,320,1100
16659,190,160,160,80,0,0,590
16660,170,80,40,0,0,0,290
16661,180,120,200,240,0,0,740
16662,230,140,120,240,0,0,730
16663,210,120,80,160,160,0,730
16664,200,160,160,160,160,0,840
16665,220,80,40,0,0,0,340
16666,170,80,120,160,160,320,1010
16667,210,160,80,0,0,0,450
16668,210,60,120,80,160,0,630
16669,170,80,80,80,0,0,410
16670,170,60,120,240,320,0,910
16671,200,140,120,80,160,320,1020
16672,200,120,120,80,160,0,680
16673,220,120,120,160,0,0,620
16674,210,120,120,160,160,0,770
16675,210,120,80,80,160,0,650
16676,200,120,120,0,0,0,440
16677,220,180,120,240,320,0,1080
16678,190,180,0,0,0,0,370
16679,190,100,80,80,0,0,450
16680,150,80,40,0,0,0,270
16681,210,120,200,160,320,0,1010
16682,220,180,160,160,0,0,720
16683,220,140,160,0,0,0,520
16684,200,140,120,80,0,0,540
16685,160,140,120,160,160,0,740
16686,190,120,200,240,160,0,910
16687,210,120,120,80,0,0,530
16688,210,140,80,0,0,0,430
16689,190,100,80,80,0,0,450
16690,190,100,80,80,0,0,450
16691,230,180,160,160,0,0,730
16692,230,120,40,0,0,0,390
16693,210,180,200,80,160,0,830
16694,180,160,80,80,0,0,500
16695,190,120,120,80,160,0,670
16696,200,100,80,80,160,0,620
16697,220,140,160,80,160,320,1080
16698,190,160,120,160,160,0,790
16699,200,60,40,0,0,0,300
16700,230,180,80,80,160,0,730
16701,200,140,80,0,0,0,420
16702,190,100,120,80,0,0,490
16703,190,120,40,80,160,0,590
16704,180,80,40,0,0,0,300
16705,180,200,120,160,160,320,1140
16706,190,80,40,80,0,0,390
16707,210,100,120,160,160,0,750
16708,230,160,160,80,160,0,790
16709,190,100,120,80,0,0,490
16710,220,180,160,160,160,0,880
16711,200,120,120,160,0,0,600
16712,210,140,40,80,160,0,630
16713,170,100,120,160,320,0,870
16714,190,100,80,80,160,320,930
16715,170,120,80,160,0,0,530
16716,190,120,80,80,160,0,630
16717,220,60,120,160,160,0,720
16718,180,160,160,80,160,320,1060
16719,190,140,120,80,0,0,530
16720,150,120,200,240,320,0,1030
16721,220,100,120,160,160,0,760
16722,220,160,160,160,160,0,860
16723,160,80,120,240,160,0,760
16724,160,140,80,160,320,0,860
16725,200,140,80,80,160,0,660
16726,200,140,120,80,160,320,1020
16727,190,140,80,80,160,0,650
16728,180,120,120,80,160,320,980
16729,200,140,160,80,160,0,740
16730,180,120,160,240,320,320,1340
16731,220,180,80,0,0,0,480
16732,200,120,80,160,320,320,1200
16733,210,80,80,80,160,0,610
16734,210,120,120,160,160,0,770
16735,160,100,120,240,320,320,1260
16736,200,140,80,80,160,0,660
16737,180,120,120,80,160,0,660
16738,180,120,120,160,320,0,900
16739,220,100,120,160,160,0,760
16740,200,140,120,80,160,0,700
16741,200,140,120,160,160,0,780
16742,180,120,80,0,0,0,380
16743,190,140,160,160,160,0,810
16744,200,100,120,80,160,0,660
16745,220,100,120,80,160,0,680
16746,200,180,240,240,0,0,860
16747,240,160,40,80,0,0,520
16748,190,80,40,80,160,320,870
16749,200,120,120,0,0,0,440
16750,220,120,120,160,160,0,780
16751,170,140,120,80,160,0,670
16752,160,140,120,160,320,0,900
16753,210,120,80,0,0,0,410
16754,210,160,80,80,160,0,690
16755,240,180,120,160,160,0,860
16756,170,140,80,0,0,0,390
16757,210,140,120,80,160,0,710
16758,190,120,160,160,0,0,630
16759,240,200,160,80,160,320,1160
16760,180,160,160,240,160,320,1220
16761,190,120,120,80,0,0,510
16762,180,100,120,80,160,0,640
16763,210,120,120,240,0,0,690
16764,190,120,120,0,0,0,430
16765,190,120,80,80,160,0,630
16766,200,60,80,80,160,0,580
16767,180,80,80,80,160,0,580
16768,210,120,80,80,0,0,490
16769,220,140,80,80,0,0,520
16770,180,60,80,160,160,0,640
16771,210,140,160,160,160,320,1150
16772,210,140,160,160,160,0,830
16773,180,80,120,160,160,0,700
16774,170,120,80,80,0,0,450
16775,210,160,40,0,0,0,410
16776,180,80,0,0,0,0,260
16777,160,180,80,160,0,0,580
16778,200,160,120,160,320,0,960
16779,180,100,120,240,160,320,1120
16780,200,120,80,0,0,0,400
16781,210,140,80,80,160,0,670
16782,210,160,120,160,320,0,970
16783,200,140,120,80,160,0,700
16784,240,260,160,160,160,0,980
16785,240,160,120,160,160,0,840
16786,200,160,120,80,160,0,720
16787,200,120,240,240,320,320,1440
16788,210,100,160,80,160,0,710
16789,170,140,200,160,160,0,830
16790,200,120,160,80,0,0,560
16791,180,120,200,320,160,0,980
16792,160,140,160,240,160,0,860
16793,150,100,120,80,160,0,610
16794,200,120,80,80,160,320,960
16795,190,100,80,80,0,0,450
16796,200,80,80,80,160,0,600
16797,200,120,160,160,0,0,640
16798,220,100,160,160,160,0,800
16799,180,140,80,80,160,0,640
16800,210,100,40,80,160,0,590
16801,170,120,80,160,160,0,690
16802,220,100,80,80,160,0,640
16803,190,140,40,0,0,0,370
16804,200,100,80,160,160,0,700
16805,180,100,160,80,0,0,520
16806,190,60,80,160,160,320,970
16807,170,60,40,80,160,0,510
16808,190,180,160,80,160,0,770
16809,190,100,40,80,160,0,570
16810,200,120,160,0,0,0,480
16811,190,120,120,160,160,0,750
16812,200,120,120,80,0,0,520
16813,220,120,80,80,0,0,500
16814,180,100,40,80,160,320,880
16815,250,180,80,160,160,0,830
16816,190,120,120,160,160,320,1070
16817,180,120,80,80,160,0,620
16818,180,80,40,0,0,0,300
16819,230,100,80,80,160,320,970
16820,190,100,120,80,160,320,970
16821,220,160,120,80,160,0,740
16822,210,120,120,160,160,0,770
16823,220,100,80,160,320,0,880
16824,200,140,80,80,0,0,500
16825,210,120,120,160,160,0,770
16826,210,160,160,80,160,0,770
16827,180,140,160,240,160,0,880
16828,180,100,120,160,160,0,720
16829,190,100,80,80,160,0,610
16830,200,100,120,80,160,0,660
16831,180,80,80,160,160,0,660
16832,180,80,80,80,160,320,900
16833,190,140,160,160,160,0,810
16834,180,100,80,80,160,0,600
16835,150,100,80,80,0,0,410
16836,220,80,40,0,0,0,340
16837,200,120,120,80,160,0,680
16838,220,80,120,240,320,0,980
16839,180,120,80,0,0,0,380
16840,180,120,160,80,0,0,540
16841,170,140,120,80,160,0,670
16842,230,160,120,0,0,0,510
16843,180,160,160,160,160,0,820
16844,190,60,40,0,0,0,290
16845,220,120,160,80,160,0,740
16846,230,140,120,80,0,0,570
16847,210,160,200,160,160,0,890
16848,190,80,80,0,0,0,350
16849,200,180,160,80,160,0,780
16850,220,160,160,0,0,0,540
16851,210,100,40,0,0,0,350
16852,160,120,120,160,160,0,720
16853,220,200,160,80,0,0,660
16854,200,120,120,160,160,320,1080
16855,210,180,80,80,160,0,710
16856,190,100,80,80,0,0,450
16857,200,120,160,240,0,0,720
16858,200,100,120,80,0,0,500
16859,220,180,160,160,160,320,1200
16860,200,160,160,160,160,0,840
16861,170,100,80,80,160,0,590
16862,220,120,40,0,0,0,380
16863,220,120,80,0,0,0,420
16864,160,120,160,80,160,0,680
16865,220,100,80,80,0,0,480
16866,210,120,120,160,0,0,610
16867,190,120,120,160,160,0,750
16868,210,140,160,160,160,0,830
16869,190,180,200,160,160,0,890
16870,180,160,120,80,0,0,540
16871,220,120,40,80,0,0,460
16872,180,100,120,240,0,0,640
16873,220,140,160,80,0,0,600
16874,230,140,120,80,160,0,730
16875,240,140,120,160,160,0,820
16876,180,100,80,80,160,320,920
16877,220,140,120,0,0,0,480
16878,190,100,80,80,0,0,450
16879,210,140,40,0,0,0,390
16880,220,80,80,80,0,0,460
16881,190,60,120,240,160,0,770
16882,180,140,120,0,0,0,440
16883,190,180,160,160,320,0,1010
16884,180,80,120,80,160,0,620
16885,200,180,80,160,160,0,780
16886,230,160,120,80,0,0,590
16887,180,160,80,80,160,0,660
16888,200,120,200,80,0,0,600
16889,180,80,40,80,160,0,540
16890,180,100,40,0,0,0,320
16891,210,120,120,80,160,0,690
16892,180,160,160,160,0,0,660
16893,230,80,80,80,0,0,470
16894,200,100,80,80,160,0,620
16895,240,180,120,160,320,0,1020
16896,190,80,80,80,160,320,910
16897,170,80,120,80,160,0,610
16898,190,120,40,80,160,0,590
16899,180,120,120,160,320,0,900
16900,210,140,200,0,0,0,550
16901,170,100,120,80,0,0,470
16902,200,140,80,160,160,320,1060
16903,180,100,40,0,0,0,320
16904,240,120,80,80,160,320,1000
16905,190,160,160,160,0,0,670
16906,190,100,120,160,320,0,890
16907,190,100,120,80,160,0,650
16908,210,120,120,160,320,320,1250
16909,220,160,160,160,160,320,1180
16910,230,160,80,0,0,0,470
16911,190,40,40,80,160,0,510
16912,200,160,80,80,0,0,520
16913,160,160,200,240,160,0,920
16914,130,100,40,0,0,0,270
16915,230,120,80,160,160,320,1070
16916,190,140,160,80,160,0,730
16917,200,80,40,80,0,0,400
16918,190,180,80,0,0,0,450
16919,190,120,160,80,0,0,550
16920,220,180,80,80,160,0,720
16921,160,120,80,80,0,0,440
16922,210,160,120,0,0,0,490
16923,180,100,80,0,0,0,360
16924,210,80,40,80,160,0,570
16925,220,100,80,80,160,0,640
16926,200,120,120,160,0,0,600
16927,210,100,80,0,0,0,390
16928,180,160,80,80,0,0,500
16929,170,100,80,80,160,320,910
16930,170,120,200,160,0,0,650
16931,240,120,120,80,160,0,720
16932,180,80,80,0,0,0,340
16933,160,140,80,0,0,0,380
16934,230,180,120,160,160,0,850
16935,200,120,80,160,160,0,720
16936,170,60,40,0,0,0,270
16937,210,60,80,0,0,0,350
16938,210,140,40,80,160,0,630
16939,160,100,120,160,0,0,540
16940,190,100,120,80,160,0,650
16941,200,160,80,80,160,0,680
16942,180,80,80,80,0,0,420
16943,190,120,80,80,0,0,470
16944,240,60,0,0,0,0,300
16945,210,60,120,160,320,0,870
16946,190,120,120,80,160,0,670
16947,260,120,120,160,160,0,820
16948,210,80,80,80,160,320,930
16949,150,140,80,160,320,0,850
16950,190,100,80,0,0,0,370
16951,210,200,160,160,160,0,890
16952,240,120,120,80,0,0,560
16953,180,140,160,240,320,0,1040
16954,210,100,120,160,320,0,910
16955,190,120,40,0,0,0,350
16956,160,120,160,80,160,0,680
16957,210,140,160,160,160,0,830
16958,190,120,160,80,160,0,710
16959,160,100,120,160,160,0,700
16960,240,60,120,0,0,0,420
16961,220,220,200,160,0,0,800
16962,210,80,80,80,0,0,450
16963,190,120,80,0,0,0,390
16964,200,120,80,80,160,0,640
16965,180,160,160,240,320,320,1380
16966,170,120,80,160,320,0,850
16967,170,160,120,80,160,0,690
16968,180,140,200,80,160,0,760
16969,200,100,40,80,0,0,420
16970,200,120,40,80,0,0,440
16971,220,140,160,80,0,0,600
16972,230,120,80,80,160,0,670
16973,190,140,80,80,160,0,650
16974,230,120,120,160,160,0,790
16975,200,100,120,0,0,0,420
16976,220,80,160,80,160,0,700
16977,190,160,240,160,160,0,910
16978,230,120,120,240,160,0,870
16979,190,140,200,80,0,0,610
16980,170,60,80,80,0,0,390
16981,220,140,40,0,0,0,400
16982,250,140,160,80,160,0,790
16983,190,120,120,160,0,0,590
16984,210,140,120,0,0,0,470
16985,230,120,80,160,320,0,910
16986,180,80,80,80,160,0,580
16987,200,100,120,160,320,320,1220
16988,210,120,120,240,320,320,1330
16989,210,160,120,80,0,0,570
16990,190,100,120,80,160,0,650
16991,190,120,120,0,0,0,430
16992,200,120,160,80,160,320,1040
16993,260,160,40,80,160,0,700
16994,240,100,80,80,160,0,660
16995,180,120,120,160,160,0,740
16996,200,140,160,160,160,0,820
16997,180,180,240,240,320,0,1160
16998,170,100,40,0,0,0,310
16999,220,140,80,160,0,0,600
17000,200,100,120,80,160,0,660
17001,210,180,160,80,0,0,630
17002,170,140,120,80,160,0,670
17003,200,200,200,160,160,0,920
17004,170,140,160,80,160,0,710
17005,160,120,40,80,0,0,400
17006,180,160,200,160,0,0,700
17007,200,160,80,80,160,320,1000
17008,170,80,40,80,160,0,530
17009,190,120,80,160,160,0,710
17010,170,160,80,80,160,0,650
17011,170,40,40,80,160,0,490
17012,200,200,120,80,160,0,760
17013,190,120,120,80,0,0,510
17014,150,120,80,80,0,0,430
17015,210,140,120,160,160,0,790
17016,170,140,80,80,160,0,630
17017,250,160,160,160,160,0,890
17018,170,120,40,0,0,0,330
17019,260,160,160,160,160,320,1220
17020,220,100,40,80,160,0,600
17021,210,120,120,160,320,0,930
17022,170,120,160,80,0,0,530
17023,200,140,120,80,0,0,540
17024,190,80,160,240,320,0,990
17025,200,160,120,0,0,0,480
17026,170,40,40,80,0,0,330
17027,200,160,120,240,160,0,880
17028,210,100,120,80,0,0,510
17029,230,140,40,0,0,0,410
17030,180,100,80,80,0,0,440
17031,210,120,40,0,0,0,370
17032,160,120,120,80,0,0,480
17033,170,100,120,80,160,320,950
17034,190,120,120,80,0,0,510
17035,200,80,40,80,160,320,880
17036,240,100,40,80,0,0,460
17037,220,120,160,240,320,320,1380
17038,240,120,120,160,320,0,960
17039,230,120,80,0,0,0,430
17040,210,120,160,80,0,0,570
17041,210,60,40,80,160,0,550
17042,190,140,120,80,160,320,1010
17043,180,120,80,160,0,0,540
17044,160,80,120,160,0,0,520
17045,210,120,120,80,160,0,690
17046,210,180,160,160,0,0,710
17047,210,160,40,0,0,0,410
17048,190,140,40,80,160,320,930
17049,190,80,160,160,160,0,750
17050,200,100,120,80,160,0,660
17051,180,100,120,160,0,0,560
17052,240,100,80,80,160,0,660
17053,200,120,120,160,0,0,600
17054,200,180,120,160,320,0,980
17055,230,120,160,80,0,0,590
17056,200,80,80,160,160,320,1000
17057,190,100,80,0,0,0,370
17058,190,60,80,0,0,0,330
17059,190,140,160,160,320,0,970
17060,210,100,120,160,0,0,590
17061,190,100,40,80,160,0,570
17062,180,100,120,80,0,0,480
17063,200,120,120,80,160,0,680
17064,150,120,160,160,320,320,1230
17065,180,220,80,80,160,0,720
17066,160,100,40,80,160,320,860
17067,170,100,120,160,0,0,550
17068,200,100,80,80,160,0,620
17069,200,120,80,80,0,0,480
17070,170,120,120,240,320,0,970
17071,240,180,120,160,160,0,860
17072,180,140,160,240,320,0,1040
17073,210,80,40,80,160,0,570
17074,180,140,120,160,320,320,1240
17075,190,140,40,80,0,0,450
17076,200,120,80,0,0,0,400
17077,250,160,120,80,0,0,610
17078,220,120,120,80,160,0,700
17079,240,140,40,80,160,320,980
17080,190,140,120,240,160,320,1170
17081,180,60,0,0,0,0,240
17082,200,120,80,80,0,0,480
17083,190,120,40,80,160,320,910
17084,160,60,40,80,0,0,340
17085,190,160,80,160,160,0,750
17086,210,140,120,240,160,0,870
17087,180,60,40,80,160,320,840
17088,230,140,0,0,0,0,370
17089,220,80,80,80,160,320,940
17090,170,160,160,80,160,0,730
17091,200,100,80,160,160,0,700
17092,230,80,120,80,0,0,510
17093,230,140,80,80,0,0,530
17094,190,120,160,80,160,0,710
17095,170,80,80,160,320,0,810
17096,180,160,160,80,160,0,740
17097,200,100,80,0,0,0,380
17098,210,100,80,80,160,0,630
17099,180,120,160,0,0,0,460
17100,170,140,120,160,0,0,590
17101,230,200,120,240,160,0,950
17102,170,100,120,80,160,0,630
17103,210,100,80,160,320,0,870
17104,160,80,80,80,160,0,560
17105,150,120,80,80,160,0,590
17106,170,120,160,80,0,0,530
17107,190,140,160,160,0,0,650
17108,210,140,160,160,320,0,990
17109,180,100,80,160,160,0,680
17110,190,140,120,80,0,0,530
17111,200,140,120,80,160,0,700
17112,220,100,80,0,0,0,400
17113,210,120,80,80,160,0,650
17114,220,120,40,0,0,0,380
17115,180,140,120,160,160,320,1080
17116,220,120,120,80,0,0,540
17117,210,140,80,80,0,0,510
17118,220,140,120,80,0,0,560
17119,190,120,160,160,0,0,630
17120,200,120,120,160,320,320,1240
17121,190,120,80,160,320,320,1190
17122,200,100,120,0,0,0,420
17123,230,140,160,160,160,0,850
17124,210,100,80,80,160,0,630
17125,150,120,120,160,160,0,710
17126,220,160,120,240,320,320,1380
17127,180,120,40,80,160,0,580
17128,200,120,160,160,320,320,1280
17129,220,140,120,80,0,0,560
17130,180,80,80,80,0,0,420
17131,190,80,0,0,0,0,270
17132,200,160,200,80,160,0,800
17133,200,100,120,80,160,0,660
17134,220,120,80,80,160,0,660
17135,160,120,40,0,0,0,320
17136,200,100,40,0,0,0,340
17137,190,80,120,160,0,0,550
17138,200,80,80,160,160,320,1000
17139,220,180,120,160,160,0,840
17140,210,60,80,0,0,0,350
17141,210,40,0,0,0,0,250
17142,230,160,160,160,0,0,710
17143,190,140,160,160,160,0,810
17144,180,80,80,80,0,0,420
17145,180,80,80,80,160,0,580
17146,240,120,40,80,160,0,640
17147,200,180,200,160,160,0,900
17148,200,120,40,80,0,0,440
17149,180,160,160,240,320,320,1380
17150,200,140,80,80,0,0,500
17151,210,160,120,160,320,320,1290
17152,190,120,120,240,0,0,670
17153,130,100,80,80,0,0,390
17154,200,120,160,80,0,0,560
17155,170,80,40,0,0,0,290
17156,180,140,80,80,0,0,480
17157,150,140,80,80,160,0,610
17158,170,40,40,0,0,0,250
17159,190,120,80,80,160,0,630
17160,170,40,80,160,0,0,450
17161,250,120,120,0,0,0,490
17162,210,140,120,160,320,320,1270
17163,200,140,80,0,0,0,420
17164,110,80,120,160,160,0,630
17165,180,100,120,160,160,0,720
17166,170,120,120,240,0,0,650
17167,250,120,120,80,0,0,570
17168,240,240,160,160,160,0,960
17169,210,120,160,160,160,0,810
17170,220,160,200,240,0,0,820
17171,160,120,120,160,160,0,720
17172,210,180,80,0,0,0,470
17173,200,140,160,160,160,320,1140
17174,180,160,120,160,320,0,940
17175,160,120,80,80,0,0,440
17176,190,120,80,80,160,0,630
17177,200,180,200,160,0,0,740
17178,220,160,160,160,320,0,1020
17179,170,100,80,80,0,0,430
17180,180,120,120,80,160,0,660
17181,190,160,40,80,0,0,470
17182,220,80,40,80,160,0,580
17183,170,140,80,80,160,0,630
17184,190,140,200,80,0,0,610
17185,170,100,40,0,0,0,310
17186,200,140,40,80,160,0,620
17187,200,100,160,160,160,0,780
17188,220,80,40,80,160,0,580
17189,150,140,160,160,160,0,770
17190,190,140,80,80,0,0,490
17191,220,200,80,160,320,0,980
17192,200,120,120,160,160,320,1080
17193,180,140,200,80,0,0,600
17194,200,160,120,80,160,0,720
17195,210,140,80,80,160,0,670
17196,220,140,80,0,0,0,440
17197,180,120,80,80,0,0,460
17198,180,140,80,80,0,0,480
17199,180,100,120,160,160,0,720
17200,210,140,160,160,160,0,830
17201,220,100,80,80,160,0,640
17202,150,80,40,0,0,0,270
17203,200,140,160,80,0,0,580
17204,150,180,160,160,320,0,970
17205,200,160,80,160,160,320,1080
17206,190,80,0,0,0,0,270
17207,220,120,80,80,0,0,500
17208,190,140,40,0,0,0,370
17209,210,160,40,0,0,0,410
17210,190,120,80,80,160,0,630
17211,220,80,80,0,0,0,380
17212,190,120,120,80,0,0,510
17213,150,60,80,160,160,320,930
17214,180,140,120,80,160,0,680
17215,220,120,80,80,160,0,660
17216,160,120,160,240,160,0,840
17217,190,140,80,80,160,320,970
17218,210,140,40,0,0,0,390
17219,170,60,40,0,0,0,270
17220,200,140,120,160,0,0,620
17221,200,160,200,160,160,0,880
17222,210,100,80,160,0,0,550
17223,230,140,160,160,160,0,850
17224,180,80,40,80,160,0,540
17225,170,80,80,80,0,0,410
17226,220,80,40,0,0,0,340
17227,210,140,200,240,320,0,1110
17228,230,140,120,80,0,0,570
17229,170,140,120,80,0,0,510
17230,170,180,80,0,0,0,430
17231,180,80,80,80,160,320,900
17232,170,120,80,160,320,320,1170
17233,210,140,120,80,0,0,550
17234,210,120,120,80,0,0,530
17235,210,120,40,80,160,320,930
17236,220,100,160,240,320,0,1040
17237,210,100,80,80,160,320,950
17238,230,160,120,80,0,0,590
17239,220,120,80,80,160,0,660
17240,160,80,80,80,0,0,400
17241,190,120,80,160,160,0,710
17242,220,140,120,160,160,0,800
17243,160,120,120,160,160,0,720
17244,170,100,40,80,160,0,550
17245,240,180,240,240,0,0,900
17246,180,100,120,80,160,0,640
17247,190,160,160,80,0,0,590
17248,200,140,160,160,0,0,660
17249,200,140,80,80,0,0,500
17250,230,140,200,160,0,0,730
17251,210,140,80,80,0,0,510
17252,180,80,40,80,160,0,540
17253,210,120,80,80,160,320,970
17254,190,80,120,80,160,320,950
17255,180,100,80,0,0,0,360
17256,160,100,80,0,0,0,340
17257,140,60,80,80,0,0,360
17258,210,100,80,160,160,0,710
17259,180,100,120,160,160,0,720
17260,170,60,80,160,160,0,630
17261,200,140,120,240,320,320,1340
17262,220,120,80,160,160,0,740
17263,180,140,120,160,320,320,1240
17264,190,60,80,80,160,0,570
17265,180,140,200,80,0,0,600
17266,200,100,40,0,0,0,340
17267,210,160,160,240,320,0,1090
17268,190,100,80,80,0,0,450
17269,230,100,0,0,0,0,330
17270,170,120,80,80,0,0,450
17271,210,100,80,160,160,0,710
17272,190,60,40,80,0,0,370
17273,190,140,40,0,0,0,370
17274,190,120,120,80,0,0,510
17275,180,120,120,80,0,0,500
17276,210,100,80,160,320,320,1190
17277,250,200,160,160,320,320,1410
17278,200,120,160,0,0,0,480
17279,170,100,120,160,160,320,1030
17280,200,160,120,160,320,0,960
17281,180,160,160,80,0,0,580
17282,180,100,120,80,0,0,480
17283,220,120,80,0,0,0,420
17284,170,120,40,80,0,0,410
17285,210,160,120,160,160,0,810
17286,150,80,80,80,0,0,390
17287,180,100,80,80,160,0,600
17288,170,80,80,160,320,0,810
17289,200,140,120,160,160,320,1100
17290,190,120,120,160,320,0,910
17291,210,60,80,80,160,0,590
17292,170,140,80,160,0,0,550
17293,150,100,120,160,320,0,850
17294,200,140,40,0,0,0,380
17295,210,140,80,80,160,0,670
17296,210,40,80,0,0,0,330
17297,170,120,120,0,0,0,410
17298,150,40,40,80,160,0,470
17299,240,180,160,80,0,0,660
17300,180,100,120,240,320,0,960
17301,230,140,120,160,0,0,650
17302,210,100,120,160,160,0,750
17303,190,100,80,0,0,0,370
17304,170,80,160,80,0,0,490
17305,190,120,80,80,160,0,630
17306,220,120,40,0,0,0,380
17307,220,120,120,80,160,320,1020
17308,220,140,200,160,160,0,880
17309,220,120,80,80,0,0,500
17310,210,180,160,160,160,0,870
17311,210,80,120,80,0,0,490
17312,170,160,120,160,160,0,770
17313,200,80,40,0,0,0,320
17314,160,120,160,160,0,0,600
17315,210,180,120,0,0,0,510
17316,200,120,80,0,0,0,400
17317,190,80,120,0,0,0,390
17318,190,160,200,160,160,0,870
17319,170,120,160,80,160,0,690
17320,190,140,80,80,160,0,650
17321,170,80,120,160,160,320,1010
17322,200,80,40,0,0,0,320
17323,170,100,80,80,160,0,590
17324,160,60,80,0,0,0,300
17325,160,180,120,160,320,320,1260
17326,180,160,160,160,0,0,660
17327,190,120,40,80,0,0,430
17328,220,140,120,160,160,0,800
17329,220,120,160,80,160,0,740
17330,200,140,160,0,0,0,500
17331,190,60,80,80,160,0,570
17332,150,100,80,0,0,0,330
17333,180,120,80,80,0,0,460
17334,210,100,80,80,0,0,470
17335,150,140,80,160,320,320,1170
17336,210,120,160,160,160,320,1130
17337,230,140,120,160,160,0,810
17338,200,120,80,0,0,0,400
17339,230,160,80,80,160,0,710
17340,160,100,80,80,160,320,900
17341,220,80,80,0,0,0,380
17342,190,100,160,160,160,0,770
17343,180,80,80,160,160,0,660
17344,210,160,160,80,0,0,610
17345,220,100,160,240,0,0,720
17346,240,140,120,80,0,0,580
17347,220,160,240,240,0,0,860
17348,170,60,40,80,0,0,350
17349,170,120,80,80,160,320,930
17350,190,160,120,160,160,320,1110
17351,250,80,160,160,320,0,970
17352,180,180,120,80,0,0,560
17353,190,100,80,80,160,0,610
17354,180,120,40,80,160,0,580
17355,200,180,120,80,160,0,740
17356,170,80,80,80,0,0,410
17357,250,200,160,80,160,320,1170
17358,180,100,80,0,0,0,360
17359,220,160,120,160,160,0,820
17360,180,140,120,160,160,0,760
17361,240,140,200,240,320,0,1140
17362,190,80,80,160,320,0,830
17363,220,200,160,160,320,320,1380
17364,190,60,80,160,0,0,490
17365,210,80,80,160,0,0,530
17366,200,140,120,80,160,0,700
17367,210,80,120,160,160,0,730
17368,210,100,40,80,0,0,430
17369,180,100,80,80,160,0,600
17370,200,120,120,160,320,0,920
17371,220,120,80,160,160,0,740
17372,190,120,40,0,0,0,350
17373,210,160,120,160,160,0,810
17374,180,80,0,0,0,0,260
17375,190,100,80,80,0,0,450
17376,230,140,80,160,0,0,610
17377,200,160,120,80,160,0,720
17378,220,120,80,80,0,0,500
17379,210,140,80,80,160,0,670
17380,200,120,80,80,0,0,480
17381,190,160,160,160,320,320,1310
17382,170,80,80,80,160,0,570
17383,210,140,160,80,0,0,590
17384,170,160,160,80,0,0,570
17385,190,160,120,0,0,0,470
17386,220,180,80,80,160,0,720
17387,180,140,160,80,0,0,560
17388,210,140,80,160,320,0,910
17389,170,120,120,80,160,0,650
17390,240,160,80,80,0,0,560
17391,230,100,80,80,0,0,490
17392,200,140,160,240,160,0,900
17393,250,180,200,240,320,0,1190
17394,200,140,40,0,0,0,380
17395,160,40,80,80,160,0,520
17396,200,80,120,160,320,320,1200
17397,190,140,160,80,0,0,570
17398,150,120,160,160,0,0,590
17399,200,140,240,160,160,0,900
17400,170,100,120,160,160,0,710
17401,200,120,80,80,0,0,480
17402,180,120,80,160,0,0,540
17403,200,100,80,80,0,0,460
17404,220,160,120,160,160,0,820
17405,200,120,120,0,0,0,440
17406,150,60,120,80,0,0,410
17407,190,140,80,0,0,0,410
17408,180,120,80,160,160,0,700
17409,180,100,160,160,320,0,920
17410,200,120,40,0,0,0,360
17411,220,180,160,80,160,0,800
17412,190,120,160,160,160,0,790
17413,200,140,40,0,0,0,380
17414,210,120,120,160,0,0,610
17415,190,120,120,160,160,0,750
17416,200,160,40,0,0,0,400
17417,190,180,160,80,0,0,610
17418,190,100,80,160,160,0,690
17419,160,140,160,240,160,320,1180
17420,170,80,40,80,0,0,370
17421,170,80,40,0,0,0,290
17422,200,120,80,80,160,0,640
17423,200,120,160,160,160,0,800
17424,200,80,40,80,160,0,560
17425,210,120,120,80,160,0,690
17426,180,160,80,160,160,0,740
17427,190,60,0,0,0,0,250
17428,210,140,160,160,0,0,670
17429,220,100,120,240,160,0,840
17430,200,140,160,0,0,0,500
17431,180,120,40,80,160,0,580
17432,200,180,160,80,160,0,780
17433,220,160,80,160,160,0,780
17434,240,120,120,160,160,0,800
17435,230,140,120,80,0,0,570
17436,200,160,120,160,320,0,960
17437,190,160,120,0,0,0,470
17438,230,180,120,160,320,320,1330
17439,180,100,40,0,0,0,320
17440,200,60,40,80,0,0,380
17441,190,100,160,160,320,0,930
17442,180,180,160,160,160,0,840
17443,210,140,80,160,160,0,750
17444,200,180,40,0,0,0,420
17445,160,60,80,80,0,0,380
17446,170,140,200,160,320,0,990
17447,250,60,80,80,160,0,630
17448,180,140,200,240,320,0,1080
17449,250,160,40,0,0,0,450
17450,180,80,40,80,160,0,540
17451,200,120,120,0,0,0,440
17452,210,140,120,80,0,0,550
17453,170,100,80,160,160,0,670
17454,220,120,80,0,0,0,420
17455,190,100,80,80,160,0,610
17456,260,100,120,160,320,320,1280
17457,200,140,120,80,0,0,540
17458,200,140,40,80,160,0,620
17459,150,120,160,80,0,0,510
17460,220,180,120,160,320,320,1320
17461,190,100,80,0,0,0,370
17462,180,120,120,80,160,0,660
17463,230,120,40,80,160,0,630
17464,180,100,120,160,320,0,880
17465,210,100,80,80,160,0,630
17466,200,60,80,80,160,0,580
17467,170,120,120,160,320,0,890
17468,180,120,80,160,160,320,1020
17469,160,120,120,160,0,0,560
17470,180,120,80,80,160,320,940
17471,220,60,40,80,0,0,400
17472,230,100,40,0,0,0,370
17473,220,160,120,80,0,0,580
17474,160,140,160,160,160,0,780
17475,210,160,160,160,160,320,1170
17476,230,160,80,0,0,0,470
17477,210,120,160,80,0,0,570
17478,200,120,80,160,160,0,720
17479,200,160,160,160,160,320,1160
17480,220,140,160,240,320,0,1080
17481,190,160,120,160,160,0,790
17482,190,120,40,0,0,0,350
17483,200,120,120,80,160,320,1000
17484,190,120,120,160,160,320,1070
17485,200,120,160,160,160,0,800
17486,190,120,120,80,160,0,670
17487,190,120,120,80,160,0,670
17488,190,160,160,0,0,0,510
17489,200,100,120,80,160,0,660
17490,210,120,160,80,160,320,1050
17491,200,140,120,160,0,0,620
17492,190,120,120,160,160,0,750
17493,200,120,160,240,0,0,720
17494,190,140,80,80,160,0,650
17495,220,160,160,240,0,0,780
17496,180,140,160,160,160,320,1120
17497,170,120,80,80,0,0,450
17498,240,120,80,80,160,0,680
17499,210,120,80,160,160,0,730
17500,180,140,80,160,160,0,720
17501,250,160,160,80,0,0,650
17502,180,80,120,80,160,0,620
17503,160,140,120,160,160,0,740
17504,230,120,80,0,0,0,430
17505,190,120,80,80,0,0,470
17506,200,120,40,80,160,0,600
17507,200,160,120,80,0,0,560
17508,170,120,120,160,160,0,730
17509,180,120,40,80,0,0,420
17510,200,100,80,80,160,0,620
17511,190,180,80,80,0,0,530
17512,170,120,120,0,0,0,410
17513,180,120,120,80,160,320,980
17514,210,140,120,80,0,0,550
17515,200,160,160,240,320,0,1080
17516,180,120,120,80,160,0,660
17517,200,160,120,160,160,0,800
17518,190,100,80,0,0,0,370
17519,200,120,80,0,0,0,400
17520,190,140,120,160,0,0,610
17521,220,160,120,80,160,0,740
17522,150,60,80,80,160,0,530
17523,220,200,120,80,160,0,780
17524,190,80,120,160,160,0,710
17525,180,100,80,160,320,0,840
17526,220,140,120,80,0,0,560
17527,250,160,200,160,160,0,930
17528,210,160,200,80,0,0,650
17529,170,80,80,80,0,0,410
17530,200,120,120,160,160,0,760
17531,170,60,120,80,0,0,430
17532,210,100,200,240,160,0,910
17533,210,120,0,0,0,0,330
17534,200,160,160,80,160,0,760
17535,270,140,40,0,0,0,450
17536,160,120,80,160,160,0,680
17537,190,180,120,80,160,320,1050
17538,200,80,120,160,160,320,1040
17539,160,80,80,0,0,0,320
17540,170,80,80,160,160,320,970
17541,200,140,120,160,160,0,780
17542,190,180,200,160,160,320,1210
17543,200,120,120,160,160,0,760
17544,210,140,80,80,160,0,670
17545,140,160,200,240,160,0,900
17546,170,100,80,80,0,0,430
17547,220,160,160,0,0,0,540
17548,240,180,200,80,0,0,700
17549,250,140,120,160,0,0,670
17550,220,140,160,80,0,0,600
17551,210,100,120,80,160,0,670
17552,180,120,80,80,160,0,620
17553,180,80,40,0,0,0,300
17554,220,160,200,80,0,0,660
17555,110,140,120,80,0,0,450
17556,180,100,80,160,320,0,840
17557,180,100,80,80,160,0,600
17558,160,120,160,80,160,0,680
17559,220,120,160,240,160,0,900
17560,170,100,120,160,160,320,1030
17561,190,60,40,0,0,0,290
17562,190,80,120,80,160,0,630
17563,170,40,40,80,160,320,810
17564,210,60,40,80,160,0,550
17565,160,100,120,80,0,0,460
17566,180,140,120,80,160,0,680
17567,210,100,40,80,0,0,430
17568,170,120,80,80,160,0,610
17569,180,140,120,80,160,0,680
17570,180,80,80,80,160,0,580
17571,210,140,120,80,160,0,710
17572,220,120,120,160,160,0,780
17573,220,100,120,80,160,320,1000
17574,230,140,80,160,320,0,930
17575,210,160,120,80,0,0,570
17576,200,100,160,0,0,0,460
17577,190,80,120,80,160,0,630
17578,190,120,80,160,160,0,710
17579,150,100,80,80,160,0,570
17580,220,80,40,80,0,0,420
17581,180,200,160,240,320,0,1100
17582,230,140,80,160,160,0,770
17583,190,120,120,160,160,0,750
17584,180,180,120,80,160,0,720
17585,170,120,200,240,0,0,730
17586,220,80,160,80,0,0,540
17587,220,120,80,160,160,0,740
17588,220,100,80,0,0,0,400
17589,190,120,120,80,160,320,990
17590,160,140,40,80,160,0,580
17591,160,100,80,80,160,0,580
17592,200,100,120,80,0,0,500
17593,200,140,200,160,0,0,700
17594,240,100,120,160,160,0,780
17595,220,160,80,80,160,0,700
17596,180,120,120,80,160,0,660
17597,190,140,80,80,0,0,490
17598,180,140,40,80,160,0,600
17599,180,120,80,80,0,0,460
17600,220,160,80,0,0,0,460
17601,170,120,80,80,160,0,610
17602,210,140,120,160,160,0,790
17603,190,100,40,80,160,0,570
17604,190,140,80,160,160,0,730
17605,200,120,120,160,160,320,1080
17606,220,140,120,80,160,0,720
17607,180,100,160,80,160,0,680
17608,160,100,80,80,160,0,580
17609,200,120,0,0,0,0,320
17610,190,120,120,160,160,320,1070
17611,210,140,160,160,160,320,1150
17612,210,140,80,80,160,0,670
17613,160,60,120,160,0,0,500
17614,200,60,40,0,0,0,300
17615,160,120,40,80,160,0,560
17616,180,80,0,0,0,0,260
17617,220,160,160,160,320,0,1020
17618,200,120,120,160,320,0,920
17619,160,180,120,160,320,320,1260
17620,180,100,120,80,0,0,480
17621,160,80,80,80,0,0,400
17622,240,140,120,160,0,0,660
17623,190,100,40,0,0,0,330
17624,180,80,80,80,160,320,900
17625,170,100,120,160,160,0,710
17626,200,160,160,240,160,0,920
17627,200,80,40,0,0,0,320
17628,170,160,120,80,0,0,530
17629,210,140,80,0,0,0,430
17630,170,140,120,80,0,0,510
17631,220,120,80,80,0,0,500
17632,210,200,200,80,160,0,850
17633,220,120,160,160,160,320,1140
17634,210,140,200,160,320,320,1350
17635,190,140,120,80,0,0,530
17636,200,120,120,80,0,0,520
17637,240,80,40,0,0,0,360
17638,220,160,120,0,0,0,500
17639,230,160,80,80,0,0,550
17640,220,160,120,0,0,0,500
17641,180,120,120,240,160,0,820
17642,150,100,80,80,160,0,570
17643,190,160,160,240,320,320,1390
17644,230,180,120,0,0,0,530
17645,150,100,80,160,160,0,650
17646,210,120,160,160,160,0,810
17647,190,180,160,160,160,0,850
17648,200,200,40,0,0,0,440
17649,160,100,80,80,160,320,900
17650,210,80,160,80,0,0,530
17651,190,140,120,160,160,0,770
17652,200,120,120,160,0,0,600
17653,170,140,120,80,160,320,990
17654,220,160,160,0,0,0,540
17655,190,120,80,0,0,0,390
17656,180,120,120,160,160,0,740
17657,240,140,120,0,0,0,500
17658,170,120,160,80,160,0,690
17659,210,120,40,0,0,0,370
17660,210,100,40,80,160,320,910
17661,210,140,200,80,0,0,630
17662,220,200,160,240,160,320,1300
17663,160,80,80,80,160,0,560
17664,190,140,120,80,0,0,530
17665,190,120,80,160,160,0,710
17666,230,40,40,0,0,0,310
17667,200,140,160,80,0,0,580
17668,180,160,40,80,0,0,460
17669,190,60,80,80,0,0,410
17670,220,200,120,160,0,0,700
17671,170,100,40,0,0,0,310
17672,190,140,40,0,0,0,370
17673,230,100,120,80,160,0,690
17674,200,180,200,160,0,0,740
17675,210,120,0,0,0,0,330
17676,180,100,40,80,160,0,560
17677,180,140,120,160,320,0,920
17678,220,120,80,80,0,0,500
17679,170,120,120,0,0,0,410
17680,150,120,160,80,160,0,670
17681,180,80,80,80,160,0,580
17682,170,100,40,0,0,0,310
17683,200,160,160,240,320,0,1080
17684,210,60,40,80,0,0,390
17685,190,100,120,0,0,0,410
17686,150,60,80,80,160,0,530
17687,190,140,120,240,320,320,1330
17688,220,160,160,80,160,0,780
17689,220,100,80,0,0,0,400
17690,240,100,120,0,0,0,460
17691,200,140,120,80,160,0,700
17692,230,180,80,80,160,0,730
17693,140,80,40,80,160,0,500
17694,190,100,120,80,0,0,490
17695,180,140,120,80,160,0,680
17696,190,100,120,160,160,0,730
17697,150,100,120,240,320,320,1250
17698,210,60,40,80,160,0,550
17699,240,120,160,240,320,320,1400
17700,200,140,80,80,0,0,500
17701,200,120,40,80,160,0,600
17702,180,80,80,0,0,0,340
17703,200,60,80,80,160,320,900
17704,190,180,120,80,160,0,730
17705,210,120,80,160,0,0,570
17706,210,140,120,160,160,0,790
17707,200,140,40,0,0,0,380
17708,190,120,80,80,0,0,470
17709,190,140,160,80,160,0,730
17710,150,140,160,160,0,0,610
17711,150,40,80,80,160,0,510
17712,210,180,120,160,160,0,830
17713,190,160,80,160,320,320,1230
17714,150,80,120,0,0,0,350
17715,160,100,80,160,0,0,500
17716,210,100,40,80,160,0,590
17717,180,40,0,0,0,0,220
17718,170,140,80,80,160,320,950
17719,180,160,120,160,0,0,620
17720,200,140,120,0,0,0,460
17721,160,100,120,80,160,0,620
17722,220,180,200,240,320,0,1160
17723,170,100,40,0,0,0,310
17724,190,100,80,160,160,0,690
17725,190,120,80,160,160,0,710
17726,180,140,120,80,160,320,1000
17727,200,120,160,160,160,0,800
17728,190,100,120,160,320,0,890
17729,220,180,200,160,0,0,760
17730,260,100,80,80,160,0,680
17731,180,120,120,160,320,0,900
17732,170,80,40,0,0,0,290
17733,240,80,40,80,160,0,600
17734,170,140,120,80,160,0,670
17735,160,80,80,0,0,0,320
17736,210,140,80,80,160,320,990
17737,200,120,80,160,0,0,560
17738,210,140,80,0,0,0,430
17739,210,120,160,0,0,0,490
17740,180,140,120,0,0,0,440
17741,170,80,80,0,0,0,330
17742,170,120,160,160,160,0,770
17743,180,140,80,80,160,0,640
17744,240,160,80,160,160,0,800
17745,190,100,80,80,160,320,930
17746,170,160,120,160,320,320,1250
17747,210,160,160,80,0,0,610
17748,220,160,120,160,160,320,1140
17749,180,160,120,80,160,320,1020
17750,150,120,120,0,0,0,390
17751,220,140,160,240,160,0,920
17752,140,140,120,80,160,0,640
17753,210,100,120,160,160,0,750
17754,190,80,120,160,160,0,710
17755,200,200,240,160,320,0,1120
17756,170,160,160,240,160,320,1210
17757,200,160,40,80,160,0,640
17758,220,120,120,80,0,0,540
17759,180,100,80,80,0,0,440
17760,210,100,120,80,0,0,510
17761,230,140,40,0,0,0,410
17762,190,160,240,160,0,0,750
17763,200,140,80,160,160,0,740
17764,170,180,120,160,320,320,1270
17765,160,100,80,0,0,0,340
17766,190,100,160,80,0,0,530
17767,140,120,80,80,160,320,900
17768,170,140,80,160,160,320,1030
17769,230,120,120,80,160,0,710
17770,170,100,40,80,160,0,550
17771,190,120,80,0,0,0,390
17772,230,100,120,160,160,0,770
17773,200,80,40,80,160,0,560
17774,180,140,120,160,0,0,600
17775,210,120,80,160,160,320,1050
17776,220,120,80,160,160,0,740
17777,220,160,80,80,160,0,700
17778,170,140,80,80,0,0,470
17779,210,140,120,80,0,0,550
17780,190,120,40,80,160,0,590
17781,190,140,80,80,160,0,650
17782,180,60,40,0,0,0,280
17783,220,120,160,240,160,0,900
17784,230,100,0,0,0,0,330
17785,200,60,80,0,0,0,340
17786,200,120,80,80,0,0,480
17787,170,100,120,240,320,320,1270
17788,220,160,160,240,320,0,1100
17789,180,100,80,160,160,0,680
17790,190,140,120,0,0,0,450
17791,230,80,40,80,160,0,590
17792,190,120,120,160,320,0,910
17793,190,120,120,80,160,0,670
17794,250,160,120,0,0,0,530
17795,170,160,160,240,320,320,1370
17796,190,60,40,80,160,0,530
17797,200,160,160,240,160,0,920
17798,200,120,160,160,160,0,800
17799,180,80,0,0,0,0,260
17800,220,140,160,160,160,320,1160
17801,160,60,40,0,0,0,260
17802,210,80,40,0,0,0,330
17803,210,120,120,160,320,320,1250
17804,170,100,120,160,160,320,1030
17805,180,100,0,0,0,0,280
17806,180,140,120,80,0,0,520
17807,190,160,160,160,320,0,990
17808,190,160,120,0,0,0,470
17809,190,120,80,160,320,0,870
17810,210,100,80,80,0,0,470
17811,200,120,80,80,160,0,640
17812,180,120,160,80,160,0,700
17813,200,100,80,0,0,0,380
17814,240,100,80,80,0,0,500
17815,200,140,160,160,160,320,1140
17816,240,120,120,80,160,0,720
17817,190,160,120,80,0,0,550
17818,240,200,160,160,160,0,920
17819,250,100,40,80,160,0,630
17820,180,160,40,0,0,0,380
17821,210,160,160,160,0,0,690
17822,210,140,120,160,160,0,790
17823,220,140,200,160,160,320,1200
17824,210,140,120,80,160,0,710
17825,220,80,40,80,160,320,900
17826,200,100,120,0,0,0,420
17827,170,180,160,0,0,0,510
17828,180,100,120,80,160,0,640
17829,200,100,120,160,160,0,740
17830,200,120,80,80,160,0,640
17831,210,120,160,240,160,320,1210
17832,200,120,120,160,160,0,760
17833,200,160,120,80,160,0,720
17834,230,120,80,80,0,0,510
17835,210,220,120,80,160,0,790
17836,200,100,40,0,0,0,340
17837,200,100,120,160,0,0,580
17838,160,120,120,80,160,0,640
17839,170,120,160,240,160,0,850
17840,170,120,160,160,320,0,930
17841,150,140,120,80,160,0,650
17842,170,100,0,0,0,0,270
17843,170,120,160,240,320,0,1010
17844,230,160,160,160,0,0,710
17845,180,80,120,160,160,0,700
17846,160,60,80,80,160,320,860
17847,200,100,80,0,0,0,380
17848,190,160,120,160,320,320,1270
17849,210,120,120,80,160,0,690
17850,240,120,120,80,0,0,560
17851,230,140,160,160,160,0,850
17852,220,180,120,80,160,0,760
17853,240,140,80,80,160,0,700
17854,190,140,80,80,0,0,490
17855,180,140,160,80,160,320,1040
17856,240,180,160,80,0,0,660
17857,220,100,40,80,160,0,600
17858,200,100,120,80,0,0,500
17859,190,160,40,0,0,0,390
17860,170,120,120,160,0,0,570
17861,150,140,200,80,0,0,570
17862,160,140,40,0,0,0,340
17863,240,120,160,160,160,320,1160
17864,180,80,120,80,0,0,460
17865,190,140,200,240,160,0,930
17866,210,120,120,80,0,0,530
17867,230,140,40,80,160,0,650
17868,220,120,80,80,0,0,500
17869,200,160,200,160,0,0,720
17870,220,180,160,80,160,320,1120
17871,200,140,120,80,160,320,1020
17872,190,160,120,80,160,0,710
17873,210,120,120,160,160,320,1090
17874,190,200,200,240,160,0,990
17875,220,80,80,0,0,0,380
17876,210,140,160,80,0,0,590
17877,210,80,120,160,0,0,570
17878,250,80,40,80,160,0,610
17879,190,120,80,80,160,0,630
17880,180,80,120,0,0,0,380
17881,200,120,200,80,160,0,760
17882,200,120,120,80,0,0,520
17883,170,140,80,160,160,0,710
17884,200,100,40,80,0,0,420
17885,250,160,200,240,160,0,1010
17886,200,160,80,160,160,0,760
17887,190,100,120,160,0,0,570
17888,200,160,120,160,160,0,800
17889,150,140,80,80,160,0,610
17890,170,100,80,0,0,0,350
17891,180,80,40,80,160,0,540
17892,220,100,80,160,320,320,1200
17893,210,120,120,240,320,320,1330
17894,190,80,40,80,160,0,550
17895,160,120,80,80,160,320,920
17896,170,100,120,160,320,0,870
17897,170,160,240,160,320,0,1050
17898,180,140,80,160,320,0,880
17899,230,100,120,0,0,0,450
17900,220,160,240,160,160,0,940
17901,190,140,120,160,160,0,770
17902,190,160,200,160,160,0,870
17903,160,160,160,240,0,0,720
17904,220,140,160,80,0,0,600
17905,210,180,120,160,0,0,670
17906,200,120,120,240,320,0,1000
17907,170,100,120,80,160,0,630
17908,230,200,160,80,0,0,670
17909,220,100,120,160,320,320,1240
17910,190,100,80,80,160,0,610
17911,200,120,80,80,0,0,480
17912,180,120,120,0,0,0,420
17913,180,60,40,0,0,0,280
17914,210,120,40,0,0,0,370
17915,180,60,40,0,0,0,280
17916,210,120,120,160,0,0,610
17917,200,80,160,80,0,0,520
17918,170,60,0,0,0,0,230
17919,190,140,80,0,0,0,410
17920,230,180,120,160,160,0,850
17921,220,140,120,160,320,0,960
17922,190,60,120,160,160,0,690
17923,200,100,120,80,0,0,500
17924,210,80,120,160,160,0,730
17925,210,140,120,160,160,0,790
17926,210,160,40,0,0,0,410
17927,180,160,160,80,160,320,1060
17928,200,140,120,240,160,0,860
17929,250,120,0,0,0,0,370
17930,200,100,40,80,160,0,580
17931,200,100,80,0,0,0,380
17932,220,160,120,80,0,0,580
17933,210,120,120,80,160,0,690
17934,160,100,200,160,160,0,780
17935,180,120,160,160,160,0,780
17936,230,140,200,240,160,0,970
17937,230,100,120,0,0,0,450
17938,200,100,120,160,160,0,740
17939,200,80,40,0,0,0,320
17940,210,120,80,160,160,0,730
17941,190,120,160,160,160,320,1110
17942,230,140,120,160,160,320,1130
17943,210,120,80,0,0,0,410
17944,260,140,80,80,0,0,560
17945,150,100,160,80,0,0,490
17946,160,140,200,80,160,320,1060
17947,170,100,120,160,0,0,550
17948,210,200,160,80,0,0,650
17949,200,120,120,160,160,320,1080
17950,180,80,80,0,0,0,340
17951,200,180,200,240,320,0,1140
17952,230,180,200,240,0,0,850
17953,190,100,120,80,160,320,970
17954,210,160,120,80,0,0,570
17955,210,160,200,160,160,0,890
17956,150,100,80,0,0,0,330
17957,200,200,120,80,0,0,600
17958,210,120,160,80,160,0,730
17959,180,100,40,0,0,0,320
17960,210,140,120,0,0,0,470
17961,220,120,80,80,160,320,980
17962,160,140,120,160,0,0,580
17963,230,40,40,80,160,0,550
17964,180,160,160,240,160,320,1220
17965,200,200,200,80,160,0,840
17966,180,100,120,160,160,0,720
17967,150,140,80,160,0,0,530
17968,190,100,80,80,0,0,450
17969,230,160,80,80,160,0,710
17970,240,140,120,160,320,320,1300
17971,230,160,120,160,0,0,670
17972,180,120,80,80,0,0,460
17973,180,100,40,0,0,0,320
17974,190,100,80,80,0,0,450
17975,210,120,40,0,0,0,370
17976,190,180,120,80,0,0,570
17977,220,140,40,80,160,0,640
17978,180,180,200,80,0,0,640
17979,210,160,120,80,0,0,570
17980,180,60,0,0,0,0,240
17981,190,100,160,80,160,0,690
17982,160,80,80,80,160,0,560
17983,190,180,120,80,160,320,1050
17984,190,140,200,80,160,0,770
17985,220,80,80,80,160,0,620
17986,190,140,120,80,160,0,690
17987,200,120,200,80,0,0,600
17988,230,80,80,0,0,0,390
17989,180,140,160,240,320,320,1360
17990,200,80,40,0,0,0,320
17991,210,180,40,0,0,0,430
17992,180,140,200,240,160,320,1240
17993,220,160,80,80,160,0,700
17994,230,140,40,80,160,0,650
17995,190,140,160,80,160,0,730
17996,180,140,80,160,160,0,720
17997,160,140,80,80,0,0,460
17998,240,160,160,240,160,320,1280
17999,240,140,120,80,160,0,740
18000,210,200,120,160,0,0,690
18001,190,140,40,80,0,0,450
18002,170,140,240,160,320,0,1030
18003,200,120,120,160,160,320,1080
18004,160,180,160,80,0,0,580
18005,210,140,120,240,160,0,870
18006,170,140,80,0,0,0,390
18007,180,120,80,160,0,0,540
18008,190,140,120,80,0,0,530
18009,200,160,80,80,0,0,520
18010,210,80,40,0,0,0,330
18011,150,80,120,240,320,0,910
18012,190,200,160,160,160,0,870
18013,230,100,80,80,0,0,490
18014,210,120,40,0,0,0,370
18015,200,100,80,160,320,0,860
18016,220,160,160,160,160,0,860
18017,230,160,120,80,0,0,590
18018,200,120,120,80,0,0,520
18019,180,100,120,160,320,0,880
18020,210,160,120,0,0,0,490
18021,190,140,120,80,160,320,1010
18022,240,120,80,160,160,0,760
18023,190,120,120,160,160,0,750
18024,220,140,120,160,160,0,800
18025,200,120,80,0,0,0,400
18026,220,60,80,160,0,0,520
18027,190,120,0,0,0,0,310
18028,210,80,120,80,160,0,650
18029,180,60,40,80,0,0,360
18030,220,180,120,160,0,0,680
18031,190,100,80,160,160,0,690
18032,200,120,120,240,320,320,1320
18033,260,120,80,80,160,0,700
18034,190,120,80,0,0,0,390
18035,240,140,160,160,0,0,700
18036,200,80,160,160,320,0,920
18037,200,100,0,0,0,0,300
18038,180,140,160,240,160,320,1200
18039,140,160,120,80,160,320,980
18040,190,140,120,80,0,0,530
18041,180,120,40,80,160,0,580
18042,170,100,120,80,0,0,470
18043,200,100,200,240,0,0,740
18044,190,120,120,80,160,0,670
18045,200,140,120,0,0,0,460
18046,200,120,120,80,160,0,680
18047,240,160,160,80,0,0,640
18048,170,100,120,80,160,0,630
18049,190,160,80,160,0,0,590
18050,210,120,40,0,0,0,370
18051,210,140,80,80,0,0,510
18052,190,140,120,80,160,0,690
18053,210,180,160,240,160,0,950
18054,170,120,120,160,320,0,890
18055,240,140,120,160,0,0,660
18056,160,40,40,80,160,0,480
18057,190,140,80,0,0,0,410
18058,150,100,120,80,160,0,610
18059,210,160,120,160,320,320,1290
18060,170,60,120,160,160,0,670
18061,170,80,40,80,160,0,530
18062,230,140,80,80,160,0,690
18063,190,100,80,80,0,0,450
18064,190,100,40,80,0,0,410
18065,210,140,200,160,160,0,870
18066,180,120,80,80,0,0,460
18067,220,140,40,80,0,0,480
18068,220,100,80,80,0,0,480
18069,200,140,80,80,0,0,500
18070,150,40,40,80,0,0,310
18071,230,80,160,160,160,0,790
18072,170,80,80,0,0,0,330
18073,210,100,80,80,0,0,470
18074,150,120,120,160,0,0,550
18075,210,160,160,80,160,0,770
18076,170,140,80,80,0,0,470
18077,200,120,40,0,0,0,360
18078,190,80,80,0,0,0,350
18079,200,160,160,160,160,0,840
18080,210,80,80,0,0,0,370
18081,230,100,120,160,320,0,930
18082,190,140,80,80,160,0,650
18083,210,100,80,0,0,0,390
18084,200,120,80,80,0,0,480
18085,190,40,40,0,0,0,270
18086,190,60,40,0,0,0,290
18087,200,160,160,160,320,320,1320
18088,180,120,120,80,0,0,500
18089,180,60,0,0,0,0,240
18090,190,140,120,80,160,320,1010
18091,210,80,40,80,160,0,570
18092,220,180,120,80,160,0,760
18093,180,80,80,80,160,0,580
18094,190,100,120,80,160,0,650
18095,190,120,40,80,160,0,590
18096,190,160,120,160,320,0,950
18097,220,140,40,0,0,0,400
18098,210,120,40,80,0,0,450
18099,180,80,80,160,0,0,500
18100,220,140,120,80,160,0,720
18101,210,120,40,80,0,0,450
18102,190,160,160,80,160,320,1070
18103,160,120,120,160,320,320,1200
18104,190,140,160,160,160,0,810
18105,180,100,160,160,0,0,600
18106,200,140,80,80,160,0,660
18107,160,180,80,80,160,0,660
18108,240,140,80,160,160,0,780
18109,190,80,80,0,0,0,350
18110,200,80,80,0,0,0,360
18111,150,120,160,240,160,0,830
18112,200,120,120,160,160,320,1080
18113,220,80,120,160,320,0,900
18114,180,160,80,80,160,0,660
18115,200,80,120,80,160,0,640
18116,240,180,120,80,160,320,1100
18117,230,160,120,80,160,0,750
18118,230,140,160,160,0,0,690
18119,190,80,80,80,0,0,430
18120,200,100,120,160,160,0,740
18121,190,100,120,160,160,0,730
18122,170,100,80,80,160,0,590
18123,160,80,160,160,160,0,720
18124,190,100,80,80,160,320,930
18125,190,140,160,80,0,0,570
18126,220,120,120,240,160,0,860
18127,200,120,120,80,160,0,680
18128,170,100,160,160,160,0,750
18129,170,180,120,160,160,0,790
18130,190,140,120,160,160,0,770
18131,220,120,80,80,0,0,500
18132,210,100,80,80,160,0,630
18133,220,140,160,160,160,0,840
18134,180,100,120,160,320,320,1200
18135,200,180,160,80,160,0,780
18136,210,160,200,320,160,0,1050
18137,180,120,80,0,0,0,380
18138,200,60,80,80,160,0,580
18139,190,140,80,80,0,0,490
18140,170,100,80,80,160,320,910
18141,230,160,120,80,160,0,750
18142,210,180,160,80,0,0,630
18143,200,120,160,80,0,0,560
18144,190,140,80,160,160,0,730
18145,230,160,160,160,320,0,1030
18146,170,180,120,160,320,0,950
18147,190,180,80,80,160,0,690
18148,210,100,120,80,160,320,990
18149,160,80,120,240,160,0,760
18150,210,120,200,0,0,0,530
18151,180,140,160,160,320,0,960
18152,270,120,120,0,0,0,510
18153,230,140,120,80,160,0,730
18154,220,140,120,240,160,0,880
18155,160,80,120,80,160,0,600
18156,170,100,80,0,0,0,350
18157,170,180,160,80,160,0,750
18158,220,140,80,80,160,320,1000
18159,190,120,160,80,160,0,710
18160,200,180,160,160,160,0,860
18161,200,140,40,0,0,0,380
18162,200,100,120,80,0,0,500
18163,210,160,160,240,160,320,1250
18164,180,140,160,0,0,0,480
18165,190,80,40,80,160,0,550
18166,210,80,80,0,0,0,370
18167,210,160,80,80,0,0,530
18168,180,140,160,240,320,320,1360
18169,190,80,80,80,0,0,430
18170,200,80,120,240,160,0,800
18171,210,140,80,80,0,0,510
18172,150,100,120,240,320,320,1250
18173,200,160,160,160,160,0,840
18174,170,160,200,0,0,0,530
18175,220,100,80,80,160,0,640
18176,180,100,80,160,160,0,680
18177,210,140,120,240,160,0,870
18178,220,100,40,0,0,0,360
18179,180,80,80,160,160,0,660
18180,180,200,80,80,0,0,540
18181,240,80,40,80,160,0,600
18182,190,80,40,80,160,0,550
18183,160,60,80,0,0,0,300
18184,200,60,80,80,160,0,580
18185,210,120,160,240,160,0,890
18186,190,60,120,80,160,0,610
18187,190,120,40,80,0,0,430
18188,190,100,120,160,0,0,570
18189,180,100,80,0,0,0,360
18190,210,120,80,80,0,0,490
18191,190,120,120,160,320,0,910
18192,220,140,120,80,160,320,1040
18193,200,120,120,0,0,0,440
18194,200,140,120,80,160,0,700
18195,190,120,120,80,0,0,510
18196,200,200,200,160,320,320,1400
18197,180,140,80,160,160,0,720
18198,170,140,120,0,0,0,430
18199,200,120,120,240,320,0,1000
18200,210,140,160,80,160,0,750
18201,200,140,120,160,0,0,620
18202,170,140,160,160,160,0,790
18203,190,120,80,80,160,0,630
18204,230,160,160,80,160,0,790
18205,190,140,40,0,0,0,370
18206,190,160,200,160,160,0,870
18207,180,200,200,160,160,0,900
18208,190,120,80,0,0,0,390
18209,190,140,80,80,0,0,490
18210,180,100,120,160,0,0,560
18211,200,100,80,80,160,0,620
18212,180,140,120,80,0,0,520
18213,210,80,40,0,0,0,330
18214,210,120,80,80,160,0,650
18215,230,160,160,80,160,0,790
18216,210,140,80,80,160,0,670
18217,220,160,40,0,0,0,420
18218,200,100,40,0,0,0,340
18219,180,100,80,80,0,0,440
18220,220,80,120,80,0,0,500
18221,170,120,120,160,0,0,570
18222,210,80,80,80,160,0,610
18223,200,120,0,0,0,0,320
18224,180,100,120,160,320,0,880
18225,210,180,120,160,160,320,1150
18226,210,200,120,160,320,320,1330
18227,190,120,160,80,160,0,710
18228,240,120,120,80,160,0,720
18229,190,80,80,80,160,0,590
18230,210,120,80,80,160,0,650
18231,210,80,80,160,160,0,690
18232,210,60,80,160,160,0,670
18233,210,140,200,240,320,0,1110
18234,150,100,160,80,160,0,650
18235,200,60,40,0,0,0,300
18236,230,80,80,160,0,0,550
18237,230,80,80,80,160,0,630
18238,250,140,80,160,160,0,790
18239,220,160,120,0,0,0,500
18240,220,180,120,80,160,0,760
18241,210,160,120,160,0,0,650
18242,180,100,40,0,0,0,320
18243,230,140,120,80,160,0,730
18244,190,140,80,160,160,0,730
18245,180,120,120,160,160,0,740
18246,190,100,40,0,0,0,330
18247,190,80,120,0,0,0,390
18248,220,120,160,160,0,0,660
18249,230,100,120,80,160,0,690
18250,220,160,160,80,160,0,780
18251,230,140,160,80,160,320,1090
18252,170,120,120,160,160,0,730
18253,190,180,160,240,320,0,1090
18254,210,100,40,0,0,0,350
18255,210,160,40,0,0,0,410
18256,200,80,80,80,0,0,440
18257,170,120,160,80,160,320,1010
18258,200,180,120,160,160,0,820
18259,220,120,160,160,160,0,820
18260,200,100,80,0,0,0,380
18261,230,140,80,80,160,0,690
18262,180,160,120,160,320,320,1260
18263,180,120,120,80,0,0,500
18264,220,120,120,160,160,0,780
18265,190,160,120,80,0,0,550
18266,160,60,80,0,0,0,300
18267,160,140,120,160,320,0,900
18268,210,80,120,80,0,0,490
18269,210,120,40,80,0,0,450
18270,190,180,160,160,160,0,850
18271,220,160,200,160,160,0,900
18272,200,200,160,80,160,320,1120
18273,180,160,120,80,160,0,700
18274,240,140,80,160,160,0,780
18275,180,120,120,160,0,0,580
18276,220,160,120,0,0,0,500
18277,220,100,80,160,160,0,720
18278,200,100,80,80,0,0,460
18279,180,120,80,80,0,0,460
18280,230,120,120,0,0,0,470
18281,180,160,120,160,160,0,780
18282,230,140,80,160,160,320,1090
18283,160,100,80,80,160,0,580
18284,170,80,120,0,0,0,370
18285,200,140,160,240,320,320,1380
18286,200,120,120,0,0,0,440
18287,210,140,160,160,160,0,830
18288,230,120,120,80,160,0,710
18289,180,100,120,80,0,0,480
18290,220,60,40,80,160,0,560
18291,160,160,160,160,160,0,800
18292,220,160,80,80,160,0,700
18293,180,160,120,160,160,0,780
18294,170,100,40,0,0,0,310
18295,210,160,160,160,160,0,850
18296,180,140,120,80,160,0,680
18297,220,120,80,160,160,0,740
18298,180,100,80,80,160,0,600
18299,210,100,80,80,160,0,630
18300,190,120,80,80,160,0,630
18301,220,120,80,0,0,0,420
18302,190,80,120,160,160,0,710
18303,210,120,120,160,160,0,770
18304,170,100,120,160,160,0,710
18305,180,80,80,80,0,0,420
18306,190,160,120,160,0,0,630
18307,210,120,120,160,320,0,930
18308,190,180,80,160,0,0,610
18309,210,120,0,0,0,0,330
18310,180,60,0,0,0,0,240
18311,190,100,0,0,0,0,290
18312,170,100,80,160,0,0,510
18313,190,80,40,80,160,320,870
18314,180,80,120,240,160,0,780
18315,170,100,80,160,160,0,670
18316,150,80,80,80,160,0,550
18317,210,80,120,160,0,0,570
18318,200,80,120,160,160,320,1040
18319,160,140,160,80,0,0,540
18320,230,160,80,80,0,0,550
18321,190,120,80,0,0,0,390
18322,220,100,120,160,0,0,600
18323,200,140,120,80,160,0,700
18324,230,140,120,160,0,0,650
18325,170,40,0,0,0,0,210
18326,240,60,120,80,0,0,500
18327,220,160,120,80,0,0,580
18328,180,160,160,160,160,0,820
18329,220,80,40,0,0,0,340
18330,190,160,160,80,160,0,750
18331,210,120,120,80,160,0,690
18332,190,80,40,80,160,0,550
18333,220,180,120,80,0,0,600
18334,230,160,160,240,320,0,1110
18335,210,180,80,0,0,0,470
18336,190,120,160,80,0,0,550
18337,190,140,80,80,0,0,490
18338,210,180,200,240,320,0,1150
18339,150,120,80,0,0,0,350
18340,210,80,40,0,0,0,330
18341,210,160,120,80,160,0,730
18342,200,140,80,80,160,0,660
18343,180,80,80,80,160,0,580
18344,200,100,80,80,160,0,620
18345,180,100,80,80,160,0,600
18346,210,200,40,0,0,0,450
18347,220,60,80,80,160,0,600
18348,200,100,80,0,0,0,380
18349,200,40,80,80,160,0,560
18350,220,140,160,240,320,0,1080
18351,170,100,80,80,0,0,430
18352,190,140,120,160,320,0,930
18353,160,140,160,160,160,0,780
18354,180,160,160,160,320,320,1300
18355,240,100,80,80,160,0,660
18356,190,100,80,160,320,0,850
18357,180,100,120,160,320,0,880
18358,150,80,80,160,160,0,630
18359,230,120,120,0,0,0,470
18360,190,100,40,80,160,0,570
18361,210,140,120,160,160,320,1110
18362,220,160,40,80,160,0,660
18363,170,100,120,80,0,0,470
18364,240,120,80,80,160,320,1000
18365,220,80,40,0,0,0,340
18366,190,100,160,160,0,0,610
18367,230,140,80,160,160,0,770
18368,190,140,200,160,160,0,850
18369,160,100,120,160,320,0,860
18370,170,100,120,240,320,0,950
18371,230,160,160,160,160,0,870
18372,220,100,80,80,0,0,480
18373,240,80,80,80,160,320,960
18374,220,180,160,320,320,0,1200
18375,160,140,200,160,160,0,820
18376,170,160,120,80,160,0,690
18377,190,80,40,80,0,0,390
18378,220,100,80,0,0,0,400
18379,180,100,80,0,0,0,360
18380,160,100,80,80,160,0,580
18381,190,140,80,0,0,0,410
18382,230,80,80,160,160,0,710
18383,170,120,120,80,160,0,650
18384,220,120,80,0,0,0,420
18385,220,120,160,160,320,320,1300
18386,160,120,120,160,160,0,720
18387,210,80,40,80,0,0,410
18388,220,120,120,160,0,0,620
18389,200,100,120,80,160,0,660
18390,210,140,80,160,160,320,1070
18391,210,160,120,160,160,320,1130
18392,210,160,120,160,160,320,1130
18393,150,120,160,80,0,0,510
18394,240,180,120,80,160,0,780
18395,190,160,160,0,0,0,510
18396,180,60,0,0,0,0,240
18397,180,140,120,80,0,0,520
18398,220,140,120,80,0,0,560
18399,240,80,120,160,320,320,1240
18400,200,140,0,0,0,0,340
18401,190,80,40,80,160,0,550
18402,200,120,160,80,160,0,720
18403,180,100,80,80,160,0,600
18404,190,120,120,240,0,0,670
18405,200,100,80,160,160,0,700
18406,190,100,120,160,0,0,570
18407,160,120,160,160,160,0,760
18408,240,120,120,160,160,320,1120
18409,190,140,80,0,0,0,410
18410,190,180,200,240,160,0,970
18411,220,180,160,80,0,0,640
18412,220,140,80,160,160,0,760
18413,220,140,80,0,0,0,440
18414,190,120,160,240,160,0,870
18415,210,120,0,0,0,0,330
18416,200,180,160,160,0,0,700
18417,180,100,40,80,0,0,400
18418,220,140,120,160,160,0,800
18419,210,120,120,160,160,0,770
18420,230,100,120,0,0,0,450
18421,150,180,120,0,0,0,450
18422,230,160,120,160,320,0,990
18423,190,160,160,80,160,0,750
18424,220,140,80,80,0,0,520
18425,210,120,160,240,320,0,1050
18426,190,140,160,80,0,0,570
18427,160,160,120,240,160,0,840
18428,210,160,200,160,0,0,730
18429,220,120,120,160,160,0,780
18430,200,140,80,160,160,0,740
18431,240,180,240,80,160,0,900
18432,220,120,120,160,160,0,780
18433,190,100,80,80,160,320,930
18434,240,180,160,160,320,320,1380
18435,220,140,120,80,0,0,560
18436,160,80,120,160,0,0,520
18437,200,120,40,80,160,0,600
18438,210,120,160,240,160,0,890
18439,180,140,80,80,0,0,480
18440,210,140,40,0,0,0,390
18441,150,100,120,160,320,320,1170
18442,210,120,160,160,160,320,1130
18443,190,80,40,80,160,0,550
18444,180,100,40,80,0,0,400
18445,190,140,160,160,320,0,970
18446,220,160,120,80,0,0,580
18447,160,120,120,240,320,0,960
18448,170,100,40,80,0,0,390
18449,220,80,80,80,0,0,460
18450,190,140,160,160,160,0,810
18451,240,120,160,160,160,0,840
18452,220,100,80,160,160,0,720
18453,180,100,40,80,160,0,560
18454,170,120,120,80,160,0,650
18455,200,140,160,80,160,0,740
18456,180,120,120,160,160,0,740
18457,190,100,120,160,160,0,730
18458,230,140,80,80,160,320,1010
18459,210,140,120,240,160,0,870
18460,220,100,120,160,160,0,760
18461,200,200,200,160,320,320,1400
18462,190,80,80,80,160,320,910
18463,190,80,40,80,160,0,550
18464,190,120,80,160,160,0,710
18465,220,120,40,80,0,0,460
18466,210,140,160,80,160,0,750
18467,240,120,120,80,160,0,720
18468,240,100,40,80,160,0,620
18469,230,80,40,80,160,0,590
18470,220,100,120,80,160,0,680
18471,200,100,0,0,0,0,300
18472,160,140,120,240,160,320,1140
18473,190,100,160,0,0,0,450
18474,190,160,160,80,160,0,750
18475,170,120,120,160,160,0,730
18476,230,160,120,160,160,0,830
18477,220,80,40,80,0,0,420
18478,200,120,160,240,160,0,880
18479,170,160,80,0,0,0,410
18480,160,100,120,80,0,0,460
18481,180,120,40,0,0,0,340
18482,170,60,40,80,0,0,350
18483,190,140,120,160,0,0,610
18484,170,120,120,0,0,0,410
18485,200,120,160,240,160,0,880
18486,220,120,120,160,160,0,780
18487,150,140,80,160,160,320,1010
18488,200,120,80,80,0,0,480
18489,230,200,80,80,160,0,750
18490,230,160,120,160,160,0,830
18491,170,100,80,0,0,0,350
18492,210,100,80,160,160,0,710
18493,200,80,160,160,160,0,760
18494,200,100,160,240,160,0,860
18495,200,100,80,0,0,0,380
18496,190,140,240,240,160,320,1290
18497,180,100,120,240,160,0,800
18498,230,160,120,80,0,0,590
18499,200,120,80,160,0,0,560
18500,180,140,200,160,160,320,1160
18501,220,160,120,160,160,0,820
18502,180,100,120,80,160,0,640
18503,190,100,80,0,0,0,370
18504,140,100,160,160,320,0,880
18505,230,140,160,160,160,0,850
18506,210,140,160,160,160,0,830
18507,210,200,120,80,160,0,770
18508,170,80,120,160,320,0,850
18509,190,140,120,160,160,0,770
18510,160,100,160,80,160,0,660
18511,170,120,80,160,160,0,690
18512,220,140,120,80,0,0,560
18513,200,100,80,160,320,320,1180
18514,190,160,120,160,160,0,790
18515,200,140,80,0,0,0,420
18516,230,140,120,160,320,0,970
18517,200,120,120,80,0,0,520
18518,230,120,120,80,0,0,550
18519,170,80,120,80,160,320,930
18520,210,120,120,160,160,0,770
18521,210,80,40,80,0,0,410
18522,200,100,120,80,160,320,980
18523,170,60,40,0,0,0,270
18524,150,120,200,240,160,0,870
18525,200,80,80,80,0,0,440
18526,170,100,120,80,160,0,630
18527,220,120,80,160,160,0,740
18528,210,120,160,160,160,0,810
18529,170,120,120,80,0,0,490
18530,190,80,40,80,0,0,390
18531,230,80,80,80,0,0,470
18532,160,80,80,80,160,0,560
18533,190,80,0,0,0,0,270
18534,230,100,120,80,0,0,530
18535,180,60,120,160,160,0,680
18536,230,80,40,80,0,0,430
18537,220,120,120,80,160,0,700
18538,200,160,120,80,0,0,560
18539,200,180,120,0,0,0,500
18540,200,100,120,0,0,0,420
18541,180,120,40,80,160,320,900
18542,180,80,40,80,0,0,380
18543,220,160,120,80,0,0,580
18544,180,120,80,160,160,0,700
18545,210,120,160,240,320,0,1050
18546,210,160,120,240,160,0,890
18547,230,120,120,160,160,0,790
18548,170,140,120,80,160,0,670
18549,200,100,40,80,160,0,580
18550,200,120,120,160,320,0,920
18551,190,160,80,160,320,0,910
18552,190,160,160,80,160,320,1070
18553,210,160,200,160,160,0,890
18554,240,180,80,80,160,0,740
18555,130,80,120,0,0,0,330
18556,210,140,120,160,160,0,790
18557,180,100,120,160,160,0,720
18558,180,180,80,80,160,0,680
18559,190,140,120,80,0,0,530
18560,150,100,120,160,160,0,690
18561,190,80,80,80,0,0,430
18562,190,120,160,240,320,0,1030
18563,190,60,80,160,0,0,490
18564,180,120,120,240,320,0,980
18565,200,200,80,0,0,0,480
18566,180,140,80,160,320,320,1200
18567,240,160,160,240,320,0,1120
18568,200,120,160,160,160,0,800
18569,170,120,80,160,160,0,690
18570,200,120,160,80,160,0,720
18571,200,140,120,160,160,0,780
18572,160,40,40,80,0,0,320
18573,210,100,80,80,160,0,630
18574,200,120,80,80,0,0,480
18575,210,160,80,160,320,320,1250
18576,180,100,120,160,320,0,880
18577,210,100,120,80,160,0,670
18578,160,120,120,160,160,320,1040
18579,230,140,200,160,320,0,1050
18580,180,120,120,160,160,320,1060
18581,200,180,80,0,0,0,460
18582,210,120,80,80,160,0,650
18583,170,100,40,80,160,320,870
18584,190,140,160,160,160,0,810
18585,180,100,80,0,0,0,360
18586,200,120,80,160,320,320,1200
18587,170,120,120,160,160,0,730
18588,220,180,200,80,160,0,840
18589,160,100,80,80,0,0,420
18590,220,140,120,80,160,0,720
18591,230,120,40,0,0,0,390
18592,190,140,120,80,160,0,690
18593,220,80,80,0,0,0,380
18594,220,140,120,80,0,0,560
18595,210,120,40,0,0,0,370
18596,230,180,160,160,160,0,890
18597,160,140,80,80,160,0,620
18598,160,100,120,80,160,0,620
18599,180,100,80,80,160,0,600
18600,190,80,80,80,160,320,910
18601,240,180,160,240,160,0,980
18602,230,140,160,160,0,0,690
18603,180,140,120,160,0,0,600
18604,200,120,80,80,160,0,640
18605,180,120,40,80,160,0,580
18606,160,60,40,80,0,0,340
18607,160,80,80,80,160,0,560
18608,230,120,160,160,160,320,1150
18609,200,120,120,80,160,320,1000
18610,210,120,120,0,0,0,450
18611,210,160,160,80,0,0,610
18612,200,140,80,80,160,320,980
18613,180,160,80,0,0,0,420
18614,170,40,40,0,0,0,250
18615,230,180,200,80,160,0,850
18616,200,140,200,240,160,0,940
18617,200,100,120,160,160,0,740
18618,200,100,80,160,320,0,860
18619,210,180,160,80,160,0,790
18620,170,80,120,80,160,0,610
18621,160,40,40,80,160,0,480
18622,240,140,120,80,0,0,580
18623,200,140,80,80,160,320,980
18624,210,120,80,80,160,320,970
18625,160,160,160,160,160,320,1120
18626,180,140,80,160,0,0,560
18627,190,160,120,80,160,320,1030
18628,180,140,120,160,160,0,760
18629,200,140,80,160,160,0,740
18630,220,100,80,160,160,0,720
18631,200,140,120,160,160,320,1100
18632,190,160,120,160,160,0,790
18633,170,60,80,160,160,320,950
18634,190,140,120,160,160,0,770
18635,200,120,120,160,160,0,760
18636,240,180,0,0,0,0,420
18637,200,160,120,160,0,0,640
18638,160,80,0,0,0,0,240
18639,200,120,120,80,160,0,680
18640,190,80,80,80,160,0,590
18641,220,160,120,80,160,0,740
18642,190,140,80,80,160,0,650
18643,160,60,80,80,0,0,380
18644,200,120,80,0,0,0,400
18645,220,180,80,80,0,0,560
18646,170,140,160,160,160,320,1110
18647,170,100,120,80,160,0,630
18648,200,120,80,0,0,0,400
18649,190,140,160,160,160,0,810
18650,180,120,80,160,160,320,1020
18651,170,60,80,80,0,0,390
18652,190,140,120,80,0,0,530
18653,190,100,80,80,0,0,450
18654,140,120,160,80,160,320,980
18655,240,140,80,80,160,0,700
18656,190,100,120,80,160,0,650
18657,170,140,80,80,160,320,950
18658,200,60,40,80,160,320,860
18659,180,80,80,80,0,0,420
18660,240,140,40,0,0,0,420
18661,180,140,120,0,0,0,440
18662,180,120,80,80,160,0,620
18663,240,100,80,80,0,0,500
18664,230,160,240,240,320,0,1190
18665,180,120,80,80,160,320,940
18666,180,160,80,80,0,0,500
18667,210,160,120,80,160,320,1050
18668,230,140,160,160,160,0,850
18669,210,120,160,160,320,320,1290
18670,240,160,160,80,160,0,800
18671,180,140,120,160,320,320,1240
18672,160,120,120,160,160,0,720
18673,190,120,120,160,0,0,590
18674,200,120,200,80,0,0,600
18675,180,100,160,240,160,0,840
18676,220,160,160,160,0,0,700
18677,220,100,80,80,0,0,480
18678,210,140,40,0,0,0,390
18679,170,120,120,80,0,0,490
18680,190,140,160,160,320,320,1290
18681,200,160,160,80,160,0,760
18682,160,100,120,80,160,0,620
18683,210,80,80,80,0,0,450
18684,230,140,160,160,160,0,850
18685,180,80,80,80,160,0,580
18686,190,120,120,160,320,0,910
18687,180,120,0,0,0,0,300
18688,200,120,80,80,160,0,640
18689,210,160,120,80,0,0,570
18690,200,120,80,80,160,320,960
18691,170,100,40,0,0,0,310
18692,180,100,80,0,0,0,360
18693,230,160,120,240,160,0,910
18694,220,100,40,80,160,0,600
18695,180,120,80,160,160,0,700
18696,210,120,40,80,160,0,610
18697,160,140,120,160,160,0,740
18698,200,140,120,80,0,0,540
18699,180,120,80,0,0,0,380
18700,230,160,120,0,0,0,510
18701,160,100,80,0,0,0,340
18702,180,140,40,80,0,0,440
18703,200,160,200,160,160,0,880
18704,190,100,40,80,0,0,410
18705,230,180,40,80,160,0,690
18706,230,120,120,240,320,320,1350
18707,130,60,80,80,160,0,510
18708,210,120,80,80,160,0,650
18709,220,140,40,0,0,0,400
18710,210,100,120,80,160,0,670
18711,220,100,120,160,160,0,760
18712,200,140,80,80,160,320,980
18713,230,120,160,160,160,320,1150
18714,190,120,160,80,160,0,710
18715,190,140,160,160,320,320,1290
18716,220,100,120,160,160,0,760
18717,170,100,120,80,160,0,630
18718,170,100,40,80,160,320,870
18719,240,120,120,160,160,0,800
18720,180,120,80,160,320,320,1180
18721,200,80,120,240,320,320,1280
18722,210,120,120,80,0,0,530
18723,220,200,160,160,160,320,1220
18724,210,140,160,160,0,0,670
18725,210,160,160,160,0,0,690
18726,190,120,160,0,0,0,470
18727,230,180,160,160,320,320,1370
18728,200,200,160,160,320,320,1360
18729,190,120,80,80,160,320,950
18730,190,140,120,80,0,0,530
18731,210,160,80,0,0,0,450
18732,240,120,120,240,160,0,880
18733,190,120,80,80,160,0,630
18734,190,120,80,160,160,0,710
18735,180,80,80,80,160,320,900
18736,200,140,160,80,160,320,1060
18737,200,140,120,160,160,320,1100
18738,210,200,200,160,320,0,1090
18739,210,180,160,160,0,0,710
18740,170,120,80,80,160,0,610
18741,210,140,120,160,160,320,1110
18742,170,140,40,0,0,0,350
18743,200,140,160,80,0,0,580
18744,190,140,160,240,320,0,1050
18745,190,100,40,0,0,0,330
18746,210,180,80,80,160,0,710
18747,220,120,0,0,0,0,340
18748,150,80,40,0,0,0,270
18749,160,140,80,80,160,0,620
18750,200,120,120,0,0,0,440
18751,200,100,80,160,160,0,700
18752,210,160,120,160,160,320,1130
18753,230,100,80,80,0,0,490
18754,160,100,120,80,160,0,620
18755,220,140,120,160,160,0,800
18756,170,100,80,80,160,0,590
18757,170,100,120,240,320,320,1270
18758,170,80,0,0,0,0,250
18759,200,160,160,160,160,0,840
18760,270,180,160,160,160,320,1250
18761,210,60,40,80,0,0,390
18762,150,120,120,160,0,0,550
18763,170,120,80,80,160,0,610
18764,200,140,200,240,160,0,940
18765,220,100,80,0,0,0,400
18766,170,120,80,0,0,0,370
18767,200,120,80,80,160,0,640
18768,200,180,80,160,160,0,780
18769,160,60,40,80,160,0,500
18770,170,160,80,80,160,0,650
18771,200,100,120,160,0,0,580
18772,220,140,40,0,0,0,400
18773,170,140,120,80,160,0,670
18774,160,100,80,80,0,0,420
18775,230,140,120,160,160,0,810
18776,210,100,120,160,160,0,750
18777,200,120,40,0,0,0,360
18778,200,100,120,0,0,0,420
18779,190,120,200,160,160,320,1150
18780,200,80,40,80,0,0,400
18781,170,100,80,0,0,0,350
18782,190,160,120,0,0,0,470
18783,240,140,120,160,160,320,1140
18784,230,160,120,0,0,0,510
18785,230,160,200,160,160,320,1230
18786,180,100,80,0,0,0,360
18787,220,120,120,0,0,0,460
18788,200,140,40,0,0,0,380
18789,210,140,120,160,160,0,790
18790,160,60,40,80,0,0,340
18791,190,140,120,160,160,320,1090
18792,230,160,40,0,0,0,430
18793,200,120,80,0,0,0,400
18794,160,60,80,80,160,320,860
18795,190,80,80,160,320,0,830
18796,180,80,80,160,320,320,1140
18797,220,120,160,160,160,0,820
18798,190,120,120,80,160,0,670
18799,220,80,40,80,160,0,580
18800,180,120,80,160,320,0,860
18801,190,100,80,80,160,0,610
18802,130,40,80,80,160,0,490
18803,190,100,40,0,0,0,330
18804,230,120,80,80,160,0,670
18805,220,100,120,160,320,320,1240
18806,160,60,40,80,160,0,500
18807,190,100,120,80,160,0,650
18808,170,140,80,0,0,0,390
18809,220,60,80,80,160,0,600
18810,220,160,200,80,0,0,660
18811,230,80,40,80,160,0,590
18812,190,140,120,80,160,320,1010
18813,210,140,80,80,0,0,510
18814,200,120,0,0,0,0,320
18815,240,140,160,240,160,0,940
18816,200,140,120,80,0,0,540
18817,200,180,160,80,0,0,620
18818,220,180,120,80,0,0,600
18819,200,200,120,0,0,0,520
18820,180,120,80,80,0,0,460
18821,190,120,200,160,160,0,830
18822,190,60,120,160,0,0,530
18823,180,100,120,80,160,0,640
18824,220,180,160,160,160,0,880
18825,210,100,80,80,0,0,470
18826,140,120,160,160,160,320,1060
18827,140,120,160,160,160,0,740
18828,200,100,80,80,0,0,460
18829,180,140,120,80,160,320,1000
18830,200,60,80,0,0,0,340
18831,180,160,160,160,160,0,820
18832,170,160,160,160,320,320,1290
18833,260,160,160,0,0,0,580
18834,200,140,200,160,0,0,700
18835,150,140,160,160,320,320,1250
18836,180,100,80,80,160,0,600
18837,200,180,80,80,160,0,700
18838,190,140,80,160,160,0,730
18839,190,160,160,80,160,0,750
18840,220,200,80,160,320,0,980
18841,180,160,160,160,160,0,820
18842,200,160,200,160,160,0,880
18843,140,60,120,80,0,0,400
18844,160,120,40,0,0,0,320
18845,170,120,80,80,160,0,610
18846,200,160,160,80,0,0,600
18847,180,140,160,160,0,0,640
18848,200,80,40,80,0,0,400
18849,180,120,40,80,160,0,580
18850,180,80,120,80,0,0,460
18851,180,140,80,0,0,0,400
18852,180,100,120,160,0,0,560
18853,190,120,120,160,160,0,750
18854,220,140,120,80,0,0,560
18855,180,120,120,80,160,0,660
18856,180,100,40,80,160,0,560
18857,220,120,120,80,160,0,700
18858,230,160,160,160,160,0,870
18859,200,120,120,80,0,0,520
18860,220,100,80,80,0,0,480
18861,180,40,40,80,160,0,500
18862,220,180,120,240,160,320,1240
18863,170,100,80,80,0,0,430
18864,180,120,80,80,0,0,460
18865,210,140,120,0,0,0,470
18866,210,140,120,0,0,0,470
18867,190,100,80,80,160,0,610
18868,170,140,40,0,0,0,350
18869,210,60,0,0,0,0,270
18870,210,100,40,80,160,0,590
18871,180,160,120,240,160,0,860
18872,200,140,80,80,160,0,660
18873,180,160,120,80,160,0,700
18874,170,100,120,240,320,320,1270
18875,160,120,40,80,160,320,880
18876,200,120,80,80,0,0,480
18877,170,100,80,160,320,0,830
18878,220,100,80,80,160,0,640
18879,240,140,120,160,320,0,980
18880,190,100,120,160,320,320,1210
18881,190,120,80,0,0,0,390
18882,200,60,0,0,0,0,260
18883,210,140,200,160,160,0,870
18884,190,100,40,80,0,0,410
18885,190,100,80,80,160,0,610
18886,180,120,120,80,0,0,500
18887,170,80,120,160,160,0,690
18888,190,140,80,0,0,0,410
18889,160,120,120,0,0,0,400
18890,210,100,80,0,0,0,390
18891,230,140,200,80,160,0,810
18892,200,60,80,80,0,0,420
18893,160,140,200,160,320,0,980
18894,200,120,200,240,160,0,920
18895,220,140,120,0,0,0,480
18896,210,220,120,160,160,0,870
18897,170,180,120,0,0,0,470
18898,140,120,160,80,0,0,500
18899,170,120,80,80,0,0,450
18900,190,160,160,160,160,0,830
18901,170,120,120,80,0,0,490
18902,190,140,120,160,320,0,930
18903,180,80,120,160,160,0,700
18904,220,140,40,0,0,0,400
18905,200,160,120,80,160,0,720
18906,180,140,120,160,160,0,760
18907,190,140,160,160,320,0,970
18908,190,140,160,80,160,0,730
18909,210,140,80,160,160,320,1070
18910,210,180,120,0,0,0,510
18911,180,120,80,80,0,0,460
18912,170,140,120,160,160,320,1070
18913,190,80,80,160,320,0,830
18914,150,120,80,80,0,0,430
18915,200,140,120,160,160,0,780
18916,170,100,80,80,0,0,430
18917,190,120,80,0,0,0,390
18918,220,100,160,0,0,0,480
18919,190,120,120,80,160,0,670
18920,170,60,40,0,0,0,270
18921,170,140,80,160,160,0,710
18922,210,160,200,160,160,0,890
18923,220,120,40,0,0,0,380
18924,230,180,160,320,320,0,1210
18925,230,160,120,160,160,0,830
18926,190,140,80,80,0,0,490
18927,190,140,200,240,160,320,1250
18928,180,100,120,80,160,0,640
18929,220,160,120,160,160,0,820
18930,210,120,120,80,0,0,530
18931,170,140,120,80,0,0,510
18932,200,40,40,80,160,0,520
18933,210,100,0,0,0,0,310
18934,200,120,120,80,0,0,520
18935,190,100,80,0,0,0,370
18936,200,80,40,80,0,0,400
18937,170,100,80,0,0,0,350
18938,200,60,40,0,0,0,300
18939,160,80,80,0,0,0,320
18940,190,120,80,80,0,0,470
18941,190,160,120,160,160,320,1110
18942,200,100,80,80,160,0,620
18943,260,200,160,80,160,0,860
18944,150,120,80,160,320,0,830
18945,140,80,120,160,0,0,500
18946,180,160,40,80,160,0,620
18947,160,120,80,80,0,0,440
18948,200,120,40,80,0,0,440
18949,180,80,160,80,160,0,660
18950,240,160,160,80,160,0,800
18951,220,100,40,0,0,0,360
18952,230,120,40,0,0,0,390
18953,210,140,120,80,0,0,550
18954,190,140,80,80,160,0,650
18955,230,160,80,80,160,0,710
18956,220,140,80,80,160,320,1000
18957,220,120,200,160,160,0,860
18958,210,100,120,240,160,0,830
18959,180,120,80,80,160,0,620
18960,180,80,80,0,0,0,340
18961,180,80,80,160,320,0,820
18962,190,100,120,80,160,0,650
18963,220,100,120,80,160,0,680
18964,210,200,80,160,160,0,810
18965,190,80,40,80,0,0,390
18966,220,160,120,80,0,0,580
18967,190,120,200,80,160,0,750
18968,220,160,200,240,160,0,980
18969,170,100,160,80,160,320,990
18970,200,80,120,80,0,0,480
18971,180,80,80,160,160,0,660
18972,170,80,80,80,160,0,570
18973,190,120,120,0,0,0,430
18974,200,100,40,80,0,0,420
18975,220,140,120,160,160,0,800
18976,210,120,120,80,0,0,530
18977,200,140,120,160,320,0,940
18978,190,120,80,0,0,0,390
18979,180,200,160,160,160,0,860
18980,230,100,160,80,160,0,730
18981,240,140,240,80,0,0,700
18982,190,120,80,80,0,0,470
18983,210,120,160,160,320,320,1290
18984,150,100,160,80,160,0,650
18985,170,120,120,80,160,0,650
18986,190,160,120,80,0,0,550
18987,190,160,160,240,320,0,1070
18988,230,180,80,80,0,0,570
18989,190,120,160,80,160,0,710
18990,210,180,160,0,0,0,550
18991,190,100,80,80,0,0,450
18992,190,120,120,0,0,0,430
18993,220,160,200,80,160,0,820
18994,190,100,40,0,0,0,330
18995,220,120,40,80,0,0,460
18996,190,140,80,80,0,0,490
18997,210,160,160,160,160,0,850
18998,160,100,120,160,0,0,540
18999,220,140,80,0,0,0,440
19000,220,140,40,80,0,0,480
19001,160,120,80,80,160,0,600
19002,210,140,160,160,320,320,1310
19003,230,140,120,160,320,320,1290
19004,210,100,80,160,160,0,710
19005,220,100,80,160,320,0,880
19006,170,120,120,160,0,0,570
19007,210,140,200,160,160,320,1190
19008,230,160,160,240,160,0,950
19009,180,80,80,160,0,0,500
19010,200,100,80,80,160,0,620
19011,230,100,120,240,0,0,690
19012,220,140,120,0,0,0,480
19013,230,200,200,160,160,0,950
19014,190,160,120,80,160,320,1030
19015,180,120,80,80,0,0,460
19016,180,100,120,80,160,0,640
19017,140,100,120,160,320,320,1160
19018,190,140,80,160,0,0,570
19019,180,100,120,240,160,0,800
19020,190,120,80,0,0,0,390
19021,220,140,160,80,160,320,1080
19022,180,140,0,0,0,0,320
19023,210,100,160,160,160,0,790
19024,190,120,40,0,0,0,350
19025,180,140,160,80,160,0,720
19026,200,120,120,80,160,0,680
19027,190,40,80,80,0,0,390
19028,210,120,120,80,0,0,530
19029,200,200,80,80,160,0,720
19030,180,100,40,80,160,0,560
19031,180,160,80,160,320,0,900
19032,210,140,80,0,0,0,430
19033,170,100,80,160,320,0,830
19034,180,100,40,0,0,0,320
19035,180,160,120,160,0,0,620
19036,170,100,40,0,0,0,310
19037,200,120,120,80,160,0,680
19038,160,120,120,160,0,0,560
19039,230,160,240,160,0,0,790
19040,180,100,120,80,160,0,640
19041,190,80,80,80,160,0,590
19042,230,180,200,80,0,0,690
19043,210,160,120,80,160,0,730
19044,180,60,80,0,0,0,320
19045,180,140,200,240,320,0,1080
19046,200,60,120,160,160,0,700
19047,200,120,120,80,0,0,520
19048,170,120,160,240,160,0,850
19049,200,100,120,0,0,0,420
19050,140,40,40,0,0,0,220
19051,190,140,200,240,320,0,1090
19052,200,120,80,160,320,0,880
19053,160,120,120,80,160,320,960
19054,170,40,80,80,0,0,370
19055,180,120,160,160,160,0,780
19056,220,120,120,80,0,0,540
19057,240,140,200,160,0,0,740
19058,190,100,80,80,160,0,610
19059,220,120,120,80,0,0,540
19060,220,80,80,160,160,0,700
19061,150,100,120,80,0,0,450
19062,190,100,80,80,160,0,610
19063,190,160,160,160,320,0,990
19064,200,120,80,80,0,0,480
19065,210,120,160,160,160,0,810
19066,180,140,120,160,0,0,600
19067,170,160,160,80,0,0,570
19068,210,160,40,80,160,0,650
19069,240,160,120,160,160,0,840
19070,240,160,240,80,0,0,720
19071,200,160,160,160,320,0,1000
19072,190,160,120,160,160,0,790
19073,240,140,80,80,0,0,540
19074,200,160,120,160,160,0,800
19075,190,100,40,0,0,0,330
19076,190,120,120,240,160,0,830
19077,220,180,160,0,0,0,560
19078,150,80,80,80,0,0,390
19079,210,120,80,80,0,0,490
19080,230,180,120,160,320,0,1010
19081,190,100,0,0,0,0,290
19082,210,100,80,80,160,0,630
19083,220,100,120,80,0,0,520
19084,190,140,160,160,160,0,810
19085,230,240,80,80,0,0,630
19086,210,140,40,80,160,320,950
19087,170,180,80,80,160,320,990
19088,160,80,80,80,160,0,560
19089,180,120,80,80,160,0,620
19090,220,180,120,80,160,0,760
19091,200,140,160,160,320,0,980
19092,240,120,120,80,160,0,720
19093,160,100,40,80,0,0,380
19094,190,120,80,80,160,0,630
19095,150,120,160,160,0,0,590
19096,160,140,40,80,0,0,420
19097,210,120,120,160,320,320,1250
19098,180,100,40,80,160,0,560
19099,190,140,80,80,160,0,650
19100,180,120,80,80,160,0,620
19101,160,120,120,80,160,0,640
19102,170,40,40,0,0,0,250
19103,190,120,40,80,160,0,590
19104,220,160,160,160,160,0,860
19105,200,120,160,160,0,0,640
19106,200,120,160,240,0,0,720
19107,190,160,80,80,160,320,990
19108,200,140,160,80,0,0,580
19109,160,100,120,160,160,0,700
19110,180,120,40,0,0,0,340
19111,210,160,120,160,160,0,810
19112,190,120,40,0,0,0,350
19113,220,160,200,160,320,320,1380
19114,160,120,120,240,320,0,960
19115,170,140,40,80,160,0,590
19116,210,120,80,80,0,0,490
19117,200,60,80,160,160,0,660
19118,180,140,160,240,160,0,880
19119,230,160,160,160,0,0,710
19120,200,140,120,160,320,320,1260
19121,190,120,120,160,160,0,750
19122,230,100,40,0,0,0,370
19123,190,120,80,160,320,0,870
19124,190,120,80,80,160,0,630
19125,230,100,120,80,160,0,690
19126,130,100,40,0,0,0,270
19127,210,200,160,240,160,0,970
19128,190,100,120,80,160,0,650
19129,170,100,160,240,160,0,830
19130,220,120,120,0,0,0,460
19131,200,160,200,240,320,0,1120
19132,200,120,120,80,160,0,680
19133,210,80,80,80,160,0,610
19134,210,180,120,160,320,0,990
19135,200,180,120,80,160,320,1060
19136,180,120,120,80,0,0,500
19137,160,180,200,160,160,0,860
19138,210,180,120,160,320,0,990
19139,150,120,80,80,160,0,590
19140,200,160,80,80,0,0,520
19141,190,100,40,80,0,0,410
19142,250,240,120,80,0,0,690
19143,190,100,80,160,160,0,690
19144,170,120,80,80,160,0,610
19145,180,120,80,80,160,0,620
19146,180,160,80,80,160,0,660
19147,200,80,160,0,0,0,440
19148,220,100,80,80,0,0,480
19149,180,80,120,160,160,0,700
19150,170,100,120,80,160,0,630
19151,200,140,40,80,160,0,620
19152,200,180,120,160,160,0,820
19153,210,140,120,160,160,320,1110
19154,140,100,120,80,160,0,600
19155,190,140,120,160,0,0,610
19156,190,60,80,80,0,0,410
19157,180,80,160,160,320,0,900
19158,190,140,80,80,0,0,490
19159,210,80,40,80,160,0,570
19160,200,100,80,80,160,0,620
19161,210,140,80,160,160,0,750
19162,160,140,120,160,160,0,740
19163,190,120,40,80,160,320,910
19164,210,160,240,240,160,0,1010
19165,210,160,120,80,0,0,570
19166,210,100,40,0,0,0,350
19167,180,180,120,160,160,0,800
19168,190,60,120,160,160,0,690
19169,230,140,160,160,0,0,690
19170,260,160,80,160,160,320,1140
19171,210,160,120,160,0,0,650
19172,170,140,40,80,0,0,430
19173,190,80,120,0,0,0,390
19174,200,120,80,160,160,0,720
19175,190,40,40,80,160,0,510
19176,200,120,40,0,0,0,360
19177,160,160,160,160,320,0,960
19178,190,80,80,80,160,320,910
19179,190,120,160,80,0,0,550
19180,190,180,80,80,160,0,690
19181,200,120,80,160,160,0,720
19182,170,60,40,0,0,0,270
19183,190,140,80,80,0,0,490
19184,220,120,120,160,160,0,780
19185,190,160,40,0,0,0,390
19186,180,60,40,0,0,0,280
19187,200,140,120,80,160,0,700
19188,230,200,160,160,160,0,910
19189,190,120,120,80,0,0,510
19190,180,120,120,80,0,0,500
19191,190,80,80,0,0,0,350
19192,210,120,40,80,160,0,610
19193,180,120,80,0,0,0,380
19194,200,80,80,80,160,0,600
19195,190,180,160,160,320,320,1330
19196,210,120,80,80,160,0,650
19197,220,100,120,160,160,320,1080
19198,180,80,120,160,160,0,700
19199,220,160,120,160,0,0,660
19200,190,120,80,80,0,0,470
19201,160,60,80,80,160,0,540
19202,200,160,40,80,160,320,960
19203,180,120,80,160,160,0,700
19204,210,140,160,240,160,0,910
19205,180,140,200,80,160,0,760
19206,160,120,160,160,0,0,600
19207,220,160,80,160,0,0,620
19208,190,100,40,80,160,0,570
19209,190,80,80,80,0,0,430
19210,200,140,0,0,0,0,340
19211,230,120,80,80,0,0,510
19212,220,140,160,240,320,320,1400
19213,190,120,80,80,160,0,630
19214,190,60,40,0,0,0,290
19215,190,120,80,80,160,0,630
19216,180,100,80,160,160,320,1000
19217,190,100,120,80,0,0,490
19218,190,140,120,160,160,320,1090
19219,210,120,120,160,160,0,770
19220,200,80,40,0,0,0,320
19221,240,100,80,160,160,320,1060
19222,220,180,120,80,160,320,1080
19223,190,80,160,80,160,0,670
19224,160,120,80,160,0,0,520
19225,170,120,160,160,0,0,610
19226,200,200,80,160,0,0,640
19227,180,180,80,160,160,0,760
19228,200,80,80,80,160,320,920
19229,200,80,80,160,320,0,840
19230,190,160,200,80,160,0,790
19231,190,140,80,80,160,0,650
19232,230,160,120,80,0,0,590
19233,210,180,200,160,160,0,910
19234,180,140,80,0,0,0,400
19235,190,140,40,80,160,0,610
19236,190,100,80,160,160,0,690
19237,190,100,80,0,0,0,370
19238,200,80,120,0,0,0,400
19239,190,140,120,0,0,0,450
19240,230,180,160,80,160,0,810
19241,210,160,160,80,160,0,770
19242,220,120,80,160,160,0,740
19243,200,120,120,80,0,0,520
19244,210,160,160,160,160,0,850
19245,210,180,160,160,0,0,710
19246,230,180,80,80,160,0,730
19247,210,140,40,0,0,0,390
19248,210,160,120,160,160,320,1130
19249,170,140,120,240,320,320,1310
19250,140,60,80,0,0,0,280
19251,210,100,80,80,0,0,470
19252,200,100,120,160,0,0,580
19253,200,120,160,240,160,0,880
19254,170,60,80,0,0,0,310
19255,200,180,120,80,0,0,580
19256,200,120,120,80,160,0,680
19257,200,140,120,80,0,0,540
19258,180,140,120,80,160,0,680
19259,220,140,160,160,160,0,840
19260,180,140,160,80,160,0,720
19261,190,100,160,240,320,0,1010
19262,190,160,120,160,160,0,790
19263,170,100,120,80,160,0,630
19264,230,180,200,160,160,320,1250
19265,190,120,120,80,0,0,510
19266,200,140,80,80,0,0,500
19267,180,140,160,80,0,0,560
19268,130,80,80,160,160,0,610
19269,210,140,120,80,0,0,550
19270,190,160,160,240,160,0,910
19271,210,140,160,240,320,0,1070
19272,200,160,120,160,160,320,1120
19273,220,80,40,0,0,0,340
19274,190,120,120,80,0,0,510
19275,200,140,40,80,0,0,460
19276,220,120,160,160,0,0,660
19277,220,120,40,80,160,0,620
19278,200,100,120,0,0,0,420
19279,170,140,120,80,160,0,670
19280,210,120,40,80,160,320,930
19281,170,100,80,80,160,0,590
19282,190,120,120,240,160,0,830
19283,210,140,80,80,160,0,670
19284,200,80,80,80,0,0,440
19285,200,160,40,0,0,0,400
19286,130,100,80,160,160,0,630
19287,220,160,160,80,0,0,620
19288,180,100,120,160,320,0,880
19289,160,80,120,80,0,0,440
19290,180,80,120,80,0,0,460
19291,180,180,40,0,0,0,400
19292,190,80,80,80,160,0,590
19293,210,80,120,0,0,0,410
19294,220,100,40,0,0,0,360
19295,210,120,200,80,160,0,770
19296,210,100,120,240,320,320,1310
19297,210,140,120,160,160,0,790
19298,170,180,120,80,160,0,710
19299,180,140,200,80,0,0,600
19300,210,160,120,160,160,0,810
19301,220,100,120,80,160,320,1000
19302,240,120,80,80,160,0,680
19303,230,120,80,80,0,0,510
19304,190,140,120,80,160,0,690
19305,210,120,40,0,0,0,370
19306,230,100,80,0,0,0,410
19307,200,120,160,80,160,320,1040
19308,180,100,120,80,160,0,640
19309,200,120,80,80,0,0,480
19310,230,180,160,160,160,0,890
19311,210,120,80,80,160,0,650
19312,200,80,120,160,320,320,1200
19313,200,100,80,80,160,0,620
19314,200,80,160,160,320,0,920
19315,190,160,120,80,160,0,710
19316,200,120,160,160,0,0,640
19317,170,100,80,80,160,320,910
19318,210,120,80,160,160,0,730
19319,190,120,40,0,0,0,350
19320,190,120,160,160,160,320,1110
19321,210,100,120,80,160,0,670
19322,210,140,120,160,320,0,950
19323,190,140,160,80,0,0,570
19324,180,120,160,80,0,0,540
19325,180,100,120,160,160,0,720
19326,190,160,240,80,160,0,830
19327,150,120,160,80,160,0,670
19328,150,80,40,0,0,0,270
19329,210,120,80,160,160,0,730
19330,170,140,120,80,160,320,990
19331,170,60,80,0,0,0,310
19332,190,100,120,240,160,0,810
19333,160,40,40,80,160,0,480
19334,210,160,160,80,160,0,770
19335,220,140,200,160,160,0,880
19336,250,180,120,240,160,0,950
19337,180,120,80,0,0,0,380
19338,180,120,80,80,160,0,620
19339,210,160,120,160,0,0,650
19340,150,80,120,160,160,0,670
19341,170,120,80,0,0,0,370
19342,170,140,120,80,160,0,670
19343,190,60,80,80,160,0,570
19344,180,80,80,80,160,0,580
19345,150,80,40,80,160,0,510
19346,170,120,120,80,0,0,490
19347,170,60,120,160,160,0,670
19348,180,120,120,160,320,0,900
19349,180,160,120,80,160,0,700
19350,150,120,120,80,160,0,630
19351,200,60,80,0,0,0,340
19352,220,140,40,80,0,0,480
19353,210,60,80,160,160,320,990
19354,230,180,40,80,160,0,690
19355,220,120,80,0,0,0,420
19356,180,100,40,0,0,0,320
19357,180,180,160,240,160,320,1240
19358,220,180,120,80,0,0,600
19359,200,100,80,80,0,0,460
19360,190,120,160,80,0,0,550
19361,240,120,160,160,0,0,680
19362,200,160,160,240,320,0,1080
19363,150,120,160,160,160,320,1070
19364,200,160,160,240,320,320,1400
19365,160,140,80,0,0,0,380
19366,200,100,120,160,160,0,740
19367,220,160,120,80,0,0,580
19368,190,120,80,80,160,0,630
19369,150,120,80,0,0,0,350
19370,160,100,80,160,320,320,1140
19371,140,80,120,80,0,0,420
19372,190,160,200,160,0,0,710
19373,210,100,40,80,0,0,430
19374,230,160,160,160,160,0,870
19375,210,160,160,80,160,0,770
19376,200,100,80,160,160,0,700
19377,180,80,80,160,160,0,660
19378,210,100,120,80,0,0,510
19379,220,120,120,80,0,0,540
19380,170,180,200,80,0,0,630
19381,150,100,80,160,320,0,810
19382,230,100,120,160,320,0,930
19383,190,120,160,80,160,0,710
19384,190,140,160,160,320,0,970
19385,210,140,120,80,0,0,550
19386,210,160,160,80,160,0,770
19387,200,140,80,80,0,0,500
19388,250,160,80,80,0,0,570
19389,200,60,80,80,160,0,580
19390,230,160,160,80,160,320,1110
19391,190,120,120,160,160,0,750
19392,240,140,80,160,320,320,1260
19393,200,160,160,160,320,320,1320
19394,200,140,160,80,0,0,580
19395,200,120,160,240,0,0,720
19396,190,120,120,160,320,0,910
19397,190,140,0,0,0,0,330
19398,190,100,120,80,0,0,490
19399,210,140,0,0,0,0,350
19400,220,180,120,80,160,0,760
19401,210,140,120,160,160,0,790
19402,220,140,160,240,0,0,760
19403,180,180,240,160,160,0,920
19404,200,120,80,80,0,0,480
19405,200,120,80,80,160,320,960
19406,190,120,160,160,160,320,1110
19407,220,220,160,80,160,0,840
19408,190,100,120,80,0,0,490
19409,220,120,40,80,160,0,620
19410,170,100,40,0,0,0,310
19411,160,120,80,80,0,0,440
19412,180,100,160,240,320,0,1000
19413,210,120,120,80,160,320,1010
19414,160,140,200,160,160,0,820
19415,180,180,200,80,160,0,800
19416,210,200,80,0,0,0,490
19417,220,160,120,160,160,0,820
19418,240,120,40,80,0,0,480
19419,210,140,200,240,320,0,1110
19420,190,100,160,160,0,0,610
19421,200,80,80,80,160,320,920
19422,170,160,120,80,160,320,1010
19423,190,120,40,80,160,320,910
19424,230,100,120,160,160,0,770
19425,150,40,80,160,160,0,590
19426,200,160,80,80,0,0,520
19427,170,120,80,0,0,0,370
19428,200,140,160,0,0,0,500
19429,210,160,120,80,160,320,1050
19430,190,120,120,160,0,0,590
19431,180,80,120,160,320,320,1180
19432,200,140,80,0,0,0,420
19433,190,100,80,160,160,320,1010
19434,210,180,160,160,0,0,710
19435,180,100,40,80,160,0,560
19436,140,100,80,80,160,0,560
19437,210,140,160,80,0,0,590
19438,220,120,120,160,320,320,1260
19439,210,120,120,80,160,0,690
19440,230,180,120,160,160,0,850
19441,150,80,80,0,0,0,310
19442,190,80,80,80,160,0,590
19443,190,80,40,0,0,0,310
19444,150,100,80,160,320,0,810
19445,220,120,80,80,160,0,660
19446,180,120,40,80,160,0,580
19447,180,100,40,0,0,0,320
19448,170,120,120,80,0,0,490
19449,210,80,80,0,0,0,370
19450,150,160,120,160,160,0,750
19451,200,80,120,80,160,320,960
19452,220,100,80,80,0,0,480
19453,230,120,120,0,0,0,470
19454,200,100,80,80,160,0,620
19455,180,180,120,80,0,0,560
19456,210,140,200,240,320,320,1430
19457,160,140,120,160,0,0,580
19458,210,140,120,80,0,0,550
19459,210,160,120,80,160,0,730
19460,200,140,80,0,0,0,420
19461,200,140,120,160,160,0,780
19462,190,180,40,80,160,0,650
19463,200,120,40,0,0,0,360
19464,210,140,120,160,160,320,1110
19465,210,220,200,160,320,0,1110
19466,210,140,80,160,160,0,750
19467,160,40,40,0,0,0,240
19468,200,100,120,80,160,320,980
19469,180,140,40,80,0,0,440
19470,160,40,40,80,0,0,320
19471,210,100,80,80,160,0,630
19472,240,160,120,240,160,0,920
19473,200,100,80,80,160,0,620
19474,230,100,120,80,160,0,690
19475,240,80,40,80,0,0,440
19476,180,120,80,80,0,0,460
19477,190,100,80,160,320,0,850
19478,210,160,80,160,320,0,930
19479,200,140,200,80,160,0,780
19480,220,140,80,80,160,0,680
19481,190,100,80,0,0,0,370
19482,200,100,80,0,0,0,380
19483,180,120,40,0,0,0,340
19484,200,120,120,160,0,0,600
19485,170,140,80,0,0,0,390
19486,230,100,120,80,160,0,690
19487,200,120,80,80,160,0,640
19488,190,140,120,160,160,0,770
19489,210,120,40,0,0,0,370
19490,200,100,120,80,160,0,660
19491,230,120,80,80,0,0,510
19492,170,80,40,0,0,0,290
19493,190,100,120,80,160,0,650
19494,210,120,80,80,0,0,490
19495,190,120,120,160,320,320,1230
19496,190,120,80,80,0,0,470
19497,200,120,80,160,160,0,720
19498,220,160,160,160,160,0,860
19499,180,100,120,80,0,0,480
19500,200,160,160,160,0,0,680
19501,190,100,40,80,160,0,570
19502,190,140,80,0,0,0,410
19503,240,80,80,80,160,320,960
19504,210,160,80,160,0,0,610
19505,190,80,40,80,0,0,390
19506,210,140,80,0,0,0,430
19507,180,160,120,80,0,0,540
19508,200,140,160,80,0,0,580
19509,200,140,160,320,320,0,1140
19510,190,120,160,80,160,0,710
19511,200,100,80,80,160,0,620
19512,180,120,0,0,0,0,300
19513,180,80,0,0,0,0,260
19514,170,120,160,160,160,0,770
19515,160,140,120,80,0,0,500
19516,190,140,120,80,0,0,530
19517,230,120,120,80,0,0,550
19518,240,80,80,0,0,0,400
19519,200,100,80,160,160,320,1020
19520,220,100,80,80,0,0,480
19521,200,120,40,80,0,0,440
19522,160,100,80,80,160,0,580
19523,210,160,200,80,160,0,810
19524,230,180,160,240,320,0,1130
19525,200,100,120,80,160,0,660
19526,200,100,160,80,160,0,700
19527,210,160,120,240,320,320,1370
19528,200,140,40,80,160,0,620
19529,210,140,200,240,160,0,950
19530,220,100,80,160,320,320,1200
19531,190,120,160,80,0,0,550
19532,180,100,80,80,160,0,600
19533,180,80,120,160,320,320,1180
19534,190,100,80,80,0,0,450
19535,210,120,160,160,0,0,650
19536,220,120,80,80,0,0,500
19537,210,120,160,0,0,0,490
19538,180,120,160,80,160,0,700
19539,170,120,80,0,0,0,370
19540,210,140,240,160,320,0,1070
19541,190,140,200,0,0,0,530
19542,210,120,120,80,160,0,690
19543,180,140,40,80,160,0,600
19544,190,100,120,80,0,0,490
19545,200,120,120,160,320,320,1240
19546,200,100,120,160,0,0,580
19547,180,80,40,0,0,0,300
19548,210,100,80,160,320,0,870
19549,250,120,120,0,0,0,490
19550,200,160,120,80,160,0,720
19551,190,160,80,80,160,0,670
19552,180,180,120,160,160,0,800
19553,210,120,120,80,0,0,530
19554,210,160,160,160,160,0,850
19555,210,80,120,160,0,0,570
19556,220,160,120,160,160,0,820
19557,200,60,120,160,160,0,700
19558,190,140,40,80,0,0,450
19559,180,140,160,160,0,0,640
19560,180,120,80,80,0,0,460
19561,190,140,120,160,160,0,770
19562,170,100,120,80,160,0,630
19563,220,160,200,160,160,0,900
19564,200,100,160,160,160,0,780
19565,160,120,120,80,160,0,640
19566,210,100,80,0,0,0,390
19567,240,140,160,160,160,0,860
19568,180,100,80,0,0,0,360
19569,200,80,120,160,160,0,720
19570,160,100,80,80,160,0,580
19571,190,120,0,0,0,0,310
19572,180,140,120,160,0,0,600
19573,190,100,160,160,0,0,610
19574,200,120,120,160,160,320,1080
19575,200,80,80,0,0,0,360
19576,190,120,120,160,160,0,750
19577,200,120,40,80,160,0,600
19578,220,100,80,160,160,0,720
19579,210,140,80,0,0,0,430
19580,220,140,120,80,160,320,1040
19581,230,160,80,80,160,0,710
19582,190,140,80,80,0,0,490
19583,200,140,80,80,160,0,660
19584,220,120,120,80,0,0,540
19585,210,100,40,0,0,0,350
19586,190,140,160,160,0,0,650
19587,190,180,200,160,0,0,730
19588,230,160,160,160,160,0,870
19589,220,160,160,160,160,0,860
19590,190,140,120,160,0,0,610
19591,210,140,160,0,0,0,510
19592,180,120,80,80,0,0,460
19593,230,140,80,80,0,0,530
19594,140,40,40,0,0,0,220
19595,200,100,40,80,0,0,420
19596,210,180,80,80,160,320,1030
19597,190,80,80,80,160,0,590
19598,210,120,120,80,160,0,690
19599,210,180,200,160,0,0,750
19600,210,80,80,80,0,0,450
19601,190,140,120,160,160,0,770
19602,200,140,160,0,0,0,500
19603,170,80,120,80,160,0,610
19604,220,140,160,160,320,0,1000
19605,170,80,40,80,0,0,370
19606,190,60,80,80,160,0,570
19607,200,120,120,80,0,0,520
19608,190,120,200,240,320,0,1070
19609,180,120,40,80,160,320,900
19610,190,200,160,80,160,0,790
19611,160,120,80,80,160,0,600
19612,200,140,80,160,160,320,1060
19613,200,140,160,160,160,0,820
19614,190,140,120,80,0,0,530
19615,200,160,80,80,160,320,1000
19616,220,80,120,240,160,0,820
19617,210,100,120,80,0,0,510
19618,170,100,80,80,160,0,590
19619,200,180,120,160,320,320,1300
19620,220,100,40,80,0,0,440
19621,200,120,80,80,160,0,640
19622,190,140,40,80,160,0,610
19623,180,100,40,80,0,0,400
19624,230,140,120,160,320,0,970
19625,180,80,80,80,160,0,580
19626,220,140,160,160,160,0,840
19627,190,160,160,0,0,0,510
19628,220,100,120,160,160,320,1080
19629,210,120,80,160,160,0,730
19630,160,100,120,80,160,0,620
19631,190,120,40,0,0,0,350
19632,210,160,80,160,0,0,610
19633,230,100,80,80,0,0,490
19634,170,100,80,80,160,0,590
19635,170,120,40,80,160,0,570
19636,190,80,80,0,0,0,350
19637,200,160,160,80,0,0,600
19638,210,120,80,80,160,0,650
19639,170,100,120,160,160,0,710
19640,190,100,120,80,0,0,490
19641,180,120,80,80,0,0,460
19642,230,180,160,80,0,0,650
19643,190,100,80,160,160,0,690
19644,200,140,40,80,0,0,460
19645,210,100,80,0,0,0,390
19646,170,140,120,80,0,0,510
19647,200,120,80,80,0,0,480
19648,200,180,200,160,0,0,740
19649,230,140,120,0,0,0,490
19650,200,100,40,0,0,0,340
19651,190,120,40,0,0,0,350
19652,200,120,80,80,0,0,480
19653,210,160,120,80,0,0,570
19654,220,140,120,240,320,320,1360
19655,200,160,160,80,160,0,760
19656,190,120,40,0,0,0,350
19657,190,100,120,160,160,0,730
19658,170,180,80,0,0,0,430
19659,220,100,160,160,160,0,800
19660,210,120,120,80,160,320,1010
19661,220,100,120,0,0,0,440
19662,140,60,80,160,320,320,1080
19663,210,140,80,80,160,0,670
19664,220,180,200,160,160,320,1240
19665,190,100,80,0,0,0,370
19666,220,100,40,80,160,0,600
19667,200,100,40,80,160,320,900
19668,220,140,80,0,0,0,440
19669,170,120,120,160,160,0,730
19670,200,160,200,80,0,0,640
19671,200,80,40,0,0,0,320
19672,200,100,80,0,0,0,380
19673,200,120,160,240,320,320,1360
19674,220,140,80,80,160,0,680
19675,210,140,160,240,320,320,1390
19676,190,160,120,80,160,0,710
19677,170,100,80,160,160,0,670
19678,170,60,80,80,160,0,550
19679,240,140,120,80,160,0,740
19680,170,140,120,80,160,0,670
19681,230,100,160,160,160,0,810
19682,180,80,40,0,0,0,300
19683,210,160,160,160,160,0,850
19684,230,160,120,160,0,0,670
19685,210,120,80,80,160,0,650
19686,180,120,160,80,0,0,540
19687,250,160,160,160,160,0,890
19688,190,80,120,160,0,0,550
19689,220,160,120,160,160,0,820
19690,240,100,80,80,160,0,660
19691,190,160,80,160,160,0,750
19692,180,80,40,0,0,0,300
19693,190,160,80,80,0,0,510
19694,170,140,120,80,0,0,510
19695,210,160,120,160,0,0,650
19696,190,160,160,160,160,0,830
19697,200,120,120,0,0,0,440
19698,160,100,160,160,320,0,900
19699,190,100,80,80,0,0,450
19700,190,120,80,80,160,320,950
19701,210,100,120,160,0,0,590
19702,170,100,120,160,320,0,870
19703,210,140,160,160,160,320,1150
19704,250,240,160,80,160,0,890
19705,210,100,160,80,160,0,710
19706,160,80,40,0,0,0,280
19707,210,120,160,80,0,0,570
19708,210,140,80,80,160,0,670
19709,230,180,160,0,0,0,570
19710,180,120,80,0,0,0,380
19711,150,100,80,160,320,0,810
19712,170,140,160,160,160,0,790
19713,240,180,160,160,160,0,900
19714,180,100,40,80,160,320,880
19715,160,120,160,240,320,0,1000
19716,190,100,160,160,0,0,610
19717,210,140,120,160,0,0,630
19718,200,120,120,0,0,0,440
19719,190,120,80,80,160,0,630
19720,190,120,160,80,0,0,550
19721,180,120,40,80,160,0,580
19722,230,120,40,0,0,0,390
19723,190,120,80,80,160,0,630
19724,260,180,160,160,320,0,1080
19725,220,100,40,0,0,0,360
19726,190,60,80,160,0,0,490
19727,220,140,80,80,160,0,680
19728,200,180,120,240,0,0,740
19729,160,100,80,160,160,320,980
19730,220,80,80,160,0,0,540
19731,190,100,120,240,160,0,810
19732,230,120,160,80,0,0,590
19733,230,120,200,320,160,0,1030
19734,200,160,160,160,320,0,1000
19735,170,80,40,80,160,0,530
19736,190,120,120,160,0,0,590
19737,180,140,200,0,0,0,520
19738,220,60,80,160,160,0,680
19739,190,140,120,240,320,0,1010
19740,200,140,120,80,0,0,540
19741,150,100,80,80,0,0,410
19742,150,120,160,160,320,0,910
19743,180,140,120,80,160,0,680
19744,190,140,160,80,160,320,1050
19745,200,180,160,160,320,320,1340
19746,190,120,120,160,160,320,1070
19747,160,80,80,80,160,0,560
19748,150,100,160,80,0,0,490
19749,230,180,80,80,0,0,570
19750,220,180,120,80,0,0,600
19751,240,160,80,80,0,0,560
19752,220,140,80,0,0,0,440
19753,170,80,80,0,0,0,330
19754,140,100,120,80,0,0,440
19755,190,100,120,80,0,0,490
19756,240,180,80,80,160,320,1060
19757,220,140,80,80,160,0,680
19758,250,200,120,160,0,0,730
19759,190,140,40,0,0,0,370
19760,230,120,80,160,160,0,750
19761,190,80,120,80,0,0,470
19762,180,120,120,80,0,0,500
19763,240,120,40,80,0,0,480
19764,180,140,120,80,160,0,680
19765,240,100,80,80,0,0,500
19766,210,100,80,160,320,0,870
19767,220,160,160,160,0,0,700
19768,180,140,80,80,0,0,480
19769,190,140,40,0,0,0,370
19770,150,80,120,160,0,0,510
19771,180,140,80,0,0,0,400
19772,210,160,160,160,0,0,690
19773,200,140,160,240,160,0,900
19774,190,120,120,80,160,0,670
19775,170,100,40,80,160,0,550
19776,180,100,200,160,320,320,1280
19777,190,80,80,160,160,0,670
19778,190,120,120,160,160,0,750
19779,200,100,80,160,320,320,1180
19780,220,140,160,160,0,0,680
19781,200,80,0,0,0,0,280
19782,180,100,120,160,160,0,720
19783,180,160,120,80,160,0,700
19784,210,100,40,0,0,0,350
19785,190,120,120,80,160,0,670
19786,190,120,80,0,0,0,390
19787,230,160,120,240,160,0,910
19788,230,180,160,0,0,0,570
19789,210,100,120,80,160,320,990
19790,160,80,40,0,0,0,280
19791,170,100,80,160,160,0,670
19792,210,140,200,160,160,0,870
19793,170,180,120,160,160,0,790
19794,200,120,120,160,160,0,760
19795,230,60,80,80,0,0,450
19796,240,120,80,80,160,0,680
19797,220,160,80,0,0,0,460
19798,170,120,80,160,160,320,1010
19799,190,160,160,240,320,0,1070
19800,160,120,200,80,160,0,720
19801,230,100,80,80,160,0,650
19802,140,80,160,160,0,0,540
19803,210,160,200,80,160,0,810
19804,200,140,80,0,0,0,420
19805,120,100,80,80,0,0,380
19806,220,200,40,0,0,0,460
19807,200,140,120,160,160,0,780
19808,190,60,40,80,160,0,530
19809,170,140,120,0,0,0,430
19810,190,80,80,160,160,0,670
19811,220,160,120,80,160,0,740
19812,200,140,160,80,160,0,740
19813,170,120,40,80,160,0,570
19814,170,160,160,80,0,0,570
19815,200,100,120,160,160,0,740
19816,140,80,80,160,160,0,620
19817,190,40,40,80,160,0,510
19818,140,80,80,80,0,0,380
19819,190,180,160,160,320,0,1010
19820,180,120,80,80,160,0,620
19821,180,120,120,160,0,0,580
19822,180,180,80,80,160,320,1000
19823,210,100,40,0,0,0,350
19824,170,120,80,80,160,0,610
19825,180,140,120,80,0,0,520
19826,180,100,120,160,160,0,720
19827,180,140,200,160,320,0,1000
19828,170,160,160,80,160,0,730
19829,160,180,240,160,160,320,1220
19830,190,100,120,160,160,0,730
19831,200,160,40,0,0,0,400
19832,180,160,120,80,0,0,540
19833,180,100,120,160,0,0,560
19834,190,100,120,160,320,320,1210
19835,220,140,80,0,0,0,440
19836,200,100,120,160,160,0,740
19837,230,100,80,80,160,0,650
19838,150,100,120,80,0,0,450
19839,190,140,80,160,160,320,1050
19840,180,60,40,80,0,0,360
19841,200,140,120,80,0,0,540
19842,200,100,80,0,0,0,380
19843,220,80,120,0,0,0,420
19844,220,140,40,80,160,0,640
19845,180,80,40,0,0,0,300
19846,200,140,200,160,0,0,700
19847,180,80,80,80,160,0,580
19848,180,100,80,160,160,0,680
19849,220,140,120,0,0,0,480
19850,250,180,160,160,320,320,1390
19851,180,100,120,80,0,0,480
19852,210,80,120,80,160,0,650
19853,190,100,120,160,320,0,890
19854,160,60,120,160,160,0,660
19855,200,160,160,160,0,0,680
19856,200,100,80,0,0,0,380
19857,190,140,160,80,0,0,570
19858,240,120,120,80,160,320,1040
19859,200,80,80,160,160,320,1000
19860,220,100,80,160,160,0,720
19861,250,160,40,80,160,0,690
19862,220,120,160,160,160,0,820
19863,200,100,80,80,0,0,460
19864,170,100,80,80,0,0,430
19865,220,140,160,240,320,320,1400
19866,230,100,120,160,0,0,610
19867,190,140,120,80,0,0,530
19868,180,60,40,80,160,0,520
19869,200,180,120,160,160,0,820
19870,180,120,80,80,160,320,940
19871,220,140,120,160,160,0,800
19872,190,120,120,80,160,0,670
19873,260,160,80,80,160,0,740
19874,230,160,200,160,160,0,910
19875,200,120,120,0,0,0,440
19876,190,120,80,160,320,320,1190
19877,210,120,80,80,160,0,650
19878,220,100,120,80,160,0,680
19879,200,160,80,160,0,0,600
19880,200,140,120,80,160,0,700
19881,200,160,200,160,0,0,720
19882,200,160,160,240,160,0,920
19883,200,80,40,80,160,0,560
19884,230,100,80,80,160,0,650
19885,150,60,40,80,0,0,330
19886,120,40,0,0,0,0,160
19887,220,140,160,160,160,0,840
19888,150,120,120,80,160,320,950
19889,220,140,160,160,320,0,1000
19890,180,120,80,80,0,0,460
19891,190,140,120,160,160,0,770
19892,210,80,120,240,320,320,1290
19893,180,180,120,80,0,0,560
19894,200,120,120,0,0,0,440
19895,200,120,80,0,0,0,400
19896,200,140,160,240,320,0,1060
19897,190,120,120,80,0,0,510
19898,160,140,120,80,0,0,500
19899,230,100,120,80,160,0,690
19900,200,160,120,80,0,0,560
19901,210,120,160,160,320,320,1290
19902,210,140,200,160,160,0,870
19903,190,140,120,0,0,0,450
19904,160,100,120,160,160,0,700
19905,190,80,120,0,0,0,390
19906,200,140,160,80,0,0,580
19907,180,120,120,80,0,0,500
19908,180,120,120,80,160,0,660
19909,180,80,40,80,0,0,380
19910,180,120,160,80,0,0,540
19911,170,100,80,160,160,0,670
19912,220,140,80,80,0,0,520
19913,220,140,40,80,160,0,640
19914,190,80,80,160,160,0,670
19915,210,160,160,160,0,0,690
19916,200,140,120,160,160,0,780
19917,150,80,120,80,160,0,590
19918,200,100,120,160,160,0,740
19919,220,120,80,0,0,0,420
19920,210,80,0,0,0,0,290
19921,180,80,120,240,320,320,1260
19922,200,140,120,80,0,0,540
19923,220,140,120,160,0,0,640
19924,220,140,200,240,160,0,960
19925,200,180,120,80,160,0,740
19926,130,80,80,80,0,0,370
19927,180,100,80,160,160,0,680
19928,210,120,120,80,160,0,690
19929,190,100,120,160,320,0,890
19930,180,60,40,0,0,0,280
19931,180,120,120,160,320,320,1220
19932,210,140,120,0,0,0,470
19933,210,120,40,80,160,0,610
19934,210,100,160,80,0,0,550
19935,220,180,160,160,160,0,880
19936,220,200,160,0,0,0,580
19937,220,120,120,80,160,320,1020
19938,150,120,120,160,160,320,1030
19939,170,140,120,0,0,0,430
19940,200,100,80,80,160,0,620
19941,200,160,80,160,0,0,600
19942,200,180,160,240,320,0,1100
19943,240,60,80,80,160,0,620
19944,210,120,80,160,160,0,730
19945,200,160,160,240,160,0,920
19946,210,120,80,80,160,0,650
19947,230,160,120,0,0,0,510
19948,250,100,40,80,160,0,630
19949,200,80,40,0,0,0,320
19950,240,140,40,80,160,0,660
19951,140,100,120,80,160,0,600
19952,220,80,120,240,320,320,1300
19953,190,80,80,160,320,0,830
19954,190,140,120,80,160,0,690
19955,170,160,160,160,160,320,1130
19956,160,120,160,80,160,0,680
19957,250,180,120,80,160,0,790
19958,140,140,160,80,160,320,1000
19959,190,160,80,160,0,0,590
19960,200,100,80,80,0,0,460
19961,180,120,40,80,0,0,420
19962,180,80,80,160,320,0,820
19963,240,80,80,160,0,0,560
19964,210,140,80,0,0,0,430
19965,190,100,160,160,160,0,770
19966,210,140,160,80,160,0,750
19967,230,160,80,0,0,0,470
19968,190,120,80,80,160,0,630
19969,210,140,120,160,160,0,790
19970,220,100,120,240,160,0,840
19971,200,140,120,80,0,0,540
19972,220,160,40,0,0,0,420
19973,170,80,80,80,160,0,570
19974,190,160,200,160,160,0,870
19975,200,160,80,80,0,0,520
19976,210,60,120,240,0,0,630
19977,200,140,120,80,0,0,540
19978,200,140,120,80,160,0,700
19979,220,140,200,160,320,0,1040
19980,200,140,120,80,160,0,700
19981,180,140,160,160,320,320,1280
19982,160,120,160,80,160,0,680
19983,170,100,40,80,160,0,550
19984,180,100,40,80,160,0,560
19985,200,120,80,160,160,0,720
19986,180,160,120,0,0,0,460
19987,190,200,120,80,160,320,1070
19988,230,160,160,160,160,0,870
19989,170,120,80,160,320,320,1170
19990,190,140,160,0,0,0,490
19991,200,80,120,0,0,0,400
19992,150,100,40,0,0,0,290
19993,170,120,80,80,160,0,610
19994,150,160,160,0,0,0,470
19995,210,100,80,80,160,0,630
19996,170,140,80,80,160,320,950
19997,220,140,120,80,0,0,560
19998,210,120,80,80,0,0,490
19999,180,120,80,80,0,0,460
20000,200,200,120,80,160,0,760
20001,190,100,0,0,0,0,290
20002,180,80,120,160,160,0,700
20003,180,100,80,160,160,320,1000
20004,190,120,200,160,160,0,830
20005,200,200,280,160,0,0,840
20006,190,140,120,160,0,0,610
20007,190,100,80,0,0,0,370
20008,220,180,80,80,160,0,720
20009,190,100,80,80,160,0,610
20010,180,120,120,80,0,0,500
20011,220,160,120,160,0,0,660
20012,200,160,120,80,160,0,720
20013,200,100,80,0,0,0,380
20014,200,80,120,160,160,0,720
20015,170,160,200,240,160,0,930
20016,190,140,160,160,160,0,810
20017,180,140,160,240,320,0,1040
20018,190,140,160,80,160,0,730
20019,210,80,80,80,0,0,450
20020,210,160,160,240,320,320,1410
20021,220,140,80,160,0,0,600
20022,180,140,160,240,320,0,1040
20023,220,160,120,160,320,0,980
20024,230,180,160,160,160,0,890
20025,170,120,120,80,0,0,490
20026,180,60,40,80,0,0,360
20027,180,60,40,80,0,0,360
20028,210,140,80,0,0,0,430
20029,190,160,160,0,0,0,510
20030,190,180,120,80,160,0,730
20031,210,120,80,80,160,0,650
20032,160,120,40,80,160,0,560
20033,210,160,160,0,0,0,530
20034,180,120,80,160,320,320,1180
20035,220,120,80,80,160,320,980
20036,170,120,80,80,160,320,930
20037,210,160,40,80,160,0,650
20038,200,140,40,0,0,0,380
20039,170,140,120,160,320,0,910
20040,180,180,200,80,160,0,800
20041,180,140,200,160,160,0,840
20042,200,120,160,0,0,0,480
20043,210,160,160,240,160,0,930
20044,160,100,80,80,0,0,420
20045,240,120,120,240,160,0,880
20046,180,120,160,80,160,320,1020
20047,200,100,40,80,160,320,900
20048,230,100,80,80,160,0,650
20049,230,100,120,80,0,0,530
20050,200,120,80,80,160,0,640
20051,230,180,160,80,0,0,650
20052,180,100,80,80,160,0,600
20053,170,100,120,160,320,320,1190
20054,190,120,160,80,160,0,710
20055,200,120,120,160,320,0,920
20056,220,180,80,80,160,320,1040
20057,190,120,120,160,320,0,910
20058,170,140,80,80,0,0,470
20059,190,80,80,160,320,0,830
20060,190,100,80,80,160,0,610
20061,180,100,80,80,160,0,600
20062,170,160,160,80,160,0,730
20063,200,100,160,240,320,0,1020
20064,210,180,80,80,160,0,710
20065,220,100,40,0,0,0,360
20066,160,80,80,160,0,0,480
20067,180,80,40,80,0,0,380
20068,230,120,80,80,160,0,670
20069,170,120,80,80,0,0,450
20070,190,80,80,160,160,0,670
20071,220,140,120,80,160,320,1040
20072,190,60,0,0,0,0,250
20073,200,100,80,80,160,320,940
20074,200,120,80,160,160,0,720
20075,150,80,80,0,0,0,310
20076,190,140,120,240,160,0,850
20077,200,80,120,160,160,0,720
20078,250,100,80,80,0,0,510
20079,150,140,80,160,320,320,1170
20080,170,180,40,80,160,0,630
20081,170,120,80,80,0,0,450
20082,160,140,120,80,0,0,500
20083,190,100,0,0,0,0,290
20084,220,160,160,80,160,0,780
20085,170,100,80,160,160,0,670
20086,160,100,80,80,160,0,580
20087,200,200,160,160,320,0,1040
20088,230,140,80,80,160,0,690
20089,230,160,200,240,160,0,990
20090,200,100,80,80,160,0,620
20091,210,100,120,0,0,0,430
20092,190,140,40,80,160,0,610
20093,190,120,120,240,320,0,990
20094,180,80,40,0,0,0,300
20095,170,120,120,80,160,0,650
20096,200,120,80,80,160,0,640
20097,220,120,160,160,160,0,820
20098,200,100,80,160,160,0,700
20099,220,140,120,160,160,0,800
20100,210,80,80,80,160,0,610
20101,180,100,80,80,0,0,440
20102,180,160,120,0,0,0,460
20103,200,140,120,160,160,0,780
20104,180,80,0,0,0,0,260
20105,200,160,160,240,320,320,1400
20106,180,100,120,80,160,0,640
20107,250,140,120,160,320,320,1310
20108,210,100,120,80,160,320,990
20109,190,120,120,160,160,0,750
20110,200,140,80,0,0,0,420
20111,260,120,80,160,320,0,940
20112,230,140,80,80,160,0,690
20113,180,120,120,160,320,0,900
20114,170,100,40,0,0,0,310
20115,180,100,80,80,160,0,600
20116,200,100,80,0,0,0,380
20117,200,140,200,160,160,0,860
20118,210,140,120,240,160,0,870
20119,210,140,120,80,0,0,550
20120,180,60,40,0,0,0,280
20121,170,80,40,0,0,0,290
20122,180,120,120,160,0,0,580
20123,190,100,120,160,320,320,1210
20124,180,60,40,80,160,0,520
20125,210,180,160,160,160,0,870
20126,200,160,200,160,160,320,1200
20127,190,120,120,80,160,0,670
20128,190,140,160,240,320,320,1370
20129,210,100,80,80,160,0,630
20130,190,160,160,240,160,0,910
20131,190,140,80,0,0,0,410
20132,190,80,120,160,320,320,1190
20133,210,140,120,160,320,0,950
20134,140,120,40,0,0,0,300
20135,240,180,40,80,160,0,700
20136,170,80,40,0,0,0,290
20137,130,80,120,160,160,320,970
20138,180,140,120,160,160,0,760
20139,190,80,80,0,0,0,350
20140,190,120,40,80,160,0,590
20141,170,100,120,160,320,0,870
20142,220,20,0,0,0,0,240
20143,210,100,80,80,160,0,630
20144,220,200,120,80,0,0,620
20145,240,140,80,80,0,0,540
20146,170,120,120,160,160,0,730
20147,210,80,120,160,320,0,890
20148,200,100,120,0,0,0,420
20149,200,140,40,80,0,0,460
20150,220,180,80,160,320,320,1280
20151,180,100,80,80,0,0,440
20152,220,140,120,160,0,0,640
20153,190,160,80,80,160,0,670
20154,180,80,80,160,320,0,820
20155,180,120,80,160,320,0,860
20156,190,160,160,80,160,0,750
20157,220,120,80,160,0,0,580
20158,180,100,80,80,160,0,600
20159,200,180,120,160,0,0,660
20160,190,100,120,240,320,0,970
20161,220,140,80,0,0,0,440
20162,210,180,240,160,160,0,950
20163,160,160,120,160,160,0,760
20164,180,120,120,0,0,0,420
20165,170,120,80,80,160,0,610
20166,160,100,120,160,320,320,1180
20167,190,160,200,160,160,0,870
20168,170,140,160,0,0,0,470
20169,210,100,40,80,160,0,590
20170,220,120,160,160,320,0,980
20171,230,120,40,0,0,0,390
20172,190,80,120,160,320,0,870
20173,220,120,120,160,160,320,1100
20174,180,160,160,80,160,0,740
20175,190,120,40,80,0,0,430
20176,160,120,160,160,160,320,1080
20177,170,120,160,80,160,320,1010
20178,210,100,40,0,0,0,350
20179,240,120,160,160,320,320,1320
20180,210,80,80,80,0,0,450
20181,190,140,80,160,0,0,570
20182,200,160,80,80,0,0,520
20183,190,100,40,80,160,0,570
20184,190,180,160,80,0,0,610
20185,230,160,120,0,0,0,510
20186,180,100,80,0,0,0,360
20187,190,200,80,0,0,0,470
20188,230,60,40,80,160,320,890
20189,180,160,120,80,160,320,1020
20190,210,120,80,80,160,320,970
20191,180,140,80,80,160,0,640
20192,240,80,40,0,0,0,360
20193,200,100,80,0,0,0,380
20194,180,140,80,80,0,0,480
20195,180,120,120,80,0,0,500
20196,190,180,120,160,160,0,810
20197,190,100,120,80,0,0,490
20198,160,100,120,160,160,0,700
20199,210,80,80,80,0,0,450
20200,200,140,120,80,0,0,540
20201,190,220,80,160,160,0,810
20202,150,80,80,80,160,0,550
20203,210,60,80,0,0,0,350
20204,190,80,80,160,0,0,510
20205,160,100,160,240,160,0,820
20206,180,160,120,160,320,0,940
20207,180,160,160,160,0,0,660
20208,190,80,80,80,0,0,430
20209,210,140,120,160,320,0,950
20210,200,120,120,80,160,320,1000
20211,180,140,160,80,160,0,720
20212,150,100,80,80,160,0,570
20213,210,160,120,160,0,0,650
20214,210,120,80,80,0,0,490
20215,220,120,120,80,0,0,540
20216,140,60,80,160,0,0,440
20217,200,140,120,0,0,0,460
20218,190,160,80,80,0,0,510
20219,220,140,80,0,0,0,440
20220,230,140,160,80,160,0,770
20221,250,100,120,80,0,0,550
20222,190,100,40,80,160,0,570
20223,180,120,80,0,0,0,380
20224,220,180,80,160,160,320,1120
20225,230,100,80,0,0,0,410
20226,180,40,0,0,0,0,220
20227,260,200,200,160,160,0,980
20228,200,80,80,80,160,0,600
20229,200,80,40,80,0,0,400
20230,210,140,160,80,0,0,590
20231,210,100,80,80,0,0,470
20232,210,140,40,0,0,0,390
20233,160,60,40,80,160,0,500
20234,250,160,120,160,320,0,1010
20235,210,140,120,160,160,0,790
20236,180,100,160,80,160,0,680
20237,170,80,40,80,160,0,530
20238,220,120,40,0,0,0,380
20239,200,120,80,160,320,320,1200
20240,170,200,120,80,160,0,730
20241,230,120,200,240,0,0,790
20242,170,120,80,80,160,0,610
20243,180,120,160,80,160,0,700
20244,200,180,160,240,320,320,1420
20245,180,100,80,0,0,0,360
20246,230,180,160,0,0,0,570
20247,190,80,120,160,320,0,870
20248,200,160,120,240,160,0,880
20249,170,60,40,0,0,0,270
20250,180,140,160,160,160,0,800
20251,210,120,120,80,160,0,690
20252,220,80,40,80,0,0,420
20253,220,120,40,0,0,0,380
20254,180,100,120,160,160,0,720
20255,180,100,80,160,160,0,680
20256,220,100,120,160,160,0,760
20257,150,100,120,80,0,0,450
20258,190,120,160,160,320,320,1270
20259,230,160,40,80,160,0,670
20260,200,140,160,160,160,0,820
20261,220,100,160,80,160,0,720
20262,190,140,120,160,160,0,770
20263,220,160,200,80,160,0,820
20264,160,100,80,0,0,0,340
20265,180,140,40,80,160,0,600
20266,200,80,40,0,0,0,320
20267,200,160,80,0,0,0,440
20268,220,140,120,80,160,0,720
20269,210,160,120,80,0,0,570
20270,190,160,80,80,0,0,510
20271,200,180,160,160,320,0,1020
20272,160,120,160,160,160,0,760
20273,140,100,120,80,0,0,440
20274,160,100,160,240,320,0,980
20275,200,120,80,80,0,0,480
20276,200,160,120,160,0,0,640
20277,220,140,120,80,160,320,1040
20278,190,120,80,80,160,0,630
20279,210,160,40,80,0,0,490
20280,200,180,160,80,0,0,620
20281,180,160,160,80,0,0,580
20282,210,80,80,80,160,0,610
20283,160,120,120,80,160,0,640
20284,190,120,120,80,0,0,510
20285,220,120,80,0,0,0,420
20286,140,120,160,80,160,0,660
20287,170,80,80,160,320,0,810
20288,220,220,120,80,160,0,800
20289,220,140,120,0,0,0,480
20290,190,120,40,80,0,0,430
20291,170,160,120,80,0,0,530
20292,170,180,200,160,160,0,870
20293,240,60,40,80,160,320,900
20294,230,100,80,0,0,0,410
20295,230,120,80,80,160,320,990
20296,190,60,40,0,0,0,290
20297,210,100,120,160,160,0,750
20298,250,180,120,160,160,0,870
20299,220,80,40,0,0,0,340
20300,150,60,40,80,160,0,490
20301,230,160,160,240,320,0,1110
20302,160,80,80,160,160,320,960
20303,220,120,40,80,160,0,620
20304,210,160,120,160,160,0,810
20305,180,140,120,160,160,0,760
20306,240,120,160,160,160,0,840
20307,170,120,80,80,160,0,610
20308,180,120,40,80,160,0,580
20309,260,140,160,160,160,320,1200
20310,210,140,120,80,160,0,710
20311,220,60,80,160,160,0,680
20312,200,100,80,160,320,320,1180
20313,160,140,200,160,160,320,1140
20314,180,80,40,0,0,0,300
20315,190,100,120,80,0,0,490
20316,210,140,120,80,0,0,550
20317,200,140,120,80,160,0,700
20318,180,180,160,80,160,0,760
20319,190,140,120,160,160,320,1090
20320,160,120,80,80,160,0,600
20321,170,100,40,0,0,0,310
20322,200,100,80,80,160,0,620
20323,190,100,120,80,160,0,650
20324,180,120,80,80,160,0,620
20325,210,120,80,160,160,0,730
20326,220,140,80,160,160,0,760
20327,210,140,160,80,160,0,750
20328,200,120,80,80,0,0,480
20329,220,120,80,80,160,0,660
20330,190,120,40,0,0,0,350
20331,190,180,160,160,0,0,690
20332,240,180,40,80,160,0,700
20333,200,120,80,80,0,0,480
20334,230,160,160,80,160,0,790
20335,180,120,80,80,0,0,460
20336,210,200,240,160,0,0,810
20337,230,140,120,160,320,320,1290
20338,230,140,40,0,0,0,410
20339,200,100,120,80,0,0,500
20340,160,80,80,80,0,0,400
20341,170,80,80,0,0,0,330
20342,180,160,120,0,0,0,460
20343,190,80,80,80,160,0,590
20344,220,140,120,240,320,0,1040
20345,190,120,120,240,320,320,1310
20346,200,120,120,160,160,0,760
20347,220,80,120,80,0,0,500
20348,210,140,120,160,320,320,1270
20349,180,100,160,80,160,0,680
20350,180,140,40,80,0,0,440
20351,190,100,120,80,160,0,650
20352,220,140,120,160,0,0,640
20353,190,80,80,80,160,320,910
20354,230,100,120,160,0,0,610
20355,170,140,80,80,160,0,630
20356,170,100,40,0,0,0,310
20357,210,220,120,160,160,0,870
20358,170,80,80,160,0,0,490
20359,210,60,120,160,160,320,1030
20360,230,180,120,80,160,0,770
20361,200,160,80,80,0,0,520
20362,160,100,80,0,0,0,340
20363,220,140,240,160,0,0,760
20364,200,140,120,80,160,0,700
20365,210,100,160,160,160,0,790
20366,200,120,120,160,0,0,600
20367,180,100,120,240,160,0,800
20368,190,140,160,240,0,0,730
20369,170,140,120,80,0,0,510
20370,220,100,80,80,160,0,640
20371,200,120,120,80,0,0,520
20372,190,140,160,0,0,0,490
20373,190,140,120,160,160,0,770
20374,210,40,40,80,0,0,370
20375,160,120,120,160,160,0,720
20376,150,120,160,160,160,0,750
20377,170,80,160,240,320,0,970
20378,190,80,160,160,320,320,1230
20379,190,100,120,160,320,320,1210
20380,160,100,80,160,320,0,820
20381,250,60,120,80,160,0,670
20382,210,120,120,160,160,0,770
20383,210,120,80,0,0,0,410
20384,190,80,120,160,160,320,1030
20385,220,180,160,160,160,320,1200
20386,190,80,40,80,0,0,390
20387,190,100,80,80,160,0,610
20388,220,140,160,160,160,0,840
20389,200,100,120,160,0,0,580
20390,190,120,120,0,0,0,430
20391,160,140,80,80,0,0,460
20392,190,140,120,160,320,0,930
20393,220,140,160,80,160,320,1080
20394,180,140,200,160,160,320,1160
20395,180,100,120,160,160,0,720
20396,180,80,40,0,0,0,300
20397,220,120,40,80,160,0,620
20398,230,200,160,160,160,0,910
20399,170,100,80,80,160,0,590
20400,210,180,120,160,160,0,830
20401,190,100,120,160,0,0,570
20402,180,100,80,160,0,0,520
20403,200,100,80,80,0,0,460
20404,150,80,80,80,0,0,390
20405,190,140,120,160,0,0,610
20406,200,120,160,160,160,0,800
20407,210,160,120,160,160,0,810
20408,200,120,40,0,0,0,360
20409,210,140,200,160,0,0,710
20410,180,180,120,80,160,0,720
20411,230,140,0,0,0,0,370
20412,180,160,200,80,0,0,620
20413,220,160,160,0,0,0,540
20414,170,140,80,80,160,0,630
20415,210,120,80,0,0,0,410
20416,170,40,40,80,0,0,330
20417,180,60,40,0,0,0,280
20418,200,160,120,160,320,0,960
20419,180,120,160,160,320,320,1260
20420,180,160,120,160,320,0,940
20421,180,120,120,80,160,320,980
20422,180,60,80,0,0,0,320
20423,220,160,160,80,160,320,1100
20424,200,140,80,0,0,0,420
20425,170,120,40,80,160,0,570
20426,200,160,160,0,0,0,520
20427,170,40,0,0,0,0,210
20428,220,100,120,0,0,0,440
20429,190,140,200,160,0,0,690
20430,230,120,80,80,0,0,510
20431,180,140,120,240,320,0,1000
20432,160,140,160,240,320,0,1020
20433,200,160,120,80,160,0,720
20434,220,80,120,160,160,0,740
20435,170,140,120,160,160,0,750
20436,220,180,120,160,320,0,1000
20437,180,140,160,240,320,0,1040
20438,190,160,160,80,160,0,750
20439,200,100,80,0,0,0,380
20440,230,120,120,160,160,320,1110
20441,240,120,80,80,160,0,680
20442,210,100,80,160,160,0,710
20443,210,180,120,160,320,0,990
20444,200,120,120,80,0,0,520
20445,200,140,160,80,160,320,1060
20446,200,160,160,240,320,0,1080
20447,200,180,160,160,320,320,1340
20448,240,120,120,160,160,320,1120
20449,190,100,120,80,160,320,970
20450,160,140,120,80,160,0,660
20451,160,120,160,160,160,0,760
20452,200,140,80,80,160,320,980
20453,210,120,80,80,0,0,490
20454,180,100,80,160,160,0,680
20455,180,100,40,80,160,0,560
20456,250,200,160,0,0,0,610
20457,130,120,120,80,160,0,610
20458,160,140,160,160,160,320,1100
20459,200,100,160,160,0,0,620
20460,180,180,80,160,160,0,760
20461,200,200,80,80,160,0,720
20462,240,160,120,80,160,0,760
20463,230,160,120,160,0,0,670
20464,180,100,120,160,0,0,560
20465,220,140,160,160,160,0,840
20466,180,100,80,80,160,320,920
20467,190,160,120,80,0,0,550
20468,150,20,40,80,160,0,450
20469,200,140,160,0,0,0,500
20470,220,160,80,80,0,0,540
20471,190,80,80,80,160,0,590
20472,180,60,40,80,160,0,520
20473,170,200,200,160,160,0,890
20474,200,60,80,160,160,0,660
20475,190,120,160,160,320,0,950
20476,210,140,160,240,320,0,1070
20477,220,80,80,0,0,0,380
20478,180,140,200,160,160,0,840
20479,170,140,120,80,0,0,510
20480,230,160,200,160,160,0,910
20481,190,100,160,160,160,0,770
20482,170,140,200,160,320,0,990
20483,210,100,80,80,160,320,950
20484,230,140,160,160,320,0,1010
20485,170,60,40,0,0,0,270
20486,200,80,40,80,160,320,880
20487,230,140,80,80,160,320,1010
20488,200,80,40,80,0,0,400
20489,180,80,120,0,0,0,380
20490,180,80,40,80,0,0,380
20491,180,60,0,0,0,0,240
20492,190,100,120,160,160,0,730
20493,210,120,0,0,0,0,330
20494,180,80,120,160,0,0,540
20495,150,140,160,160,160,0,770
20496,190,100,80,0,0,0,370
20497,200,100,80,80,0,0,460
20498,210,120,120,0,0,0,450
20499,190,100,80,80,0,0,450
20500,190,100,160,80,160,320,1010
20501,210,160,80,0,0,0,450
20502,190,100,80,80,160,0,610
20503,220,120,80,80,0,0,500
20504,220,120,40,80,160,0,620
20505,200,140,120,0,0,0,460
20506,220,160,120,80,160,320,1060
20507,180,80,80,80,160,0,580
20508,220,140,80,80,160,0,680
20509,210,100,80,80,0,0,470
20510,170,100,0,0,0,0,270
20511,210,60,40,80,160,320,870
20512,150,160,160,160,160,0,790
20513,210,80,40,80,160,0,570
20514,190,120,120,240,320,0,990
20515,210,100,80,80,160,0,630
20516,170,140,120,160,160,0,750
20517,190,140,240,160,160,0,890
20518,190,140,160,160,0,0,650
20519,210,160,160,80,160,0,770
20520,170,60,80,80,160,0,550
20521,200,140,80,80,160,0,660
20522,210,100,80,80,160,0,630
20523,190,120,80,0,0,0,390
20524,200,140,200,80,0,0,620
20525,160,120,120,80,0,0,480
20526,220,120,80,160,0,0,580
20527,200,120,120,160,160,0,760
20528,170,80,80,160,0,0,490
20529,200,140,120,160,0,0,620
20530,220,160,40,0,0,0,420
20531,220,80,120,80,160,320,980
20532,180,40,80,160,160,0,620
20533,260,180,200,160,320,0,1120
20534,220,160,40,80,160,320,980
20535,190,140,120,160,0,0,610
20536,150,100,80,80,160,0,570
20537,210,120,120,160,160,0,770
20538,180,120,80,80,0,0,460
20539,210,60,0,0,0,0,270
20540,170,140,120,0,0,0,430
20541,230,100,120,80,160,320,1010
20542,200,100,120,80,0,0,500
20543,150,100,80,80,160,0,570
20544,180,100,80,80,160,0,600
20545,220,120,120,0,0,0,460
20546,190,160,160,240,160,0,910
20547,180,80,80,160,160,0,660
20548,200,100,120,160,0,0,580
20549,170,140,120,160,160,320,1070
20550,150,120,200,160,0,0,630
20551,220,120,160,240,0,0,740
20552,170,60,40,80,160,0,510
20553,210,140,160,80,160,0,750
20554,200,120,120,0,0,0,440
20555,200,120,120,80,160,0,680
20556,190,120,80,80,160,0,630
20557,190,120,80,80,160,0,630
20558,180,100,120,80,160,0,640
20559,230,180,80,80,160,0,730
20560,170,100,80,80,160,0,590
20561,170,80,120,80,160,0,610
20562,210,160,80,80,160,320,1010
20563,170,100,80,160,160,0,670
20564,190,180,160,240,160,0,930
20565,210,60,40,0,0,0,310
20566,220,140,80,80,160,320,1000
20567,200,120,160,160,160,0,800
20568,210,120,120,160,160,0,770
20569,180,140,160,160,0,0,640
20570,190,80,80,0,0,0,350
20571,210,140,80,80,160,320,990
20572,190,120,160,160,320,0,950
20573,230,140,120,80,0,0,570
20574,220,140,160,240,320,0,1080
20575,210,120,80,80,0,0,490
20576,220,180,160,80,160,320,1120
20577,220,160,200,80,160,0,820
20578,200,100,120,80,160,0,660
20579,200,120,120,80,160,0,680
20580,200,120,80,80,160,0,640
20581,240,180,160,80,160,0,820
20582,130,60,40,80,0,0,310
20583,220,140,160,240,160,0,920
20584,160,140,120,80,0,0,500
20585,180,120,80,80,0,0,460
20586,200,160,160,160,320,0,1000
20587,170,100,40,80,0,0,390
20588,230,180,80,0,0,0,490
20589,150,80,80,80,160,0,550
20590,200,140,160,80,160,0,740
20591,250,180,200,160,160,0,950
20592,200,120,160,80,0,0,560
20593,180,100,80,80,160,320,920
20594,210,60,80,80,160,0,590
20595,180,80,80,160,160,0,660
20596,180,120,80,80,160,0,620
20597,200,120,80,80,160,320,960
20598,170,100,40,80,0,0,390
20599,200,100,120,80,0,0,500
20600,200,160,80,80,160,0,680
20601,220,180,120,0,0,0,520
20602,170,140,120,80,160,0,670
20603,190,180,120,80,160,0,730
20604,240,100,160,80,0,0,580
20605,210,180,160,160,0,0,710
20606,210,180,80,80,160,320,1030
20607,190,160,80,0,0,0,430
20608,200,160,80,80,160,320,1000
20609,210,0,0,0,0,0,210
20610,170,140,80,80,0,0,470
20611,200,100,80,160,160,0,700
20612,210,160,160,160,320,320,1330
20613,200,40,80,80,0,0,400
20614,200,100,80,80,0,0,460
20615,200,160,120,80,0,0,560
20616,220,80,120,160,160,0,740
20617,190,140,240,160,320,320,1370
20618,170,100,120,240,160,0,790
20619,220,100,120,160,0,0,600
20620,180,140,120,80,160,0,680
20621,210,100,80,80,160,320,950
20622,180,80,40,80,0,0,380
20623,190,100,120,240,160,0,810
20624,200,140,120,80,160,0,700
20625,250,140,80,80,160,0,710
20626,220,100,120,80,160,320,1000
20627,170,80,160,160,160,320,1050
20628,220,80,80,80,0,0,460
20629,180,140,160,80,160,0,720
20630,200,100,80,80,160,0,620
20631,200,120,120,160,160,320,1080
20632,180,100,80,160,320,0,840
20633,200,100,160,80,160,0,700
20634,200,80,120,160,320,0,880
20635,160,100,40,80,0,0,380
20636,200,120,80,0,0,0,400
20637,200,80,40,80,160,0,560
20638,190,60,0,0,0,0,250
20639,170,120,120,80,160,0,650
20640,150,140,120,80,0,0,490
20641,170,80,120,80,160,320,930
20642,170,120,120,80,160,0,650
20643,210,60,40,80,160,0,550
20644,180,80,80,0,0,0,340
20645,160,100,80,160,0,0,500
20646,190,120,160,160,160,0,790
20647,210,180,160,0,0,0,550
20648,210,180,120,80,0,0,590
20649,170,140,80,160,320,0,870
20650,170,100,80,80,160,0,590
20651,180,140,120,0,0,0,440
20652,210,120,120,80,0,0,530
20653,210,180,200,160,160,0,910
20654,200,120,120,160,160,0,760
20655,170,120,160,160,160,0,770
20656,210,140,240,160,160,0,910
20657,230,80,0,0,0,0,310
20658,180,160,80,0,0,0,420
20659,210,120,40,80,0,0,450
20660,180,80,80,160,160,0,660
20661,170,100,80,160,320,0,830
20662,170,140,120,160,160,0,750
20663,180,100,80,160,320,0,840
20664,160,60,40,0,0,0,260
20665,210,140,80,160,160,0,750
20666,170,100,120,80,0,0,470
20667,210,140,120,80,0,0,550
20668,230,120,120,240,320,0,1030
20669,180,120,160,160,160,0,780
20670,210,160,120,80,0,0,570
20671,150,140,80,80,160,320,930
20672,170,120,80,0,0,0,370
20673,170,100,0,0,0,0,270
20674,170,160,200,160,0,0,690
20675,200,140,160,80,0,0,580
20676,210,140,200,160,160,0,870
20677,200,100,120,160,160,0,740
20678,190,140,80,80,0,0,490
20679,220,120,40,80,160,320,940
20680,200,140,80,0,0,0,420
20681,190,140,200,160,0,0,690
20682,180,180,160,160,160,320,1160
20683,220,140,200,0,0,0,560
20684,190,80,120,160,0,0,550
20685,140,100,120,0,0,0,360
20686,200,120,120,80,160,320,1000
20687,200,120,120,160,0,0,600
20688,190,120,40,80,160,0,590
20689,180,80,120,160,160,0,700
20690,170,80,40,0,0,0,290
20691,230,180,120,160,160,320,1170
20692,200,140,80,80,160,0,660
20693,220,100,80,160,160,0,720
20694,220,120,80,80,160,0,660
20695,200,120,120,80,160,0,680
20696,220,120,80,160,0,0,580
20697,190,140,120,160,320,0,930
20698,220,80,120,0,0,0,420
20699,180,100,160,240,320,0,1000
20700,180,100,200,240,160,0,880
20701,200,100,80,80,160,0,620
20702,220,160,160,80,160,0,780
20703,180,80,80,160,0,0,500
20704,200,120,160,160,160,320,1120
20705,220,100,120,160,320,0,920
20706,140,140,160,160,320,0,920
20707,190,80,40,80,160,0,550
20708,230,140,40,80,160,0,650
20709,190,80,80,160,160,320,990
20710,190,120,80,0,0,0,390
20711,200,120,80,160,320,320,1200
20712,190,120,120,80,160,0,670
20713,160,80,40,80,0,0,360
20714,200,160,120,80,160,0,720
20715,160,100,120,80,0,0,460
20716,170,100,80,160,160,320,990
20717,200,140,80,0,0,0,420
20718,220,120,40,80,160,320,940
20719,210,160,40,80,0,0,490
20720,180,140,0,0,0,0,320
20721,170,120,120,80,0,0,490
20722,200,100,40,0,0,0,340
20723,170,140,160,0,0,0,470
20724,200,120,40,0,0,0,360
20725,180,120,40,80,0,0,420
20726,200,160,160,80,160,0,760
20727,190,120,80,80,160,0,630
20728,160,100,40,0,0,0,300
20729,220,140,40,80,0,0,480
20730,210,100,120,0,0,0,430
20731,190,80,80,0,0,0,350
20732,200,160,120,240,160,0,880
20733,220,120,200,160,160,0,860
20734,170,100,120,160,320,320,1190
20735,220,160,160,160,160,0,860
20736,150,80,120,80,160,0,590
20737,170,120,40,0,0,0,330
20738,190,160,160,240,160,0,910
20739,170,120,160,80,0,0,530
20740,230,180,120,80,160,0,770
20741,220,160,160,80,0,0,620
20742,230,100,80,160,160,0,730
20743,180,140,120,160,320,320,1240
20744,220,160,120,80,160,320,1060
20745,190,120,120,80,0,0,510
20746,210,180,80,160,0,0,630
20747,200,100,80,80,160,0,620
20748,170,100,40,0,0,0,310
20749,140,60,40,80,160,0,480
20750,200,180,160,160,0,0,700
20751,200,80,120,80,160,0,640
20752,170,80,120,160,160,320,1010
20753,220,140,160,160,160,0,840
20754,210,120,80,0,0,0,410
20755,190,140,80,80,160,0,650
20756,210,120,120,0,0,0,450
20757,190,80,120,80,160,0,630
20758,160,120,120,160,0,0,560
20759,190,220,240,240,160,0,1050
20760,130,80,80,80,0,0,370
20761,170,100,120,80,160,0,630
20762,190,80,80,80,0,0,430
20763,200,140,80,80,160,0,660
20764,200,80,120,80,160,0,640
20765,220,140,160,160,160,320,1160
20766,220,120,120,80,160,0,700
20767,190,40,40,0,0,0,270
20768,210,140,160,80,0,0,590
20769,200,140,120,80,160,0,700
20770,180,120,80,80,0,0,460
20771,190,160,160,80,0,0,590
20772,220,140,80,0,0,0,440
20773,190,100,120,160,160,0,730
20774,170,100,80,80,0,0,430
20775,200,80,80,80,160,320,920
20776,160,100,80,80,160,320,900
20777,210,140,40,0,0,0,390
20778,180,160,120,160,320,0,940
20779,200,140,160,80,160,320,1060
20780,210,140,120,160,0,0,630
20781,180,140,160,80,0,0,560
20782,190,140,120,80,160,0,690
20783,190,160,200,160,160,0,870
20784,170,140,120,80,0,0,510
20785,190,100,120,80,160,320,970
20786,210,120,120,160,160,0,770
20787,180,120,120,240,160,0,820
20788,180,120,120,160,0,0,580
20789,150,120,120,80,160,320,950
20790,170,80,120,80,0,0,450
20791,240,100,40,80,0,0,460
20792,210,140,120,80,160,0,710
20793,210,140,160,160,160,0,830
20794,210,60,40,80,0,0,390
20795,200,80,80,80,160,0,600
20796,200,120,80,160,160,0,720
20797,200,120,160,80,160,0,720
20798,180,100,80,80,160,0,600
20799,190,120,40,80,160,320,910
20800,190,140,80,80,160,0,650
20801,230,160,40,0,0,0,430
20802,190,120,80,0,0,0,390
20803,210,100,40,80,160,0,590
20804,200,120,80,80,160,0,640
20805,210,120,40,80,160,320,930
20806,190,180,160,80,160,320,1090
20807,220,120,200,160,160,0,860
20808,210,140,80,80,160,0,670
20809,210,140,160,80,0,0,590
20810,180,140,160,240,320,0,1040
20811,190,140,120,160,160,320,1090
20812,220,140,80,80,0,0,520
20813,180,80,0,0,0,0,260
20814,150,60,0,0,0,0,210
20815,190,200,200,240,320,0,1150
20816,210,120,120,160,160,0,770
20817,180,160,120,160,0,0,620
20818,210,100,120,160,320,0,910
20819,170,100,80,80,160,320,910
20820,220,100,80,80,160,0,640
20821,220,140,120,80,160,0,720
20822,190,120,200,80,160,0,750
20823,210,80,80,80,160,0,610
20824,130,100,120,80,160,0,590
20825,190,100,120,160,160,320,1050
20826,170,160,200,160,160,0,850
20827,240,140,120,0,0,0,500
20828,250,200,120,80,160,0,810
20829,230,120,120,80,0,0,550
20830,210,160,80,80,0,0,530
20831,160,100,120,160,320,0,860
20832,220,140,200,80,0,0,640
20833,170,180,160,80,160,0,750
20834,210,160,160,160,320,0,1010
20835,190,160,160,160,160,320,1150
20836,230,120,120,0,0,0,470
20837,200,160,160,80,0,0,600
20838,210,100,80,80,160,0,630
20839,200,140,160,160,0,0,660
20840,200,140,120,80,0,0,540
20841,180,100,120,0,0,0,400
20842,170,120,80,160,320,320,1170
20843,210,80,120,0,0,0,410
20844,200,160,200,160,160,0,880
20845,210,140,40,80,160,320,950
20846,170,120,80,160,320,0,850
20847,170,120,120,80,0,0,490
20848,200,140,40,80,160,0,620
20849,160,100,40,0,0,0,300
20850,170,80,160,80,160,0,650
20851,200,160,120,160,0,0,640
20852,180,120,120,240,320,0,980
20853,220,120,40,80,160,0,620
20854,180,120,80,80,0,0,460
20855,160,100,120,80,160,320,940
20856,190,120,80,160,320,0,870
20857,230,80,80,80,160,0,630
20858,230,140,80,0,0,0,450
20859,170,120,120,80,160,320,970
20860,230,160,80,160,160,0,790
20861,180,80,80,80,160,320,900
20862,200,80,40,80,160,0,560
20863,190,120,120,80,0,0,510
20864,210,100,120,160,160,0,750
20865,180,100,80,160,160,0,680
20866,160,160,40,80,160,0,600
20867,220,100,120,160,0,0,600
20868,210,120,160,160,0,0,650
20869,200,80,120,80,160,0,640
20870,140,120,160,240,160,0,820
20871,230,180,120,0,0,0,530
20872,200,200,160,240,320,320,1440
20873,170,120,160,160,320,0,930
20874,200,120,120,160,160,320,1080
20875,180,160,80,80,0,0,500
20876,200,180,120,240,160,0,900
20877,190,120,120,160,160,0,750
20878,180,140,120,0,0,0,440
20879,190,100,160,160,160,0,770
20880,210,140,160,0,0,0,510
20881,190,180,200,160,0,0,730
20882,210,140,80,80,160,320,990
20883,200,80,80,0,0,0,360
20884,220,200,160,160,160,0,900
20885,210,100,0,0,0,0,310
20886,160,80,120,80,160,0,600
20887,190,160,120,160,160,0,790
20888,210,100,40,0,0,0,350
20889,210,140,80,80,160,320,990
20890,170,120,120,160,0,0,570
20891,190,80,40,80,0,0,390
20892,150,140,80,80,160,0,610
20893,200,120,80,80,0,0,480
20894,170,160,120,80,160,0,690
20895,180,120,200,80,0,0,580
20896,250,120,80,80,160,320,1010
20897,190,120,80,160,320,0,870
20898,240,120,80,80,0,0,520
20899,180,120,120,0,0,0,420
20900,190,60,40,0,0,0,290
20901,220,140,120,80,0,0,560
20902,230,140,80,80,160,0,690
20903,150,120,80,160,320,0,830
20904,220,180,160,160,320,0,1040
20905,190,160,120,80,0,0,550
20906,190,160,160,240,320,0,1070
20907,140,100,40,0,0,0,280
20908,160,80,40,0,0,0,280
20909,170,60,80,80,160,320,870
20910,210,160,200,240,320,0,1130
20911,180,80,120,80,0,0,460
20912,160,80,80,80,0,0,400
20913,220,140,40,0,0,0,400
20914,170,140,120,160,160,0,750
20915,170,140,80,0,0,0,390
20916,140,100,0,0,0,0,240
20917,220,220,200,240,160,320,1360
20918,220,160,80,80,160,0,700
20919,170,120,120,80,0,0,490
20920,170,120,80,80,0,0,450
20921,190,120,80,80,160,0,630
20922,240,160,120,80,160,320,1080
20923,230,160,120,160,320,320,1310
20924,210,160,80,80,160,0,690
20925,160,180,160,80,160,0,740
20926,210,140,120,80,0,0,550
20927,170,100,80,80,0,0,430
20928,190,120,120,160,160,0,750
20929,210,120,80,0,0,0,410
20930,240,140,120,0,0,0,500
20931,240,160,120,80,160,320,1080
20932,150,120,120,0,0,0,390
20933,210,120,80,80,0,0,490
20934,200,140,160,80,160,0,740
20935,170,140,120,80,160,0,670
20936,170,80,120,160,160,0,690
20937,230,120,120,160,160,0,790
20938,220,140,120,160,160,0,800
20939,190,140,40,80,0,0,450
20940,200,160,120,160,160,0,800
20941,190,160,120,160,160,0,790
20942,220,80,120,160,160,0,740
20943,230,100,80,0,0,0,410
20944,160,160,200,160,160,0,840
20945,200,100,80,160,160,0,700
20946,220,140,120,80,160,0,720
20947,230,140,80,160,160,320,1090
20948,190,120,120,80,160,0,670
20949,210,120,80,0,0,0,410
20950,230,140,160,80,160,320,1090
20951,220,120,120,240,160,0,860
20952,230,140,80,0,0,0,450
20953,200,140,160,80,160,0,740
20954,210,100,120,160,160,0,750
20955,220,140,240,240,320,0,1160
20956,180,160,160,80,160,0,740
20957,180,140,160,80,0,0,560
20958,210,80,160,160,160,0,770
20959,210,100,120,160,0,0,590
20960,240,120,120,160,160,0,800
20961,220,140,160,80,160,0,760
20962,150,100,80,160,160,0,650
20963,250,140,160,160,0,0,710
20964,220,180,80,0,0,0,480
20965,210,120,120,80,160,0,690
20966,180,40,80,160,160,0,620
20967,190,120,80,160,160,0,710
20968,220,80,80,160,160,320,1020
20969,160,60,40,0,0,0,260
20970,220,180,80,80,160,320,1040
20971,150,80,0,0,0,0,230
20972,170,100,40,0,0,0,310
20973,210,80,40,0,0,0,330
20974,200,140,120,240,160,0,860
20975,230,100,120,160,160,0,770
20976,180,100,80,80,0,0,440
20977,190,100,40,80,160,0,570
20978,230,120,80,0,0,0,430
20979,210,160,160,240,160,0,930
20980,240,100,40,80,160,0,620
20981,210,140,120,240,160,320,1190
20982,180,60,80,160,160,0,640
20983,180,120,40,0,0,0,340
20984,160,80,40,80,0,0,360
20985,180,100,160,0,0,0,440
20986,170,140,120,0,0,0,430
20987,170,120,120,160,0,0,570
20988,200,140,120,0,0,0,460
20989,170,180,120,160,160,0,790
20990,190,140,200,160,320,0,1010
20991,160,100,0,0,0,0,260
20992,210,160,80,0,0,0,450
20993,190,180,240,80,0,0,690
20994,200,140,120,160,320,320,1260
20995,180,140,120,80,0,0,520
20996,220,100,40,0,0,0,360
20997,190,80,120,80,160,0,630
20998,260,180,80,80,0,0,600
20999,200,140,160,160,320,0,980
21000,200,140,160,80,160,0,740
21001,220,120,160,160,0,0,660
21002,170,80,80,160,160,320,970
21003,190,140,120,160,320,0,930
21004,210,100,40,0,0,0,350
21005,210,120,160,80,160,320,1050
21006,180,100,40,80,160,0,560
21007,200,100,80,80,0,0,460
21008,180,140,80,80,160,320,960
21009,220,140,80,0,0,0,440
21010,220,100,40,80,160,0,600
21011,210,120,120,80,0,0,530
21012,190,100,120,160,320,0,890
21013,240,140,120,160,160,0,820
21014,190,160,160,160,160,0,830
21015,210,120,40,80,160,0,610
21016,200,140,80,80,0,0,500
21017,230,160,200,240,160,0,990
21018,230,140,120,160,160,320,1130
21019,220,140,80,80,0,0,520
21020,200,160,160,240,0,0,760
21021,230,120,80,80,0,0,510
21022,230,140,80,80,160,0,690
21023,210,120,160,160,160,0,810
21024,210,180,120,80,160,0,750
21025,210,180,160,240,160,0,950
21026,190,140,160,0,0,0,490
21027,180,80,40,80,0,0,380
21028,180,80,40,80,160,0,540
21029,200,180,120,160,160,0,820
21030,200,120,160,0,0,0,480
21031,190,140,80,0,0,0,410
21032,230,180,120,80,160,0,770
21033,180,160,160,240,0,0,740
21034,190,140,120,240,320,0,1010
21035,200,120,160,80,0,0,560
21036,200,120,80,80,160,0,640
21037,170,60,120,160,160,0,670
21038,200,160,160,240,160,320,1240
21039,250,140,120,160,160,0,830
21040,200,60,40,0,0,0,300
21041,190,100,120,160,160,0,730
21042,180,140,80,0,0,0,400
21043,170,100,80,80,0,0,430
21044,210,80,80,80,160,0,610
21045,210,100,40,80,160,0,590
21046,220,80,120,80,160,0,660
21047,160,100,40,80,0,0,380
21048,220,120,120,240,320,320,1340
21049,220,100,120,160,320,0,920
21050,170,140,120,160,0,0,590
21051,170,100,120,80,160,320,950
21052,180,180,240,160,160,320,1240
21053,210,120,120,80,160,0,690
21054,150,100,80,0,0,0,330
21055,210,180,160,160,160,0,870
21056,220,200,160,240,0,0,820
21057,200,120,160,160,160,0,800
21058,180,120,120,160,160,0,740
21059,170,100,0,0,0,0,270
21060,220,120,80,80,160,0,660
21061,120,100,120,160,0,0,500
21062,210,160,120,80,0,0,570
21063,190,140,160,160,320,0,970
21064,200,140,120,0,0,0,460
21065,180,120,120,160,320,320,1220
21066,190,120,80,160,160,0,710
21067,190,160,80,0,0,0,430
21068,180,160,160,240,160,0,900
21069,200,100,120,160,160,0,740
21070,150,120,120,80,0,0,470
21071,190,100,40,80,160,0,570
21072,160,140,40,80,160,0,580
21073,190,80,120,160,160,0,710
21074,190,80,80,80,160,0,590
21075,200,140,120,240,160,0,860
21076,220,140,160,160,320,0,1000
21077,190,120,120,240,0,0,670
21078,200,80,0,0,0,0,280
21079,170,80,80,0,0,0,330
21080,190,140,120,80,160,320,1010
21081,160,120,160,240,160,0,840
21082,200,120,80,160,160,0,720
21083,220,80,80,80,160,0,620
21084,170,140,40,0,0,0,350
21085,200,100,80,0,0,0,380
21086,220,160,200,240,160,320,1300
21087,230,120,120,160,160,0,790
21088,240,180,120,160,160,0,860
21089,170,120,120,240,320,0,970
21090,200,100,120,80,160,0,660
21091,220,100,80,80,0,0,480
21092,210,120,80,160,320,0,890
21093,170,140,160,160,160,0,790
21094,230,140,160,80,0,0,610
21095,200,160,40,80,160,0,640
21096,180,100,80,0,0,0,360
21097,210,100,120,80,160,0,670
21098,230,160,120,80,160,0,750
21099,230,120,80,160,160,0,750
21100,210,100,80,80,0,0,470
21101,170,120,80,80,160,0,610
21102,170,160,120,160,160,0,770
21103,230,140,80,80,160,0,690
21104,190,160,80,80,160,0,670
21105,200,120,160,160,320,0,960
21106,200,120,120,0,0,0,440
21107,270,160,120,160,320,0,1030
21108,200,80,80,80,0,0,440
21109,140,120,80,80,0,0,420
21110,180,140,120,0,0,0,440
21111,210,220,40,0,0,0,470
21112,240,220,240,160,0,0,860
21113,160,120,120,160,0,0,560
21114,140,100,40,0,0,0,280
21115,170,100,120,0,0,0,390
21116,200,120,120,160,160,0,760
21117,240,160,80,160,320,0,960
21118,220,140,40,0,0,0,400
21119,180,100,0,0,0,0,280
21120,220,100,120,80,160,0,680
21121,180,140,40,80,160,0,600
21122,180,120,160,80,160,0,700
21123,200,80,120,160,160,0,720
21124,200,120,80,0,0,0,400
21125,180,120,120,80,160,320,980
21126,220,140,120,80,160,320,1040
21127,190,120,120,240,160,0,830
21128,220,160,200,240,320,320,1460
21129,180,100,120,160,160,0,720
21130,200,100,80,80,160,0,620
21131,190,100,40,0,0,0,330
21132,180,140,120,160,160,0,760
21133,160,180,120,0,0,0,460
21134,160,120,120,160,160,0,720
21135,240,160,80,80,0,0,560
21136,210,120,120,80,160,0,690
21137,210,100,80,0,0,0,390
21138,190,100,120,160,160,320,1050
21139,230,120,40,80,160,320,950
21140,180,160,80,80,160,320,980
21141,170,60,40,0,0,0,270
21142,190,160,120,80,160,0,710
21143,180,160,200,160,160,0,860
21144,150,60,80,160,160,0,610
21145,180,140,120,80,0,0,520
21146,210,100,40,0,0,0,350
21147,190,120,40,0,0,0,350
21148,230,140,80,160,160,0,770
21149,220,120,120,80,160,320,1020
21150,180,120,40,80,160,0,580
21151,210,100,80,80,160,0,630
21152,200,140,80,80,160,0,660
21153,200,120,120,160,160,320,1080
21154,170,160,160,160,160,0,810
21155,200,100,120,240,320,320,1300
21156,180,180,160,80,0,0,600
21157,190,160,160,80,160,320,1070
21158,180,100,120,160,0,0,560
21159,190,40,40,80,160,0,510
21160,200,160,80,80,0,0,520
21161,190,100,80,80,160,320,930
21162,200,100,40,0,0,0,340
21163,240,140,120,160,160,0,820
21164,190,100,40,0,0,0,330
21165,200,120,120,240,320,0,1000
21166,170,120,160,240,320,320,1330
21167,240,180,160,80,160,0,820
21168,220,100,40,80,160,0,600
21169,190,140,200,160,320,0,1010
21170,170,100,80,0,0,0,350
21171,210,140,120,160,320,0,950
21172,200,140,120,160,0,0,620
21173,220,140,160,160,0,0,680
21174,210,100,120,0,0,0,430
21175,160,100,80,160,320,0,820
21176,190,80,80,80,160,0,590
21177,210,160,80,80,0,0,530
21178,180,160,160,160,160,0,820
21179,180,180,120,80,0,0,560
21180,190,80,40,0,0,0,310
21181,170,40,40,80,160,0,490
21182,220,200,160,80,0,0,660
21183,180,120,0,0,0,0,300
21184,200,160,160,80,160,0,760
21185,200,100,120,160,160,0,740
21186,170,120,160,240,320,0,1010
21187,200,60,80,160,320,320,1140
21188,210,160,80,80,160,0,690
21189,230,120,80,80,160,0,670
21190,180,120,120,160,320,320,1220
21191,160,160,120,160,160,0,760
21192,200,120,80,80,0,0,480
21193,260,120,80,0,0,0,460
21194,200,100,80,80,160,0,620
21195,200,160,80,0,0,0,440
21196,160,120,160,160,320,320,1240
21197,180,180,120,160,160,0,800
21198,190,160,40,80,160,0,630
21199,190,100,160,160,320,0,930
21200,170,100,40,80,160,0,550
21201,190,140,160,160,320,0,970
21202,220,60,0,0,0,0,280
21203,170,120,120,160,160,0,730
21204,180,140,80,80,160,0,640
21205,170,100,160,240,320,320,1310
21206,190,120,40,0,0,0,350
21207,190,180,160,240,160,0,930
21208,170,120,120,160,160,0,730
21209,200,100,40,80,160,320,900
21210,210,60,80,160,0,0,510
21211,210,120,160,80,160,0,730
21212,210,100,80,0,0,0,390
21213,190,140,80,80,0,0,490
21214,210,200,120,80,0,0,610
21215,230,140,160,80,160,320,1090
21216,200,100,80,0,0,0,380
21217,200,140,120,240,160,0,860
21218,210,120,120,160,320,0,930
21219,190,120,120,240,160,0,830
21220,200,100,160,160,0,0,620
21221,180,120,160,240,160,0,860
21222,190,100,120,80,160,0,650
21223,220,140,40,0,0,0,400
21224,180,160,160,240,160,0,900
21225,190,140,160,80,160,0,730
21226,200,100,80,0,0,0,380
21227,170,60,40,80,160,0,510
21228,190,100,120,160,160,320,1050
21229,200,60,80,80,160,0,580
21230,200,140,120,160,160,0,780
21231,230,140,80,160,160,0,770
21232,200,200,120,160,160,0,840
21233,150,120,160,160,0,0,590
21234,200,100,0,0,0,0,300
21235,200,140,160,80,160,0,740
21236,230,140,40,0,0,0,410
21237,250,160,120,80,160,320,1090
21238,210,120,80,80,160,320,970
21239,160,120,160,80,160,0,680
21240,150,60,40,80,160,0,490
21241,210,140,240,80,160,0,830
21242,200,140,120,0,0,0,460
21243,170,100,160,80,160,320,990
21244,200,140,80,80,160,0,660
21245,170,140,200,160,160,0,830
21246,230,80,40,80,0,0,430
21247,220,120,120,80,160,0,700
21248,230,220,160,240,160,320,1330
21249,220,160,160,160,160,0,860
21250,200,100,120,80,0,0,500
21251,180,80,40,80,160,0,540
21252,180,100,80,80,160,320,920
21253,230,140,80,0,0,0,450
21254,170,120,120,240,160,0,810
21255,210,160,120,160,160,320,1130
21256,160,100,0,0,0,0,260
21257,210,120,120,80,160,0,690
21258,170,140,80,0,0,0,390
21259,190,180,80,80,0,0,530
21260,200,120,0,0,0,0,320
21261,210,100,120,80,160,0,670
21262,220,120,120,0,0,0,460
21263,200,160,80,0,0,0,440
21264,190,60,80,0,0,0,330
21265,160,100,40,0,0,0,300
21266,200,140,160,240,320,320,1380
21267,190,100,80,80,160,320,930
21268,230,120,120,160,320,320,1270
21269,190,80,120,80,0,0,470
21270,180,180,80,80,160,320,1000
21271,190,80,40,80,160,320,870
21272,220,140,120,160,160,0,800
21273,200,100,160,0,0,0,460
21274,210,140,40,0,0,0,390
21275,220,160,120,160,160,0,820
21276,180,200,160,160,0,0,700
21277,180,80,40,80,160,0,540
21278,190,100,120,80,160,0,650
21279,190,120,120,160,160,0,750
21280,210,80,120,160,320,0,890
21281,180,140,160,160,320,0,960
21282,190,80,40,80,160,0,550
21283,190,140,120,0,0,0,450
21284,210,120,120,80,0,0,530
21285,160,100,40,0,0,0,300
21286,190,140,120,80,160,320,1010
21287,180,120,160,160,160,320,1100
21288,160,120,80,80,160,0,600
21289,210,80,40,0,0,0,330
21290,190,120,120,0,0,0,430
21291,190,80,80,160,0,0,510
21292,230,160,80,80,160,0,710
21293,160,60,0,0,0,0,220
21294,200,160,120,80,160,0,720
21295,200,80,120,160,320,0,880
21296,190,160,80,80,160,0,670
21297,210,120,160,160,160,0,810
21298,220,160,120,80,0,0,580
21299,220,160,120,80,0,0,580
21300,220,100,40,80,160,0,600
21301,210,120,120,160,160,320,1090
21302,210,140,120,80,160,320,1030
21303,190,120,120,80,160,0,670
21304,190,80,40,80,0,0,390
21305,250,140,120,240,320,320,1390
21306,190,100,80,80,160,0,610
21307,190,100,80,80,160,0,610
21308,230,100,120,160,160,0,770
21309,200,160,200,160,160,0,880
21310,200,120,0,0,0,0,320
21311,230,160,160,160,160,0,870
21312,230,120,160,80,0,0,590
21313,210,140,120,160,0,0,630
21314,160,80,40,0,0,0,280
21315,160,120,80,80,160,0,600
21316,160,180,200,160,160,0,860
21317,160,120,80,160,0,0,520
21318,170,80,120,80,160,0,610
21319,200,120,80,80,0,0,480
21320,230,80,0,0,0,0,310
21321,180,180,120,160,0,0,640
21322,200,180,160,160,160,0,860
21323,250,160,80,160,160,0,810
21324,200,180,160,160,320,0,1020
21325,220,120,120,0,0,0,460
21326,190,160,200,240,0,0,790
21327,220,140,160,160,160,0,840
21328,140,100,40,80,160,0,520
21329,210,100,80,80,0,0,470
21330,210,140,120,80,160,0,710
21331,210,160,80,80,160,0,690
21332,190,120,120,80,160,0,670
21333,160,100,80,160,160,0,660
21334,190,100,160,240,160,320,1170
21335,160,120,120,80,160,0,640
21336,190,120,80,80,160,0,630
21337,210,100,40,0,0,0,350
21338,220,100,80,0,0,0,400
21339,200,120,120,80,0,0,520
21340,160,100,80,80,160,320,900
21341,200,200,120,80,0,0,600
21342,220,180,200,160,160,0,920
21343,190,160,160,160,160,0,830
21344,200,100,80,80,160,0,620
21345,240,120,80,0,0,0,440
21346,200,60,80,80,160,0,580
21347,240,140,120,80,0,0,580
21348,170,100,80,80,0,0,430
21349,180,140,80,160,0,0,560
21350,200,100,80,0,0,0,380
21351,170,100,120,160,0,0,550
21352,170,100,80,80,160,0,590
21353,150,60,80,80,0,0,370
21354,200,100,0,0,0,0,300
21355,170,80,120,80,160,320,930
21356,210,60,80,160,160,0,670
21357,200,160,80,0,0,0,440
21358,220,140,120,80,160,0,720
21359,170,100,80,80,160,0,590
21360,180,80,80,80,0,0,420
21361,210,140,80,160,160,0,750
21362,190,120,120,160,160,0,750
21363,200,120,0,0,0,0,320
21364,170,180,160,0,0,0,510
21365,170,120,120,160,160,0,730
21366,210,120,80,80,160,0,650
21367,230,120,120,80,0,0,550
21368,230,140,40,0,0,0,410
21369,200,120,80,80,160,0,640
21370,150,100,80,80,0,0,410
21371,200,100,120,160,160,320,1060
21372,160,100,120,80,0,0,460
21373,160,140,80,80,160,0,620
21374,190,100,120,80,160,0,650
21375,200,160,80,80,0,0,520
21376,170,100,120,160,0,0,550
21377,240,160,80,160,160,320,1120
21378,220,120,80,80,160,0,660
21379,200,120,120,80,0,0,520
21380,180,120,120,240,160,0,820
21381,200,140,80,80,0,0,500
21382,160,60,0,0,0,0,220
21383,170,140,80,80,160,0,630
21384,180,120,80,160,320,0,860
21385,210,100,120,240,320,0,990
21386,190,80,80,80,0,0,430
21387,210,100,80,160,0,0,550
21388,180,180,160,80,0,0,600
21389,190,80,40,0,0,0,310
21390,180,140,120,0,0,0,440
21391,200,160,40,80,160,0,640
21392,210,140,160,0,0,0,510
21393,160,120,120,160,160,0,720
21394,200,80,120,80,160,0,640
21395,200,80,0,0,0,0,280
21396,190,180,160,160,160,0,850
21397,170,60,80,80,160,0,550
21398,230,180,200,160,320,0,1090
21399,230,100,80,80,160,0,650
21400,190,160,120,240,160,0,870
21401,210,120,120,160,160,0,770
21402,220,140,160,240,320,0,1080
21403,210,100,80,160,160,0,710
21404,140,80,80,80,0,0,380
21405,200,140,80,160,160,0,740
21406,220,140,240,160,160,0,920
21407,220,140,120,160,0,0,640
21408,200,140,160,80,0,0,580
21409,220,120,160,80,160,0,740
21410,200,100,40,0,0,0,340
21411,210,180,160,240,160,0,950
21412,180,100,0,0,0,0,280
21413,190,180,120,80,0,0,570
21414,190,80,80,80,160,320,910
21415,210,160,160,80,0,0,610
21416,200,140,120,160,320,0,940
21417,190,80,80,80,160,0,590
21418,170,80,80,80,0,0,410
21419,200,140,80,80,160,320,980
21420,190,120,160,160,160,0,790
21421,170,100,120,160,320,0,870
21422,180,100,120,0,0,0,400
21423,220,120,120,80,0,0,540
21424,230,140,120,160,160,0,810
21425,210,200,80,0,0,0,490
21426,180,120,200,160,160,0,820
21427,190,120,80,80,0,0,470
21428,180,120,200,160,320,0,980
21429,210,140,80,0,0,0,430
21430,220,120,200,160,160,0,860
21431,200,100,160,160,320,0,940
21432,170,120,160,80,0,0,530
21433,210,100,0,0,0,0,310
21434,250,120,120,160,160,0,810
21435,200,160,80,0,0,0,440
21436,210,60,80,80,0,0,430
21437,200,160,80,0,0,0,440
21438,210,100,160,160,320,0,950
21439,190,120,80,160,320,320,1190
21440,220,180,120,0,0,0,520
21441,220,120,80,80,160,320,980
21442,200,160,80,80,160,0,680
21443,210,100,80,0,0,0,390
21444,190,140,0,0,0,0,330
21445,160,160,160,80,0,0,560
21446,230,140,40,80,160,0,650
21447,170,80,80,80,0,0,410
21448,210,140,160,240,0,0,750
21449,190,140,160,80,160,320,1050
21450,180,140,120,80,160,0,680
21451,190,100,40,80,160,0,570
21452,240,160,120,80,0,0,600
21453,220,160,160,160,160,0,860
21454,180,140,160,160,320,0,960
21455,200,160,160,80,0,0,600
21456,210,180,200,160,160,0,910
21457,210,140,80,80,160,0,670
21458,210,100,160,240,320,0,1030
21459,210,140,120,0,0,0,470
21460,230,180,120,160,0,0,690
21461,220,120,0,0,0,0,340
21462,180,140,120,240,320,0,1000
21463,200,140,160,240,160,0,900
21464,190,40,40,0,0,0,270
21465,200,160,120,160,320,320,1280
21466,200,120,80,80,0,0,480
21467,200,100,40,0,0,0,340
21468,240,160,120,80,0,0,600
21469,220,160,160,80,160,0,780
21470,210,140,160,160,0,0,670
21471,190,100,80,80,0,0,450
21472,190,100,40,80,160,0,570
21473,210,120,160,80,160,0,730
21474,180,80,0,0,0,0,260
21475,190,120,120,160,160,320,1070
21476,170,140,80,160,160,320,1030
21477,190,120,160,160,160,320,1110
21478,190,140,80,80,160,0,650
21479,160,180,160,160,0,0,660
21480,200,120,160,80,0,0,560
21481,170,140,120,240,320,320,1310
21482,190,160,120,240,320,0,1030
21483,240,120,80,80,160,0,680
21484,220,100,120,80,160,0,680
21485,280,160,120,160,160,0,880
21486,200,120,80,0,0,0,400
21487,200,120,80,80,0,0,480
21488,190,120,80,160,160,0,710
21489,240,80,120,80,160,320,1000
21490,170,120,120,160,160,0,730
21491,190,120,80,80,160,0,630
21492,200,100,120,240,160,0,820
21493,230,160,80,160,160,0,790
21494,240,180,80,0,0,0,500
21495,200,140,80,80,160,0,660
21496,200,80,40,80,0,0,400
21497,160,100,80,80,160,0,580
21498,190,160,200,80,160,0,790
21499,180,80,80,160,320,0,820
21500,190,100,80,80,160,320,930
21501,200,120,160,80,0,0,560
21502,190,100,80,0,0,0,370
21503,210,80,0,0,0,0,290
21504,220,120,200,160,0,0,700
21505,170,100,80,160,320,0,830
21506,200,140,120,160,160,320,1100
21507,210,160,120,0,0,0,490
21508,190,180,160,80,0,0,610
21509,230,140,160,160,160,0,850
21510,210,120,160,80,160,0,730
21511,250,140,40,80,0,0,510
21512,220,120,120,0,0,0,460
21513,180,100,80,80,0,0,440
21514,220,160,160,80,160,0,780
21515,200,140,120,0,0,0,460
21516,250,140,120,160,160,0,830
21517,190,160,120,0,0,0,470
21518,180,80,160,160,160,0,740
21519,210,160,80,80,160,0,690
21520,190,80,120,160,160,320,1030
21521,220,140,120,160,160,0,800
21522,190,140,200,240,320,320,1410
21523,190,100,40,80,0,0,410
21524,200,160,160,160,160,0,840
21525,170,100,120,160,320,0,870
21526,200,140,200,160,160,320,1180
21527,200,100,80,80,160,320,940
21528,190,160,200,80,160,320,1110
21529,200,60,40,80,160,0,540
21530,220,140,200,240,0,0,800
21531,230,160,200,160,320,0,1070
21532,180,100,80,0,0,0,360
21533,190,120,80,80,160,320,950
21534,160,120,80,80,160,0,600
21535,220,120,160,160,0,0,660
21536,240,180,80,0,0,0,500
21537,170,100,80,80,160,0,590
21538,170,120,80,160,320,320,1170
21539,190,100,80,0,0,0,370
21540,200,160,120,80,160,320,1040
21541,170,80,120,80,160,0,610
21542,230,140,120,0,0,0,490
21543,190,140,200,160,160,0,850
21544,220,160,120,160,160,320,1140
21545,170,100,80,80,160,0,590
21546,130,80,120,80,160,0,570
21547,200,120,120,160,0,0,600
21548,190,180,160,80,0,0,610
21549,200,140,160,80,0,0,580
21550,210,140,80,0,0,0,430
21551,180,180,240,240,160,320,1320
21552,160,80,40,80,160,0,520
21553,200,140,160,240,160,0,900
21554,220,140,120,160,160,0,800
21555,170,140,120,80,160,0,670
21556,160,180,80,0,0,0,420
21557,190,140,40,80,160,0,610
21558,160,120,80,80,160,0,600
21559,200,100,80,160,160,0,700
21560,180,140,80,0,0,0,400
21561,190,140,80,80,160,0,650
21562,210,160,160,80,160,0,770
21563,200,60,40,80,0,0,380
21564,200,80,0,0,0,0,280
21565,170,140,120,80,0,0,510
21566,200,120,120,160,320,0,920
21567,160,80,80,0,0,0,320
21568,160,120,120,160,160,320,1040
21569,200,100,40,0,0,0,340
21570,210,120,160,80,160,0,730
21571,210,200,200,160,160,0,930
21572,220,180,160,160,160,0,880
21573,160,120,160,80,0,0,520
21574,200,160,80,80,160,0,680
21575,200,80,40,0,0,0,320
21576,180,120,120,80,160,320,980
21577,200,80,160,160,0,0,600
21578,230,140,120,80,160,0,730
21579,180,100,120,240,320,0,960
21580,230,160,160,160,0,0,710
21581,210,160,80,160,160,0,770
21582,180,80,40,0,0,0,300
21583,200,100,120,80,160,320,980
21584,180,80,80,0,0,0,340
21585,170,140,80,80,160,0,630
21586,140,20,40,80,160,0,440
21587,210,180,80,80,0,0,550
21588,230,120,120,160,160,0,790
21589,260,180,80,80,160,0,760
21590,200,180,80,160,160,0,780
21591,200,100,120,80,160,0,660
21592,190,140,120,160,160,0,770
21593,190,60,80,160,160,0,650
21594,170,100,0,0,0,0,270
21595,190,120,200,80,0,0,590
21596,200,140,160,160,0,0,660
21597,200,120,120,0,0,0,440
21598,190,120,80,80,160,0,630
21599,150,80,80,160,160,320,950
21600,190,80,120,80,160,0,630
21601,220,140,80,0,0,0,440
21602,200,160,80,80,160,0,680
21603,210,140,120,80,160,0,710
21604,180,100,40,0,0,0,320
21605,220,180,160,160,0,0,720
21606,190,120,120,80,0,0,510
21607,180,140,160,160,0,0,640
21608,190,120,120,160,320,0,910
21609,160,140,80,80,160,0,620
21610,190,80,80,80,160,0,590
21611,240,120,160,0,0,0,520
21612,210,120,40,0,0,0,370
21613,180,100,80,160,160,0,680
21614,190,80,80,0,0,0,350
21615,190,100,40,80,160,0,570
21616,200,120,80,80,0,0,480
21617,180,100,80,160,160,320,1000
21618,200,140,80,160,320,0,900
21619,190,140,200,160,0,0,690
21620,210,80,80,80,0,0,450
21621,150,20,0,0,0,0,170
21622,220,100,80,80,0,0,480
21623,200,160,120,80,0,0,560
21624,220,160,160,0,0,0,540
21625,190,100,120,80,160,0,650
21626,210,80,80,80,160,0,610
21627,190,100,40,80,160,0,570
21628,200,100,120,80,0,0,500
21629,170,120,120,160,320,320,1210
21630,180,140,160,160,320,0,960
21631,140,80,40,0,0,0,260
21632,180,100,80,80,160,0,600
21633,190,140,160,160,160,0,810
21634,210,60,120,80,0,0,470
21635,180,80,160,240,320,320,1300
21636,200,160,160,240,160,0,920
21637,140,120,80,80,160,0,580
21638,170,140,160,80,160,320,1030
21639,200,140,120,160,0,0,620
21640,200,80,40,80,160,320,880
21641,200,100,120,160,160,320,1060
21642,220,120,200,240,160,320,1260
21643,200,140,80,80,0,0,500
21644,160,80,80,160,320,0,800
21645,220,160,80,80,160,320,1020
21646,200,120,120,240,320,0,1000
21647,230,100,120,160,0,0,610
21648,180,80,80,80,160,0,580
21649,200,120,120,80,160,0,680
21650,180,60,40,0,0,0,280
21651,180,140,80,80,0,0,480
21652,190,100,80,0,0,0,370
21653,220,100,80,160,160,0,720
21654,210,80,160,80,160,0,690
21655,230,160,80,80,0,0,550
21656,230,140,80,0,0,0,450
21657,200,160,120,160,160,0,800
21658,190,160,120,0,0,0,470
21659,210,80,80,80,0,0,450
21660,190,140,80,80,0,0,490
21661,180,140,40,80,0,0,440
21662,190,120,120,80,160,0,670
21663,230,140,40,0,0,0,410
21664,210,120,120,240,320,0,1010
21665,210,140,80,160,160,320,1070
21666,200,120,120,80,160,320,1000
21667,230,100,80,80,160,0,650
21668,160,80,40,80,160,0,520
21669,210,100,80,80,160,320,950
21670,200,120,120,80,0,0,520
21671,170,140,160,240,160,320,1190
21672,180,100,40,80,160,0,560
21673,190,100,40,0,0,0,330
21674,200,160,40,0,0,0,400
21675,230,100,120,80,160,0,690
21676,200,120,160,240,320,0,1040
21677,170,80,0,0,0,0,250
21678,160,120,80,0,0,0,360
21679,220,120,120,160,320,0,940
21680,170,120,200,160,320,0,970
21681,180,60,80,0,0,0,320
21682,210,140,80,80,160,320,990
21683,190,220,120,80,0,0,610
21684,200,160,200,160,320,320,1360
21685,230,160,160,80,160,0,790
21686,130,80,80,80,0,0,370
21687,220,120,160,160,160,320,1140
21688,210,160,80,0,0,0,450
21689,210,80,40,80,0,0,410
21690,210,140,120,80,0,0,550
21691,190,60,0,0,0,0,250
21692,220,120,120,80,160,0,700
21693,220,120,120,240,160,0,860
21694,200,60,80,80,0,0,420
21695,220,100,120,80,160,0,680
21696,250,100,160,160,160,0,830
21697,210,120,40,80,0,0,450
21698,180,200,120,80,160,0,740
21699,180,100,80,80,160,0,600
21700,200,120,80,80,160,0,640
21701,200,80,120,80,160,320,960
21702,210,80,80,160,320,0,850
21703,170,100,40,80,0,0,390
21704,180,140,160,160,160,0,800
21705,170,80,80,80,160,0,570
21706,210,120,80,160,320,320,1210
21707,210,140,120,80,160,0,710
21708,180,140,40,80,0,0,440
21709,180,80,120,160,160,0,700
21710,230,160,120,80,160,0,750
21711,200,160,200,160,160,0,880
21712,170,120,120,80,160,320,970
21713,210,120,80,0,0,0,410
21714,170,100,80,80,0,0,430
21715,200,140,40,80,160,0,620
21716,180,120,160,240,160,0,860
21717,180,100,80,0,0,0,360
21718,210,140,80,0,0,0,430
21719,180,40,80,80,0,0,380
21720,180,140,120,0,0,0,440
21721,190,80,120,0,0,0,390
21722,210,40,40,0,0,0,290
21723,200,80,40,80,0,0,400
21724,200,140,80,80,160,320,980
21725,200,140,160,160,0,0,660
21726,230,140,120,80,160,0,730
21727,200,140,80,0,0,0,420
21728,190,120,160,160,160,0,790
21729,230,140,80,0,0,0,450
21730,140,140,200,80,0,0,560
21731,170,120,80,80,0,0,450
21732,180,80,40,0,0,0,300
21733,170,140,120,80,160,0,670
21734,230,200,120,160,160,0,870
21735,210,100,120,80,160,0,670
21736,200,120,120,160,160,0,760
21737,180,120,120,160,160,0,740
21738,240,80,40,0,0,0,360
21739,210,160,80,0,0,0,450
21740,210,80,160,80,0,0,530
21741,200,140,160,240,160,0,900
21742,180,100,80,80,160,0,600
21743,190,140,80,80,160,0,650
21744,150,100,80,80,160,320,890
21745,190,100,120,0,0,0,410
21746,200,120,120,80,160,0,680
21747,230,140,120,160,160,320,1130
21748,200,200,80,80,160,320,1040
21749,240,180,200,160,160,0,940
21750,210,100,80,80,0,0,470
21751,230,180,120,240,320,0,1090
21752,200,100,80,0,0,0,380
21753,220,120,120,80,160,0,700
21754,250,180,160,160,160,0,910
21755,200,120,80,80,160,0,640
21756,220,140,80,0,0,0,440
21757,190,120,120,80,160,0,670
21758,220,140,80,160,160,0,760
21759,230,200,120,80,0,0,630
21760,160,120,120,160,160,0,720
21761,220,180,120,80,0,0,600
21762,210,160,160,160,320,0,1010
21763,230,160,80,80,160,0,710
21764,150,100,120,160,160,0,690
21765,170,140,80,160,160,0,710
21766,240,160,240,320,160,0,1120
21767,250,160,200,80,0,0,690
21768,170,80,120,0,0,0,370
21769,170,140,120,160,160,0,750
21770,190,120,80,80,0,0,470
21771,160,120,120,160,0,0,560
21772,180,140,120,80,160,320,1000
21773,210,120,80,0,0,0,410
21774,220,140,120,160,160,0,800
21775,230,140,120,160,320,320,1290
21776,190,120,80,0,0,0,390
21777,220,140,120,80,0,0,560
21778,140,80,40,0,0,0,260
21779,180,120,40,80,160,0,580
21780,170,80,40,0,0,0,290
21781,180,140,80,80,160,0,640
21782,160,80,80,0,0,0,320
21783,160,80,40,80,0,0,360
21784,180,100,40,80,160,0,560
21785,210,160,80,0,0,0,450
21786,220,100,40,80,160,0,600
21787,170,80,40,0,0,0,290
21788,180,160,160,160,160,0,820
21789,210,100,40,80,160,0,590
21790,210,220,80,80,160,0,750
21791,230,120,80,0,0,0,430
21792,180,120,80,0,0,0,380
21793,240,60,80,80,160,0,620
21794,160,140,80,160,320,320,1180
21795,180,140,120,240,320,320,1320
21796,180,180,160,160,0,0,680
21797,210,160,160,160,160,320,1170
21798,220,180,200,80,0,0,680
21799,170,120,80,0,0,0,370
21800,150,100,80,0,0,0,330
21801,180,160,120,160,160,0,780
21802,230,160,80,80,160,0,710
21803,240,180,200,160,320,0,1100
21804,210,100,40,0,0,0,350
21805,220,180,80,0,0,0,480
21806,200,120,160,0,0,0,480
21807,220,100,120,80,0,0,520
21808,190,140,160,80,0,0,570
21809,240,180,80,80,0,0,580
21810,220,140,200,80,160,0,800
21811,190,200,200,240,0,0,830
21812,200,140,80,80,160,0,660
21813,180,120,200,160,160,0,820
21814,180,120,80,0,0,0,380
21815,220,140,80,80,160,0,680
21816,260,160,120,160,160,320,1180
21817,210,60,40,80,160,0,550
21818,250,120,80,0,0,0,450
21819,180,120,80,80,160,0,620
21820,180,160,40,80,160,0,620
21821,200,80,40,80,160,0,560
21822,230,160,120,160,160,0,830
21823,230,160,80,0,0,0,470
21824,200,100,120,160,0,0,580
21825,210,100,80,80,0,0,470
21826,180,120,120,160,320,0,900
21827,230,120,120,80,0,0,550
21828,210,140,80,0,0,0,430
21829,180,140,120,80,160,0,680
21830,220,140,120,160,320,0,960
21831,190,120,120,160,0,0,590
21832,170,80,120,80,0,0,450
21833,230,160,120,80,160,0,750
21834,230,120,160,160,160,0,830
21835,160,80,80,80,160,0,560
21836,200,140,200,80,160,320,1100
21837,220,140,120,160,160,320,1120
21838,160,140,120,160,0,0,580
21839,230,120,80,80,160,320,990
21840,170,120,80,0,0,0,370
21841,150,100,80,160,160,0,650
21842,230,160,120,160,320,0,990
21843,200,140,120,80,160,0,700
21844,210,120,80,160,160,0,730
21845,180,120,0,0,0,0,300
21846,200,120,120,160,0,0,600
21847,210,100,40,0,0,0,350
21848,200,160,160,80,160,320,1080
21849,190,60,80,80,160,0,570
21850,220,120,80,80,160,0,660
21851,210,120,80,80,160,0,650
21852,210,160,120,160,0,0,650
21853,190,100,120,160,160,0,730
21854,160,100,120,160,160,0,700
21855,190,80,120,160,160,0,710
21856,190,80,80,80,160,0,590
21857,190,120,160,160,160,320,1110
21858,170,120,80,80,160,0,610
21859,180,100,120,160,320,320,1200
21860,190,60,40,0,0,0,290
21861,190,120,120,160,160,0,750
21862,180,140,40,80,0,0,440
21863,210,120,120,160,160,320,1090
21864,220,140,160,160,320,0,1000
21865,200,140,120,0,0,0,460
21866,170,120,80,80,160,0,610
21867,200,160,160,80,0,0,600
21868,200,60,40,0,0,0,300
21869,150,120,40,80,160,0,550
21870,170,40,40,0,0,0,250
21871,200,120,160,160,160,320,1120
21872,180,100,120,80,0,0,480
21873,180,180,160,240,0,0,760
21874,220,100,160,240,320,0,1040
21875,180,160,160,240,160,0,900
21876,220,140,120,80,0,0,560
21877,190,120,120,240,160,0,830
21878,250,100,40,0,0,0,390
21879,200,140,80,80,0,0,500
21880,190,160,120,80,0,0,550
21881,170,140,160,160,160,0,790
21882,150,100,80,160,160,0,650
21883,200,80,120,80,160,0,640
21884,200,160,160,160,320,320,1320
21885,160,100,40,80,0,0,380
21886,170,100,80,80,0,0,430
21887,190,120,120,160,160,0,750
21888,230,140,120,80,160,320,1050
21889,210,120,120,160,160,0,770
21890,160,120,80,80,160,0,600
21891,220,140,120,160,320,0,960
21892,190,100,0,0,0,0,290
21893,190,160,120,80,0,0,550
21894,220,120,120,80,160,0,700
21895,210,80,80,80,160,0,610
21896,240,60,80,0,0,0,380
21897,150,40,40,80,160,0,470
21898,200,120,120,240,320,0,1000
21899,230,100,80,80,160,0,650
21900,180,100,120,80,0,0,480
21901,240,120,120,0,0,0,480
21902,180,140,40,80,0,0,440
21903,200,120,120,160,320,320,1240
21904,200,100,40,0,0,0,340
21905,190,120,80,80,160,0,630
21906,200,120,120,80,0,0,520
21907,200,120,80,0,0,0,400
21908,200,160,200,160,160,0,880
21909,210,60,0,0,0,0,270
21910,170,100,120,240,320,0,950
21911,160,140,120,80,160,0,660
21912,170,60,80,160,160,0,630
21913,200,120,80,80,160,320,960
21914,220,140,120,80,0,0,560
21915,190,100,40,0,0,0,330
21916,180,160,120,160,160,0,780
21917,180,140,200,160,160,0,840
21918,220,140,160,80,160,0,760
21919,220,100,80,160,0,0,560
21920,180,120,160,80,160,0,700
21921,220,180,120,160,160,320,1160
21922,180,80,120,80,160,0,620
21923,160,60,0,0,0,0,220
21924,180,100,120,80,0,0,480
21925,200,60,80,160,320,320,1140
21926,160,60,120,80,160,0,580
21927,210,100,160,160,160,0,790
21928,210,140,120,0,0,0,470
21929,170,140,40,80,0,0,430
21930,180,100,80,0,0,0,360
21931,220,60,0,0,0,0,280
21932,200,180,40,80,160,0,660
21933,180,80,40,80,0,0,380
21934,190,100,80,80,160,0,610
21935,200,120,40,80,160,0,600
21936,200,140,200,160,160,0,860
21937,190,160,40,80,160,0,630
21938,230,160,120,80,0,0,590
21939,170,80,80,80,160,0,570
21940,260,160,120,160,160,0,860
21941,200,140,160,0,0,0,500
21942,220,140,120,160,160,0,800
21943,220,140,80,0,0,0,440
21944,230,160,120,160,160,0,830
21945,190,120,160,240,320,0,1030
21946,200,160,160,80,0,0,600
21947,190,120,40,80,160,0,590
21948,200,140,40,80,160,0,620
21949,160,60,40,80,0,0,340
21950,160,40,40,80,160,320,800
21951,190,140,40,0,0,0,370
21952,220,100,120,160,160,0,760
21953,200,100,120,160,160,0,740
21954,180,80,120,80,160,320,940
21955,230,140,80,80,160,0,690
21956,260,100,160,160,160,0,840
21957,190,120,80,80,160,0,630
21958,230,120,160,80,0,0,590
21959,230,80,80,160,320,0,870
21960,190,140,120,80,0,0,530
21961,200,100,40,80,0,0,420
21962,200,140,160,240,0,0,740
21963,200,80,80,80,160,0,600
21964,190,160,160,160,160,0,830
21965,200,140,80,80,0,0,500
21966,230,60,80,0,0,0,370
21967,210,160,80,80,0,0,530
21968,210,100,0,0,0,0,310
21969,170,100,80,80,0,0,430
21970,190,120,120,80,160,320,990
21971,200,100,120,240,160,0,820
21972,200,140,80,160,160,0,740
21973,180,140,80,80,160,0,640
21974,190,140,200,0,0,0,530
21975,180,140,120,80,160,0,680
21976,160,120,80,80,160,320,920
21977,140,140,120,80,0,0,480
21978,180,60,80,0,0,0,320
21979,230,120,120,160,0,0,630
21980,220,100,120,160,320,0,920
21981,220,100,80,0,0,0,400
21982,170,80,40,80,0,0,370
21983,160,100,80,0,0,0,340
21984,170,140,200,240,160,0,910
21985,180,100,80,0,0,0,360
21986,250,180,200,160,160,0,950
21987,190,100,120,160,0,0,570
21988,210,140,120,80,160,0,710
21989,200,160,200,80,160,0,800
21990,190,100,80,80,0,0,450
21991,230,140,120,80,160,0,730
21992,190,100,120,80,160,0,650
21993,150,100,80,160,0,0,490
21994,170,120,80,160,320,320,1170
21995,200,100,120,80,0,0,500
21996,190,120,80,0,0,0,390
21997,210,160,120,80,160,320,1050
21998,210,140,160,0,0,0,510
21999,240,140,200,240,0,0,820
22000,180,120,120,80,160,0,660
22001,160,140,120,80,160,0,660
22002,180,140,120,80,0,0,520
22003,170,80,80,80,160,0,570
22004,230,140,160,160,160,0,850
22005,190,80,80,80,160,0,590
22006,180,120,80,160,0,0,540
22007,220,140,120,160,320,0,960
22008,170,100,80,80,160,0,590
22009,200,80,80,80,160,320,920
22010,160,140,80,80,0,0,460
22011,190,120,80,160,320,0,870
22012,160,140,120,160,160,0,740
22013,170,120,120,160,160,0,730
22014,200,160,80,80,0,0,520
22015,210,80,120,240,320,320,1290
22016,210,120,120,80,160,0,690
22017,180,120,160,160,160,0,780
22018,170,160,120,80,160,320,1010
22019,210,160,80,80,0,0,530
22020,210,100,80,80,0,0,470
22021,190,120,120,80,0,0,510
22022,210,180,200,160,160,0,910
22023,210,140,40,0,0,0,390
22024,220,40,40,0,0,0,300
22025,210,120,80,160,160,0,730
22026,200,80,120,160,160,0,720
22027,190,120,120,80,160,0,670
22028,170,120,120,80,0,0,490
22029,200,80,40,0,0,0,320
22030,240,120,80,0,0,0,440
22031,210,140,120,80,0,0,550
22032,200,160,200,160,160,0,880
22033,170,120,80,0,0,0,370
22034,210,140,80,0,0,0,430
22035,220,160,120,160,160,320,1140
22036,210,140,160,80,0,0,590
22037,200,60,80,0,0,0,340
22038,170,60,40,80,160,0,510
22039,190,120,120,160,160,0,750
22040,220,160,40,80,0,0,500
22041,190,100,120,0,0,0,410
22042,190,80,40,80,160,0,550
22043,220,60,40,80,0,0,400
22044,210,160,160,80,160,0,770
22045,220,140,120,80,160,0,720
22046,190,100,40,80,160,0,570
22047,200,100,40,0,0,0,340
22048,190,100,40,80,160,0,570
22049,220,140,160,240,160,0,920
22050,200,140,200,80,160,320,1100
22051,250,100,0,0,0,0,350
22052,180,140,80,80,160,0,640
22053,230,120,80,0,0,0,430
22054,190,120,80,160,320,0,870
22055,210,160,160,160,160,0,850
22056,230,160,160,80,160,0,790
22057,200,140,40,80,0,0,460
22058,210,200,160,160,160,0,890
22059,200,140,120,0,0,0,460
22060,190,120,120,80,0,0,510
22061,180,120,160,160,160,320,1100
22062,250,120,120,160,320,0,970
22063,230,120,120,80,0,0,550
22064,220,140,80,160,0,0,600
22065,180,100,120,80,160,0,640
22066,170,100,40,80,0,0,390
22067,220,60,80,0,0,0,360
22068,150,140,120,80,160,0,650
22069,190,100,120,160,160,0,730
22070,260,180,160,80,0,0,680
22071,190,140,160,80,160,320,1050
22072,190,120,120,80,0,0,510
22073,210,120,120,160,160,0,770
22074,220,180,80,80,160,0,720
22075,190,140,120,160,0,0,610
22076,220,160,120,160,320,0,980
22077,190,120,120,160,0,0,590
22078,180,120,120,160,0,0,580
22079,240,140,120,240,320,0,1060
22080,210,180,160,160,160,0,870
22081,170,60,80,0,0,0,310
22082,190,120,160,240,160,320,1190
22083,210,80,40,0,0,0,330
22084,190,140,80,80,160,0,650
22085,190,120,0,0,0,0,310
22086,250,180,160,160,160,0,910
22087,180,100,40,0,0,0,320
22088,200,140,80,80,160,0,660
22089,150,120,80,80,160,320,910
22090,190,160,40,80,160,0,630
22091,230,140,120,160,320,0,970
22092,210,80,80,80,160,0,610
22093,180,80,80,160,320,0,820
22094,210,100,120,160,160,0,750
22095,180,120,160,80,160,0,700
22096,200,140,120,80,0,0,540
22097,190,80,120,160,320,0,870
22098,170,120,80,160,160,320,1010
22099,160,60,40,80,160,0,500
22100,190,80,80,80,160,320,910
22101,250,100,160,160,320,320,1310
22102,200,140,160,80,0,0,580
22103,180,100,80,160,320,320,1160
22104,210,100,160,0,0,0,470
22105,210,160,160,160,160,0,850
22106,220,120,160,160,320,0,980
22107,190,160,160,240,160,0,910
22108,210,160,120,160,320,320,1290
22109,190,40,40,0,0,0,270
22110,160,80,40,0,0,0,280
22111,150,80,80,160,160,0,630
22112,210,180,200,240,320,320,1470
22113,200,140,120,80,160,0,700
22114,200,140,120,80,0,0,540
22115,210,80,120,160,0,0,570
22116,190,80,80,80,160,0,590
22117,190,100,40,80,160,0,570
22118,220,180,200,160,0,0,760
22119,230,140,160,160,160,0,850
22120,230,100,80,160,320,320,1210
22121,220,100,40,80,160,0,600
22122,180,100,80,0,0,0,360
22123,220,80,40,0,0,0,340
22124,200,60,80,80,160,0,580
22125,220,160,120,160,160,0,820
22126,190,100,120,80,160,0,650
22127,200,140,80,80,160,0,660
22128,190,100,120,160,160,320,1050
22129,210,120,120,240,160,0,850
22130,190,140,160,160,160,0,810
22131,200,160,80,80,160,0,680
22132,180,140,120,0,0,0,440
22133,210,140,80,160,0,0,590
22134,230,100,80,0,0,0,410
22135,190,140,120,80,160,0,690
22136,190,140,120,80,0,0,530
22137,220,120,80,80,0,0,500
22138,190,100,120,80,0,0,490
22139,220,100,160,160,160,0,800
22140,180,140,120,160,0,0,600
22141,220,160,80,80,0,0,540
22142,140,160,160,160,160,320,1100
22143,170,120,80,160,160,320,1010
22144,180,160,120,160,0,0,620
22145,200,180,80,80,160,0,700
22146,240,140,40,80,160,0,660
22147,210,100,160,160,160,0,790
22148,200,120,120,160,160,320,1080
22149,210,180,120,80,160,0,750
22150,190,160,160,0,0,0,510
22151,210,140,80,80,0,0,510
22152,220,120,80,80,160,0,660
22153,210,160,160,160,0,0,690
22154,230,80,80,80,160,0,630
22155,160,60,80,80,160,0,540
22156,160,60,120,160,160,0,660
22157,220,180,80,80,160,0,720
22158,190,180,120,160,0,0,650
22159,200,60,40,80,0,0,380
22160,190,120,40,80,0,0,430
22161,230,140,120,160,0,0,650
22162,230,120,80,80,160,0,670
22163,200,60,40,0,0,0,300
22164,200,100,80,160,320,0,860
22165,220,140,120,240,160,0,880
22166,220,140,120,80,0,0,560
22167,180,100,80,80,0,0,440
22168,190,80,80,80,0,0,430
22169,160,60,80,80,160,0,540
22170,170,60,120,160,160,0,670
22171,240,180,40,80,0,0,540
22172,210,120,40,0,0,0,370
22173,210,100,80,160,160,320,1030
22174,210,120,120,240,160,0,850
22175,200,160,120,80,160,320,1040
22176,190,140,80,160,320,0,890
22177,210,120,80,160,320,0,890
22178,190,160,40,80,160,0,630
22179,170,80,120,80,160,0,610
22180,210,80,120,80,160,0,650
22181,220,120,120,160,160,0,780
22182,210,140,160,240,160,0,910
22183,210,100,80,80,160,320,950
22184,250,160,160,0,0,0,570
22185,160,100,80,0,0,0,340
22186,240,140,120,160,160,320,1140
22187,180,100,120,80,0,0,480
22188,190,160,160,80,0,0,590
22189,210,180,160,240,160,0,950
22190,180,140,120,160,320,0,920
22191,190,140,120,160,160,0,770
22192,200,140,120,160,160,0,780
22193,210,100,160,80,160,320,1030
22194,230,140,160,80,160,0,770
22195,180,140,40,80,160,320,920
22196,180,160,80,80,0,0,500
22197,170,80,40,80,160,0,530
22198,230,140,120,80,0,0,570
22199,200,100,80,0,0,0,380
22200,190,40,40,80,0,0,350
22201,210,160,160,240,160,320,1250
22202,210,180,160,80,0,0,630
22203,220,100,80,160,320,0,880
22204,190,160,160,160,0,0,670
22205,220,180,200,240,160,0,1000
22206,220,100,40,0,0,0,360
22207,170,120,160,80,160,0,690
22208,220,160,80,0,0,0,460
22209,190,140,160,160,320,0,970
22210,180,160,160,80,160,0,740
22211,190,140,120,240,160,0,850
22212,190,140,120,160,160,0,770
22213,200,140,80,0,0,0,420
22214,190,100,80,0,0,0,370
22215,220,160,80,0,0,0,460
22216,180,140,160,80,0,0,560
22217,210,160,160,80,160,320,1090
22218,120,60,40,0,0,0,220
22219,210,80,0,0,0,0,290
22220,170,100,80,80,160,0,590
22221,190,100,160,160,160,0,770
22222,250,120,120,80,0,0,570
22223,220,160,160,0,0,0,540
22224,190,100,120,80,160,0,650
22225,210,100,160,160,320,0,950
22226,190,60,40,80,0,0,370
22227,170,140,120,80,160,0,670
22228,190,120,120,240,160,0,830
22229,210,100,80,160,160,320,1030
22230,160,160,160,240,320,0,1040
22231,180,140,160,160,160,0,800
22232,180,120,120,160,160,0,740
22233,180,100,40,0,0,0,320
22234,190,180,120,80,0,0,570
22235,220,140,120,80,0,0,560
22236,190,120,120,80,160,0,670
22237,230,120,40,0,0,0,390
22238,200,120,120,80,0,0,520
22239,220,140,240,240,320,320,1480
22240,200,140,160,160,160,0,820
22241,190,120,40,0,0,0,350
22242,200,100,120,80,160,0,660
22243,230,120,80,160,160,0,750
22244,180,140,160,80,0,0,560
22245,180,120,120,160,0,0,580
22246,210,60,120,160,320,320,1190
22247,210,140,40,80,160,0,630
22248,200,120,120,160,160,0,760
22249,170,100,40,80,160,320,870
22250,200,100,40,0,0,0,340
22251,190,100,160,160,0,0,610
22252,180,180,120,160,160,0,800
22253,190,80,120,160,160,320,1030
22254,210,120,80,80,0,0,490
22255,160,80,120,80,0,0,440
22256,210,100,80,0,0,0,390
22257,200,160,120,80,0,0,560
22258,220,100,40,80,160,320,920
22259,150,100,80,160,160,0,650
22260,190,80,120,0,0,0,390
22261,170,120,160,160,160,0,770
22262,210,120,160,240,320,0,1050
22263,210,120,40,80,0,0,450
22264,200,140,160,160,160,0,820
22265,170,140,160,80,160,320,1030
22266,210,160,80,80,160,320,1010
22267,150,100,120,160,320,320,1170
22268,250,180,200,80,160,0,870
22269,220,140,160,240,160,0,920
22270,200,140,120,80,160,0,700
22271,200,220,120,160,160,320,1180
22272,210,140,120,0,0,0,470
22273,220,120,80,80,160,0,660
22274,210,100,120,160,160,320,1070
22275,190,80,40,0,0,0,310
22276,210,140,120,160,160,0,790
22277,230,140,160,0,0,0,530
22278,190,140,120,80,0,0,530
22279,170,100,120,0,0,0,390
22280,220,180,200,80,0,0,680
22281,210,140,160,160,320,320,1310
22282,150,60,120,80,0,0,410
22283,230,120,160,240,160,0,910
22284,180,80,80,160,320,0,820
22285,240,140,80,0,0,0,460
22286,200,80,80,80,160,0,600
22287,170,100,40,80,0,0,390
22288,190,140,120,80,160,0,690
22289,210,160,200,160,160,0,890
22290,240,160,80,80,0,0,560
22291,180,80,80,0,0,0,340
22292,190,140,160,160,160,0,810
22293,200,120,80,0,0,0,400
22294,180,140,80,160,160,0,720
22295,180,100,120,0,0,0,400
22296,180,60,40,80,160,0,520
22297,190,120,120,160,0,0,590
22298,160,120,80,80,160,0,600
22299,180,120,40,0,0,0,340
22300,200,120,120,160,160,0,760
22301,210,100,80,80,0,0,470
22302,210,160,160,160,160,0,850
22303,180,60,80,80,160,0,560
22304,190,100,40,80,0,0,410
22305,170,120,120,80,160,320,970
22306,200,140,80,80,160,0,660
22307,170,140,120,160,160,0,750
22308,180,120,120,160,320,0,900
22309,190,160,200,0,0,0,550
22310,230,180,80,80,0,0,570
22311,210,80,80,80,0,0,450
22312,200,160,160,80,160,0,760
22313,210,140,80,80,160,0,670
22314,210,80,80,80,160,320,930
22315,210,160,120,80,0,0,570
22316,170,100,40,0,0,0,310
22317,190,120,160,0,0,0,470
22318,200,120,40,80,160,0,600
22319,200,100,120,160,0,0,580
22320,180,120,80,80,0,0,460
22321,180,120,120,160,320,320,1220
22322,240,120,80,0,0,0,440
22323,230,140,160,160,0,0,690
22324,210,160,80,80,160,0,690
22325,180,60,40,80,160,0,520
22326,160,100,80,160,320,320,1140
22327,190,100,80,80,0,0,450
22328,180,120,160,160,320,320,1260
22329,190,120,80,160,320,320,1190
22330,190,200,120,80,0,0,590
22331,230,140,200,240,320,0,1130
22332,190,120,160,80,160,320,1030
22333,240,160,40,0,0,0,440
22334,240,120,40,80,0,0,480
22335,220,120,40,80,0,0,460
22336,190,100,120,80,0,0,490
22337,250,100,120,80,0,0,550
22338,180,100,40,80,160,0,560
22339,210,120,80,160,0,0,570
22340,200,160,200,160,320,0,1040
22341,180,140,160,0,0,0,480
22342,210,160,160,160,160,0,850
22343,220,100,80,160,160,320,1040
22344,200,140,120,80,160,0,700
22345,200,80,0,0,0,0,280
22346,220,100,160,80,160,320,1040
22347,190,100,120,160,320,320,1210
22348,180,100,80,0,0,0,360
22349,230,140,160,80,160,0,770
22350,190,80,160,80,0,0,510
22351,170,100,80,80,160,320,910
22352,220,160,120,80,0,0,580
22353,200,140,120,160,320,320,1260
22354,230,140,120,80,160,0,730
22355,190,80,0,0,0,0,270
22356,200,100,120,80,160,0,660
22357,190,100,80,80,160,0,610
22358,180,120,160,80,0,0,540
22359,220,120,120,0,0,0,460
22360,160,80,120,80,160,320,920
22361,210,160,40,80,0,0,490
22362,160,120,120,160,320,0,880
22363,230,80,80,80,160,0,630
22364,200,120,120,160,320,320,1240
22365,190,120,40,80,160,320,910
22366,170,60,80,0,0,0,310
22367,200,120,120,80,160,0,680
22368,150,120,120,160,160,0,710
22369,190,80,80,80,0,0,430
22370,180,140,80,80,160,320,960
22371,250,160,160,80,160,0,810
22372,190,140,200,160,0,0,690
22373,220,100,80,80,160,0,640
22374,180,100,120,160,160,0,720
22375,250,60,120,80,160,0,670
22376,230,120,120,240,160,0,870
22377,170,100,80,0,0,0,350
22378,200,160,200,240,320,320,1440
22379,230,180,160,160,0,0,730
22380,220,160,40,80,0,0,500
22381,190,120,120,80,160,0,670
22382,120,100,40,0,0,0,260
22383,160,100,40,0,0,0,300
22384,220,160,120,160,0,0,660
22385,200,140,40,0,0,0,380
22386,170,140,160,160,160,0,790
22387,190,120,120,80,160,0,670
22388,240,120,120,160,320,320,1280
22389,200,100,40,0,0,0,340
22390,200,60,80,80,0,0,420
22391,180,60,120,80,160,0,600
22392,210,120,120,0,0,0,450
22393,190,100,120,80,160,0,650
22394,200,120,120,240,160,0,840
22395,230,160,160,160,320,0,1030
22396,190,140,0,0,0,0,330
22397,200,100,80,80,160,0,620
22398,170,160,120,160,320,0,930
22399,200,80,120,80,0,0,480
22400,180,100,120,160,160,0,720
22401,130,100,120,80,160,0,590
22402,220,140,200,320,320,0,1200
22403,220,80,80,160,160,320,1020
22404,210,80,80,80,160,0,610
22405,170,80,80,160,160,320,970
22406,180,160,160,240,160,0,900
22407,230,100,80,0,0,0,410
22408,210,140,80,80,0,0,510
22409,200,80,40,0,0,0,320
22410,190,120,80,160,320,0,870
22411,220,200,160,240,160,0,980
22412,170,100,80,0,0,0,350
22413,180,120,80,0,0,0,380
22414,190,100,120,0,0,0,410
22415,250,140,80,160,160,0,790
22416,210,100,80,160,160,0,710
22417,200,140,40,0,0,0,380
22418,140,100,80,80,0,0,400
22419,190,180,160,80,160,0,770
22420,200,100,80,160,160,0,700
22421,200,140,200,80,0,0,620
22422,190,120,120,240,160,0,830
22423,200,120,40,0,0,0,360
22424,200,100,120,160,320,320,1220
22425,210,120,80,80,160,0,650
22426,200,140,80,160,320,320,1220
22427,230,160,160,160,320,320,1350
22428,170,100,80,80,160,0,590
22429,190,60,40,80,0,0,370
22430,190,60,40,0,0,0,290
22431,180,120,120,80,160,0,660
22432,160,120,160,80,160,320,1000
22433,170,120,120,240,320,320,1290
22434,190,120,120,80,0,0,510
22435,180,160,160,80,0,0,580
22436,220,120,120,80,160,0,700
22437,210,160,120,0,0,0,490
22438,160,120,120,160,160,0,720
22439,190,120,40,0,0,0,350
22440,180,80,40,80,160,0,540
22441,210,60,40,0,0,0,310
22442,220,140,80,80,160,320,1000
22443,170,80,40,80,0,0,370
22444,150,80,80,80,160,0,550
22445,200,140,120,160,160,0,780
22446,200,140,80,80,0,0,500
22447,190,100,120,240,160,0,810
22448,220,100,120,160,160,320,1080
22449,180,100,80,80,160,320,920
22450,220,160,160,160,0,0,700
22451,170,60,120,80,160,0,590
22452,210,220,120,80,160,320,1110
22453,170,100,160,160,320,320,1230
22454,210,100,40,80,160,0,590
22455,200,120,80,80,160,0,640
22456,180,80,40,0,0,0,300
22457,200,140,200,240,160,0,940
22458,170,60,80,80,0,0,390
22459,200,120,40,80,160,320,920
22460,190,120,80,0,0,0,390
22461,200,60,40,0,0,0,300
22462,170,100,80,160,160,0,670
22463,220,140,80,160,160,320,1080
22464,170,120,120,160,160,0,730
22465,180,80,80,80,160,0,580
22466,230,140,160,80,0,0,610
22467,220,140,200,160,160,0,880
22468,220,100,80,160,160,0,720
22469,180,140,120,80,160,320,1000
22470,220,100,80,80,160,0,640
22471,200,120,160,80,160,320,1040
22472,170,100,120,80,0,0,470
22473,160,140,80,80,160,320,940
22474,170,140,80,80,0,0,470
22475,200,140,80,80,0,0,500
22476,210,60,80,80,160,0,590
22477,180,80,120,240,160,0,780
22478,220,120,120,160,320,320,1260
22479,180,100,120,160,160,0,720
22480,180,140,120,80,160,0,680
22481,200,100,80,80,0,0,460
22482,180,140,80,0,0,0,400
22483,190,140,80,80,160,0,650
22484,180,100,80,160,160,0,680
22485,150,120,120,160,160,0,710
22486,190,100,80,160,0,0,530
22487,180,100,0,0,0,0,280
22488,200,100,80,0,0,0,380
22489,190,120,80,0,0,0,390
22490,220,100,160,0,0,0,480
22491,230,140,120,80,0,0,570
22492,200,140,40,80,160,0,620
22493,180,180,120,160,160,0,800
22494,210,140,80,160,320,320,1230
22495,190,160,80,160,160,0,750
22496,150,100,80,80,0,0,410
22497,210,120,80,160,160,0,730
22498,190,180,80,80,160,0,690
22499,260,180,160,160,160,0,920
22500,140,80,120,80,160,0,580
22501,160,100,160,160,160,0,740
22502,170,100,80,0,0,0,350
22503,150,100,80,160,160,320,970
22504,190,120,80,80,160,0,630
22505,200,100,160,0,0,0,460
22506,210,100,120,160,160,0,750
22507,170,100,80,0,0,0,350
22508,190,120,80,80,0,0,470
22509,210,140,80,160,320,0,910
22510,190,160,120,0,0,0,470
22511,170,160,200,160,320,0,1010
22512,220,160,120,160,160,320,1140
22513,170,120,40,80,160,0,570
22514,220,160,40,0,0,0,420
22515,180,80,80,80,160,320,900
22516,220,160,200,160,160,0,900
22517,150,120,160,160,160,0,750
22518,210,100,0,0,0,0,310
22519,150,100,40,0,0,0,290
22520,190,140,120,80,160,0,690
22521,230,120,40,80,0,0,470
22522,200,60,40,80,160,0,540
22523,220,140,80,80,0,0,520
22524,200,180,120,80,160,0,740
22525,170,80,80,80,0,0,410
22526,200,140,120,80,160,0,700
22527,220,160,80,0,0,0,460
22528,190,80,80,80,160,320,910
22529,240,220,240,240,320,320,1580
22530,260,120,40,80,160,320,980
22531,180,120,160,160,0,0,620
22532,150,80,120,160,160,0,670
22533,230,200,200,80,0,0,710
22534,200,140,40,0,0,0,380
22535,170,140,160,160,320,320,1270
22536,200,140,120,0,0,0,460
22537,200,140,120,80,0,0,540
22538,180,160,160,240,320,0,1060
22539,220,140,160,160,160,0,840
22540,180,100,120,0,0,0,400
22541,190,100,40,0,0,0,330
22542,170,80,40,80,160,0,530
22543,240,80,120,80,0,0,520
22544,250,160,200,80,160,0,850
22545,230,140,160,240,0,0,770
22546,170,140,160,80,0,0,550
22547,190,100,80,80,160,0,610
22548,190,80,80,80,0,0,430
22549,180,60,80,160,160,320,960
22550,200,60,40,80,160,0,540
22551,230,140,80,80,160,0,690
22552,190,140,160,160,160,0,810
22553,230,140,80,160,0,0,610
22554,190,180,120,160,160,0,810
22555,210,100,40,0,0,0,350
22556,230,160,80,80,160,0,710
22557,180,160,200,160,0,0,700
22558,200,140,120,160,160,320,1100
22559,180,140,80,160,0,0,560
22560,210,200,120,80,160,0,770
22561,180,140,120,80,0,0,520
22562,200,60,0,0,0,0,260
22563,200,120,80,160,160,0,720
22564,180,80,40,80,0,0,380
22565,190,60,80,0,0,0,330
22566,200,80,40,80,160,0,560
22567,220,160,120,240,0,0,740
22568,170,120,200,80,160,0,730
22569,220,120,160,160,160,0,820
22570,180,100,120,80,160,0,640
22571,210,100,80,80,0,0,470
22572,190,80,160,80,160,0,670
22573,190,100,80,80,0,0,450
22574,220,200,160,160,160,0,900
22575,190,120,80,0,0,0,390
22576,200,100,40,0,0,0,340
22577,200,140,200,160,160,320,1180
22578,260,100,80,80,160,0,680
22579,160,120,120,160,0,0,560
22580,210,160,40,0,0,0,410
22581,210,140,160,160,320,0,990
22582,230,100,40,80,160,0,610
22583,180,140,40,80,160,0,600
22584,200,120,80,0,0,0,400
22585,150,140,160,160,160,0,770
22586,250,140,40,80,160,0,670
22587,210,160,160,160,320,320,1330
22588,150,80,120,80,0,0,430
22589,200,100,0,0,0,0,300
22590,170,120,160,240,160,320,1170
22591,180,120,80,80,160,0,620
22592,170,80,80,80,160,0,570
22593,160,120,80,80,160,0,600
22594,170,120,160,160,160,0,770
22595,200,100,80,0,0,0,380
22596,160,160,120,80,160,0,680
22597,220,160,160,160,160,0,860
22598,230,100,80,80,160,0,650
22599,190,100,40,80,160,0,570
22600,210,160,120,160,160,0,810
22601,210,160,160,160,160,0,850
22602,160,60,40,0,0,0,260
22603,190,120,120,160,160,0,750
22604,180,160,160,160,0,0,660
22605,200,120,160,240,320,0,1040
22606,190,120,160,80,160,0,710
22607,210,120,80,80,160,0,650
22608,260,220,80,80,0,0,640
22609,190,100,40,80,160,0,570
22610,200,180,120,160,160,0,820
22611,200,160,200,160,320,320,1360
22612,170,120,80,160,160,0,690
22613,190,160,120,160,320,0,950
22614,150,100,40,0,0,0,290
22615,190,100,40,80,160,0,570
22616,180,140,120,160,320,320,1240
22617,200,140,160,80,160,320,1060
22618,200,100,120,80,0,0,500
22619,250,160,80,0,0,0,490
22620,210,120,120,160,320,0,930
22621,180,100,120,80,0,0,480
22622,150,80,80,80,0,0,390
22623,240,160,200,80,160,0,840
22624,190,160,80,0,0,0,430
22625,170,180,160,80,160,0,750
22626,160,100,40,0,0,0,300
22627,180,120,160,80,0,0,540
22628,170,100,120,160,160,0,710
22629,190,120,160,240,320,0,1030
22630,200,100,80,80,0,0,460
22631,170,80,80,80,0,0,410
22632,160,120,40,0,0,0,320
22633,160,120,80,80,160,0,600
22634,210,100,120,80,160,0,670
22635,170,160,120,160,160,0,770
22636,180,120,160,240,160,0,860
22637,200,140,120,80,160,320,1020
22638,200,140,120,80,0,0,540
22639,220,100,40,80,0,0,440
22640,210,120,160,80,160,0,730
22641,190,140,80,80,0,0,490
22642,240,160,160,80,160,0,800
22643,220,160,200,240,160,0,980
22644,210,160,160,160,160,0,850
22645,180,80,80,160,320,320,1140
22646,180,120,120,80,160,0,660
22647,210,140,80,80,160,0,670
22648,170,120,80,80,160,0,610
22649,160,140,120,80,160,0,660
22650,210,120,120,80,0,0,530
22651,200,140,160,160,160,0,820
22652,160,80,80,80,160,0,560
22653,230,140,160,160,320,0,1010
22654,200,160,80,0,0,0,440
22655,190,140,80,0,0,0,410
22656,200,80,120,160,320,320,1200
22657,230,160,120,160,160,0,830
22658,170,100,80,80,0,0,430
22659,170,80,80,80,0,0,410
22660,160,140,120,80,0,0,500
22661,150,80,120,0,0,0,350
22662,210,140,120,160,160,0,790
22663,180,80,80,160,160,0,660
22664,230,140,40,80,0,0,490
22665,200,120,40,80,0,0,440
22666,180,100,80,160,160,0,680
22667,240,120,80,160,320,0,920
22668,220,160,80,80,160,0,700
22669,190,140,160,80,160,0,730
22670,210,140,200,160,0,0,710
22671,190,160,120,160,160,0,790
22672,230,140,80,0,0,0,450
22673,170,120,120,160,0,0,570
22674,190,160,200,160,160,0,870
22675,180,100,80,0,0,0,360
22676,230,120,160,160,0,0,670
22677,230,140,120,80,160,0,730
22678,190,100,80,80,160,0,610
22679,210,180,160,80,160,0,790
22680,230,160,120,0,0,0,510
22681,190,120,120,80,0,0,510
22682,220,100,120,160,320,0,920
22683,210,140,120,160,160,0,790
22684,180,100,80,80,160,320,920
22685,170,140,160,0,0,0,470
22686,190,80,40,0,0,0,310
22687,170,160,80,160,160,0,730
22688,180,40,40,80,160,0,500
22689,190,160,80,80,0,0,510
22690,140,120,40,80,160,320,860
22691,170,160,120,80,160,0,690
22692,160,140,160,80,0,0,540
22693,170,40,40,80,160,0,490
22694,220,200,120,80,160,320,1100
22695,200,140,120,0,0,0,460
22696,190,120,120,240,160,0,830
22697,190,140,120,80,160,0,690
22698,190,120,120,80,0,0,510
22699,190,100,80,0,0,0,370
22700,180,160,80,80,160,0,660
22701,200,160,160,160,160,0,840
22702,170,60,40,80,0,0,350
22703,200,140,160,240,160,0,900
22704,210,120,80,80,0,0,490
22705,220,180,160,80,0,0,640
22706,230,120,160,160,320,0,990
22707,190,80,120,160,160,0,710
22708,180,120,120,80,0,0,500
22709,170,100,120,80,0,0,470
22710,220,200,120,80,160,0,780
22711,190,140,160,80,160,0,730
22712,190,100,80,0,0,0,370
22713,190,100,80,0,0,0,370
22714,190,140,200,160,160,320,1170
22715,230,100,160,160,0,0,650
22716,180,140,80,80,0,0,480
22717,180,160,200,240,160,0,940
22718,190,140,160,160,160,320,1130
22719,190,80,120,160,160,320,1030
22720,230,140,200,0,0,0,570
22721,190,180,160,80,0,0,610
22722,180,120,40,80,160,0,580
22723,190,140,120,240,320,0,1010
22724,180,100,120,160,0,0,560
22725,200,100,120,80,160,0,660
22726,150,100,120,240,0,0,610
22727,200,120,120,160,320,320,1240
22728,180,120,120,160,160,0,740
22729,170,100,120,80,0,0,470
22730,190,120,40,0,0,0,350
22731,180,100,120,80,160,0,640
22732,210,80,80,160,320,0,850
22733,190,80,80,80,160,0,590
22734,150,120,40,0,0,0,310
22735,200,100,120,80,0,0,500
22736,200,140,200,80,0,0,620
22737,230,140,80,80,160,0,690
22738,240,60,40,80,160,0,580
22739,170,80,80,160,160,0,650
22740,190,160,200,160,160,320,1190
22741,190,100,80,0,0,0,370
22742,180,120,40,80,160,0,580
22743,190,60,0,0,0,0,250
22744,180,80,80,80,160,0,580
22745,170,100,120,160,160,0,710
22746,200,80,80,80,160,0,600
22747,200,120,120,80,0,0,520
22748,150,120,120,160,320,0,870
22749,260,140,160,160,320,0,1040
22750,240,160,160,80,0,0,640
22751,190,80,80,80,160,0,590
22752,210,140,80,80,160,0,670
22753,220,120,40,80,160,320,940
22754,170,140,120,160,160,320,1070
22755,160,100,80,0,0,0,340
22756,200,140,80,80,160,0,660
22757,220,100,40,80,160,0,600
22758,200,180,80,160,160,0,780
22759,160,80,120,160,160,0,680
22760,170,140,200,80,0,0,590
22761,160,100,160,160,0,0,580
22762,210,100,40,80,160,0,590
22763,170,120,80,160,0,0,530
22764,210,140,120,160,320,0,950
22765,220,160,200,80,0,0,660
22766,230,100,0,0,0,0,330
22767,190,140,80,80,160,0,650
22768,210,100,40,80,0,0,430
22769,210,120,0,0,0,0,330
22770,170,80,40,0,0,0,290
22771,170,80,80,0,0,0,330
22772,210,100,120,0,0,0,430
22773,170,80,120,80,160,320,930
22774,190,180,160,160,160,0,850
22775,210,160,80,160,160,0,770
22776,220,140,120,160,160,320,1120
22777,210,60,40,80,160,0,550
22778,170,80,120,80,160,0,610
22779,230,120,80,80,0,0,510
22780,220,180,80,160,160,0,800
22781,160,100,120,160,0,0,540
22782,210,140,160,240,320,320,1390
22783,210,180,120,80,0,0,590
22784,230,180,200,160,320,320,1410
22785,240,140,120,0,0,0,500
22786,200,100,40,80,160,0,580
22787,200,120,120,80,160,320,1000
22788,200,120,120,160,160,0,760
22789,180,140,120,80,160,0,680
22790,170,40,80,80,0,0,370
22791,220,100,160,160,160,0,800
22792,170,140,120,80,0,0,510
22793,210,60,80,80,160,0,590
22794,180,100,80,80,0,0,440
22795,250,80,80,80,160,320,970
22796,180,80,40,80,160,0,540
22797,230,140,160,160,0,0,690
22798,170,60,0,0,0,0,230
22799,180,80,40,0,0,0,300
22800,210,120,120,80,0,0,530
22801,190,160,80,160,320,0,910
22802,200,80,80,80,160,0,600
22803,210,140,120,80,0,0,550
22804,150,120,160,160,320,0,910
22805,220,180,120,80,0,0,600
22806,240,160,80,80,160,320,1040
22807,210,80,120,80,0,0,490
22808,180,80,40,80,160,320,860
22809,230,140,80,80,160,0,690
22810,220,160,160,80,160,0,780
22811,170,120,120,80,0,0,490
22812,220,140,120,0,0,0,480
22813,250,120,40,80,0,0,490
22814,220,200,200,160,320,0,1100
22815,180,100,120,0,0,0,400
22816,220,140,80,80,0,0,520
22817,180,60,40,0,0,0,280
22818,190,100,80,0,0,0,370
22819,210,80,120,160,160,0,730
22820,210,140,80,80,160,0,670
22821,160,140,120,240,160,0,820
22822,160,120,80,160,320,0,840
22823,170,60,120,80,160,0,590
22824,230,180,120,160,320,320,1330
22825,170,60,40,80,160,0,510
22826,200,140,80,80,160,0,660
22827,230,140,80,160,160,0,770
22828,170,160,120,80,0,0,530
22829,190,60,40,80,160,0,530
22830,240,100,40,80,160,0,620
22831,220,120,120,160,160,320,1100
22832,250,140,120,80,0,0,590
22833,170,60,80,160,160,320,950
22834,190,100,40,0,0,0,330
22835,180,120,80,80,0,0,460
22836,200,100,80,160,160,0,700
22837,230,120,40,0,0,0,390
22838,180,100,80,0,0,0,360
22839,240,140,160,80,0,0,620
22840,220,160,160,0,0,0,540
22841,200,120,120,160,160,320,1080
22842,190,100,40,0,0,0,330
22843,200,140,120,80,160,0,700
22844,240,140,40,0,0,0,420
22845,150,80,0,0,0,0,230
22846,190,140,80,0,0,0,410
22847,200,60,120,240,0,0,620
22848,140,100,80,0,0,0,320
22849,200,80,80,0,0,0,360
22850,180,40,40,80,160,0,500
22851,160,120,120,160,160,320,1040
22852,160,120,200,80,0,0,560
22853,200,100,40,80,0,0,420
22854,230,120,160,80,160,0,750
22855,220,160,120,160,160,0,820
22856,210,120,120,80,0,0,530
22857,210,160,120,0,0,0,490
22858,150,80,0,0,0,0,230
22859,190,100,120,160,320,320,1210
22860,210,120,120,80,160,0,690
22861,200,100,80,80,160,0,620
22862,170,140,80,160,160,0,710
22863,210,120,120,80,160,0,690
22864,200,100,80,80,0,0,460
22865,190,140,120,240,160,320,1170
22866,210,140,160,0,0,0,510
22867,190,100,80,0,0,0,370
22868,180,100,120,80,0,0,480
22869,170,40,80,80,0,0,370
22870,200,160,120,80,160,0,720
22871,210,140,40,0,0,0,390
22872,200,120,200,80,0,0,600
22873,140,100,120,80,160,0,600
22874,200,120,40,0,0,0,360
22875,210,120,40,80,160,0,610
22876,210,60,40,80,160,0,550
22877,200,100,80,80,0,0,460
22878,220,100,120,160,160,320,1080
22879,210,160,160,160,160,320,1170
22880,180,100,120,160,160,0,720
22881,180,160,160,80,160,0,740
22882,170,60,120,240,320,0,910
22883,220,160,120,160,0,0,660
22884,200,160,120,240,160,0,880
22885,190,100,80,80,160,0,610
22886,180,160,120,80,0,0,540
22887,230,120,80,80,0,0,510
22888,210,200,120,0,0,0,530
22889,190,100,120,80,160,0,650
22890,220,120,80,0,0,0,420
22891,170,80,40,80,160,0,530
22892,150,80,80,0,0,0,310
22893,140,140,200,240,320,0,1040
22894,200,120,120,80,0,0,520
22895,190,160,120,80,160,0,710
22896,210,120,120,240,160,0,850
22897,240,140,120,80,0,0,580
22898,190,160,160,80,160,0,750
22899,200,140,160,240,160,0,900
22900,170,100,160,160,160,0,750
22901,200,100,40,0,0,0,340
22902,200,140,80,80,160,0,660
22903,180,60,40,80,160,0,520
22904,220,120,80,0,0,0,420
22905,180,140,80,80,160,0,640
22906,200,120,120,0,0,0,440
22907,180,140,80,80,0,0,480
22908,190,100,40,80,0,0,410
22909,150,60,0,0,0,0,210
22910,160,120,80,80,0,0,440
22911,210,80,160,160,160,0,770
22912,170,140,160,80,160,0,710
22913,180,120,160,160,320,0,940
22914,200,180,200,240,160,0,980
22915,240,140,80,0,0,0,460
22916,240,140,80,80,0,0,540
22917,190,120,80,0,0,0,390
22918,230,120,80,80,160,0,670
22919,180,140,120,80,0,0,520
22920,180,80,80,80,160,320,900
22921,170,100,160,80,0,0,510
22922,210,100,120,80,0,0,510
22923,210,140,120,0,0,0,470
22924,200,120,200,240,160,320,1240
22925,180,60,80,0,0,0,320
22926,180,180,160,240,320,0,1080
22927,210,140,120,80,160,0,710
22928,210,120,120,80,0,0,530
22929,180,100,120,80,160,0,640
22930,170,100,120,160,160,0,710
22931,200,180,120,80,160,0,740
22932,190,140,120,80,0,0,530
22933,200,140,160,80,160,0,740
22934,230,120,120,80,0,0,550
22935,240,140,120,160,160,0,820
22936,180,80,120,160,320,0,860
22937,180,140,120,240,320,0,1000
22938,190,100,120,0,0,0,410
22939,200,120,80,0,0,0,400
22940,210,100,80,80,0,0,470
22941,210,100,120,160,160,320,1070
22942,190,60,40,0,0,0,290
22943,190,120,120,160,320,0,910
22944,220,140,80,160,0,0,600
22945,200,140,80,80,160,0,660
22946,190,80,80,80,0,0,430
22947,190,180,240,160,320,0,1090
22948,220,160,160,160,160,320,1180
22949,210,160,80,80,0,0,530
22950,220,160,120,80,160,0,740
22951,180,120,40,0,0,0,340
22952,210,120,40,80,160,320,930
22953,170,80,120,80,0,0,450
22954,190,80,80,160,160,0,670
22955,180,100,80,80,160,0,600
22956,200,120,160,80,0,0,560
22957,220,140,40,80,160,0,640
22958,190,120,160,160,160,0,790
22959,220,120,40,0,0,0,380
22960,210,200,40,0,0,0,450
22961,180,100,120,80,160,0,640
22962,200,100,120,160,320,0,900
22963,210,80,80,80,160,0,610
22964,220,180,160,80,160,0,800
22965,170,140,120,0,0,0,430
22966,200,100,120,80,160,0,660
22967,160,120,80,80,160,0,600
22968,220,140,120,160,160,0,800
22969,210,120,40,80,0,0,450
22970,210,120,120,80,0,0,530
22971,200,140,120,80,160,320,1020
22972,190,160,200,160,160,0,870
22973,200,120,120,80,0,0,520
22974,190,100,120,0,0,0,410
22975,210,160,160,80,0,0,610
22976,180,100,0,0,0,0,280
22977,210,60,80,160,320,0,830
22978,220,160,80,80,160,0,700
22979,230,180,120,0,0,0,530
22980,150,100,80,0,0,0,330
22981,190,120,120,80,160,320,990
22982,170,120,80,80,160,0,610
22983,210,80,40,80,160,0,570
22984,180,100,120,0,0,0,400
22985,170,100,40,80,0,0,390
22986,200,120,80,0,0,0,400
22987,220,180,120,0,0,0,520
22988,220,100,160,160,0,0,640
22989,200,120,160,160,160,320,1120
22990,190,80,120,160,320,320,1190
22991,130,100,80,80,160,0,550
22992,210,100,40,0,0,0,350
22993,190,100,120,0,0,0,410
22994,190,140,200,160,160,0,850
22995,200,120,120,240,0,0,680
22996,230,120,120,80,160,0,710
22997,190,140,160,160,320,0,970
22998,220,40,40,80,0,0,380
22999,200,160,160,240,320,320,1400
23000,180,100,0,0,0,0,280
23001,200,100,40,80,160,320,900
23002,210,120,120,0,0,0,450
23003,160,120,120,80,160,0,640
23004,200,140,120,80,160,320,1020
23005,180,160,120,160,0,0,620
23006,190,160,120,160,160,320,1110
23007,140,120,200,80,0,0,540
23008,180,120,80,160,160,0,700
23009,180,140,80,160,160,0,720
23010,210,120,120,80,160,0,690
23011,170,140,0,0,0,0,310
23012,190,160,120,160,160,0,790
23013,150,120,120,80,160,320,950
23014,160,60,40,80,160,0,500
23015,210,140,80,80,160,0,670
23016,200,120,160,160,0,0,640
23017,160,100,80,0,0,0,340
23018,230,140,120,160,320,0,970
23019,160,80,120,160,160,0,680
23020,210,120,80,160,320,320,1210
23021,190,80,160,160,320,0,910
23022,160,100,120,0,0,0,380
23023,250,180,160,160,320,0,1070
23024,160,140,120,0,0,0,420
23025,190,100,40,0,0,0,330
23026,210,160,120,240,320,0,1050
23027,210,60,80,80,160,0,590
23028,170,60,40,80,160,320,830
23029,210,100,80,80,0,0,470
23030,210,120,160,240,320,0,1050
23031,200,140,80,80,0,0,500
23032,170,120,120,80,160,320,970
23033,210,100,80,80,0,0,470
23034,190,140,200,80,0,0,610
23035,200,140,120,160,160,0,780
23036,190,140,160,160,160,0,810
23037,200,100,120,80,160,0,660
23038,160,100,120,160,160,0,700
23039,210,100,120,160,160,320,1070
23040,170,80,40,80,0,0,370
23041,160,140,200,240,320,0,1060
23042,200,160,80,160,160,0,760
23043,180,80,120,80,0,0,460
23044,190,60,120,160,160,0,690
23045,210,120,160,160,0,0,650
23046,200,140,120,160,320,0,940
23047,230,140,120,80,0,0,570
23048,230,140,160,240,160,0,930
23049,210,120,120,160,160,0,770
23050,230,140,200,160,320,320,1370
23051,210,120,40,0,0,0,370
23052,180,120,120,80,0,0,500
23053,180,140,80,80,160,0,640
23054,210,80,120,80,0,0,490
23055,220,140,120,160,160,0,800
23056,160,120,80,160,160,320,1000
23057,200,100,120,160,160,0,740
23058,160,140,120,80,0,0,500
23059,170,120,80,80,0,0,450
23060,210,100,80,0,0,0,390
23061,210,140,120,160,160,0,790
23062,210,120,80,160,160,320,1050
23063,200,120,160,240,320,0,1040
23064,160,160,200,80,0,0,600
23065,110,60,40,80,0,0,290
23066,160,80,120,160,320,320,1160
23067,210,100,120,0,0,0,430
23068,230,120,120,160,160,0,790
23069,190,100,120,160,160,0,730
23070,200,140,120,80,160,0,700
23071,170,80,120,160,320,0,850
23072,220,100,120,160,320,0,920
23073,170,100,120,80,0,0,470
23074,220,160,120,80,160,0,740
23075,200,60,80,80,160,0,580
23076,220,200,200,80,0,0,700
23077,210,120,120,160,160,0,770
23078,210,100,120,160,320,0,910
23079,200,140,80,160,160,320,1060
23080,120,120,80,0,0,0,320
23081,230,140,80,80,160,0,690
23082,200,100,120,240,320,0,980
23083,160,120,80,80,0,0,440
23084,170,100,120,80,0,0,470
23085,180,120,120,240,160,0,820
23086,190,120,120,80,160,0,670
23087,240,120,120,240,160,0,880
23088,190,120,80,0,0,0,390
23089,190,100,120,160,160,0,730
23090,240,140,160,240,320,0,1100
23091,220,100,160,160,160,0,800
23092,190,140,160,80,160,0,730
23093,210,140,80,0,0,0,430
23094,220,140,80,80,160,0,680
23095,210,140,120,160,160,0,790
23096,180,80,120,160,160,0,700
23097,220,140,120,80,160,320,1040
23098,160,140,240,160,0,0,700
23099,200,120,40,0,0,0,360
23100,180,120,120,80,0,0,500
23101,210,120,0,0,0,0,330
23102,240,40,0,0,0,0,280
23103,190,140,120,80,0,0,530
23104,160,80,80,80,160,0,560
23105,190,140,160,80,0,0,570
23106,160,140,160,240,160,0,860
23107,210,160,160,80,0,0,610
23108,180,80,80,80,160,320,900
23109,240,100,80,0,0,0,420
23110,230,140,80,0,0,0,450
23111,160,200,80,80,160,0,680
23112,180,140,160,80,160,0,720
23113,240,180,200,160,160,0,940
23114,220,140,40,80,0,0,480
23115,190,160,240,160,160,0,910
23116,170,100,80,160,160,0,670
23117,180,100,80,80,0,0,440
23118,220,80,120,240,160,320,1140
23119,160,120,120,80,160,0,640
23120,260,220,120,80,0,0,680
23121,220,80,160,80,160,0,700
23122,220,160,40,80,0,0,500
23123,190,100,80,160,160,0,690
23124,160,140,40,80,160,0,580
23125,210,140,80,80,160,0,670
23126,170,120,0,0,0,0,290
23127,180,100,120,160,320,320,1200
23128,210,100,40,0,0,0,350
23129,200,100,120,80,160,0,660
23130,160,60,80,0,0,0,300
23131,210,120,120,80,0,0,530
23132,180,80,80,80,160,0,580
23133,190,140,120,80,0,0,530
23134,150,80,40,0,0,0,270
23135,230,80,40,0,0,0,350
23136,190,140,160,80,160,0,730
23137,180,120,40,80,0,0,420
23138,150,120,160,80,0,0,510
23139,190,120,120,0,0,0,430
23140,220,120,40,80,0,0,460
23141,150,80,0,0,0,0,230
23142,200,100,80,160,320,0,860
23143,210,100,120,160,160,0,750
23144,150,120,80,160,320,0,830
23145,170,140,120,80,160,0,670
23146,200,140,160,240,160,320,1220
23147,200,120,80,80,160,0,640
23148,160,100,120,160,320,0,860
23149,160,160,80,80,0,0,480
23150,220,160,120,80,160,0,740
23151,180,140,200,240,320,0,1080
23152,190,120,160,160,160,0,790
23153,220,80,40,0,0,0,340
23154,170,140,160,160,0,0,630
23155,220,120,120,80,160,0,700
23156,180,120,80,0,0,0,380
23157,220,160,120,240,160,0,900
23158,180,100,40,80,0,0,400
23159,220,100,80,80,160,0,640
23160,190,100,120,80,160,0,650
23161,200,160,80,0,0,0,440
23162,180,80,80,160,160,0,660
23163,220,100,80,80,0,0,480
23164,230,160,160,160,320,0,1030
23165,200,80,80,160,160,0,680
23166,160,140,80,0,0,0,380
23167,180,160,80,80,0,0,500
23168,150,120,120,80,0,0,470
23169,170,100,120,160,160,0,710
23170,180,100,80,80,160,0,600
23171,180,80,120,80,160,0,620
23172,210,120,40,0,0,0,370
23173,190,140,80,80,160,0,650
23174,150,120,120,160,160,320,1030
23175,220,80,40,80,0,0,420
23176,230,160,200,240,160,0,990
23177,190,160,160,240,0,0,750
23178,210,180,200,160,160,0,910
23179,190,40,0,0,0,0,230
23180,180,140,160,160,160,320,1120
23181,180,60,0,0,0,0,240
23182,190,140,160,160,320,0,970
23183,180,140,120,80,160,0,680
23184,190,180,80,0,0,0,450
23185,180,140,80,0,0,0,400
23186,170,100,120,80,160,320,950
23187,230,180,160,160,0,0,730
23188,190,100,160,160,320,320,1250
23189,210,180,120,240,320,0,1070
23190,190,120,160,80,160,0,710
23191,240,120,120,160,160,0,800
23192,220,80,120,80,0,0,500
23193,210,180,80,0,0,0,470
23194,200,160,200,0,0,0,560
23195,200,100,80,160,0,0,540
23196,200,160,240,240,320,320,1480
23197,190,60,40,80,160,0,530
23198,190,120,40,80,160,0,590
23199,180,200,120,80,160,0,740
23200,220,80,80,80,0,0,460
23201,210,100,0,0,0,0,310
23202,220,140,160,80,160,0,760
23203,220,140,120,0,0,0,480
23204,200,160,160,240,160,0,920
23205,230,160,80,160,160,0,790
23206,190,120,80,80,160,0,630
23207,200,140,80,0,0,0,420
23208,210,100,80,80,160,0,630
23209,230,100,40,0,0,0,370
23210,180,80,120,160,320,320,1180
23211,180,100,80,80,160,320,920
23212,200,120,40,80,160,0,600
23213,200,140,120,160,320,0,940
23214,240,140,120,80,160,0,740
23215,170,120,80,80,160,0,610
23216,200,80,40,0,0,0,320
23217,180,160,160,240,0,0,740
23218,210,120,160,80,0,0,570
23219,190,140,0,0,0,0,330
23220,240,200,160,160,320,0,1080
23221,230,100,160,240,160,0,890
23222,220,120,80,160,320,0,900
23223,180,120,80,80,0,0,460
23224,170,100,80,160,320,0,830
23225,230,200,160,80,0,0,670
23226,190,120,120,80,160,0,670
23227,190,60,80,80,160,320,890
23228,180,80,40,80,0,0,380
23229,240,160,160,240,320,0,1120
23230,180,120,160,0,0,0,460
23231,220,80,80,80,0,0,460
23232,200,160,80,80,0,0,520
23233,250,140,40,0,0,0,430
23234,220,220,80,160,160,0,840
23235,210,80,0,0,0,0,290
23236,220,160,120,240,320,0,1060
23237,240,160,120,80,160,0,760
23238,190,80,160,160,160,0,750
23239,170,120,160,80,160,0,690
23240,220,160,80,80,0,0,540
23241,230,160,80,80,160,0,710
23242,170,100,80,80,160,0,590
23243,220,140,80,80,160,0,680
23244,200,80,80,80,160,0,600
23245,170,120,120,160,320,0,890
23246,170,140,160,80,160,320,1030
23247,250,140,200,80,0,0,670
23248,200,100,80,80,160,0,620
23249,170,100,80,80,160,0,590
23250,250,140,120,160,160,320,1150
23251,200,140,160,240,160,0,900
23252,220,180,80,160,160,0,800
23253,200,120,120,160,160,0,760
23254,190,120,120,0,0,0,430
23255,220,140,120,160,160,320,1120
23256,180,160,40,80,160,320,940
23257,190,140,160,160,160,0,810
23258,210,80,80,0,0,0,370
23259,240,120,160,160,320,0,1000
23260,190,140,160,160,160,0,810
23261,210,100,80,160,0,0,550
23262,240,100,120,80,160,320,1020
23263,190,140,120,160,160,0,770
23264,180,100,120,160,160,0,720
23265,160,140,120,80,160,320,980
23266,220,120,160,80,0,0,580
23267,200,60,120,160,320,320,1180
23268,220,120,40,0,0,0,380
23269,220,160,80,80,160,0,700
23270,180,80,40,80,160,320,860
23271,210,160,120,160,0,0,650
23272,180,80,120,160,160,0,700
23273,160,160,120,160,160,0,760
23274,200,140,120,240,160,0,860
23275,240,140,120,160,0,0,660
23276,190,140,120,80,160,0,690
23277,220,140,80,160,160,0,760
23278,240,100,40,80,160,0,620
23279,200,100,80,160,0,0,540
23280,180,120,120,80,0,0,500
23281,190,160,200,240,320,320,1430
23282,170,120,120,80,0,0,490
23283,230,140,120,160,160,0,810
23284,210,140,40,80,160,0,630
23285,170,80,40,0,0,0,290
23286,190,80,120,160,160,0,710
23287,190,100,40,80,160,0,570
23288,180,120,120,80,160,0,660
23289,210,120,80,80,160,0,650
23290,220,140,160,80,160,320,1080
23291,170,100,120,160,0,0,550
23292,200,140,120,80,0,0,540
23293,180,140,120,80,160,0,680
23294,190,160,200,240,320,0,1110
23295,190,100,160,0,0,0,450
23296,210,60,80,80,160,0,590
23297,160,160,240,160,160,0,880
23298,230,120,80,80,0,0,510
23299,210,120,160,80,160,0,730
23300,190,60,40,80,0,0,370
23301,180,140,120,0,0,0,440
23302,200,180,120,80,0,0,580
23303,200,80,80,80,0,0,440
23304,180,160,160,160,0,0,660
23305,200,160,160,160,320,320,1320
23306,210,120,160,160,0,0,650
23307,190,120,120,80,160,0,670
23308,230,140,80,80,160,320,1010
23309,210,100,120,0,0,0,430
23310,170,60,0,0,0,0,230
23311,190,140,160,240,320,320,1370
23312,230,140,40,80,0,0,490
23313,210,140,160,80,160,0,750
23314,190,100,80,80,160,0,610
23315,180,120,120,160,320,320,1220
23316,210,140,120,160,160,320,1110
23317,210,120,120,80,160,0,690
23318,280,180,120,0,0,0,580
23319,160,140,200,240,0,0,740
23320,210,100,80,0,0,0,390
23321,220,120,120,240,320,0,1020
23322,220,100,80,80,160,0,640
23323,170,60,0,0,0,0,230
23324,200,140,80,160,160,0,740
23325,230,100,160,160,0,0,650
23326,170,120,80,80,160,0,610
23327,200,160,160,80,0,0,600
23328,230,160,80,80,160,320,1030
23329,220,160,200,240,160,320,1300
23330,200,120,80,0,0,0,400
23331,160,120,40,80,160,0,560
23332,220,140,200,240,320,0,1120
23333,210,160,120,0,0,0,490
23334,200,80,80,80,0,0,440
23335,160,140,120,80,160,0,660
23336,180,120,40,80,160,0,580
23337,220,40,40,80,160,0,540
23338,220,140,120,80,160,0,720
23339,190,140,120,160,320,0,930
23340,210,120,160,160,160,0,810
23341,200,120,40,0,0,0,360
23342,190,120,160,160,0,0,630
23343,230,120,80,80,0,0,510
23344,200,120,80,160,160,0,720
23345,150,60,80,160,160,0,610
23346,240,180,120,160,320,320,1340
23347,180,80,80,80,0,0,420
23348,210,100,40,0,0,0,350
23349,230,160,80,80,0,0,550
23350,190,120,200,240,160,0,910
23351,140,80,80,80,160,0,540
23352,180,80,40,0,0,0,300
23353,170,120,160,80,0,0,530
23354,160,80,0,0,0,0,240
23355,200,120,80,160,320,320,1200
23356,210,60,40,80,160,0,550
23357,190,120,120,80,0,0,510
23358,190,60,40,80,0,0,370
23359,190,120,40,80,160,0,590
23360,210,120,80,80,160,0,650
23361,200,140,120,160,0,0,620
23362,180,100,80,160,160,0,680
23363,210,80,40,80,160,0,570
23364,160,160,80,80,160,0,640
23365,220,180,120,80,160,320,1080
23366,200,80,80,160,320,0,840
23367,170,120,120,80,160,0,650
23368,220,160,80,80,0,0,540
23369,200,100,80,80,160,0,620
23370,210,180,120,80,160,320,1070
23371,240,120,80,80,0,0,520
23372,180,120,80,80,0,0,460
23373,130,60,80,80,160,0,510
23374,210,100,40,0,0,0,350
23375,160,140,80,160,160,0,700
23376,170,80,80,0,0,0,330
23377,160,120,120,160,160,0,720
23378,210,100,120,160,0,0,590
23379,190,60,80,80,0,0,410
23380,200,140,120,160,0,0,620
23381,190,140,80,160,0,0,570
23382,260,140,80,80,160,0,720
23383,160,60,40,80,160,0,500
23384,210,120,40,80,160,0,610
23385,190,80,160,80,0,0,510
23386,220,120,120,80,160,320,1020
23387,200,140,40,80,0,0,460
23388,190,120,160,160,320,0,950
23389,140,140,120,80,160,0,640
23390,170,100,40,0,0,0,310
23391,170,120,40,0,0,0,330
23392,140,60,80,0,0,0,280
23393,210,120,120,240,160,0,850
23394,160,120,120,80,160,0,640
23395,220,160,80,80,160,0,700
23396,230,140,120,80,160,0,730
23397,210,140,160,80,0,0,590
23398,200,140,120,0,0,0,460
23399,220,140,80,80,0,0,520
23400,200,120,120,80,0,0,520
23401,180,140,80,160,320,320,1200
23402,220,120,40,0,0,0,380
23403,180,60,40,80,160,0,520
23404,210,160,120,80,0,0,570
23405,160,100,120,240,160,0,780
23406,210,120,80,80,160,320,970
23407,200,140,200,160,320,320,1340
23408,180,160,160,160,0,0,660
23409,180,140,200,80,160,0,760
23410,200,120,120,80,0,0,520
23411,220,100,40,80,160,0,600
23412,180,80,40,80,160,320,860
23413,190,80,120,80,160,0,630
23414,180,80,80,160,160,0,660
23415,190,120,80,0,0,0,390
23416,230,180,200,160,160,0,930
23417,190,140,80,160,160,320,1050
23418,220,160,200,0,0,0,580
23419,210,200,120,80,160,0,770
23420,170,80,80,80,160,0,570
23421,220,180,160,160,320,0,1040
23422,230,140,80,160,160,0,770
23423,160,140,80,160,0,0,540
23424,180,160,80,160,160,0,740
23425,180,120,80,160,320,0,860
23426,180,120,160,160,0,0,620
23427,160,140,80,80,0,0,460
23428,240,120,160,160,160,0,840
23429,150,100,120,0,0,0,370
23430,230,120,120,80,160,0,710
23431,200,60,120,80,160,0,620
23432,180,100,80,80,0,0,440
23433,230,120,120,80,160,0,710
23434,210,140,80,160,160,0,750
23435,190,140,120,160,0,0,610
23436,220,120,80,80,160,0,660
23437,200,160,40,0,0,0,400
23438,170,120,80,80,160,0,610
23439,180,160,80,160,160,320,1060
23440,150,140,120,80,0,0,490
23441,220,120,80,0,0,0,420
23442,190,100,160,160,160,0,770
23443,200,120,120,80,160,0,680
23444,200,100,80,80,160,0,620
23445,190,140,80,80,160,0,650
23446,180,100,160,80,160,0,680
23447,170,80,40,80,160,0,530
23448,210,100,120,160,160,0,750
23449,220,100,80,80,0,0,480
23450,190,80,120,160,320,0,870
23451,180,160,160,240,160,320,1220
23452,200,120,80,80,160,320,960
23453,210,120,120,160,160,0,770
23454,190,60,40,80,160,0,530
23455,210,180,80,160,160,0,790
23456,210,120,120,160,320,320,1250
23457,200,100,160,240,320,320,1340
23458,210,140,80,80,160,0,670
23459,210,120,80,80,160,0,650
23460,230,120,40,80,160,0,630
23461,180,80,120,160,0,0,540
23462,200,140,160,80,160,0,740
23463,220,180,120,0,0,0,520
23464,180,120,80,80,160,0,620
23465,180,140,160,160,160,0,800
23466,250,140,160,160,0,0,710
23467,200,140,120,160,320,0,940
23468,150,100,80,0,0,0,330
23469,180,140,80,80,160,0,640
23470,220,100,80,0,0,0,400
23471,160,120,200,160,160,0,800
23472,180,60,40,80,160,0,520
23473,170,80,40,80,0,0,370
23474,240,200,160,0,0,0,600
23475,180,160,80,80,160,320,980
23476,150,100,80,80,160,0,570
23477,180,100,80,80,0,0,440
23478,190,80,40,0,0,0,310
23479,210,160,40,0,0,0,410
23480,220,120,80,0,0,0,420
23481,200,120,40,80,0,0,440
23482,190,180,120,160,0,0,650
23483,210,120,160,160,160,0,810
23484,240,140,160,80,160,0,780
23485,250,160,120,80,0,0,610
23486,180,120,160,160,160,0,780
23487,200,120,120,160,0,0,600
23488,220,100,0,0,0,0,320
23489,200,180,160,0,0,0,540
23490,170,100,120,160,0,0,550
23491,200,120,160,0,0,0,480
23492,180,100,80,0,0,0,360
23493,200,80,0,0,0,0,280
23494,170,160,200,240,320,0,1090
23495,190,120,120,80,160,320,990
23496,190,140,0,0,0,0,330
23497,180,100,80,160,160,0,680
23498,230,100,0,0,0,0,330
23499,220,100,120,160,160,0,760
23500,240,140,120,80,160,0,740
23501,230,60,80,160,0,0,530
23502,210,80,160,160,160,0,770
23503,200,180,80,0,0,0,460
23504,210,100,120,80,0,0,510
23505,210,120,160,160,160,0,810
23506,200,120,40,0,0,0,360
23507,200,140,120,160,320,0,940
23508,180,120,80,80,0,0,460
23509,120,60,40,80,160,0,460
23510,200,80,80,160,160,0,680
23511,210,60,40,0,0,0,310
23512,220,140,80,0,0,0,440
23513,160,60,80,80,0,0,380
23514,160,100,80,80,160,0,580
23515,190,80,120,160,160,0,710
23516,190,100,40,80,0,0,410
23517,190,80,40,80,160,0,550
23518,220,20,0,0,0,0,240
23519,230,140,40,80,0,0,490
23520,170,120,120,160,160,0,730
23521,170,120,80,80,160,0,610
23522,190,100,40,80,160,0,570
23523,210,120,0,0,0,0,330
23524,190,100,80,0,0,0,370
23525,200,120,40,80,160,0,600
23526,200,120,120,160,160,0,760
23527,170,100,80,80,160,0,590
23528,190,60,80,160,160,320,970
23529,190,140,80,80,160,0,650
23530,180,80,120,80,0,0,460
23531,210,140,160,240,0,0,750
23532,190,140,40,0,0,0,370
23533,180,140,120,80,160,320,1000
23534,160,180,160,80,160,0,740
23535,180,100,40,80,0,0,400
23536,170,120,120,160,160,0,730
23537,200,160,120,0,0,0,480
23538,210,160,120,160,160,0,810
23539,190,180,200,80,160,0,810
23540,220,200,200,80,0,0,700
23541,170,80,0,0,0,0,250
23542,170,100,80,160,0,0,510
23543,190,100,80,80,0,0,450
23544,210,160,80,80,160,320,1010
23545,200,200,120,160,160,0,840
23546,210,120,120,80,0,0,530
23547,180,120,160,240,320,320,1340
23548,200,160,120,0,0,0,480
23549,200,100,80,80,0,0,460
23550,160,140,120,160,160,0,740
23551,210,140,120,80,160,0,710
23552,220,80,80,80,0,0,460
23553,190,160,120,160,0,0,630
23554,200,140,80,160,160,0,740
23555,210,80,40,0,0,0,330
23556,180,80,120,160,160,0,700
23557,140,100,80,160,160,320,960
23558,220,140,120,160,0,0,640
23559,200,140,160,80,160,0,740
23560,180,140,120,80,0,0,520
23561,160,120,40,0,0,0,320
23562,170,120,80,160,160,0,690
23563,190,100,80,0,0,0,370
23564,240,120,160,160,160,0,840
23565,190,180,160,160,160,0,850
23566,170,120,120,160,160,320,1050
23567,170,100,80,80,160,0,590
23568,200,140,120,160,160,0,780
23569,210,100,80,0,0,0,390
23570,180,120,120,80,160,0,660
23571,230,120,120,80,160,320,1030
23572,210,120,80,80,0,0,490
23573,200,100,160,80,0,0,540
23574,230,140,80,80,0,0,530
23575,140,180,120,80,160,0,680
23576,190,120,80,80,160,320,950
23577,210,140,80,160,320,0,910
23578,190,140,160,0,0,0,490
23579,250,160,120,0,0,0,530
23580,210,140,40,0,0,0,390
23581,210,100,40,80,160,0,590
23582,170,120,120,80,0,0,490
23583,220,140,160,0,0,0,520
23584,210,120,120,0,0,0,450
23585,160,140,120,80,160,0,660
23586,210,100,80,80,160,320,950
23587,190,100,40,80,160,320,890
23588,170,80,120,160,0,0,530
23589,190,80,80,0,0,0,350
23590,210,180,160,160,160,0,870
23591,180,100,120,80,0,0,480
23592,260,140,120,0,0,0,520
23593,180,140,80,80,160,0,640
23594,210,80,80,160,160,320,1010
23595,200,100,120,0,0,0,420
23596,180,120,80,80,160,0,620
23597,210,120,160,160,0,0,650
23598,170,100,80,80,0,0,430
23599,180,120,40,0,0,0,340
23600,220,140,40,0,0,0,400
23601,170,100,80,0,0,0,350
23602,190,120,80,80,0,0,470
23603,200,120,80,80,0,0,480
23604,220,120,40,80,160,320,940
23605,180,180,120,160,0,0,640
23606,200,100,80,80,160,0,620
23607,150,100,80,80,0,0,410
23608,160,80,120,160,320,320,1160
23609,190,140,120,160,320,0,930
23610,210,120,80,0,0,0,410
23611,170,100,120,160,160,0,710
23612,210,120,200,160,0,0,690
23613,170,120,200,80,160,0,730
23614,220,100,80,80,0,0,480
23615,180,120,80,0,0,0,380
23616,180,100,160,0,0,0,440
23617,230,120,80,160,160,0,750
23618,170,120,80,160,0,0,530
23619,190,120,40,0,0,0,350
23620,200,140,120,80,0,0,540
23621,190,140,160,160,160,0,810
23622,200,80,40,80,160,0,560
23623,220,60,120,160,160,0,720
23624,170,120,160,240,320,0,1010
23625,200,140,120,80,0,0,540
23626,170,100,160,160,320,320,1230
23627,170,40,80,80,160,0,530
23628,220,80,80,160,320,0,860
23629,200,160,40,0,0,0,400
23630,190,120,160,160,160,0,790
23631,190,140,80,160,320,0,890
23632,180,80,80,160,160,0,660
23633,240,120,120,80,160,0,720
23634,160,80,80,0,0,0,320
23635,210,100,120,80,160,0,670
23636,220,140,160,80,160,0,760
23637,180,140,40,80,160,320,920
23638,190,120,120,160,160,0,750
23639,220,160,120,160,160,320,1140
23640,230,160,160,240,320,0,1110
23641,190,140,0,0,0,0,330
23642,190,140,160,80,160,320,1050
23643,220,140,40,80,160,320,960
23644,170,40,40,80,160,0,490
23645,190,160,120,80,160,0,710
23646,190,100,80,80,160,0,610
23647,200,120,160,160,160,320,1120
23648,170,120,160,160,320,0,930
23649,180,80,80,160,320,0,820
23650,200,120,120,160,320,0,920
23651,210,160,80,80,160,0,690
23652,180,140,160,160,160,0,800
23653,140,20,0,0,0,0,160
23654,200,140,80,80,0,0,500
23655,230,100,160,80,0,0,570
23656,190,160,120,80,160,320,1030
23657,140,80,80,80,160,0,540
23658,240,120,80,0,0,0,440
23659,220,160,160,0,0,0,540
23660,160,100,160,240,160,0,820
23661,130,100,40,80,160,0,510
23662,170,120,120,240,0,0,650
23663,190,100,80,80,160,0,610
23664,220,120,120,160,160,0,780
23665,200,120,120,80,160,0,680
23666,210,120,120,80,0,0,530
23667,190,60,80,160,320,0,810
23668,230,140,120,80,0,0,570
23669,200,120,80,160,320,0,880
23670,200,160,200,80,0,0,640
23671,200,120,120,160,320,0,920
23672,160,140,160,240,160,0,860
23673,220,160,80,80,0,0,540
23674,180,100,80,80,160,0,600
23675,190,140,120,160,160,320,1090
23676,210,120,80,80,0,0,490
23677,190,100,120,240,160,0,810
23678,180,100,120,160,160,0,720
23679,190,60,40,80,0,0,370
23680,190,160,200,160,0,0,710
23681,200,160,160,80,160,0,760
23682,210,100,80,160,160,0,710
23683,220,140,120,160,0,0,640
23684,210,60,120,240,160,0,790
23685,200,80,0,0,0,0,280
23686,180,100,120,80,160,0,640
23687,200,100,120,240,320,0,980
23688,260,100,80,0,0,0,440
23689,230,200,200,160,0,0,790
23690,230,160,160,160,0,0,710
23691,200,140,160,240,0,0,740
23692,180,120,160,160,160,0,780
23693,170,100,80,80,160,320,910
23694,210,60,40,80,0,0,390
23695,200,160,120,160,160,320,1120
23696,210,100,80,80,0,0,470
23697,220,120,120,160,160,0,780
23698,140,60,40,80,160,0,480
23699,200,100,80,0,0,0,380
23700,180,100,80,80,160,320,920
23701,180,140,120,80,0,0,520
23702,210,160,40,80,160,0,650
23703,210,120,80,80,0,0,490
23704,210,140,160,160,160,0,830
23705,150,80,120,240,160,0,750
23706,140,120,240,80,160,0,740
23707,160,40,40,80,160,0,480
23708,170,80,120,160,320,0,850
23709,190,160,160,240,320,0,1070
23710,220,140,160,160,160,0,840
23711,210,60,40,0,0,0,310
23712,210,180,80,80,160,0,710
23713,180,100,80,80,0,0,440
23714,210,100,80,80,160,0,630
23715,190,100,80,80,160,0,610
23716,230,120,160,160,0,0,670
23717,180,100,40,80,0,0,400
23718,210,140,120,80,0,0,550
23719,150,100,120,160,0,0,530
23720,190,120,120,240,160,0,830
23721,220,120,120,80,0,0,540
23722,150,180,160,160,320,0,970
23723,240,160,160,160,160,0,880
23724,150,80,120,160,160,0,670
23725,170,100,160,160,160,0,750
23726,210,100,120,80,160,0,670
23727,240,140,120,160,160,0,820
23728,190,60,120,80,0,0,450
23729,140,100,160,160,320,0,880
23730,150,80,80,80,160,0,550
23731,230,140,120,160,320,0,970
23732,200,140,120,160,0,0,620
23733,180,100,160,160,160,0,760
23734,210,180,120,80,160,0,750
23735,150,80,80,80,0,0,390
23736,190,120,80,80,0,0,470
23737,220,140,160,160,0,0,680
23738,200,120,120,0,0,0,440
23739,220,140,160,0,0,0,520
23740,170,120,160,160,0,0,610
23741,190,60,80,80,0,0,410
23742,220,160,160,160,160,0,860
23743,190,140,80,80,0,0,490
23744,180,140,120,160,160,320,1080
23745,170,40,40,80,160,0,490
23746,200,80,40,80,0,0,400
23747,250,120,160,240,320,0,1090
23748,150,80,120,160,320,0,830
23749,170,120,120,80,160,320,970
23750,160,100,80,80,160,0,580
23751,210,140,240,160,160,320,1230
23752,220,120,160,240,320,320,1380
23753,220,160,40,0,0,0,420
23754,230,140,120,160,160,0,810
23755,220,80,80,160,160,0,700
23756,180,140,120,80,160,0,680
23757,230,140,80,160,0,0,610
23758,200,140,160,160,320,0,980
23759,200,60,120,80,0,0,460
23760,200,200,160,160,320,0,1040
23761,210,140,200,80,0,0,630
23762,190,80,120,160,320,320,1190
23763,210,120,80,160,160,0,730
23764,190,140,80,80,0,0,490
23765,250,180,120,80,0,0,630
23766,170,160,160,0,0,0,490
23767,220,180,200,240,320,0,1160
23768,210,100,120,160,0,0,590
23769,190,100,160,160,320,0,930
23770,180,160,160,160,0,0,660
23771,180,160,160,240,320,320,1380
23772,190,120,120,160,160,0,750
23773,230,120,120,80,0,0,550
23774,200,140,40,0,0,0,380
23775,200,60,80,80,160,0,580
23776,210,100,160,160,320,0,950
23777,180,40,40,0,0,0,260
23778,160,100,120,0,0,0,380
23779,220,140,120,160,0,0,640
23780,180,60,40,0,0,0,280
23781,200,180,120,80,160,0,740
23782,210,100,80,80,0,0,470
23783,200,120,120,80,160,0,680
23784,230,200,200,160,160,0,950
23785,180,100,80,160,0,0,520
23786,200,140,80,80,0,0,500
23787,200,100,120,80,160,0,660
23788,200,100,120,160,160,0,740
23789,200,40,0,0,0,0,240
23790,180,160,120,160,160,0,780
23791,210,100,120,80,160,0,670
23792,180,140,80,80,0,0,480
23793,200,100,80,160,160,0,700
23794,200,120,120,80,0,0,520
23795,170,140,80,160,320,0,870
23796,180,100,80,0,0,0,360
23797,240,140,120,0,0,0,500
23798,200,100,80,80,0,0,460
23799,190,100,120,160,160,320,1050
23800,200,120,120,80,0,0,520
23801,190,120,40,0,0,0,350
23802,210,140,120,80,160,0,710
23803,210,140,200,0,0,0,550
23804,210,120,80,80,160,0,650
23805,190,120,120,160,320,320,1230
23806,180,120,160,0,0,0,460
23807,140,100,80,160,0,0,480
23808,220,100,80,0,0,0,400
23809,180,140,80,80,160,0,640
23810,200,160,80,80,0,0,520
23811,190,140,160,160,0,0,650
23812,180,120,120,160,160,320,1060
23813,200,100,160,160,160,0,780
23814,200,160,120,160,160,0,800
23815,200,120,120,160,320,0,920
23816,180,140,200,160,160,320,1160
23817,160,100,120,0,0,0,380
23818,230,80,40,0,0,0,350
23819,240,140,160,80,0,0,620
23820,200,100,40,80,160,0,580
23821,220,100,80,80,0,0,480
23822,210,140,160,80,160,0,750
23823,210,120,160,240,160,0,890
23824,230,160,120,80,0,0,590
23825,190,60,40,80,160,0,530
23826,150,120,40,0,0,0,310
23827,240,140,240,160,320,0,1100
23828,200,160,160,80,160,0,760
23829,200,100,80,160,160,0,700
23830,190,120,80,80,0,0,470
23831,200,180,160,240,160,0,940
23832,200,80,40,80,160,0,560
23833,240,160,200,160,0,0,760
23834,160,100,120,160,160,0,700
23835,150,100,120,80,0,0,450
23836,200,160,120,160,160,0,800
23837,160,100,80,80,160,0,580
23838,200,100,80,0,0,0,380
23839,170,100,120,0,0,0,390
23840,200,100,40,80,160,320,900
23841,210,160,120,80,160,0,730
23842,190,80,80,160,160,0,670
23843,190,180,120,80,160,320,1050
23844,200,140,120,160,320,0,940
23845,200,80,80,80,160,0,600
23846,160,80,40,80,0,0,360
23847,210,80,120,160,0,0,570
23848,200,100,120,80,0,0,500
23849,220,80,120,160,320,0,900
23850,160,100,80,80,160,320,900
23851,200,140,120,160,320,0,940
23852,210,140,120,80,0,0,550
23853,160,120,120,80,160,0,640
23854,190,160,160,80,0,0,590
23855,230,160,80,0,0,0,470
23856,190,140,160,80,160,0,730
23857,210,120,120,0,0,0,450
23858,190,140,160,160,160,0,810
23859,170,100,80,80,160,0,590
23860,220,80,40,80,0,0,420
23861,200,140,80,80,160,320,980
23862,240,160,160,160,320,0,1040
23863,200,140,120,80,160,0,700
23864,220,140,80,80,0,0,520
23865,210,140,160,160,160,320,1150
23866,210,120,160,80,0,0,570
23867,180,140,120,80,160,320,1000
23868,190,160,120,0,0,0,470
23869,220,100,80,80,160,0,640
23870,210,120,40,80,160,0,610
23871,200,100,80,80,160,0,620
23872,190,100,80,80,0,0,450
23873,210,140,80,160,0,0,590
23874,140,80,40,0,0,0,260
23875,160,160,160,240,320,0,1040
23876,190,160,160,80,0,0,590
23877,180,60,40,80,160,0,520
23878,260,200,120,80,160,0,820
23879,200,120,120,160,160,0,760
23880,210,80,120,160,160,0,730
23881,200,140,120,160,320,0,940
23882,180,140,120,80,0,0,520
23883,200,160,80,80,160,0,680
23884,160,120,80,160,320,0,840
23885,190,100,120,80,0,0,490
23886,180,100,120,160,320,0,880
23887,200,120,80,0,0,0,400
23888,150,100,40,0,0,0,290
23889,240,140,120,160,160,0,820
23890,210,160,120,160,160,0,810
23891,230,100,80,160,160,0,730
23892,190,120,120,160,0,0,590
23893,180,160,160,160,160,0,820
23894,170,100,120,80,160,0,630
23895,200,100,120,160,160,320,1060
23896,190,140,120,80,0,0,530
23897,190,140,120,80,0,0,530
23898,180,120,80,80,0,0,460
23899,200,160,200,160,320,320,1360
23900,130,100,80,80,160,320,870
23901,250,220,120,160,0,0,750
23902,140,120,80,80,160,0,580
23903,200,100,120,80,160,0,660
23904,230,180,80,160,160,0,810
23905,220,140,80,80,160,0,680
23906,180,160,160,80,160,0,740
23907,220,100,120,80,160,0,680
23908,180,180,160,80,0,0,600
23909,220,100,120,160,160,0,760
23910,180,160,200,240,320,0,1100
23911,230,120,160,160,0,0,670
23912,220,80,120,80,160,0,660
23913,200,100,40,0,0,0,340
23914,200,100,80,80,160,320,940
23915,230,120,80,80,160,0,670
23916,220,140,80,0,0,0,440
23917,190,100,80,80,160,320,930
23918,180,120,80,160,320,320,1180
23919,210,160,80,80,160,0,690
23920,230,140,80,80,160,0,690
23921,180,100,80,0,0,0,360
23922,220,80,40,80,160,0,580
23923,190,120,120,80,160,0,670
23924,210,160,80,80,160,320,1010
23925,170,120,120,80,160,0,650
23926,230,140,160,240,0,0,770
23927,170,160,160,160,320,0,970
23928,210,140,80,0,0,0,430
23929,190,140,40,0,0,0,370
23930,200,100,80,80,0,0,460
23931,170,100,80,80,160,0,590
23932,160,100,80,80,160,0,580
23933,190,160,200,160,160,0,870
23934,230,60,0,0,0,0,290
23935,180,140,120,160,160,0,760
23936,220,120,40,80,160,0,620
23937,190,140,80,80,160,320,970
23938,210,100,0,0,0,0,310
23939,150,120,80,80,0,0,430
23940,160,180,160,0,0,0,500
23941,200,140,160,160,0,0,660
23942,210,120,0,0,0,0,330
23943,170,140,120,160,160,0,750
23944,170,100,40,0,0,0,310
23945,180,60,40,80,0,0,360
23946,200,120,0,0,0,0,320
23947,230,140,120,80,0,0,570
23948,210,120,80,80,160,0,650
23949,190,100,80,160,320,0,850
23950,230,120,120,80,160,0,710
23951,180,60,0,0,0,0,240
23952,210,120,40,0,0,0,370
23953,180,100,120,80,0,0,480
23954,180,80,80,80,160,0,580
23955,190,140,160,160,320,320,1290
23956,210,140,200,160,320,0,1030
23957,160,120,160,160,0,0,600
23958,180,120,80,0,0,0,380
23959,200,160,160,160,160,0,840
23960,200,180,80,0,0,0,460
23961,200,100,80,80,160,0,620
23962,170,120,80,0,0,0,370
23963,180,120,120,160,160,0,740
23964,170,80,80,80,160,0,570
23965,220,100,80,80,160,0,640
23966,170,80,80,80,160,0,570
23967,180,140,80,80,160,0,640
23968,230,140,200,240,160,0,970
23969,260,140,120,160,160,0,840
23970,190,120,160,160,160,0,790
23971,170,100,80,80,160,0,590
23972,230,160,120,160,320,320,1310
23973,180,140,200,160,320,0,1000
23974,190,120,80,160,160,320,1030
23975,200,100,80,160,0,0,540
23976,150,80,80,80,0,0,390
23977,210,140,200,160,0,0,710
23978,230,120,80,80,0,0,510
23979,210,120,120,160,160,320,1090
23980,190,140,120,80,160,320,1010
23981,220,160,240,160,160,320,1260
23982,200,60,80,160,320,320,1140
23983,230,180,120,0,0,0,530
23984,160,120,120,80,160,0,640
23985,200,120,80,160,160,0,720
23986,220,180,120,80,160,320,1080
23987,180,60,80,0,0,0,320
23988,220,60,80,160,160,0,680
23989,190,120,120,80,160,0,670
23990,210,160,120,160,160,0,810
23991,220,180,120,80,160,0,760
23992,240,180,160,160,160,0,900
23993,210,100,40,80,0,0,430
23994,170,140,120,80,0,0,510
23995,190,140,200,160,160,0,850
23996,170,140,120,240,160,0,830
23997,200,180,80,0,0,0,460
23998,190,160,120,160,160,0,790
23999,190,120,120,160,160,0,750
24000,240,100,80,160,320,0,900
24001,180,140,40,80,160,0,600
24002,200,140,120,80,160,0,700
24003,190,80,40,0,0,0,310
24004,210,120,160,160,0,0,650
24005,180,60,120,160,320,0,840
24006,240,120,120,80,0,0,560
24007,200,160,120,80,160,0,720
24008,180,120,80,80,160,0,620
24009,190,180,120,160,160,0,810
24010,200,100,80,0,0,0,380
24011,210,140,80,0,0,0,430
24012,190,160,160,160,320,320,1310
24013,200,120,80,80,160,320,960
24014,200,160,160,160,160,0,840
24015,150,100,80,80,160,0,570
24016,190,160,120,0,0,0,470
24017,190,40,40,80,160,0,510
24018,180,80,120,240,320,0,940
24019,200,80,80,80,160,320,920
24020,220,140,160,240,320,0,1080
24021,210,160,160,240,0,0,770
24022,200,100,40,80,160,0,580
24023,210,120,80,80,160,0,650
24024,210,100,160,160,160,0,790
24025,200,120,160,160,160,0,800
24026,200,80,80,80,160,0,600
24027,190,100,40,80,160,0,570
24028,180,120,120,80,160,0,660
24029,240,160,160,160,320,320,1360
24030,220,160,120,80,0,0,580
24031,140,100,120,160,160,0,680
24032,210,120,160,80,0,0,570
24033,240,100,120,160,160,0,780
24034,190,120,80,0,0,0,390
24035,200,120,40,0,0,0,360
24036,210,100,80,80,160,0,630
24037,190,140,40,80,0,0,450
24038,220,120,40,0,0,0,380
24039,210,180,160,160,0,0,710
24040,200,100,120,80,160,0,660
24041,200,140,160,160,160,0,820
24042,180,80,120,80,0,0,460
24043,200,120,120,160,320,320,1240
24044,170,120,80,80,0,0,450
24045,220,180,120,160,320,0,1000
24046,230,100,80,160,0,0,570
24047,220,200,120,160,160,0,860
24048,250,160,160,240,160,0,970
24049,210,60,80,160,320,320,1150
24050,200,140,120,160,0,0,620
24051,150,100,120,240,0,0,610
24052,170,80,80,160,320,320,1130
24053,230,180,80,160,160,0,810
24054,220,160,160,240,320,0,1100
24055,170,60,40,80,160,0,510
24056,190,120,40,0,0,0,350
24057,210,140,80,80,0,0,510
24058,190,100,40,80,160,320,890
24059,180,140,80,80,0,0,480
24060,190,140,200,160,320,0,1010
24061,200,100,80,80,160,320,940
24062,130,120,40,0,0,0,290
24063,210,180,80,80,0,0,550
24064,210,160,80,0,0,0,450
24065,190,120,120,0,0,0,430
24066,220,140,40,0,0,0,400
24067,200,140,120,160,160,0,780
24068,250,180,160,160,160,320,1230
24069,200,80,40,80,160,320,880
24070,180,100,80,0,0,0,360
24071,190,140,120,80,160,0,690
24072,220,100,80,80,0,0,480
24073,190,140,120,160,0,0,610
24074,220,140,120,80,160,0,720
24075,160,100,160,160,160,0,740
24076,220,120,80,80,0,0,500
24077,190,160,120,80,160,0,710
24078,210,100,120,80,160,0,670
24079,180,100,40,0,0,0,320
24080,170,120,80,0,0,0,370
24081,210,180,120,160,160,0,830
24082,200,140,160,0,0,0,500
24083,200,200,280,240,160,0,1080
24084,240,100,120,160,160,0,780
24085,210,140,160,160,320,320,1310
24086,200,100,80,80,160,0,620
24087,170,80,120,160,160,0,690
24088,180,100,120,0,0,0,400
24089,190,120,80,80,160,0,630
24090,260,180,160,80,0,0,680
24091,190,140,120,80,160,0,690
24092,170,80,40,80,160,0,530
24093,200,80,120,160,160,0,720
24094,180,60,40,80,160,0,520
24095,210,160,80,80,0,0,530
24096,180,120,120,160,160,0,740
24097,220,140,200,80,160,0,800
24098,230,120,40,80,160,0,630
24099,180,140,80,80,0,0,480
24100,230,160,120,0,0,0,510
24101,210,100,120,80,160,0,670
24102,180,120,160,160,160,0,780
24103,160,140,80,80,160,0,620
24104,250,140,120,80,160,0,750
24105,220,140,120,80,160,0,720
24106,180,160,120,80,160,320,1020
24107,180,80,40,0,0,0,300
24108,250,120,80,80,0,0,530
24109,170,120,80,0,0,0,370
24110,230,180,200,240,160,320,1330
24111,220,160,200,80,160,0,820
24112,160,120,80,80,160,0,600
24113,260,100,40,80,160,0,640
24114,190,120,40,0,0,0,350
24115,210,120,200,240,320,320,1410
24116,180,140,160,160,160,0,800
24117,200,120,120,160,320,0,920
24118,200,160,80,80,0,0,520
24119,160,60,80,80,0,0,380
24120,200,100,40,80,160,0,580
24121,190,120,80,160,160,0,710
24122,240,160,160,160,0,0,720
24123,190,120,120,160,160,320,1070
24124,200,100,80,80,160,0,620
24125,150,120,200,240,160,0,870
24126,160,60,80,80,160,0,540
24127,200,120,40,80,160,0,600
24128,230,140,40,80,160,0,650
24129,240,100,80,80,0,0,500
24130,210,140,0,0,0,0,350
24131,220,160,120,80,160,0,740
24132,210,180,160,80,160,0,790
24133,190,100,160,160,160,0,770
24134,190,140,160,0,0,0,490
24135,190,100,120,160,320,0,890
24136,210,180,160,80,160,0,790
24137,230,120,80,80,160,0,670
24138,220,100,80,160,320,0,880
24139,160,60,80,160,320,0,780
24140,170,140,160,240,320,0,1030
24141,170,80,160,160,0,0,570
24142,180,80,80,0,0,0,340
24143,140,120,160,160,160,0,740
24144,220,160,80,80,160,0,700
24145,170,60,40,80,0,0,350
24146,150,60,80,0,0,0,290
24147,200,100,120,160,0,0,580
24148,180,160,120,160,160,0,780
24149,180,100,160,160,160,0,760
24150,170,100,80,160,160,320,990
24151,170,80,80,160,160,0,650
24152,180,160,120,80,0,0,540
24153,210,160,200,0,0,0,570
24154,200,80,120,80,160,0,640
24155,220,100,120,80,160,0,680
24156,200,140,160,160,0,0,660
24157,230,120,120,80,160,320,1030
24158,200,160,160,80,160,0,760
24159,200,140,120,80,0,0,540
24160,170,100,40,0,0,0,310
24161,200,160,160,240,320,320,1400
24162,200,140,40,80,160,0,620
24163,220,140,120,160,320,320,1280
24164,210,100,80,80,0,0,470
24165,220,120,120,80,160,0,700
24166,200,100,80,0,0,0,380
24167,190,140,80,80,160,320,970
24168,190,100,120,80,160,0,650
24169,140,100,80,80,160,0,560
24170,210,160,80,0,0,0,450
24171,240,120,40,0,0,0,400
24172,230,120,80,80,0,0,510
24173,200,60,40,80,160,0,540
24174,220,100,80,80,0,0,480
24175,250,160,160,80,0,0,650
24176,220,160,160,160,160,0,860
24177,160,100,40,0,0,0,300
24178,190,140,120,80,0,0,530
24179,180,80,120,160,160,0,700
24180,180,140,160,240,320,0,1040
24181,170,120,80,0,0,0,370
24182,190,100,120,80,160,0,650
24183,170,140,120,160,320,320,1230
24184,170,100,160,80,160,0,670
24185,160,80,120,160,160,0,680
24186,190,120,80,160,160,0,710
24187,190,160,120,80,160,0,710
24188,140,80,80,80,160,0,540
24189,200,160,160,80,0,0,600
24190,220,160,160,80,0,0,620
24191,160,120,80,80,160,320,920
24192,180,160,120,160,160,0,780
24193,210,160,120,0,0,0,490
24194,250,100,160,80,160,0,750
24195,180,100,120,80,0,0,480
24196,150,100,160,160,160,0,730
24197,200,100,120,160,320,320,1220
24198,190,120,160,80,160,0,710
24199,180,100,80,160,160,320,1000
24200,190,100,40,80,160,0,570
24201,190,100,40,80,0,0,410
24202,180,160,160,240,160,0,900
24203,220,180,80,80,0,0,560
24204,190,80,120,160,320,0,870
24205,190,160,200,240,320,0,1110
24206,180,140,120,80,160,0,680
24207,220,140,40,0,0,0,400
24208,250,180,160,80,160,0,830
24209,210,140,80,80,160,320,990
24210,210,120,80,80,160,0,650
24211,180,140,200,240,320,0,1080
24212,170,100,80,160,160,0,670
24213,210,100,80,0,0,0,390
24214,210,100,80,80,0,0,470
24215,200,120,160,80,160,0,720
24216,180,100,40,80,160,320,880
24217,190,120,80,80,0,0,470
24218,180,160,200,240,0,0,780
24219,180,140,120,160,320,0,920
24220,240,120,80,80,0,0,520
24221,160,120,40,0,0,0,320
24222,150,120,120,160,0,0,550
24223,210,180,160,160,160,320,1190
24224,180,80,120,80,160,0,620
24225,140,60,40,80,0,0,320
24226,210,60,40,80,0,0,390
24227,230,120,120,80,0,0,550
24228,160,100,80,160,320,0,820
24229,180,160,120,80,160,0,700
24230,190,200,80,160,160,0,790
24231,220,120,80,80,160,0,660
24232,240,140,200,240,320,0,1140
24233,210,100,120,80,160,0,670
24234,220,140,80,0,0,0,440
24235,200,120,80,160,160,0,720
24236,190,100,80,160,320,320,1170
24237,180,100,40,0,0,0,320
24238,210,120,120,160,320,0,930
24239,170,120,40,0,0,0,330
24240,220,180,120,160,160,320,1160
24241,190,160,120,80,0,0,550
24242,220,80,40,0,0,0,340
24243,210,140,120,80,160,320,1030
24244,230,140,120,80,0,0,570
24245,220,80,80,80,160,0,620
24246,200,80,80,160,160,0,680
24247,180,160,120,160,320,0,940
24248,210,120,160,240,160,0,890
24249,190,80,80,80,160,0,590
24250,210,140,160,160,320,0,990
24251,190,160,80,80,160,0,670
24252,160,120,120,240,320,320,1280
24253,210,160,120,80,0,0,570
24254,210,140,160,240,320,0,1070
24255,210,180,120,160,320,320,1310
24256,200,80,80,0,0,0,360
24257,200,120,120,160,0,0,600
24258,220,80,120,80,160,0,660
24259,220,140,160,240,320,0,1080
24260,200,160,120,80,0,0,560
24261,210,180,80,80,160,0,710
24262,210,140,80,160,320,0,910
24263,200,120,120,80,160,0,680
24264,200,140,40,80,160,320,940
24265,200,120,120,80,0,0,520
24266,190,100,80,0,0,0,370
24267,210,180,120,160,0,0,670
24268,200,140,160,160,320,0,980
24269,170,80,40,0,0,0,290
24270,200,100,80,80,160,320,940
24271,170,100,40,80,160,0,550
24272,190,120,120,240,320,0,990
24273,190,80,80,160,160,0,670
24274,190,100,80,80,160,0,610
24275,210,120,120,160,160,0,770
24276,200,140,0,0,0,0,340
24277,230,120,80,80,160,0,670
24278,190,140,160,80,0,0,570
24279,180,120,120,80,160,0,660
24280,220,160,200,240,320,0,1140
24281,160,100,80,160,160,0,660
24282,200,160,120,0,0,0,480
24283,200,140,120,0,0,0,460
24284,200,140,120,160,160,320,1100
24285,260,120,40,80,160,0,660
24286,180,100,80,80,0,0,440
24287,160,140,40,80,160,0,580
24288,220,160,80,160,0,0,620
24289,210,160,120,160,320,320,1290
24290,210,200,240,160,160,320,1290
24291,180,120,80,80,160,320,940
24292,210,120,40,0,0,0,370
24293,160,100,80,0,0,0,340
24294,220,100,120,160,160,0,760
24295,210,160,160,240,320,0,1090
24296,160,160,120,160,160,0,760
24297,210,160,80,0,0,0,450
24298,200,140,160,80,160,320,1060
24299,180,140,120,80,160,0,680
24300,190,120,40,0,0,0,350
24301,170,160,40,0,0,0,370
24302,200,160,160,80,160,0,760
24303,170,120,120,80,0,0,490
24304,170,60,80,80,160,0,550
24305,200,200,200,160,0,0,760
24306,210,160,160,240,320,320,1410
24307,230,140,160,240,320,320,1410
24308,210,160,200,240,320,320,1450
24309,170,120,160,80,160,0,690
24310,170,100,40,0,0,0,310
24311,210,140,120,80,160,0,710
24312,200,100,160,0,0,0,460
24313,220,160,120,80,160,0,740
24314,230,100,120,160,320,320,1250
24315,150,120,120,80,0,0,470
24316,190,100,80,160,0,0,530
24317,180,140,120,160,320,320,1240
24318,210,80,80,160,160,0,690
24319,240,160,160,240,160,0,960
24320,180,140,120,0,0,0,440
24321,180,80,80,0,0,0,340
24322,200,100,80,0,0,0,380
24323,170,60,120,0,0,0,350
24324,160,40,40,0,0,0,240
24325,220,180,80,160,160,0,800
24326,180,140,160,80,160,0,720
24327,220,140,80,160,160,0,760
24328,210,180,120,80,160,320,1070
24329,250,160,120,80,160,0,770
24330,180,20,40,80,0,0,320
24331,140,100,160,160,160,0,720
24332,190,140,160,160,0,0,650
24333,220,80,80,0,0,0,380
24334,220,160,200,160,160,0,900
24335,200,160,120,160,320,0,960
24336,180,120,120,80,160,320,980
24337,180,160,160,240,160,0,900
24338,200,120,120,160,0,0,600
24339,200,160,200,160,160,0,880
24340,190,100,80,80,160,0,610
24341,160,120,120,160,160,0,720
24342,190,100,80,0,0,0,370
24343,170,60,120,80,0,0,430
24344,190,80,0,0,0,0,270
24345,220,120,120,160,160,320,1100
24346,190,60,40,0,0,0,290
24347,180,80,120,80,160,0,620
24348,220,120,40,0,0,0,380
24349,170,100,80,80,0,0,430
24350,220,140,120,160,0,0,640
24351,210,140,80,80,0,0,510
24352,200,160,160,160,0,0,680
24353,200,100,120,160,160,320,1060
24354,200,80,80,160,320,0,840
24355,210,100,120,160,320,320,1230
24356,180,80,80,160,160,0,660
24357,180,120,120,160,160,0,740
24358,210,80,120,80,160,0,650
24359,160,80,120,0,0,0,360
24360,210,140,80,80,160,0,670
24361,250,160,120,0,0,0,530
24362,210,120,80,0,0,0,410
24363,210,140,120,160,160,0,790
24364,210,80,40,80,160,0,570
24365,210,140,200,240,160,0,950
24366,190,160,120,160,320,0,950
24367,200,40,0,0,0,0,240
24368,160,60,80,160,320,320,1100
24369,150,100,160,160,160,0,730
24370,180,100,40,80,0,0,400
24371,170,120,80,80,160,0,610
24372,180,100,80,0,0,0,360
24373,160,140,120,80,160,0,660
24374,220,160,160,240,160,0,940
24375,210,100,160,160,320,320,1270
24376,230,140,160,160,320,0,1010
24377,230,60,0,0,0,0,290
24378,190,120,120,0,0,0,430
24379,190,160,160,240,320,320,1390
24380,200,120,80,160,0,0,560
24381,200,160,80,0,0,0,440
24382,240,180,80,80,160,320,1060
24383,170,80,120,0,0,0,370
24384,170,120,200,240,320,0,1050
24385,230,180,120,80,160,320,1090
24386,190,160,120,0,0,0,470
24387,230,120,80,0,0,0,430
24388,160,120,80,160,160,0,680
24389,200,160,80,80,0,0,520
24390,180,80,80,160,160,0,660
24391,230,100,80,0,0,0,410
24392,210,180,160,240,320,0,1110
24393,190,140,120,160,160,320,1090
24394,190,80,120,160,320,320,1190
24395,210,120,40,80,160,0,610
24396,200,80,40,0,0,0,320
24397,200,120,160,160,0,0,640
24398,200,80,80,160,160,0,680
24399,210,140,160,80,160,320,1070
24400,240,140,160,80,0,0,620
24401,190,120,0,0,0,0,310
24402,240,160,160,160,320,0,1040
24403,190,120,40,0,0,0,350
24404,160,120,160,160,160,0,760
24405,190,120,120,80,160,0,670
24406,180,100,40,80,160,0,560
24407,190,120,160,80,0,0,550
24408,210,100,120,0,0,0,430
24409,180,120,160,240,320,0,1020
24410,240,160,80,80,160,0,720
24411,200,100,80,80,0,0,460
24412,170,100,40,80,160,0,550
24413,250,160,160,160,320,0,1050
24414,210,140,120,240,160,320,1190
24415,210,100,120,160,320,0,910
24416,150,100,120,80,160,0,610
24417,180,120,80,160,160,0,700
24418,180,80,120,240,0,0,620
24419,220,40,80,80,0,0,420
24420,120,80,80,0,0,0,280
24421,170,80,120,160,160,0,690
24422,210,180,160,240,320,320,1430
24423,190,140,80,80,160,0,650
24424,230,160,160,80,0,0,630
24425,190,140,80,80,0,0,490
24426,220,120,120,160,0,0,620
24427,220,160,80,160,0,0,620
24428,140,80,80,0,0,0,300
24429,180,140,120,160,160,0,760
24430,160,80,80,0,0,0,320
24431,200,120,120,160,160,0,760
24432,180,60,80,80,0,0,400
24433,220,140,80,80,0,0,520
24434,230,140,120,240,160,320,1210
24435,200,160,120,160,160,0,800
24436,170,100,120,160,320,320,1190
24437,220,100,120,80,160,0,680
24438,220,180,160,160,160,0,880
24439,160,100,120,160,160,0,700
24440,160,120,120,80,160,0,640
24441,180,100,120,0,0,0,400
24442,200,140,120,160,0,0,620
24443,210,120,80,0,0,0,410
24444,220,140,40,0,0,0,400
24445,160,100,120,80,160,0,620
24446,170,100,120,80,0,0,470
24447,190,120,120,160,320,0,910
24448,210,120,160,160,0,0,650
24449,230,120,160,80,0,0,590
24450,180,80,80,80,160,0,580
24451,190,120,160,80,160,0,710
24452,170,60,40,0,0,0,270
24453,180,100,40,0,0,0,320
24454,240,160,120,160,160,320,1160
24455,190,160,120,80,160,0,710
24456,250,180,200,160,320,0,1110
24457,140,80,80,80,0,0,380
24458,180,120,120,160,320,0,900
24459,230,180,120,80,0,0,610
24460,180,160,200,80,160,0,780
24461,210,80,80,160,320,0,850
24462,210,160,40,80,160,320,970
24463,200,160,40,80,160,0,640
24464,170,120,80,80,160,0,610
24465,190,120,120,80,0,0,510
24466,200,100,40,80,160,0,580
24467,170,100,120,80,160,0,630
24468,250,140,160,0,0,0,550
24469,200,140,160,240,160,0,900
24470,160,100,80,0,0,0,340
24471,180,120,120,160,0,0,580
24472,220,200,160,160,160,0,900
24473,190,100,120,80,0,0,490
24474,200,140,160,80,0,0,580
24475,170,100,160,0,0,0,430
24476,170,140,80,80,160,0,630
24477,210,140,40,0,0,0,390
24478,170,160,80,80,0,0,490
24479,220,140,120,80,0,0,560
24480,230,140,160,160,320,0,1010
24481,230,180,120,160,160,320,1170
24482,150,100,120,160,320,320,1170
24483,160,100,40,0,0,0,300
24484,200,120,120,160,160,0,760
24485,200,140,40,0,0,0,380
24486,160,80,80,80,160,320,880
24487,190,140,120,80,160,0,690
24488,240,220,160,80,160,0,860
24489,250,100,80,80,0,0,510
24490,210,100,40,80,160,0,590
24491,210,160,120,160,320,0,970
24492,210,100,120,80,0,0,510
24493,180,200,160,160,160,0,860
24494,180,80,80,160,160,0,660
24495,160,100,80,80,0,0,420
24496,190,140,120,80,0,0,530
24497,190,80,80,80,160,0,590
24498,200,120,80,80,160,320,960
24499,190,120,40,80,0,0,430
24500,170,100,120,80,160,0,630
24501,230,80,80,160,160,320,1030
24502,200,120,160,160,160,0,800
24503,210,160,120,160,160,0,810
24504,230,140,80,80,0,0,530
24505,180,100,160,160,160,320,1080
24506,160,80,0,0,0,0,240
24507,220,140,80,80,0,0,520
24508,230,140,120,80,160,0,730
24509,180,120,120,80,160,0,660
24510,160,160,160,80,0,0,560
24511,170,160,40,0,0,0,370
24512,180,140,160,160,160,0,800
24513,220,220,200,160,0,0,800
24514,150,100,80,0,0,0,330
24515,210,120,80,80,0,0,490
24516,180,160,40,0,0,0,380
24517,190,120,160,80,0,0,550
24518,180,100,80,80,160,0,600
24519,210,80,120,80,160,0,650
24520,200,140,40,0,0,0,380
24521,190,140,120,160,0,0,610
24522,150,80,40,80,160,320,830
24523,200,160,120,80,0,0,560
24524,230,120,80,80,160,0,670
24525,170,100,80,80,0,0,430
24526,220,140,120,80,0,0,560
24527,170,120,160,80,160,0,690
24528,190,120,120,80,160,0,670
24529,170,80,80,80,0,0,410
24530,200,160,160,80,160,0,760
24531,220,100,40,0,0,0,360
24532,210,60,80,0,0,0,350
24533,180,120,80,160,160,0,700
24534,190,160,160,80,160,0,750
24535,210,120,120,80,160,320,1010
24536,160,120,40,80,0,0,400
24537,220,120,80,160,160,320,1060
24538,150,80,80,80,160,0,550
24539,210,120,160,80,160,0,730
24540,190,100,80,0,0,0,370
24541,250,160,80,160,160,0,810
24542,190,120,160,160,160,0,790
24543,150,120,160,240,320,0,990
24544,220,120,80,0,0,0,420
24545,180,200,120,160,160,0,820
24546,210,140,160,160,160,0,830
24547,170,100,80,80,160,0,590
24548,210,160,120,80,160,0,730
24549,180,140,120,160,160,0,760
24550,200,140,120,160,160,0,780
24551,180,140,0,0,0,0,320
24552,220,100,80,80,0,0,480
24553,230,120,160,160,0,0,670
24554,200,160,80,80,0,0,520
24555,190,100,80,0,0,0,370
24556,200,80,80,80,0,0,440
24557,200,140,160,0,0,0,500
24558,200,100,80,80,0,0,460
24559,220,180,120,80,0,0,600
24560,190,100,160,240,320,320,1330
24561,170,140,40,80,160,0,590
24562,210,100,80,160,160,320,1030
24563,200,80,80,80,160,320,920
24564,220,140,160,160,0,0,680
24565,220,140,120,0,0,0,480
24566,200,120,160,80,160,0,720
24567,220,140,120,80,0,0,560
24568,160,80,120,80,160,0,600
24569,160,120,80,80,0,0,440
24570,200,120,80,80,0,0,480
24571,190,120,40,0,0,0,350
24572,180,80,80,0,0,0,340
24573,170,140,80,80,0,0,470
24574,190,100,80,0,0,0,370
24575,210,120,160,80,0,0,570
24576,200,160,80,80,0,0,520
24577,220,180,120,160,160,0,840
24578,190,80,80,0,0,0,350
24579,150,60,40,0,0,0,250
24580,160,60,40,80,160,0,500
24581,160,60,120,160,320,0,820
24582,210,140,80,80,160,0,670
24583,200,180,160,160,160,0,860
24584,180,140,80,80,0,0,480
24585,190,40,40,80,160,0,510
24586,170,100,80,160,0,0,510
24587,180,100,80,160,160,320,1000
24588,170,100,40,80,160,0,550
24589,230,120,120,80,160,0,710
24590,220,140,120,0,0,0,480
24591,180,120,80,0,0,0,380
24592,210,140,80,160,160,320,1070
24593,210,160,160,80,160,0,770
24594,210,160,40,0,0,0,410
24595,180,100,120,160,160,0,720
24596,190,80,40,80,160,0,550
24597,200,80,80,0,0,0,360
24598,210,140,0,0,0,0,350
24599,190,120,0,0,0,0,310
24600,170,120,80,80,160,0,610
24601,220,140,160,80,160,0,760
24602,170,120,40,0,0,0,330
24603,140,160,120,160,320,320,1220
24604,200,140,160,80,160,0,740
24605,210,100,40,0,0,0,350
24606,170,140,40,0,0,0,350
24607,180,100,40,0,0,0,320
24608,120,80,80,160,160,0,600
24609,200,100,160,0,0,0,460
24610,190,80,80,80,0,0,430
24611,150,120,160,240,160,0,830
24612,180,180,120,160,0,0,640
24613,180,120,160,80,160,0,700
24614,230,100,160,160,160,0,810
24615,190,80,120,240,320,0,950
24616,220,160,200,160,160,0,900
24617,190,160,80,160,160,0,750
24618,180,160,80,80,160,0,660
24619,240,180,160,160,320,320,1380
24620,210,180,160,80,0,0,630
24621,190,80,0,0,0,0,270
24622,190,100,120,80,0,0,490
24623,220,140,120,240,160,320,1200
24624,210,160,120,160,160,0,810
24625,170,100,160,160,160,0,750
24626,200,100,80,80,160,0,620
24627,210,140,80,0,0,0,430
24628,180,120,80,80,160,0,620
24629,200,120,80,80,0,0,480
24630,180,120,160,240,160,0,860
24631,180,80,80,80,0,0,420
24632,200,140,120,80,160,0,700
24633,230,100,80,0,0,0,410
24634,220,140,40,0,0,0,400
24635,210,100,80,80,160,0,630
24636,200,160,160,160,160,320,1160
24637,180,100,80,80,160,320,920
24638,210,120,160,160,320,0,970
24639,180,160,120,0,0,0,460
24640,220,100,200,160,160,0,840
24641,180,180,120,80,160,0,720
24642,190,60,80,80,160,0,570
24643,200,180,120,80,0,0,580
24644,200,180,120,160,0,0,660
24645,200,120,160,160,320,0,960
24646,160,140,80,160,320,0,860
24647,230,180,120,160,160,0,850
24648,240,80,120,80,160,0,680
24649,190,120,80,160,160,0,710
24650,200,140,160,160,160,0,820
24651,230,180,160,80,160,0,810
24652,150,100,120,0,0,0,370
24653,210,180,160,160,160,0,870
24654,210,120,120,0,0,0,450
24655,170,160,80,0,0,0,410
24656,200,140,120,160,0,0,620
24657,180,120,0,0,0,0,300
24658,190,140,80,80,160,0,650
24659,200,140,80,0,0,0,420
24660,170,100,80,80,0,0,430
24661,180,160,160,160,320,320,1300
24662,200,120,160,80,160,0,720
24663,200,80,40,80,160,0,560
24664,200,160,80,80,0,0,520
24665,160,120,80,160,0,0,520
24666,190,120,80,80,160,320,950
24667,170,120,160,240,320,0,1010
24668,180,80,80,0,0,0,340
24669,200,60,40,80,0,0,380
24670,220,100,120,160,160,0,760
24671,190,100,40,0,0,0,330
24672,180,180,120,0,0,0,480
24673,220,100,80,80,160,320,960
24674,220,140,160,240,320,0,1080
24675,170,80,80,0,0,0,330
24676,170,80,80,80,0,0,410
24677,160,80,120,80,0,0,440
24678,210,160,200,240,320,0,1130
24679,210,120,80,80,0,0,490
24680,210,100,120,160,160,0,750
24681,210,100,120,80,160,0,670
24682,170,160,120,0,0,0,450
24683,220,120,80,0,0,0,420
24684,200,120,120,80,0,0,520
24685,160,160,160,80,160,0,720
24686,200,80,120,0,0,0,400
24687,240,160,200,80,160,0,840
24688,210,160,80,160,160,320,1090
24689,210,140,40,0,0,0,390
24690,180,160,120,80,0,0,540
24691,190,100,80,80,160,320,930
24692,160,100,160,80,160,320,980
24693,170,100,80,80,0,0,430
24694,210,140,80,80,0,0,510
24695,180,120,80,80,160,0,620
24696,190,80,40,0,0,0,310
24697,200,140,80,0,0,0,420
24698,220,120,80,160,160,0,740
24699,200,80,0,0,0,0,280
24700,200,140,120,160,160,320,1100
24701,180,140,120,0,0,0,440
24702,200,100,160,240,160,0,860
24703,160,120,200,160,160,320,1120
24704,190,140,120,160,320,0,930
24705,140,80,40,80,0,0,340
24706,190,100,80,80,160,0,610
24707,200,120,160,160,160,320,1120
24708,190,100,160,160,160,0,770
24709,160,140,160,160,0,0,620
24710,200,120,160,80,160,0,720
24711,210,120,160,160,160,0,810
24712,180,200,120,160,0,0,660
24713,220,100,120,0,0,0,440
24714,210,140,120,160,160,0,790
24715,230,100,120,160,160,0,770
24716,210,140,160,80,160,0,750
24717,210,120,120,0,0,0,450
24718,230,180,160,240,320,0,1130
24719,230,140,80,160,160,320,1090
24720,170,80,80,160,320,0,810
24721,200,140,120,80,0,0,540
24722,200,160,120,80,0,0,560
24723,150,140,80,160,160,0,690
24724,180,120,120,80,0,0,500
24725,200,160,40,0,0,0,400
24726,190,100,120,160,320,320,1210
24727,190,60,80,0,0,0,330
24728,150,100,120,80,160,0,610
24729,190,100,80,80,0,0,450
24730,170,100,80,0,0,0,350
24731,200,120,120,0,0,0,440
24732,210,120,80,80,160,0,650
24733,210,120,80,80,160,0,650
24734,210,100,80,80,160,0,630
24735,230,180,240,160,0,0,810
24736,210,100,80,80,0,0,470
24737,190,160,120,160,160,0,790
24738,210,140,120,80,160,0,710
24739,160,120,120,80,160,320,960
24740,170,140,120,80,160,320,990
24741,170,80,40,0,0,0,290
24742,180,120,200,240,0,0,740
24743,210,200,200,160,160,0,930
24744,200,120,40,80,160,0,600
24745,210,100,40,80,160,0,590
24746,230,220,40,0,0,0,490
24747,190,180,160,240,160,0,930
24748,210,80,40,80,160,0,570
24749,180,120,120,0,0,0,420
24750,210,140,80,80,0,0,510
24751,180,160,120,160,160,0,780
24752,200,100,80,160,160,320,1020
24753,220,140,80,160,160,0,760
24754,200,120,200,240,320,0,1080
24755,230,160,120,160,320,0,990
24756,170,100,160,160,160,0,750
24757,210,140,200,160,160,320,1190
24758,170,60,80,80,0,0,390
24759,200,140,160,240,320,0,1060
24760,150,80,80,80,160,320,870
24761,200,140,120,80,160,320,1020
24762,190,120,80,160,320,320,1190
24763,210,140,160,160,160,0,830
24764,180,160,160,240,320,320,1380
24765,190,80,40,0,0,0,310
24766,200,120,80,160,160,0,720
24767,160,120,160,80,160,0,680
24768,170,120,80,80,160,0,610
24769,190,140,160,240,320,0,1050
24770,190,160,160,160,320,0,990
24771,200,140,40,80,160,0,620
24772,140,80,120,80,160,0,580
24773,200,120,120,80,0,0,520
24774,200,120,160,160,160,0,800
24775,200,120,120,160,160,0,760
24776,230,180,160,240,320,0,1130
24777,180,100,120,80,0,0,480
24778,160,160,160,80,0,0,560
24779,200,60,40,0,0,0,300
24780,220,100,40,0,0,0,360
24781,210,180,200,240,320,0,1150
24782,220,120,120,80,160,0,700
24783,230,80,40,80,160,0,590
24784,200,120,80,80,160,0,640
24785,170,160,160,160,160,0,810
24786,210,120,40,80,0,0,450
24787,160,140,120,240,320,0,980
24788,180,100,120,0,0,0,400
24789,230,140,200,80,160,0,810
24790,210,80,0,0,0,0,290
24791,200,100,80,160,160,320,1020
24792,200,120,160,160,0,0,640
24793,170,220,160,80,160,0,790
24794,170,80,80,0,0,0,330
24795,200,100,80,160,320,320,1180
24796,160,80,120,80,160,0,600
24797,190,120,80,80,0,0,470
24798,170,120,160,160,320,0,930
24799,180,180,200,80,160,0,800
24800,190,140,80,80,160,0,650
24801,210,100,120,160,320,0,910
24802,160,80,120,160,160,0,680
24803,210,140,160,240,160,0,910
24804,200,120,80,0,0,0,400
24805,220,140,80,80,160,0,680
24806,190,100,80,160,160,320,1010
24807,190,160,120,240,160,0,870
24808,240,140,80,160,320,0,940
24809,210,100,40,0,0,0,350
24810,220,140,160,160,160,0,840
24811,210,60,80,160,160,0,670
24812,220,140,120,160,160,0,800
24813,180,120,80,80,0,0,460
24814,210,100,80,80,160,0,630
24815,230,80,0,0,0,0,310
24816,210,60,40,0,0,0,310
24817,200,100,160,160,160,320,1100
24818,170,180,120,160,160,0,790
24819,210,120,160,160,0,0,650
24820,210,140,160,160,160,320,1150
24821,180,120,200,160,160,0,820
24822,180,160,120,80,160,320,1020
24823,220,160,160,80,160,0,780
24824,210,140,80,160,0,0,590
24825,210,140,80,0,0,0,430
24826,200,120,120,160,320,0,920
24827,170,160,160,240,320,320,1370
24828,210,140,160,160,160,0,830
24829,100,120,160,80,160,320,940
24830,220,140,120,80,0,0,560
24831,170,140,120,80,0,0,510
24832,180,140,160,160,320,0,960
24833,170,100,120,160,160,0,710
24834,200,100,160,160,160,0,780
24835,220,140,40,80,0,0,480
24836,210,80,80,80,160,0,610
24837,170,80,120,160,160,0,690
24838,210,120,120,0,0,0,450
24839,170,140,120,80,0,0,510
24840,200,120,120,160,0,0,600
24841,180,120,120,240,160,0,820
24842,190,160,120,0,0,0,470
24843,180,80,40,80,0,0,380
24844,180,120,160,160,160,0,780
24845,190,100,80,160,160,0,690
24846,230,100,120,240,0,0,690
24847,200,160,160,160,160,320,1160
24848,210,60,0,0,0,0,270
24849,210,180,120,160,160,0,830
24850,220,160,80,80,160,0,700
24851,170,100,80,160,0,0,510
24852,210,40,40,0,0,0,290
24853,170,80,80,80,160,0,570
24854,220,160,120,80,0,0,580
24855,170,60,120,0,0,0,350
24856,210,160,80,80,0,0,530
24857,170,100,200,240,320,0,1030
24858,190,160,120,80,0,0,550
24859,190,60,40,0,0,0,290
24860,210,100,120,80,160,0,670
24861,190,140,120,160,0,0,610
24862,180,80,120,160,160,320,1020
24863,200,80,40,0,0,0,320
24864,200,140,120,80,0,0,540
24865,180,80,120,240,320,0,940
24866,170,100,120,160,320,320,1190
24867,200,120,120,160,160,0,760
24868,220,100,80,80,160,0,640
24869,210,120,0,0,0,0,330
24870,210,60,80,80,0,0,430
24871,150,140,120,0,0,0,410
24872,150,80,80,160,160,0,630
24873,180,100,80,160,320,320,1160
24874,180,120,120,80,0,0,500
24875,150,80,80,80,160,0,550
24876,200,120,120,80,160,0,680
24877,190,160,80,80,0,0,510
24878,180,100,120,80,160,0,640
24879,180,140,80,80,0,0,480
24880,230,140,80,0,0,0,450
24881,220,120,80,0,0,0,420
24882,230,40,40,80,160,0,550
24883,210,160,200,160,0,0,730
24884,220,120,80,160,0,0,580
24885,200,140,120,80,160,0,700
24886,180,100,40,0,0,0,320
24887,190,120,80,80,0,0,470
24888,170,140,120,0,0,0,430
24889,200,120,120,80,0,0,520
24890,230,140,40,80,0,0,490
24891,170,100,0,0,0,0,270
24892,200,140,40,0,0,0,380
24893,190,120,120,80,0,0,510
24894,200,140,120,80,160,0,700
24895,200,160,200,160,320,0,1040
24896,200,140,40,0,0,0,380
24897,230,220,240,240,0,0,930
24898,230,140,120,160,320,0,970
24899,210,160,80,160,320,320,1250
24900,150,100,160,160,160,0,730
24901,200,120,120,240,320,320,1320
24902,190,100,80,80,160,320,930
24903,210,120,120,240,320,0,1010
24904,190,120,160,80,0,0,550
24905,230,140,120,80,0,0,570
24906,210,60,40,0,0,0,310
24907,180,140,80,80,0,0,480
24908,180,140,120,80,160,320,1000
24909,170,140,120,160,160,0,750
24910,190,120,40,80,160,0,590
24911,220,60,120,160,160,0,720
24912,180,120,80,80,160,0,620
24913,230,160,80,0,0,0,470
24914,220,100,40,80,160,0,600
24915,200,140,120,80,0,0,540
24916,210,140,40,0,0,0,390
24917,170,160,80,80,160,0,650
24918,230,140,40,80,0,0,490
24919,230,160,80,0,0,0,470
24920,170,80,40,0,0,0,290
24921,190,140,80,80,160,320,970
24922,170,140,120,160,160,0,750
24923,190,80,80,80,160,0,590
24924,210,180,40,80,0,0,510
24925,190,140,80,80,0,0,490
24926,180,160,80,0,0,0,420
24927,180,100,80,80,160,0,600
24928,180,100,0,0,0,0,280
24929,170,100,80,80,160,0,590
24930,210,120,80,80,160,0,650
24931,220,100,80,80,160,320,960
24932,210,140,80,160,160,0,750
24933,210,80,80,160,0,0,530
24934,210,120,40,0,0,0,370
24935,190,60,40,80,0,0,370
24936,210,80,0,0,0,0,290
24937,190,120,80,80,0,0,470
24938,180,80,0,0,0,0,260
24939,180,140,160,160,320,320,1280
24940,230,160,160,160,320,0,1030
24941,180,200,80,160,160,0,780
24942,190,140,120,160,160,0,770
24943,200,160,120,80,160,320,1040
24944,230,120,160,160,160,0,830
24945,200,100,0,0,0,0,300
24946,220,120,40,80,0,0,460
24947,190,140,80,80,160,0,650
24948,170,160,200,80,160,320,1090
24949,210,120,80,0,0,0,410
24950,200,120,120,80,0,0,520
24951,200,120,120,80,0,0,520
24952,220,140,160,160,0,0,680
24953,250,100,80,80,0,0,510
24954,180,140,120,80,0,0,520
24955,210,120,160,160,160,320,1130
24956,210,120,160,80,0,0,570
24957,200,200,160,160,320,0,1040
24958,180,120,80,80,0,0,460
24959,200,180,160,0,0,0,540
24960,220,120,120,160,160,0,780
24961,220,120,80,160,320,0,900
24962,250,220,200,160,160,0,990
24963,220,140,120,160,160,0,800
24964,220,80,80,80,160,320,940
24965,230,100,40,80,0,0,450
24966,150,40,40,0,0,0,230
24967,240,140,40,80,160,0,660
24968,220,140,80,0,0,0,440
24969,250,120,80,80,160,0,690
24970,190,120,120,160,160,0,750
24971,170,140,160,240,320,0,1030
24972,170,40,40,0,0,0,250
24973,180,60,80,160,160,0,640
24974,170,140,40,0,0,0,350
24975,170,140,120,80,160,320,990
24976,230,120,160,80,160,0,750
24977,210,100,80,80,160,0,630
24978,170,60,40,0,0,0,270
24979,190,80,120,80,160,0,630
24980,160,100,40,80,0,0,380
24981,190,100,160,80,0,0,530
24982,210,120,80,0,0,0,410
24983,210,100,80,80,0,0,470
24984,170,180,80,80,160,0,670
24985,210,100,120,80,160,0,670
24986,220,160,40,80,160,0,660
24987,200,120,80,0,0,0,400
24988,170,100,80,80,160,0,590
24989,180,60,120,80,160,0,600
24990,210,140,120,160,320,320,1270
24991,170,100,160,0,0,0,430
24992,200,100,80,0,0,0,380
24993,200,160,80,80,160,0,680
24994,150,140,120,80,160,0,650
24995,220,180,160,160,160,0,880
24996,160,160,160,80,160,0,720
24997,220,120,120,160,320,0,940
24998,260,180,160,80,160,0,840
24999,190,120,120,160,160,0,750
25000,170,80,160,160,160,320,1050
25001,160,60,120,160,160,320,980
25002,180,120,120,80,0,0,500
25003,170,100,40,80,0,0,390
25004,180,160,160,240,320,0,1060
25005,220,160,80,80,0,0,540
25006,200,120,120,160,160,0,760
25007,210,120,120,0,0,0,450
25008,190,120,120,160,160,0,750
25009,200,160,120,160,320,320,1280
25010,180,120,80,160,0,0,540
25011,190,120,160,160,160,0,790
25012,200,140,160,240,320,0,1060
25013,160,120,40,80,0,0,400
25014,210,180,80,80,0,0,550
25015,220,100,120,80,0,0,520
25016,190,100,120,80,160,0,650
25017,190,140,120,160,160,0,770
25018,210,120,120,80,160,0,690
25019,200,120,160,160,320,0,960
25020,160,40,0,0,0,0,200
25021,220,140,120,160,0,0,640
25022,200,100,120,80,160,0,660
25023,200,120,120,160,0,0,600
25024,180,140,80,80,0,0,480
25025,170,140,80,160,160,0,710
25026,180,140,120,80,0,0,520
25027,170,100,40,80,160,0,550
25028,210,100,120,160,160,320,1070
25029,170,120,80,160,160,0,690
25030,220,120,120,80,0,0,540
25031,230,140,120,160,0,0,650
25032,220,140,80,0,0,0,440
25033,170,100,80,80,160,0,590
25034,190,140,40,0,0,0,370
25035,200,100,120,80,160,0,660
25036,220,80,120,160,160,0,740
25037,160,100,80,80,160,0,580
25038,200,160,120,160,160,0,800
25039,180,80,40,0,0,0,300
25040,210,100,120,80,160,0,670
25041,210,160,120,160,160,0,810
25042,210,120,80,0,0,0,410
25043,190,140,80,160,160,0,730
25044,230,120,80,80,160,0,670
25045,200,100,160,0,0,0,460
25046,180,40,80,80,0,0,380
25047,220,140,120,80,160,0,720
25048,210,100,160,80,160,0,710
25049,210,100,120,80,0,0,510
25050,180,100,80,80,160,320,920
25051,240,160,80,160,160,0,800
25052,190,80,40,0,0,0,310
25053,220,120,80,80,0,0,500
25054,150,120,160,160,160,0,750
25055,220,180,160,160,0,0,720
25056,170,140,80,80,160,0,630
25057,210,120,120,0,0,0,450
25058,170,80,80,0,0,0,330
25059,190,120,80,160,320,0,870
25060,190,120,80,80,160,0,630
25061,210,120,0,0,0,0,330
25062,220,120,120,80,160,0,700
25063,170,120,80,160,160,0,690
25064,230,180,160,240,160,0,970
25065,250,160,80,80,160,0,730
25066,170,80,120,80,160,0,610
25067,180,120,160,80,160,320,1020
25068,160,120,120,80,0,0,480
25069,190,160,160,240,160,0,910
25070,190,120,40,80,0,0,430
25071,230,120,80,80,160,0,670
25072,230,140,120,160,320,0,970
25073,160,120,120,160,160,0,720
25074,230,120,160,80,160,0,750
25075,220,160,120,80,160,0,740
25076,160,120,160,240,320,320,1320
25077,220,140,120,240,320,0,1040
25078,130,20,0,0,0,0,150
25079,150,100,80,80,160,0,570
25080,240,140,120,0,0,0,500
25081,190,140,120,160,160,0,770
25082,250,120,120,0,0,0,490
25083,200,120,80,0,0,0,400
25084,220,120,120,80,0,0,540
25085,160,60,80,160,160,320,940
25086,220,160,80,80,160,0,700
25087,190,100,40,0,0,0,330
25088,210,160,160,160,160,0,850
25089,210,80,40,80,160,320,890
25090,240,140,160,80,160,0,780
25091,190,120,80,80,160,0,630
25092,230,200,160,80,160,0,830
25093,200,140,80,80,160,0,660
25094,210,140,80,160,320,320,1230
25095,220,140,120,80,160,0,720
25096,240,120,80,0,0,0,440
25097,180,120,40,80,160,0,580
25098,170,100,80,80,0,0,430
25099,200,120,120,160,160,0,760
25100,190,100,40,80,160,0,570
25101,190,100,80,80,160,0,610
25102,230,180,200,160,320,320,1410
25103,160,100,120,80,160,0,620
25104,160,100,120,80,0,0,460
25105,200,120,120,0,0,0,440
25106,210,120,80,0,0,0,410
25107,240,140,120,160,320,0,980
25108,230,180,200,160,320,0,1090
25109,180,120,80,80,160,0,620
25110,200,140,160,80,160,0,740
25111,180,100,120,160,0,0,560
25112,200,140,80,80,160,0,660
25113,250,160,160,80,160,0,810
25114,180,40,40,80,160,0,500
25115,200,160,160,80,160,320,1080
25116,180,100,80,80,160,0,600
25117,150,80,120,160,320,320,1150
25118,220,140,80,160,160,0,760
25119,140,60,40,80,160,0,480
25120,200,140,120,160,320,0,940
25121,200,100,80,80,160,0,620
25122,200,120,120,160,160,0,760
25123,210,100,80,80,160,0,630
25124,170,100,80,0,0,0,350
25125,180,120,40,80,160,0,580
25126,150,80,80,80,160,0,550
25127,200,40,40,0,0,0,280
25128,180,120,160,160,320,0,940
25129,220,60,120,80,0,0,480
25130,190,180,80,0,0,0,450
25131,210,100,80,0,0,0,390
25132,150,140,160,240,320,0,1010
25133,190,120,120,240,320,0,990
25134,170,100,80,80,160,320,910
25135,200,80,40,80,160,320,880
25136,160,120,40,0,0,0,320
25137,150,120,80,160,160,0,670
25138,210,100,120,160,0,0,590
25139,190,160,200,160,160,320,1190
25140,220,100,120,80,160,0,680
25141,180,60,40,80,0,0,360
25142,230,140,160,240,160,0,930
25143,170,80,80,80,160,0,570
25144,190,100,120,0,0,0,410
25145,230,160,160,160,160,0,870
25146,160,60,40,80,0,0,340
25147,180,80,80,160,160,320,980
25148,230,140,120,240,0,0,730
25149,190,60,40,0,0,0,290
25150,170,100,80,0,0,0,350
25151,190,60,0,0,0,0,250
25152,220,140,40,80,160,0,640
25153,170,80,120,160,320,0,850
25154,210,140,120,240,160,0,870
25155,200,180,120,160,320,0,980
25156,220,120,120,160,0,0,620
25157,160,140,120,0,0,0,420
25158,210,100,120,80,160,320,990
25159,160,120,120,160,0,0,560
25160,220,140,40,0,0,0,400
25161,200,80,80,80,160,0,600
25162,170,60,120,80,160,0,590
25163,190,120,120,160,160,320,1070
25164,200,200,200,240,160,0,1000
25165,220,140,160,160,160,320,1160
25166,190,120,120,80,160,0,670
25167,210,100,40,0,0,0,350
25168,190,80,80,0,0,0,350
25169,230,100,40,0,0,0,370
25170,170,80,120,160,320,0,850
25171,210,160,80,80,160,320,1010
25172,220,120,120,0,0,0,460
25173,180,120,80,80,160,0,620
25174,190,100,120,80,160,0,650
25175,240,140,120,80,160,0,740
25176,170,120,120,160,320,0,890
25177,170,140,80,80,160,0,630
25178,230,160,120,160,160,0,830
25179,170,120,160,240,320,0,1010
25180,190,140,80,160,320,320,1210
25181,160,120,120,160,160,320,1040
25182,180,80,40,80,0,0,380
25183,200,80,40,80,0,0,400
25184,150,80,40,80,0,0,350
25185,200,140,120,160,160,0,780
25186,240,160,40,80,160,0,680
25187,200,140,160,160,160,0,820
25188,250,140,160,160,160,0,870
25189,220,80,80,160,160,0,700
25190,210,160,160,160,160,0,850
25191,230,100,120,160,0,0,610
25192,180,140,200,240,160,0,920
25193,200,160,160,160,160,0,840
25194,190,120,80,80,160,0,630
25195,200,80,80,160,160,0,680
25196,180,120,80,80,160,320,940
25197,190,140,160,80,160,0,730
25198,180,160,200,160,160,0,860
25199,130,120,200,80,160,0,690
25200,210,120,120,80,160,0,690
25201,160,140,120,80,160,0,660
25202,170,100,40,0,0,0,310
25203,210,100,120,0,0,0,430
25204,230,160,120,80,160,0,750
25205,180,120,80,0,0,0,380
25206,210,140,120,160,160,0,790
25207,170,100,40,0,0,0,310
25208,170,140,120,80,160,0,670
25209,220,140,80,160,320,0,920
25210,250,140,80,80,160,0,710
25211,180,140,160,160,160,0,800
25212,190,160,240,160,160,0,910
25213,160,80,40,80,0,0,360
25214,190,100,120,0,0,0,410
25215,220,80,80,80,160,320,940
25216,190,140,160,160,320,0,970
25217,180,160,120,80,160,320,1020
25218,190,120,80,0,0,0,390
25219,230,120,120,80,0,0,550
25220,200,80,80,0,0,0,360
25221,160,120,80,160,160,0,680
25222,190,40,40,80,0,0,350
25223,180,80,80,160,160,0,660
25224,220,100,80,160,160,0,720
25225,190,120,40,0,0,0,350
25226,150,80,40,0,0,0,270
25227,190,140,80,0,0,0,410
25228,230,120,120,80,160,320,1030
25229,180,100,120,80,160,320,960
25230,180,100,120,160,320,0,880
25231,210,100,120,80,160,0,670
25232,180,120,120,160,160,0,740
25233,190,160,120,160,160,0,790
25234,170,60,80,80,160,0,550
25235,240,140,160,0,0,0,540
25236,190,100,120,80,0,0,490
25237,160,80,80,160,0,0,480
25238,160,100,40,80,0,0,380
25239,230,160,120,160,160,0,830
25240,190,160,120,160,160,0,790
25241,190,100,80,0,0,0,370
25242,190,140,160,80,0,0,570
25243,200,120,40,0,0,0,360
25244,210,120,120,0,0,0,450
25245,190,120,80,160,160,0,710
25246,200,140,40,0,0,0,380
25247,180,100,80,0,0,0,360
25248,170,100,160,160,320,0,910
25249,190,120,120,0,0,0,430
25250,180,140,120,80,160,0,680
25251,230,140,160,80,160,0,770
25252,170,160,120,80,0,0,530
25253,220,180,120,160,160,0,840
25254,160,60,80,80,160,0,540
25255,140,80,160,80,160,0,620
25256,170,120,120,80,0,0,490
25257,240,160,80,80,160,320,1040
25258,220,140,120,160,160,0,800
25259,190,100,40,0,0,0,330
25260,200,160,160,240,160,320,1240
25261,210,140,40,80,160,0,630
25262,160,120,80,80,160,0,600
25263,190,180,200,240,320,0,1130
25264,200,120,160,240,0,0,720
25265,220,140,120,80,0,0,560
25266,170,140,160,80,0,0,550
25267,230,140,200,80,160,0,810
25268,210,140,80,80,160,0,670
25269,170,140,120,240,320,320,1310
25270,210,120,160,80,160,0,730
25271,170,160,80,80,160,320,970
25272,160,160,120,80,160,0,680
25273,150,80,80,160,160,0,630
25274,200,180,120,0,0,0,500
25275,160,120,120,240,320,0,960
25276,230,120,80,160,160,320,1070
25277,180,160,160,160,320,0,980
25278,220,140,40,0,0,0,400
25279,210,100,40,80,0,0,430
25280,200,100,120,80,0,0,500
25281,220,80,40,0,0,0,340
25282,180,80,40,80,0,0,380
25283,210,100,80,80,160,0,630
25284,190,120,120,160,160,0,750
25285,230,80,80,80,160,0,630
25286,190,120,160,80,160,320,1030
25287,200,140,160,0,0,0,500
25288,180,120,120,80,160,0,660
25289,200,100,120,80,160,0,660
25290,240,180,120,160,160,320,1180
25291,180,100,120,80,160,0,640
25292,220,80,80,160,160,320,1020
25293,180,140,120,160,0,0,600
25294,210,140,80,0,0,0,430
25295,240,120,160,80,0,0,600
25296,180,120,120,160,320,0,900
25297,170,100,120,160,160,0,710
25298,200,120,80,80,0,0,480
25299,170,160,160,80,160,0,730
25300,170,60,120,80,160,320,910
25301,180,100,40,0,0,0,320
25302,210,160,160,160,160,320,1170
25303,180,140,80,80,160,0,640
25304,220,100,80,80,160,320,960
25305,230,180,80,160,160,0,810
25306,200,120,120,160,160,0,760
25307,180,140,80,0,0,0,400
25308,210,80,80,0,0,0,370
25309,220,120,120,80,160,0,700
25310,200,100,80,0,0,0,380
25311,210,180,160,80,0,0,630
25312,180,100,120,160,320,0,880
25313,190,140,120,160,0,0,610
25314,230,180,80,0,0,0,490
25315,190,120,0,0,0,0,310
25316,210,140,80,160,160,0,750
25317,170,100,120,80,0,0,470
25318,200,160,120,80,0,0,560
25319,210,120,80,80,160,0,650
25320,190,180,160,80,160,0,770
25321,250,140,80,0,0,0,470
25322,200,140,40,80,160,0,620
25323,250,160,40,80,160,0,690
25324,150,140,200,160,0,0,650
25325,190,100,120,240,320,0,970
25326,230,140,120,160,160,0,810
25327,180,180,160,240,160,0,920
25328,200,100,160,80,160,0,700
25329,200,120,120,160,320,0,920
25330,190,140,40,0,0,0,370
25331,210,140,40,0,0,0,390
25332,190,100,40,80,160,0,570
25333,220,180,160,160,160,320,1200
25334,230,60,80,0,0,0,370
25335,170,80,80,80,160,0,570
25336,190,100,80,0,0,0,370
25337,170,100,120,80,0,0,470
25338,160,80,120,160,160,0,680
25339,170,100,0,0,0,0,270
25340,230,100,80,160,160,0,730
25341,170,100,80,80,0,0,430
25342,240,120,80,0,0,0,440
25343,210,160,80,80,0,0,530
25344,210,160,120,160,320,0,970
25345,210,80,80,0,0,0,370
25346,160,120,120,160,160,0,720
25347,180,140,160,160,160,0,800
25348,160,80,80,80,160,0,560
25349,220,100,80,80,0,0,480
25350,200,80,40,0,0,0,320
25351,220,160,120,80,160,0,740
25352,250,200,200,160,160,0,970
25353,200,100,80,80,0,0,460
25354,180,180,200,160,0,0,720
25355,190,140,120,80,160,0,690
25356,200,140,120,80,0,0,540
25357,210,120,160,160,0,0,650
25358,160,100,120,0,0,0,380
25359,200,140,120,160,160,0,780
25360,170,100,80,80,0,0,430
25361,170,140,80,0,0,0,390
25362,150,80,160,0,0,0,390
25363,200,120,120,160,160,320,1080
25364,200,200,200,80,160,0,840
25365,170,120,80,0,0,0,370
25366,230,100,80,80,0,0,490
25367,230,100,200,80,160,0,770
25368,190,120,200,240,160,0,910
25369,190,120,40,0,0,0,350
25370,170,160,80,80,160,0,650
25371,180,100,80,80,160,0,600
25372,180,140,120,80,160,0,680
25373,190,160,120,160,160,0,790
25374,190,160,80,160,160,0,750
25375,170,80,120,80,160,0,610
25376,170,100,120,80,160,0,630
25377,210,140,160,80,160,0,750
25378,210,100,120,160,160,0,750
25379,170,40,40,0,0,0,250
25380,160,60,40,0,0,0,260
25381,230,180,120,160,160,320,1170
25382,220,80,40,0,0,0,340
25383,180,120,80,80,160,0,620
25384,210,140,40,80,160,320,950
25385,170,100,80,80,160,320,910
25386,230,160,160,80,0,0,630
25387,210,140,120,240,160,0,870
25388,200,140,40,80,0,0,460
25389,210,120,80,160,0,0,570
25390,170,120,80,80,160,320,930
25391,170,160,160,80,160,0,730
25392,200,120,120,80,0,0,520
25393,180,100,80,80,160,0,600
25394,210,160,160,160,160,0,850
25395,220,160,120,80,160,0,740
25396,210,160,160,160,160,0,850
25397,190,120,80,80,0,0,470
25398,190,80,80,0,0,0,350
25399,170,40,40,80,160,0,490
25400,200,80,40,0,0,0,320
25401,200,140,160,160,160,0,820
25402,230,120,120,80,0,0,550
25403,200,160,80,80,160,0,680
25404,210,80,40,0,0,0,330
25405,180,100,80,80,160,0,600
25406,190,160,120,160,320,0,950
25407,200,180,200,240,320,0,1140
25408,210,100,80,80,160,0,630
25409,170,80,80,160,0,0,490
25410,180,120,120,160,160,0,740
25411,180,120,120,160,160,320,1060
25412,190,140,80,0,0,0,410
25413,190,140,80,80,160,0,650
25414,160,160,160,160,320,0,960
25415,140,80,80,80,0,0,380
25416,170,120,80,80,160,0,610
25417,190,120,120,160,320,0,910
25418,180,100,80,80,160,0,600
25419,180,120,120,80,0,0,500
25420,190,100,80,80,0,0,450
25421,200,80,80,80,160,320,920
25422,260,180,120,80,0,0,640
25423,210,160,80,80,0,0,530
25424,180,60,80,160,320,320,1120
25425,210,120,40,0,0,0,370
25426,230,100,120,160,160,320,1090
25427,200,100,120,80,160,0,660
25428,170,120,200,80,0,0,570
25429,180,100,120,0,0,0,400
25430,190,140,40,0,0,0,370
25431,170,100,80,80,160,320,910
25432,190,80,40,80,160,0,550
25433,190,140,0,0,0,0,330
25434,200,140,160,240,160,0,900
25435,200,120,160,240,160,320,1200
25436,220,160,160,240,160,320,1260
25437,170,120,80,160,320,320,1170
25438,190,120,160,80,160,0,710
25439,230,140,160,160,160,0,850
25440,230,120,80,0,0,0,430
25441,190,160,120,80,0,0,550
25442,240,100,120,80,0,0,540
25443,180,80,80,0,0,0,340
25444,250,200,160,80,160,0,850
25445,180,80,40,80,0,0,380
25446,160,100,120,80,160,0,620
25447,180,120,160,80,0,0,540
25448,180,120,120,80,160,320,980
25449,180,100,80,80,0,0,440
25450,180,120,120,240,160,0,820
25451,240,140,160,80,0,0,620
25452,200,140,80,80,0,0,500
25453,210,100,200,240,320,0,1070
25454,150,160,160,160,0,0,630
25455,200,140,160,160,0,0,660
25456,160,100,80,80,0,0,420
25457,190,100,0,0,0,0,290
25458,180,120,120,80,160,320,980
25459,250,120,80,0,0,0,450
25460,180,100,120,80,160,0,640
25461,220,160,80,0,0,0,460
25462,220,180,120,160,0,0,680
25463,200,140,160,160,160,0,820
25464,200,120,120,160,320,320,1240
25465,160,140,80,0,0,0,380
25466,210,100,120,0,0,0,430
25467,190,120,80,80,160,0,630
25468,190,80,120,80,0,0,470
25469,190,140,200,160,0,0,690
25470,190,100,120,80,160,0,650
25471,200,120,160,240,160,320,1200
25472,180,140,120,160,160,0,760
25473,180,100,80,160,160,320,1000
25474,160,100,40,0,0,0,300
25475,210,140,120,160,0,0,630
25476,230,100,120,160,320,0,930
25477,190,140,160,160,320,0,970
25478,190,160,200,80,0,0,630
25479,210,160,80,80,0,0,530
25480,220,120,80,80,0,0,500
25481,190,140,120,80,0,0,530
25482,240,120,80,80,160,0,680
25483,200,60,40,0,0,0,300
25484,190,120,120,0,0,0,430
25485,220,80,40,0,0,0,340
25486,170,120,40,80,160,0,570
25487,240,100,120,160,0,0,620
25488,230,120,160,80,160,0,750
25489,220,100,0,0,0,0,320
25490,190,80,120,80,0,0,470
25491,170,120,200,160,160,0,810
25492,150,120,80,80,0,0,430
25493,190,100,40,0,0,0,330
25494,160,80,80,80,160,0,560
25495,200,80,80,80,160,0,600
25496,210,120,80,80,160,0,650
25497,190,180,200,160,0,0,730
25498,240,120,80,0,0,0,440
25499,230,160,160,160,320,0,1030
25500,190,80,40,80,160,0,550
25501,210,120,40,0,0,0,370
25502,270,140,80,80,160,320,1050
25503,240,200,200,160,160,0,960
25504,190,120,80,80,160,0,630
25505,220,100,120,160,320,320,1240
25506,190,120,120,80,160,320,990
25507,230,120,160,80,160,0,750
25508,150,140,200,80,160,320,1050
25509,250,140,80,0,0,0,470
25510,200,160,160,80,160,320,1080
25511,190,80,40,80,0,0,390
25512,190,100,80,80,0,0,450
25513,170,80,40,0,0,0,290
25514,230,120,120,160,0,0,630
25515,180,120,80,80,160,0,620
25516,180,80,120,80,160,0,620
25517,210,140,200,240,160,0,950
25518,200,100,160,240,320,0,1020
25519,190,140,120,80,0,0,530
25520,230,100,80,0,0,0,410
25521,170,120,120,240,320,320,1290
25522,210,140,120,80,0,0,550
25523,160,100,120,80,0,0,460
25524,230,200,160,80,0,0,670
25525,170,140,160,80,0,0,550
25526,190,100,40,80,0,0,410
25527,260,140,120,160,160,0,840
25528,200,100,120,0,0,0,420
25529,180,140,120,80,160,0,680
25530,210,180,120,160,160,320,1150
25531,200,160,120,160,160,0,800
25532,160,140,160,80,160,0,700
25533,200,180,120,80,0,0,580
25534,190,40,0,0,0,0,230
25535,210,100,80,80,0,0,470
25536,200,140,160,240,320,0,1060
25537,210,120,40,80,0,0,450
25538,210,140,120,160,160,0,790
25539,200,100,40,0,0,0,340
25540,200,80,80,80,160,320,920
25541,200,100,40,80,160,0,580
25542,200,120,120,160,160,0,760
25543,170,80,40,0,0,0,290
25544,220,80,40,80,0,0,420
25545,230,80,160,160,0,0,630
25546,230,100,40,80,0,0,450
25547,210,160,200,160,320,320,1370
25548,190,160,240,160,320,320,1390
25549,180,100,80,160,160,320,1000
25550,190,120,80,0,0,0,390
25551,210,100,80,80,0,0,470
25552,180,100,120,160,160,0,720
25553,220,140,200,240,320,0,1120
25554,210,100,160,160,0,0,630
25555,150,140,120,0,0,0,410
25556,200,100,120,0,0,0,420
25557,220,180,160,80,0,0,640
25558,200,160,160,80,160,0,760
25559,220,200,240,80,160,0,900
25560,210,140,80,0,0,0,430
25561,200,120,120,240,320,0,1000
25562,200,80,40,80,0,0,400
25563,180,100,80,80,160,320,920
25564,250,140,40,80,0,0,510
25565,170,160,160,240,160,0,890
25566,190,60,0,0,0,0,250
25567,200,160,240,320,160,320,1400
25568,190,100,160,160,0,0,610
25569,230,120,80,80,0,0,510
25570,210,140,40,80,0,0,470
25571,200,120,120,80,160,320,1000
25572,240,140,120,80,160,0,740
25573,200,120,200,160,320,0,1000
25574,180,140,120,80,160,0,680
25575,190,160,80,80,0,0,510
25576,180,140,120,80,0,0,520
25577,200,60,80,80,0,0,420
25578,170,100,80,80,0,0,430
25579,230,220,160,240,320,0,1170
25580,240,120,120,80,160,0,720
25581,180,80,120,80,160,0,620
25582,210,160,120,160,160,0,810
25583,190,40,0,0,0,0,230
25584,210,120,120,160,160,320,1090
25585,210,60,80,0,0,0,350
25586,180,60,40,80,0,0,360
25587,140,60,120,160,0,0,480
25588,200,160,40,0,0,0,400
25589,210,80,80,80,160,0,610
25590,170,120,40,0,0,0,330
25591,210,160,120,160,160,0,810
25592,230,180,160,240,160,0,970
25593,210,140,160,80,160,0,750
25594,180,80,120,160,320,320,1180
25595,200,80,160,160,0,0,600
25596,190,100,120,80,0,0,490
25597,210,180,120,80,0,0,590
25598,220,100,80,80,0,0,480
25599,220,200,80,80,0,0,580
25600,180,100,120,80,160,320,960
25601,160,120,120,0,0,0,400
25602,230,140,120,0,0,0,490
25603,200,100,80,80,160,0,620
25604,210,140,80,80,160,0,670
25605,210,140,80,80,0,0,510
25606,220,140,120,80,160,0,720
25607,200,180,160,240,160,320,1260
25608,170,80,40,0,0,0,290
25609,180,140,160,0,0,0,480
25610,230,80,40,80,160,320,910
25611,190,200,120,160,320,320,1310
25612,190,100,80,160,320,0,850
25613,220,100,120,80,0,0,520
25614,180,60,0,0,0,0,240
25615,190,120,200,160,160,0,830
25616,210,80,80,160,160,0,690
25617,200,120,80,80,0,0,480
25618,220,180,200,80,0,0,680
25619,240,100,80,80,0,0,500
25620,250,160,120,160,320,0,1010
25621,180,120,160,80,0,0,540
25622,190,120,120,240,160,320,1150
25623,200,80,40,80,160,0,560
25624,190,160,120,80,0,0,550
25625,200,160,40,80,160,0,640
25626,210,120,200,160,320,320,1330
25627,200,80,80,0,0,0,360
25628,180,140,120,80,160,0,680
25629,190,160,160,80,160,0,750
25630,210,120,120,80,160,0,690
25631,190,60,80,80,160,0,570
25632,230,180,160,240,160,0,970
25633,170,100,80,80,160,0,590
25634,220,180,80,0,0,0,480
25635,170,80,120,80,160,0,610
25636,160,100,120,80,160,0,620
25637,190,60,80,0,0,0,330
25638,200,100,0,0,0,0,300
25639,200,120,160,160,320,0,960
25640,180,100,160,240,320,320,1320
25641,160,80,120,160,160,0,680
25642,180,120,160,80,160,0,700
25643,220,100,80,0,0,0,400
25644,210,160,120,160,320,0,970
25645,220,160,160,160,160,0,860
25646,240,180,120,160,160,320,1180
25647,160,120,160,80,160,0,680
25648,230,120,120,80,0,0,550
25649,200,120,160,240,160,320,1200
25650,210,120,160,160,160,0,810
25651,170,60,80,80,160,0,550
25652,180,100,120,160,160,320,1040
25653,200,160,160,160,160,0,840
25654,210,120,120,160,160,0,770
25655,160,80,80,80,0,0,400
25656,160,80,80,0,0,0,320
25657,190,120,80,80,0,0,470
25658,220,80,80,80,160,320,940
25659,150,120,120,80,0,0,470
25660,140,100,120,160,160,0,680
25661,160,120,80,80,160,0,600
25662,190,120,160,80,160,320,1030
25663,170,120,80,160,320,0,850
25664,180,100,0,0,0,0,280
25665,190,120,120,80,0,0,510
25666,220,120,40,0,0,0,380
25667,180,100,120,240,320,0,960
25668,200,120,120,160,0,0,600
25669,200,140,80,80,0,0,500
25670,180,60,40,80,160,0,520
25671,190,140,80,80,0,0,490
25672,200,100,0,0,0,0,300
25673,170,120,80,160,160,320,1010
25674,170,100,80,80,0,0,430
25675,200,160,160,160,0,0,680
25676,220,120,120,160,0,0,620
25677,210,140,160,80,160,0,750
25678,210,100,40,0,0,0,350
25679,160,140,120,80,0,0,500
25680,210,120,200,160,0,0,690
25681,220,120,120,80,0,0,540
25682,200,120,40,80,160,0,600
25683,220,180,200,240,160,0,1000
25684,200,140,120,80,160,320,1020
25685,230,140,120,160,320,0,970
25686,250,80,40,80,160,0,610
25687,160,80,80,80,0,0,400
25688,170,140,160,80,160,0,710
25689,210,120,40,80,0,0,450
25690,190,100,120,240,320,320,1290
25691,190,120,120,240,160,320,1150
25692,200,160,80,160,0,0,600
25693,220,160,120,240,320,0,1060
25694,200,80,80,0,0,0,360
25695,180,160,120,0,0,0,460
25696,200,120,160,240,160,0,880
25697,170,120,160,80,0,0,530
25698,200,140,120,160,160,0,780
25699,170,60,80,0,0,0,310
25700,220,100,120,160,160,320,1080
25701,230,120,80,0,0,0,430
25702,190,60,80,160,0,0,490
25703,190,120,160,80,160,320,1030
25704,220,200,160,240,160,0,980
25705,170,120,120,80,160,0,650
25706,210,80,40,80,0,0,410
25707,210,100,80,0,0,0,390
25708,170,80,120,80,0,0,450
25709,190,140,120,80,0,0,530
25710,220,140,120,240,160,0,880
25711,210,120,0,0,0,0,330
25712,180,120,120,80,160,0,660
25713,220,160,80,160,160,0,780
25714,220,160,120,80,160,320,1060
25715,200,120,120,160,0,0,600
25716,180,80,80,0,0,0,340
25717,210,120,80,80,160,0,650
25718,170,120,120,160,160,0,730
25719,160,120,160,80,0,0,520
25720,250,160,40,80,0,0,530
25721,200,120,40,80,160,0,600
25722,190,100,40,80,160,0,570
25723,200,120,200,160,160,0,840
25724,220,140,160,0,0,0,520
25725,220,140,160,320,320,320,1480
25726,220,140,120,0,0,0,480
25727,190,80,80,80,160,0,590
25728,180,100,120,160,0,0,560
25729,180,160,200,240,160,0,940
25730,210,80,80,80,0,0,450
25731,240,140,120,0,0,0,500
25732,220,100,80,0,0,0,400
25733,260,140,0,0,0,0,400
25734,210,80,120,80,160,0,650
25735,220,80,40,0,0,0,340
25736,220,120,160,80,0,0,580
25737,210,120,160,160,160,320,1130
25738,170,120,80,0,0,0,370
25739,170,120,40,0,0,0,330
25740,190,100,160,160,320,0,930
25741,200,160,200,160,320,0,1040
25742,200,200,160,240,160,0,960
25743,240,140,160,160,320,0,1020
25744,210,140,80,80,0,0,510
25745,180,160,120,160,160,320,1100
25746,190,160,120,160,0,0,630
25747,160,160,120,80,0,0,520
25748,210,120,120,160,160,0,770
25749,170,100,120,0,0,0,390
25750,200,100,80,80,0,0,460
25751,200,80,80,0,0,0,360
25752,250,120,80,80,160,0,690
25753,200,160,120,160,160,0,800
25754,180,160,160,80,160,0,740
25755,230,160,160,160,160,0,870
25756,190,120,120,160,160,320,1070
25757,180,100,160,160,0,0,600
25758,230,160,160,160,160,320,1190
25759,210,60,0,0,0,0,270
25760,180,120,80,160,320,320,1180
25761,170,160,200,160,160,0,850
25762,190,160,160,240,320,0,1070
25763,180,140,120,80,0,0,520
25764,180,140,160,80,160,0,720
25765,200,80,120,0,0,0,400
25766,180,160,120,160,160,0,780
25767,170,120,80,80,0,0,450
25768,160,80,80,80,160,0,560
25769,230,60,0,0,0,0,290
25770,220,160,120,160,160,0,820
25771,170,80,80,80,0,0,410
25772,170,80,40,0,0,0,290
25773,140,80,80,160,320,0,780
25774,220,80,80,160,0,0,540
25775,210,100,80,80,160,320,950
25776,170,60,80,160,160,0,630
25777,200,160,80,160,160,0,760
25778,160,80,80,0,0,0,320
25779,190,180,120,80,160,0,730
25780,230,160,80,80,160,0,710
25781,160,100,80,0,0,0,340
25782,170,120,160,80,160,0,690
25783,180,80,80,80,160,0,580
25784,220,180,120,80,0,0,600
25785,200,80,120,160,160,0,720
25786,210,140,120,80,160,320,1030
25787,170,120,160,240,0,0,690
25788,150,60,80,160,160,0,610
25789,170,140,120,80,0,0,510
25790,220,100,80,0,0,0,400
25791,170,120,80,80,0,0,450
25792,240,140,80,80,160,0,700
25793,220,140,80,80,160,0,680
25794,160,160,200,80,0,0,600
25795,190,100,80,0,0,0,370
25796,200,140,120,240,160,0,860
25797,200,160,160,160,160,0,840
25798,200,120,80,80,0,0,480
25799,210,140,80,80,160,0,670
25800,210,160,240,80,0,0,690
25801,210,140,120,80,0,0,550
25802,200,100,80,0,0,0,380
25803,170,140,120,240,160,0,830
25804,200,120,120,160,320,0,920
25805,160,100,120,80,0,0,460
25806,220,120,120,240,320,320,1340
25807,210,120,120,80,0,0,530
25808,200,140,120,80,160,320,1020
25809,200,80,80,80,160,320,920
25810,160,160,40,0,0,0,360
25811,180,140,160,80,160,0,720
25812,210,180,120,80,160,0,750
25813,230,140,80,0,0,0,450
25814,220,120,160,160,160,0,820
25815,200,80,40,0,0,0,320
25816,160,140,160,160,0,0,620
25817,200,120,80,80,160,0,640
25818,190,160,120,80,160,0,710
25819,190,140,120,80,0,0,530
25820,200,160,80,80,0,0,520
25821,180,140,160,160,0,0,640
25822,190,140,120,160,160,0,770
25823,190,60,40,80,160,0,530
25824,180,100,80,80,160,0,600
25825,200,140,80,160,160,320,1060
25826,190,120,120,80,160,0,670
25827,150,100,120,80,160,0,610
25828,180,80,80,160,0,0,500
25829,170,60,80,80,160,0,550
25830,150,120,120,0,0,0,390
25831,210,180,160,160,320,0,1030
25832,190,160,160,240,160,0,910
25833,170,100,120,240,0,0,630
25834,200,100,40,0,0,0,340
25835,210,200,40,0,0,0,450
25836,180,120,80,80,160,0,620
25837,220,100,40,80,0,0,440
25838,150,100,40,0,0,0,290
25839,180,120,80,0,0,0,380
25840,220,140,80,0,0,0,440
25841,150,100,160,160,0,0,570
25842,190,160,160,80,160,320,1070
25843,250,140,120,160,160,0,830
25844,170,140,160,80,160,0,710
25845,170,160,80,80,0,0,490
25846,140,100,40,80,160,0,520
25847,210,160,160,160,0,0,690
25848,160,140,80,160,160,0,700
25849,190,100,160,80,160,320,1010
25850,150,80,80,80,160,0,550
25851,210,100,120,80,160,0,670
25852,240,200,80,80,160,0,760
25853,200,100,80,160,160,0,700
25854,200,100,120,0,0,0,420
25855,210,120,160,160,160,320,1130
25856,210,140,120,80,160,320,1030
25857,180,160,40,0,0,0,380
25858,200,120,120,80,0,0,520
25859,190,160,80,160,160,0,750
25860,190,120,40,0,0,0,350
25861,170,100,120,80,160,320,950
25862,220,140,80,0,0,0,440
25863,210,140,160,160,160,320,1150
25864,150,140,160,240,320,0,1010
25865,190,80,80,0,0,0,350
25866,200,100,80,80,160,0,620
25867,200,160,120,80,160,0,720
25868,230,80,80,80,0,0,470
25869,200,120,160,160,320,0,960
25870,210,100,120,160,160,320,1070
25871,170,160,80,160,320,0,890
25872,200,160,160,160,320,0,1000
25873,190,100,120,160,160,0,730
25874,210,160,160,160,160,320,1170
25875,220,160,120,0,0,0,500
25876,200,140,120,80,160,0,700
25877,210,140,80,0,0,0,430
25878,140,120,200,160,160,0,780
25879,180,100,80,80,0,0,440
25880,170,140,40,0,0,0,350
25881,200,120,80,80,0,0,480
25882,180,80,120,80,0,0,460
25883,220,120,80,160,320,0,900
25884,190,140,80,80,160,0,650
25885,180,160,120,80,160,0,700
25886,190,60,40,0,0,0,290
25887,180,80,80,160,0,0,500
25888,170,60,0,0,0,0,230
25889,230,140,160,160,160,320,1170
25890,230,140,120,160,320,0,970
25891,220,140,120,160,0,0,640
25892,210,160,200,160,160,0,890
25893,200,120,120,240,160,320,1160
25894,200,140,80,160,0,0,580
25895,180,180,200,240,160,0,960
25896,180,160,160,240,0,0,740
25897,210,160,80,80,160,320,1010
25898,220,100,80,80,160,320,960
25899,210,80,0,0,0,0,290
25900,180,140,40,0,0,0,360
25901,250,120,80,80,160,0,690
25902,230,140,120,80,0,0,570
25903,160,100,160,160,320,0,900
25904,180,80,80,0,0,0,340
25905,210,120,160,80,0,0,570
25906,230,160,120,0,0,0,510
25907,180,60,120,80,160,0,600
25908,210,120,160,160,320,320,1290
25909,210,60,80,80,0,0,430
25910,200,160,160,160,160,0,840
25911,160,100,120,80,0,0,460
25912,210,180,160,80,160,0,790
25913,230,120,80,80,160,0,670
25914,230,120,120,0,0,0,470
25915,190,180,200,80,0,0,650
25916,200,160,200,80,0,0,640
25917,200,160,120,80,160,0,720
25918,240,180,120,80,160,0,780
25919,190,140,40,0,0,0,370
25920,180,160,80,80,0,0,500
25921,200,100,200,160,0,0,660
25922,190,140,40,80,160,0,610
25923,200,160,40,80,0,0,480
25924,190,100,80,160,320,320,1170
25925,200,180,120,160,0,0,660
25926,180,120,80,80,0,0,460
25927,200,120,40,80,0,0,440
25928,190,120,80,80,160,0,630
25929,190,180,120,160,320,320,1290
25930,190,160,160,160,160,320,1150
25931,190,140,120,0,0,0,450
25932,160,140,120,80,160,0,660
25933,160,40,40,80,0,0,320
25934,180,140,120,80,0,0,520
25935,240,140,120,160,160,0,820
25936,170,80,80,80,160,0,570
25937,190,160,120,80,0,0,550
25938,210,160,160,160,320,0,1010
25939,160,140,120,80,160,0,660
25940,170,120,80,80,0,0,450
25941,220,120,40,0,0,0,380
25942,190,80,80,0,0,0,350
25943,220,160,160,160,320,0,1020
25944,150,100,80,80,0,0,410
25945,170,80,80,80,160,0,570
25946,190,140,120,80,0,0,530
25947,170,120,160,80,160,0,690
25948,160,100,120,240,320,0,940
25949,160,60,80,80,0,0,380
25950,180,60,120,240,0,0,600
25951,170,60,40,80,160,0,510
25952,180,160,160,160,0,0,660
25953,210,160,80,0,0,0,450
25954,200,120,120,80,160,320,1000
25955,210,140,160,160,160,0,830
25956,210,80,40,80,160,0,570
25957,170,140,120,160,160,0,750
25958,200,160,40,0,0,0,400
25959,160,100,80,80,160,0,580
25960,230,160,120,0,0,0,510
25961,190,140,120,80,0,0,530
25962,250,160,160,80,0,0,650
25963,190,140,120,160,160,0,770
25964,180,140,120,160,160,0,760
25965,200,140,200,160,0,0,700
25966,160,100,40,80,0,0,380
25967,220,160,80,80,0,0,540
25968,190,180,200,160,0,0,730
25969,160,60,40,0,0,0,260
25970,210,140,80,160,160,0,750
25971,190,120,80,0,0,0,390
25972,200,100,80,80,0,0,460
25973,150,100,120,160,160,0,690
25974,230,200,120,0,0,0,550
25975,190,100,80,80,160,320,930
25976,230,220,240,160,0,0,850
25977,190,140,160,160,160,0,810
25978,180,80,80,80,160,0,580
25979,170,100,80,80,160,0,590
25980,160,80,0,0,0,0,240
25981,180,140,120,160,0,0,600
25982,220,120,200,240,160,0,940
25983,220,160,160,80,0,0,620
25984,150,100,120,0,0,0,370
25985,170,120,120,240,320,0,970
25986,190,120,40,0,0,0,350
25987,200,120,120,160,160,0,760
25988,170,120,40,80,160,0,570
25989,220,180,160,80,160,0,800
25990,210,120,120,160,320,320,1250
25991,200,160,80,80,0,0,520
25992,210,120,40,0,0,0,370
25993,170,120,40,80,160,0,570
25994,220,140,80,80,160,0,680
25995,190,120,120,80,0,0,510
25996,220,160,160,240,320,320,1420
25997,200,120,120,80,0,0,520
25998,180,120,120,160,320,320,1220
25999,180,100,80,80,160,0,600
26000,220,160,120,160,160,0,820
26001,190,100,80,80,0,0,450
26002,200,160,160,160,160,0,840
26003,210,100,80,80,0,0,470
26004,220,80,80,0,0,0,380
26005,230,120,120,160,160,0,790
26006,230,120,120,80,160,0,710
26007,210,120,160,0,0,0,490
26008,170,120,80,0,0,0,370
26009,220,120,80,80,160,0,660
26010,250,160,200,240,160,0,1010
26011,200,120,40,0,0,0,360
26012,190,140,40,80,0,0,450
26013,200,140,80,160,160,0,740
26014,160,80,80,80,160,0,560
26015,190,120,120,80,160,0,670
26016,240,200,200,160,320,0,1120
26017,210,60,80,0,0,0,350
26018,140,40,80,80,0,0,340
26019,180,60,40,0,0,0,280
26020,190,140,80,80,0,0,490
26021,200,80,40,80,160,0,560
26022,150,100,120,0,0,0,370
26023,200,100,120,80,0,0,500
26024,150,120,120,80,0,0,470
26025,190,140,160,160,160,320,1130
26026,220,100,40,80,160,0,600
26027,180,120,160,160,160,320,1100
26028,190,140,120,160,160,0,770
26029,270,160,40,80,160,0,710
26030,230,140,80,80,0,0,530
26031,190,180,200,80,160,0,810
26032,180,100,40,80,160,0,560
26033,200,100,80,160,160,0,700
26034,210,80,120,160,160,0,730
26035,160,100,120,0,0,0,380
26036,200,80,40,0,0,0,320
26037,190,120,120,80,160,0,670
26038,180,120,80,160,320,0,860
26039,170,140,40,0,0,0,350
26040,210,140,160,0,0,0,510
26041,180,100,80,80,0,0,440
26042,180,80,80,80,160,0,580
26043,210,120,120,160,320,320,1250
26044,190,100,80,80,160,320,930
26045,160,160,120,160,320,320,1240
26046,200,80,120,160,160,0,720
26047,180,160,40,80,160,0,620
26048,200,140,120,160,160,0,780
26049,130,100,120,80,160,0,590
26050,200,80,40,0,0,0,320
26051,170,100,80,80,0,0,430
26052,180,140,80,80,160,0,640
26053,180,60,40,80,160,320,840
26054,200,100,120,80,0,0,500
26055,170,100,40,80,160,320,870
26056,250,160,160,160,160,0,890
26057,200,160,120,0,0,0,480
26058,150,80,160,160,160,0,710
26059,200,140,160,0,0,0,500
26060,220,160,200,80,160,0,820
26061,170,180,200,240,160,320,1270
26062,210,160,160,80,160,0,770
26063,170,140,160,160,160,320,1110
26064,210,100,160,160,160,0,790
26065,160,120,80,80,160,0,600
26066,200,160,160,80,160,320,1080
26067,230,180,120,0,0,0,530
26068,190,120,160,240,0,0,710
26069,220,120,160,80,0,0,580
26070,170,120,120,80,160,0,650
26071,210,120,160,240,320,0,1050
26072,200,160,120,80,160,0,720
26073,240,200,80,0,0,0,520
26074,210,200,160,160,160,0,890
26075,180,120,80,0,0,0,380
26076,180,140,160,160,160,0,800
26077,230,100,160,80,160,320,1050
26078,190,140,80,0,0,0,410
26079,210,180,80,80,160,0,710
26080,230,140,40,80,160,0,650
26081,170,100,160,160,160,0,750
26082,210,120,120,80,160,0,690
26083,220,140,120,80,0,0,560
26084,190,100,120,160,160,320,1050
26085,220,140,120,80,160,0,720
26086,170,120,160,0,0,0,450
26087,210,100,120,160,160,0,750
26088,180,140,80,160,160,0,720
26089,210,100,80,0,0,0,390
26090,190,140,120,160,160,0,770
26091,190,80,40,0,0,0,310
26092,190,120,80,0,0,0,390
26093,200,120,120,0,0,0,440
26094,200,160,160,0,0,0,520
26095,220,140,80,160,320,0,920
26096,180,100,160,160,0,0,600
26097,210,120,80,0,0,0,410
26098,210,120,160,0,0,0,490
26099,160,100,120,160,160,0,700
26100,200,160,120,160,0,0,640
26101,160,140,40,80,160,0,580
26102,230,140,120,160,160,0,810
26103,190,180,120,80,160,0,730
26104,230,180,200,160,160,0,930
26105,170,80,40,80,160,0,530
26106,160,60,80,160,0,0,460
26107,210,160,160,160,0,0,690
26108,180,80,160,160,320,0,900
26109,160,80,40,80,160,0,520
26110,240,100,120,80,160,0,700
26111,200,180,80,0,0,0,460
26112,170,60,40,80,0,0,350
26113,160,140,80,160,0,0,540
26114,210,140,160,160,160,320,1150
26115,240,140,120,160,160,0,820
26116,190,140,200,240,160,0,930
26117,240,160,120,160,160,320,1160
26118,210,120,80,0,0,0,410
26119,180,120,80,80,0,0,460
26120,170,120,200,240,160,0,890
26121,190,160,80,80,160,0,670
26122,170,160,160,80,0,0,570
26123,190,120,80,0,0,0,390
26124,200,140,120,80,160,320,1020
26125,220,140,160,160,0,0,680
26126,200,140,0,0,0,0,340
26127,200,120,80,80,160,0,640
26128,220,80,40,80,160,0,580
26129,180,160,80,80,0,0,500
26130,200,140,160,80,160,0,740
26131,190,140,120,80,160,0,690
26132,210,120,80,80,160,0,650
26133,170,100,120,160,320,0,870
26134,220,120,120,0,0,0,460
26135,150,140,200,160,160,0,810
26136,180,160,120,240,320,0,1020
26137,240,180,160,160,160,0,900
26138,220,160,160,160,320,320,1340
26139,180,100,160,160,160,320,1080
26140,180,160,80,0,0,0,420
26141,190,40,80,160,160,0,630
26142,200,140,120,80,160,0,700
26143,220,140,120,160,160,0,800
26144,180,120,40,0,0,0,340
26145,220,100,120,0,0,0,440
26146,170,140,80,0,0,0,390
26147,220,120,120,80,0,0,540
26148,210,140,120,80,160,320,1030
26149,210,180,120,160,160,0,830
26150,180,120,120,160,0,0,580
26151,220,100,160,160,320,0,960
26152,200,60,40,80,160,0,540
26153,170,160,160,240,0,0,730
26154,190,140,160,0,0,0,490
26155,210,140,120,160,320,320,1270
26156,220,200,120,0,0,0,540
26157,210,100,120,80,160,0,670
26158,200,140,120,160,320,0,940
26159,160,160,160,80,160,320,1040
26160,220,180,160,160,320,0,1040
26161,170,100,80,80,0,0,430
26162,200,180,120,80,160,0,740
26163,190,60,120,160,160,0,690
26164,160,100,120,80,0,0,460
26165,250,140,120,160,320,0,990
26166,190,120,160,80,0,0,550
26167,210,140,160,160,160,320,1150
26168,210,140,120,160,320,320,1270
26169,210,100,160,240,160,0,870
26170,170,80,0,0,0,0,250
26171,180,160,120,160,0,0,620
26172,220,100,160,0,0,0,480
26173,200,180,200,240,160,0,980
26174,170,120,120,80,0,0,490
26175,230,140,120,80,160,0,730
26176,210,80,80,80,160,0,610
26177,230,120,160,0,0,0,510
26178,190,60,80,0,0,0,330
26179,200,100,40,80,160,0,580
26180,220,140,120,240,320,0,1040
26181,180,120,40,80,0,0,420
26182,180,80,40,80,160,0,540
26183,210,180,80,160,160,0,790
26184,190,100,120,80,160,0,650
26185,190,140,200,80,160,0,770
26186,190,120,80,80,160,320,950
26187,210,160,160,240,0,0,770
26188,180,60,80,80,160,0,560
26189,240,100,80,80,160,0,660
26190,130,120,120,80,160,320,930
26191,250,100,120,80,160,320,1030
26192,230,180,200,160,0,0,770
26193,200,100,160,160,160,0,780
26194,180,100,80,80,0,0,440
26195,200,120,120,160,160,0,760
26196,170,60,40,0,0,0,270
26197,210,120,120,160,0,0,610
26198,200,100,40,80,160,0,580
26199,220,140,80,80,0,0,520
26200,190,60,80,80,160,0,570
26201,190,120,120,0,0,0,430
26202,180,140,160,160,0,0,640
26203,230,100,40,80,0,0,450
26204,220,120,120,80,0,0,540
26205,200,140,80,80,0,0,500
26206,170,80,80,160,160,320,970
26207,200,140,160,80,0,0,580
26208,190,160,160,0,0,0,510
26209,200,120,160,160,160,0,800
26210,210,40,80,80,0,0,410
26211,190,100,80,80,0,0,450
26212,160,140,120,160,320,0,900
26213,150,100,120,240,160,0,770
26214,140,80,80,80,160,0,540
26215,190,120,80,160,320,0,870
26216,160,80,40,80,0,0,360
26217,170,100,120,80,160,0,630
26218,190,100,120,160,0,0,570
26219,210,140,80,80,160,320,990
26220,220,100,120,160,320,0,920
26221,240,140,120,80,160,320,1060
26222,200,100,120,0,0,0,420
26223,200,140,120,80,160,0,700
26224,210,100,120,160,320,0,910
26225,210,100,80,80,160,320,950
26226,180,80,120,80,160,0,620
26227,210,120,120,80,0,0,530
26228,250,120,120,160,160,0,810
26229,190,140,120,80,0,0,530
26230,190,80,80,80,160,0,590
26231,200,120,120,160,160,0,760
26232,200,140,120,160,160,0,780
26233,180,80,40,80,0,0,380
26234,190,160,40,80,160,0,630
26235,210,100,120,160,160,0,750
26236,190,80,40,80,0,0,390
26237,250,120,80,160,0,0,610
26238,160,60,0,0,0,0,220
26239,200,120,40,80,0,0,440
26240,210,140,40,0,0,0,390
26241,240,200,120,0,0,0,560
26242,190,140,120,160,0,0,610
26243,160,80,40,80,160,0,520
26244,200,140,200,160,160,0,860
26245,240,140,120,160,0,0,660
26246,160,160,160,240,160,0,880
26247,190,140,80,80,160,0,650
26248,210,80,120,160,0,0,570
26249,190,120,120,80,0,0,510
26250,220,80,160,240,160,0,860
26251,220,120,120,160,0,0,620
26252,170,140,120,80,0,0,510
26253,210,140,120,80,0,0,550
26254,200,120,120,0,0,0,440
26255,180,100,120,80,160,0,640
26256,230,80,80,80,160,0,630
26257,230,160,160,80,160,0,790
26258,230,120,160,160,160,0,830
26259,170,140,80,80,160,0,630
26260,190,140,120,160,160,0,770
26261,170,120,120,160,0,0,570
26262,190,160,120,80,160,320,1030
26263,160,140,200,240,320,0,1060
26264,230,180,120,80,0,0,610
26265,180,120,80,80,160,320,940
26266,210,80,40,80,160,0,570
26267,220,120,160,80,0,0,580
26268,180,140,120,80,160,0,680
26269,190,140,80,0,0,0,410
26270,220,160,120,0,0,0,500
26271,220,100,120,160,320,0,920
26272,150,100,80,80,160,0,570
26273,190,100,80,0,0,0,370
26274,220,140,120,80,160,0,720
26275,170,80,120,80,0,0,450
26276,220,160,120,160,160,0,820
26277,190,120,120,80,160,0,670
26278,190,160,40,80,0,0,470
26279,220,140,120,80,160,0,720
26280,240,100,80,0,0,0,420
26281,190,140,40,0,0,0,370
26282,180,60,120,80,160,320,920
26283,200,100,120,80,0,0,500
26284,190,180,200,80,160,320,1130
26285,150,100,40,80,0,0,370
26286,230,140,80,0,0,0,450
26287,180,140,160,160,320,320,1280
26288,200,120,120,160,160,0,760
26289,190,120,160,80,160,320,1030
26290,220,180,200,160,320,0,1080
26291,210,100,120,160,160,0,750
26292,210,120,120,160,160,0,770
26293,180,100,120,80,0,0,480
26294,180,120,120,160,160,0,740
26295,210,140,80,160,0,0,590
26296,210,140,80,0,0,0,430
26297,220,140,120,80,160,0,720
26298,190,120,120,80,160,0,670
26299,170,80,120,240,0,0,610
26300,190,160,80,0,0,0,430
26301,200,80,160,240,0,0,680
26302,180,140,160,160,0,0,640
26303,170,160,120,80,160,0,690
26304,210,60,80,80,160,0,590
26305,180,140,120,80,160,0,680
26306,210,140,80,80,0,0,510
26307,240,160,160,240,320,0,1120
26308,180,80,40,80,0,0,380
26309,210,140,160,240,320,0,1070
26310,240,100,80,80,160,0,660
26311,190,100,120,80,0,0,490
26312,170,120,160,80,160,0,690
26313,210,140,120,80,0,0,550
26314,150,100,200,160,160,0,770
26315,210,120,160,160,160,0,810
26316,230,140,120,160,160,0,810
26317,210,160,160,160,160,0,850
26318,210,220,80,80,160,320,1070
26319,200,120,120,160,0,0,600
26320,190,80,120,160,160,320,1030
26321,220,140,80,160,160,0,760
26322,170,100,120,160,160,0,710
26323,240,140,40,0,0,0,420
26324,200,100,80,80,0,0,460
26325,190,100,40,0,0,0,330
26326,160,140,160,160,0,0,620
26327,180,160,200,80,160,320,1100
26328,170,120,120,160,320,0,890
26329,210,100,80,0,0,0,390
26330,200,80,80,80,0,0,440
26331,180,100,40,0,0,0,320
26332,210,180,120,160,320,320,1310
26333,180,100,120,240,320,0,960
26334,210,120,120,80,160,0,690
26335,170,140,160,160,320,320,1270
26336,200,140,120,80,0,0,540
26337,190,140,120,160,160,0,770
26338,180,160,120,160,160,320,1100
26339,190,100,120,160,320,320,1210
26340,170,80,40,80,160,0,530
26341,190,120,120,80,0,0,510
26342,210,140,160,160,160,0,830
26343,170,100,80,160,160,320,990
26344,200,60,40,0,0,0,300
26345,160,160,160,320,320,0,1120
26346,190,120,120,0,0,0,430
26347,190,100,40,0,0,0,330
26348,250,160,160,80,0,0,650
26349,180,100,80,0,0,0,360
26350,150,120,120,80,160,0,630
26351,240,140,160,160,160,0,860
26352,190,120,80,80,160,320,950
26353,220,140,120,160,320,0,960
26354,200,120,80,80,0,0,480
26355,190,160,120,160,320,0,950
26356,190,160,120,80,0,0,550
26357,220,120,120,160,160,0,780
26358,170,100,0,0,0,0,270
26359,250,140,160,80,160,0,790
26360,180,120,120,80,160,0,660
26361,180,120,80,0,0,0,380
26362,180,100,120,80,0,0,480
26363,180,140,40,80,0,0,440
26364,240,140,160,160,320,0,1020
26365,220,160,160,80,160,0,780
26366,200,120,160,240,160,0,880
26367,210,120,80,160,160,0,730
26368,230,200,120,80,160,0,790
26369,200,160,200,160,320,0,1040
26370,220,80,40,80,0,0,420
26371,180,100,120,160,160,0,720
26372,170,120,40,0,0,0,330
26373,170,120,40,80,0,0,410
26374,210,160,120,80,0,0,570
26375,180,100,80,80,0,0,440
26376,200,120,80,160,320,0,880
26377,150,120,120,80,160,0,630
26378,170,140,80,80,0,0,470
26379,250,80,0,0,0,0,330
26380,210,160,120,80,160,0,730
26381,150,160,200,240,160,320,1230
26382,210,60,80,160,320,0,830
26383,250,160,120,80,160,320,1090
26384,250,80,80,80,0,0,490
26385,200,80,80,80,160,0,600
26386,240,140,40,80,0,0,500
26387,170,80,80,160,160,320,970
26388,220,60,80,160,160,0,680
26389,200,160,80,160,0,0,600
26390,210,100,40,80,160,320,910
26391,210,120,120,80,0,0,530
26392,220,160,160,240,320,0,1100
26393,190,180,200,160,160,320,1210
26394,230,100,80,80,0,0,490
26395,220,100,120,80,160,0,680
26396,220,100,80,80,160,0,640
26397,150,60,0,0,0,0,210
26398,200,140,40,0,0,0,380
26399,180,160,120,80,160,0,700
26400,160,140,160,80,0,0,540
26401,210,140,80,160,160,0,750
26402,190,140,160,160,160,320,1130
26403,220,60,40,0,0,0,320
26404,180,60,80,80,160,320,880
26405,190,120,120,80,160,0,670
26406,200,100,40,80,160,0,580
26407,200,80,40,80,160,0,560
26408,230,140,120,160,160,0,810
26409,200,80,40,80,160,320,880
26410,130,100,40,80,0,0,350
26411,200,80,120,160,160,320,1040
26412,210,120,40,0,0,0,370
26413,220,80,40,0,0,0,340
26414,150,60,80,160,160,0,610
26415,170,120,40,0,0,0,330
26416,210,140,40,80,160,0,630
26417,220,180,80,160,320,0,960
26418,190,120,160,80,160,320,1030
26419,180,120,160,80,160,0,700
26420,190,100,120,240,160,0,810
26421,200,120,120,160,160,0,760
26422,190,40,40,0,0,0,270
26423,190,160,80,80,0,0,510
26424,170,80,120,240,160,320,1090
26425,210,80,40,0,0,0,330
26426,170,160,120,160,0,0,610
26427,190,180,160,160,160,0,850
26428,180,200,160,160,160,0,860
26429,160,60,40,80,0,0,340
26430,160,100,80,80,160,0,580
26431,180,160,120,0,0,0,460
26432,200,180,160,80,160,0,780
26433,170,80,80,80,160,320,890
26434,200,180,120,160,160,320,1140
26435,200,80,40,80,160,0,560
26436,200,120,160,160,0,0,640
26437,230,160,80,80,160,0,710
26438,200,120,120,80,160,320,1000
26439,220,120,80,0,0,0,420
26440,160,100,80,80,160,320,900
26441,180,80,80,0,0,0,340
26442,230,160,80,80,160,0,710
26443,160,180,80,160,320,0,900
26444,200,180,40,0,0,0,420
26445,220,100,80,80,160,0,640
26446,200,120,120,160,320,0,920
26447,190,120,80,80,160,0,630
26448,230,200,160,160,160,0,910
26449,190,80,120,160,160,320,1030
26450,200,160,200,160,160,320,1200
26451,210,200,240,160,0,0,810
26452,210,120,120,80,0,0,530
26453,210,120,120,160,0,0,610
26454,180,120,40,80,0,0,420
26455,220,140,80,80,160,0,680
26456,220,100,160,80,0,0,560
26457,170,60,80,80,160,320,870
26458,190,120,120,80,160,0,670
26459,230,160,160,240,320,0,1110
26460,230,100,80,80,160,0,650
26461,220,160,80,80,160,320,1020
26462,190,100,160,80,160,320,1010
26463,160,80,40,0,0,0,280
26464,200,80,80,80,160,0,600
26465,210,120,160,80,160,0,730
26466,220,160,160,160,320,0,1020
26467,160,100,120,240,320,320,1260
26468,140,140,160,160,320,0,920
26469,160,120,120,160,160,0,720
26470,190,120,160,160,0,0,630
26471,200,140,120,80,0,0,540
26472,190,100,80,80,0,0,450
26473,230,120,40,0,0,0,390
26474,220,140,160,80,160,0,760
26475,210,120,40,0,0,0,370
26476,240,140,80,80,0,0,540
26477,230,100,120,80,0,0,530
26478,160,80,80,80,0,0,400
26479,220,120,120,80,160,0,700
26480,160,120,120,160,160,0,720
26481,180,140,80,80,160,0,640
26482,200,100,120,160,0,0,580
26483,160,140,120,80,0,0,500
26484,210,160,120,80,160,0,730
26485,180,160,120,160,160,0,780
26486,190,140,40,80,160,320,930
26487,170,120,160,0,0,0,450
26488,230,120,120,160,160,0,790
26489,200,120,40,0,0,0,360
26490,180,80,80,0,0,0,340
26491,210,100,80,160,320,320,1190
26492,200,140,120,80,160,0,700
26493,190,100,80,80,160,0,610
26494,200,100,80,160,160,0,700
26495,180,100,120,80,160,320,960
26496,190,120,120,160,160,0,750
26497,190,140,120,160,160,320,1090
26498,220,120,40,80,0,0,460
26499,170,140,120,80,0,0,510
26500,180,100,0,0,0,0,280
26501,170,100,120,160,160,0,710
26502,190,120,200,160,320,0,990
26503,250,100,40,80,160,320,950
26504,160,120,40,0,0,0,320
26505,200,140,40,80,0,0,460
26506,200,120,120,80,160,0,680
26507,210,100,40,0,0,0,350
26508,200,140,160,80,0,0,580
26509,170,180,160,80,160,0,750
26510,200,120,120,160,320,0,920
26511,190,100,160,240,160,0,850
26512,150,140,160,160,0,0,610
26513,210,180,160,240,320,0,1110
26514,200,140,200,160,320,320,1340
26515,190,140,80,160,160,0,730
26516,180,80,120,0,0,0,380
26517,190,80,40,80,160,0,550
26518,210,140,200,80,0,0,630
26519,220,80,40,0,0,0,340
26520,210,120,80,160,320,0,890
26521,220,80,0,0,0,0,300
26522,210,120,120,160,160,0,770
26523,190,120,120,80,0,0,510
26524,240,140,120,160,320,0,980
26525,190,100,120,80,160,320,970
26526,210,100,120,160,160,320,1070
26527,200,160,240,160,160,320,1240
26528,210,120,160,160,160,0,810
26529,200,80,80,160,160,320,1000
26530,180,80,40,0,0,0,300
26531,190,140,80,80,160,0,650
26532,190,120,80,80,160,0,630
26533,190,100,80,0,0,0,370
26534,230,160,240,80,160,0,870
26535,160,80,80,80,160,0,560
26536,200,140,120,80,160,0,700
26537,230,140,120,80,160,0,730
26538,220,100,120,240,0,0,680
26539,180,100,80,80,160,0,600
26540,210,100,40,0,0,0,350
26541,120,100,160,80,0,0,460
26542,180,120,80,80,160,320,940
26543,230,100,120,80,160,0,690
26544,220,120,80,160,160,0,740
26545,190,120,80,80,160,320,950
26546,140,80,80,80,160,0,540
26547,200,120,120,80,160,0,680
26548,190,140,120,80,0,0,530
26549,170,60,80,160,0,0,470
26550,180,140,200,160,160,0,840
26551,210,140,120,0,0,0,470
26552,140,80,80,0,0,0,300
26553,190,140,80,160,320,320,1210
26554,210,120,40,80,0,0,450
26555,180,140,120,160,320,0,920
26556,240,140,80,80,160,0,700
26557,190,120,160,80,0,0,550
26558,240,180,160,80,0,0,660
26559,200,160,120,240,320,0,1040
26560,200,120,120,80,0,0,520
26561,240,140,120,80,0,0,580
26562,190,80,80,80,0,0,430
26563,190,120,120,160,160,320,1070
26564,230,160,80,80,160,0,710
26565,190,180,200,80,160,0,810
26566,220,200,200,80,160,0,860
26567,220,160,200,80,0,0,660
26568,210,120,160,160,320,320,1290
26569,230,140,120,160,0,0,650
26570,170,140,80,160,160,0,710
26571,180,160,160,240,320,320,1380
26572,220,200,40,0,0,0,460
26573,200,160,200,160,160,0,880
26574,150,140,160,160,160,0,770
26575,190,140,80,0,0,0,410
26576,180,180,120,160,320,320,1280
26577,180,80,80,80,160,0,580
26578,180,80,40,80,160,0,540
26579,200,100,80,80,0,0,460
26580,170,140,120,0,0,0,430
26581,190,140,80,80,160,320,970
26582,220,120,80,160,160,0,740
26583,190,120,80,80,0,0,470
26584,230,200,80,80,160,0,750
26585,210,100,120,160,160,0,750
26586,170,120,40,0,0,0,330
26587,190,80,40,80,160,0,550
26588,190,60,40,0,0,0,290
26589,170,160,120,80,160,0,690
26590,170,120,160,160,320,320,1250
26591,180,120,80,0,0,0,380
26592,210,100,80,160,160,0,710
26593,150,140,80,80,160,0,610
26594,220,180,200,160,320,320,1400
26595,170,100,80,80,0,0,430
26596,200,160,160,160,160,0,840
26597,190,140,120,160,160,0,770
26598,200,140,120,160,160,320,1100
26599,210,160,120,160,320,0,970
26600,190,80,40,0,0,0,310
26601,160,60,120,80,0,0,420
26602,210,140,80,160,160,0,750
26603,180,120,120,0,0,0,420
26604,180,100,40,80,160,320,880
26605,220,160,40,0,0,0,420
26606,220,160,80,80,0,0,540
26607,190,140,120,80,160,0,690
26608,190,100,120,80,160,0,650
26609,230,180,160,80,0,0,650
26610,160,100,160,240,160,0,820
26611,200,100,160,240,320,320,1340
26612,190,100,120,80,0,0,490
26613,180,80,80,0,0,0,340
26614,230,160,80,0,0,0,470
26615,220,140,200,240,160,0,960
26616,190,140,80,0,0,0,410
26617,180,140,40,80,160,0,600
26618,210,140,120,240,320,0,1030
26619,190,140,120,160,0,0,610
26620,210,160,120,240,320,0,1050
26621,190,100,40,80,160,0,570
26622,180,80,80,0,0,0,340
26623,190,160,120,80,160,0,710
26624,180,100,80,80,160,0,600
26625,190,120,120,80,160,0,670
26626,240,160,40,0,0,0,440
26627,200,100,40,80,160,0,580
26628,210,60,80,80,0,0,430
26629,170,180,160,160,160,0,830
26630,190,160,120,80,160,0,710
26631,190,100,40,0,0,0,330
26632,170,40,0,0,0,0,210
26633,220,100,120,80,160,0,680
26634,190,160,200,160,160,0,870
26635,190,40,40,0,0,0,270
26636,220,100,80,80,0,0,480
26637,220,160,160,160,320,0,1020
26638,200,140,200,240,320,320,1420
26639,220,80,40,80,160,320,900
26640,200,100,40,80,160,0,580
26641,180,60,80,160,160,0,640
26642,150,140,80,0,0,0,370
26643,230,120,120,160,0,0,630
26644,200,180,160,240,320,0,1100
26645,190,140,80,80,0,0,490
26646,140,80,80,160,160,0,620
26647,240,100,80,80,160,0,660
26648,200,100,120,0,0,0,420
26649,220,120,120,160,160,0,780
26650,210,120,120,80,0,0,530
26651,230,60,40,80,0,0,410
26652,160,120,120,80,160,320,960
26653,200,180,80,160,160,0,780
26654,210,60,80,0,0,0,350
26655,200,100,160,240,0,0,700
26656,170,100,160,0,0,0,430
26657,210,160,120,160,160,320,1130
26658,170,100,120,160,0,0,550
26659,200,160,80,80,160,0,680
26660,170,100,40,0,0,0,310
26661,180,120,160,0,0,0,460
26662,180,120,80,80,160,0,620
26663,190,100,120,160,0,0,570
26664,210,120,80,160,0,0,570
26665,210,140,120,80,160,0,710
26666,220,160,120,80,160,0,740
26667,230,120,80,160,320,320,1230
26668,200,140,160,160,0,0,660
26669,170,120,120,160,0,0,570
26670,210,140,80,80,0,0,510
26671,200,180,120,80,160,320,1060
26672,210,180,160,160,320,320,1350
26673,220,160,40,80,0,0,500
26674,220,120,80,160,0,0,580
26675,230,140,80,0,0,0,450
26676,180,100,160,80,0,0,520
26677,160,100,80,80,0,0,420
26678,170,120,160,240,0,0,690
26679,190,140,120,80,160,0,690
26680,220,140,120,0,0,0,480
26681,180,80,120,160,160,0,700
26682,160,120,160,160,160,0,760
26683,190,80,40,80,0,0,390
26684,170,120,80,160,160,320,1010
26685,200,60,0,0,0,0,260
26686,210,80,80,80,160,320,930
26687,180,140,120,160,160,0,760
26688,190,120,80,80,0,0,470
26689,210,120,80,80,0,0,490
26690,170,180,160,80,160,0,750
26691,200,160,240,160,160,0,920
26692,170,120,120,160,160,0,730
26693,220,100,40,80,160,0,600
26694,200,140,120,80,0,0,540
26695,130,100,80,80,160,0,550
26696,190,100,120,0,0,0,410
26697,250,100,80,160,160,0,750
26698,180,100,80,0,0,0,360
26699,180,120,160,80,0,0,540
26700,210,80,40,80,160,0,570
26701,170,100,120,80,160,0,630
26702,180,120,80,80,0,0,460
26703,220,140,120,240,160,0,880
26704,200,120,160,160,320,320,1280
26705,190,100,80,80,0,0,450
26706,190,120,40,80,160,0,590
26707,200,100,120,80,160,0,660
26708,170,100,80,80,160,0,590
26709,180,60,40,80,160,0,520
26710,200,120,80,80,0,0,480
26711,220,120,120,160,160,0,780
26712,170,120,80,80,0,0,450
26713,200,140,200,0,0,0,540
26714,220,160,120,80,160,0,740
26715,220,180,160,160,0,0,720
26716,210,120,80,160,160,0,730
26717,170,160,120,160,160,0,770
26718,220,160,80,160,160,320,1100
26719,190,140,120,240,160,320,1170
26720,210,140,120,80,0,0,550
26721,140,80,80,80,0,0,380
26722,160,100,120,80,160,0,620
26723,190,120,120,160,160,0,750
26724,200,160,80,0,0,0,440
26725,190,160,120,160,320,0,950
26726,190,160,160,80,160,0,750
26727,170,100,200,160,160,0,790
26728,150,120,120,160,160,0,710
26729,180,60,0,0,0,0,240
26730,190,160,120,0,0,0,470
26731,220,80,120,80,160,0,660
26732,230,160,80,160,0,0,630
26733,190,140,160,160,160,0,810
26734,220,200,160,80,160,0,820
26735,190,100,40,80,160,0,570
26736,220,120,160,160,320,320,1300
26737,200,100,80,80,0,0,460
26738,190,120,80,160,320,0,870
26739,230,120,160,160,160,0,830
26740,190,120,80,80,160,0,630
26741,170,80,120,80,0,0,450
26742,170,120,160,80,160,0,690
26743,180,100,160,160,160,0,760
26744,180,80,120,80,0,0,460
26745,190,120,80,160,320,320,1190
26746,200,160,160,160,160,0,840
26747,180,140,160,80,0,0,560
26748,210,140,120,160,160,0,790
26749,170,120,80,80,0,0,450
26750,220,140,80,80,160,0,680
26751,240,160,160,160,160,0,880
26752,150,80,40,80,0,0,350
26753,210,120,120,240,320,0,1010
26754,210,80,120,240,320,320,1290
26755,170,140,80,160,160,0,710
26756,200,120,120,80,0,0,520
26757,170,100,40,0,0,0,310
26758,170,100,120,160,320,0,870
26759,200,120,40,80,0,0,440
26760,180,80,80,80,160,0,580
26761,200,60,40,0,0,0,300
26762,190,100,120,160,160,0,730
26763,230,160,160,240,320,0,1110
26764,200,120,80,0,0,0,400
26765,200,100,120,80,160,0,660
26766,210,100,120,80,0,0,510
26767,210,60,120,80,160,0,630
26768,220,140,120,160,160,0,800
26769,230,100,120,160,0,0,610
26770,210,160,160,160,160,0,850
26771,200,180,120,80,0,0,580
26772,210,80,40,0,0,0,330
26773,170,160,120,80,160,320,1010
26774,160,100,80,80,0,0,420
26775,170,80,120,160,320,0,850
26776,190,120,80,80,160,320,950
26777,170,100,80,160,320,0,830
26778,180,80,40,0,0,0,300
26779,220,140,80,80,0,0,520
26780,160,80,120,160,0,0,520
26781,220,140,0,0,0,0,360
26782,200,140,80,0,0,0,420
26783,200,60,40,0,0,0,300
26784,220,140,120,80,0,0,560
26785,150,80,120,240,320,320,1230
26786,180,120,80,160,0,0,540
26787,170,100,40,80,160,0,550
26788,230,220,160,80,0,0,690
26789,240,100,40,0,0,0,380
26790,200,140,120,160,320,320,1260
26791,210,160,120,160,160,0,810
26792,170,100,160,160,160,0,750
26793,200,160,160,160,0,0,680
26794,150,100,120,80,0,0,450
26795,190,140,0,0,0,0,330
26796,180,100,160,160,160,0,760
26797,200,160,80,80,160,0,680
26798,180,140,160,80,160,0,720
26799,250,160,200,160,320,0,1090
26800,200,160,80,80,160,0,680
26801,190,100,120,80,160,0,650
26802,210,120,160,160,160,320,1130
26803,200,160,80,0,0,0,440
26804,220,100,120,160,0,0,600
26805,200,80,40,80,160,0,560
26806,260,100,40,0,0,0,400
26807,160,100,160,80,160,0,660
26808,180,140,200,160,160,0,840
26809,160,140,200,160,160,0,820
26810,220,100,40,0,0,0,360
26811,210,120,200,160,160,0,850
26812,160,120,80,80,160,0,600
26813,180,120,120,80,0,0,500
26814,200,100,120,160,160,0,740
26815,190,120,120,80,160,0,670
26816,180,140,40,80,0,0,440
26817,230,60,40,0,0,0,330
26818,200,100,160,0,0,0,460
26819,210,100,120,0,0,0,430
26820,240,200,80,80,160,320,1080
26821,180,140,160,240,320,320,1360
26822,180,120,40,0,0,0,340
26823,210,140,120,80,160,0,710
26824,180,80,40,0,0,0,300
26825,210,160,120,80,160,0,730
26826,220,160,160,160,160,0,860
26827,160,120,120,160,320,320,1200
26828,180,140,120,80,160,0,680
26829,170,140,120,160,160,320,1070
26830,210,160,80,80,160,0,690
26831,180,100,120,160,0,0,560
26832,130,140,80,80,0,0,430
26833,210,160,80,80,0,0,530
26834,220,140,120,80,160,320,1040
26835,210,180,160,240,160,320,1270
26836,200,140,80,80,160,0,660
26837,210,120,120,0,0,0,450
26838,200,100,160,160,320,0,940
26839,210,140,80,80,160,0,670
26840,210,100,80,160,160,0,710
26841,210,140,160,160,0,0,670
26842,190,120,120,160,320,0,910
26843,230,120,80,80,160,0,670
26844,180,80,80,160,160,0,660
26845,190,100,120,160,160,0,730
26846,180,140,160,160,0,0,640
26847,200,160,120,80,0,0,560
26848,210,100,80,80,0,0,470
26849,180,140,80,80,160,0,640
26850,190,80,120,160,160,0,710
26851,250,160,160,240,320,0,1130
26852,210,120,80,0,0,0,410
26853,190,120,120,240,160,0,830
26854,190,140,120,80,160,0,690
26855,210,120,80,80,0,0,490
26856,190,120,80,0,0,0,390
26857,250,160,200,160,320,0,1090
26858,160,80,80,160,160,0,640
26859,170,80,80,80,160,0,570
26860,200,120,160,0,0,0,480
26861,200,140,120,80,160,320,1020
26862,190,140,160,0,0,0,490
26863,180,180,80,80,0,0,520
26864,190,120,160,0,0,0,470
26865,180,40,40,0,0,0,260
26866,190,140,80,80,0,0,490
26867,200,160,200,80,160,0,800
26868,170,100,80,80,160,0,590
26869,170,80,80,160,160,0,650
26870,190,140,80,160,320,0,890
26871,220,140,160,160,160,0,840
26872,120,100,120,80,160,0,580
26873,220,160,120,80,160,0,740
26874,160,120,160,240,0,0,680
26875,220,120,120,160,320,0,940
26876,170,120,40,0,0,0,330
26877,190,80,120,80,0,0,470
26878,240,140,80,80,160,0,700
26879,180,100,120,0,0,0,400
26880,190,80,80,0,0,0,350
26881,190,140,80,160,320,320,1210
26882,180,80,120,80,0,0,460
26883,180,140,120,80,0,0,520
26884,230,140,120,0,0,0,490
26885,180,160,80,0,0,0,420
26886,180,120,120,160,320,0,900
26887,200,180,80,80,160,0,700
26888,220,200,240,160,0,0,820
26889,190,100,200,240,320,0,1050
26890,240,240,120,80,0,0,680
26891,190,120,120,0,0,0,430
26892,190,140,80,160,320,0,890
26893,180,80,120,160,320,320,1180
26894,200,140,80,160,0,0,580
26895,210,160,120,160,0,0,650
26896,230,140,120,80,0,0,570
26897,200,140,80,0,0,0,420
26898,160,100,80,80,160,0,580
26899,200,140,160,240,0,0,740
26900,190,140,120,80,0,0,530
26901,180,120,80,160,160,0,700
26902,240,140,80,160,320,320,1260
26903,180,100,120,80,160,0,640
26904,200,140,160,80,160,320,1060
26905,230,80,120,80,160,0,670
26906,210,140,120,160,160,0,790
26907,180,80,80,80,160,0,580
26908,200,140,160,160,0,0,660
26909,230,160,80,160,160,320,1110
26910,190,120,160,160,0,0,630
26911,170,80,40,80,160,0,530
26912,160,140,200,160,160,0,820
26913,180,80,120,80,0,0,460
26914,180,120,80,80,160,0,620
26915,170,80,120,160,0,0,530
26916,220,140,120,240,320,0,1040
26917,210,80,40,0,0,0,330
26918,160,120,160,80,0,0,520
26919,230,140,80,80,0,0,530
26920,190,160,120,160,320,0,950
26921,220,120,80,80,0,0,500
26922,220,120,40,0,0,0,380
26923,230,100,120,80,160,0,690
26924,180,140,120,160,320,0,920
26925,210,120,40,80,160,0,610
26926,160,120,200,240,320,0,1040
26927,200,120,120,160,320,0,920
26928,220,140,120,240,320,320,1360
26929,220,140,120,0,0,0,480
26930,220,80,80,80,160,0,620
26931,220,80,120,160,160,0,740
26932,210,100,80,80,160,320,950
26933,170,100,120,160,160,0,710
26934,190,160,200,80,160,320,1110
26935,160,60,80,80,160,0,540
26936,190,80,80,80,0,0,430
26937,230,120,160,80,0,0,590
26938,180,100,40,80,160,0,560
26939,240,160,120,160,0,0,680
26940,170,140,40,0,0,0,350
26941,200,160,80,80,0,0,520
26942,180,100,120,80,160,0,640
26943,210,180,120,80,160,320,1070
26944,240,180,160,160,320,0,1060
26945,170,160,120,240,320,320,1330
26946,210,100,40,80,160,0,590
26947,210,100,40,80,160,0,590
26948,210,120,120,160,0,0,610
26949,210,120,120,240,0,0,690
26950,180,140,160,160,160,0,800
26951,180,140,160,80,160,0,720
26952,200,140,80,0,0,0,420
26953,220,120,120,80,160,0,700
26954,150,80,160,160,160,320,1030
26955,200,180,120,80,0,0,580
26956,180,120,80,80,160,0,620
26957,170,80,40,0,0,0,290
26958,190,140,80,0,0,0,410
26959,210,120,120,80,0,0,530
26960,170,120,40,80,160,0,570
26961,210,80,80,80,160,320,930
26962,200,120,160,160,320,0,960
26963,170,80,40,80,160,320,850
26964,160,140,120,160,160,0,740
26965,200,120,200,160,320,0,1000
26966,220,120,120,80,0,0,540
26967,200,140,200,160,160,0,860
26968,210,200,80,160,160,0,810
26969,170,100,40,80,160,0,550
26970,160,120,160,160,0,0,600
26971,250,180,120,160,160,0,870
26972,200,100,160,80,160,0,700
26973,180,140,200,160,160,0,840
26974,190,100,120,80,160,0,650
26975,200,140,80,160,160,0,740
26976,200,140,120,240,160,0,860
26977,200,120,160,160,0,0,640
26978,240,140,120,160,160,0,820
26979,220,140,120,160,0,0,640
26980,220,140,160,240,160,0,920
26981,220,140,200,0,0,0,560
26982,190,140,160,160,160,320,1130
26983,190,100,120,160,160,320,1050
26984,180,140,80,80,0,0,480
26985,180,120,80,160,320,0,860
26986,220,140,160,240,160,0,920
26987,190,180,160,80,160,0,770
26988,230,180,160,160,320,0,1050
26989,230,180,240,240,320,320,1530
26990,210,100,120,160,160,320,1070
26991,220,140,40,80,160,0,640
26992,220,140,40,0,0,0,400
26993,220,220,80,80,0,0,600
26994,210,80,80,160,160,320,1010
26995,160,100,40,0,0,0,300
26996,200,120,40,0,0,0,360
26997,180,160,120,80,160,0,700
26998,120,80,120,240,160,0,720
26999,160,100,40,0,0,0,300
27000,200,120,80,160,160,0,720
27001,190,80,80,80,0,0,430
27002,170,100,80,80,160,0,590
27003,190,140,80,80,160,0,650
27004,180,100,120,160,160,0,720
27005,180,120,160,160,160,320,1100
27006,180,160,200,240,160,320,1260
27007,200,100,80,80,0,0,460
27008,200,60,80,80,0,0,420
27009,160,40,40,0,0,0,240
27010,210,200,120,80,0,0,610
27011,180,140,160,80,0,0,560
27012,220,100,40,80,160,0,600
27013,190,180,80,80,160,0,690
27014,180,140,120,80,0,0,520
27015,190,140,80,160,0,0,570
27016,210,100,120,160,0,0,590
27017,180,100,40,0,0,0,320
27018,180,140,80,160,0,0,560
27019,220,120,80,80,160,320,980
27020,190,80,80,160,160,0,670
27021,160,80,80,80,0,0,400
27022,190,160,160,80,0,0,590
27023,230,140,80,80,160,0,690
27024,160,60,80,80,0,0,380
27025,190,140,80,160,320,0,890
27026,190,120,120,160,160,0,750
27027,220,80,80,80,160,0,620
27028,200,80,80,80,160,0,600
27029,160,60,80,80,160,320,860
27030,210,60,0,0,0,0,270
27031,180,160,120,80,0,0,540
27032,230,140,120,160,160,0,810
27033,210,140,80,80,160,0,670
27034,210,60,120,80,160,0,630
27035,210,100,80,80,0,0,470
27036,170,100,120,80,160,0,630
27037,210,80,80,80,160,0,610
27038,200,120,120,160,160,0,760
27039,180,160,160,240,0,0,740
27040,200,120,120,160,320,320,1240
27041,190,140,120,80,160,0,690
27042,190,120,40,80,0,0,430
27043,170,100,120,80,160,0,630
27044,200,180,200,240,320,0,1140
27045,180,120,160,240,320,0,1020
27046,220,160,120,80,0,0,580
27047,210,160,160,80,160,0,770
27048,170,140,160,80,160,0,710
27049,210,140,160,160,160,0,830
27050,200,120,40,0,0,0,360
27051,200,80,80,80,160,320,920
27052,170,140,120,160,160,0,750
27053,220,160,160,160,0,0,700
27054,210,180,160,240,320,0,1110
27055,200,80,120,160,160,0,720
27056,200,120,80,80,160,0,640
27057,180,120,40,80,160,320,900
27058,190,120,80,80,0,0,470
27059,210,160,160,80,0,0,610
27060,220,180,160,240,160,320,1280
27061,180,100,40,0,0,0,320
27062,190,100,80,160,160,0,690
27063,250,180,160,240,160,0,990
27064,210,100,80,80,160,0,630
27065,240,180,120,80,160,0,780
27066,190,120,40,80,0,0,430
27067,200,160,160,160,160,0,840
27068,200,80,120,80,160,320,960
27069,160,80,80,160,0,0,480
27070,170,80,80,80,160,0,570
27071,170,140,120,240,160,320,1150
27072,170,120,80,80,0,0,450
27073,230,180,200,160,160,0,930
27074,240,160,200,240,320,0,1160
27075,170,140,120,80,0,0,510
27076,150,80,40,80,160,320,830
27077,220,160,160,160,160,0,860
27078,200,100,120,80,0,0,500
27079,210,140,120,160,160,0,790
27080,170,140,80,80,160,320,950
27081,190,100,160,0,0,0,450
27082,190,140,120,160,160,0,770
27083,250,140,80,0,0,0,470
27084,150,80,80,80,160,0,550
27085,210,100,120,80,0,0,510
27086,180,100,40,0,0,0,320
27087,170,160,120,80,0,0,530
27088,140,80,40,0,0,0,260
27089,220,100,120,160,160,320,1080
27090,180,140,80,80,0,0,480
27091,220,60,80,80,0,0,440
27092,190,140,80,160,160,0,730
27093,240,120,80,160,320,0,920
27094,190,160,200,160,160,0,870
27095,200,140,200,80,160,0,780
27096,180,140,120,0,0,0,440
27097,230,160,120,160,160,320,1150
27098,220,120,40,80,160,0,620
27099,250,120,200,80,160,0,810
27100,230,100,80,80,160,320,970
27101,210,160,80,0,0,0,450
27102,190,20,40,0,0,0,250
27103,160,120,40,80,0,0,400
27104,210,120,120,240,320,320,1330
27105,190,120,80,80,160,0,630
27106,210,120,120,160,320,0,930
27107,190,100,80,160,320,0,850
27108,190,100,120,160,320,0,890
27109,190,120,80,160,160,0,710
27110,210,100,120,80,0,0,510
27111,200,100,120,80,0,0,500
27112,210,80,80,160,320,320,1170
27113,150,100,80,80,160,0,570
27114,190,160,120,80,160,0,710
27115,180,60,80,0,0,0,320
27116,210,120,120,80,0,0,530
27117,210,120,120,240,160,0,850
27118,200,120,120,0,0,0,440
27119,150,140,160,240,160,0,850
27120,210,140,160,160,320,0,990
27121,150,120,40,80,160,0,550
27122,190,120,160,240,320,320,1350
27123,190,120,80,80,160,0,630
27124,200,140,160,80,160,0,740
27125,210,100,40,80,160,320,910
27126,200,160,120,0,0,0,480
27127,190,80,40,80,160,320,870
27128,210,140,120,160,0,0,630
27129,210,120,120,80,0,0,530
27130,190,180,40,0,0,0,410
27131,210,100,80,160,160,0,710
27132,210,100,120,160,160,0,750
27133,200,80,80,80,160,320,920
27134,180,120,160,160,160,0,780
27135,210,140,120,160,320,320,1270
27136,230,140,120,80,160,320,1050
27137,190,140,200,160,160,320,1170
27138,210,160,80,0,0,0,450
27139,230,120,120,80,160,0,710
27140,180,120,80,80,160,0,620
27141,190,80,40,80,160,0,550
27142,190,120,120,80,160,0,670
27143,190,120,80,80,0,0,470
27144,170,100,120,0,0,0,390
27145,170,140,120,80,160,0,670
27146,200,100,80,80,160,320,940
27147,230,120,80,0,0,0,430
27148,220,160,120,80,0,0,580
27149,190,100,80,80,0,0,450
27150,240,60,40,80,160,320,900
27151,220,140,80,80,160,0,680
27152,190,100,80,80,160,0,610
27153,210,140,120,80,160,0,710
27154,210,100,80,80,160,0,630
27155,240,140,80,160,320,0,940
27156,210,180,160,80,0,0,630
27157,180,100,80,0,0,0,360
27158,230,100,40,80,160,0,610
27159,190,100,80,160,160,0,690
27160,200,120,160,240,320,0,1040
27161,160,100,80,160,320,0,820
27162,200,140,80,80,0,0,500
27163,210,100,40,80,160,0,590
27164,200,140,120,0,0,0,460
27165,190,140,120,80,160,320,1010
27166,180,100,80,0,0,0,360
27167,250,120,80,80,0,0,530
27168,190,140,200,240,0,0,770
27169,190,60,80,80,0,0,410
27170,170,100,40,80,160,0,550
27171,170,100,80,160,320,320,1150
27172,200,160,80,80,160,0,680
27173,170,120,80,80,160,0,610
27174,160,100,40,80,160,0,540
27175,190,120,80,160,0,0,550
27176,170,140,80,80,0,0,470
27177,200,120,120,160,160,0,760
27178,200,160,160,160,0,0,680
27179,220,140,160,160,320,0,1000
27180,180,160,120,80,160,320,1020
27181,210,120,80,80,160,0,650
27182,200,100,40,80,160,0,580
27183,220,160,120,160,160,0,820
27184,170,100,80,0,0,0,350
27185,190,100,160,240,320,0,1010
27186,200,160,160,240,0,0,760
27187,200,160,80,0,0,0,440
27188,180,120,120,80,0,0,500
27189,190,100,160,160,320,0,930
27190,190,100,120,80,0,0,490
27191,190,140,200,80,160,0,770
27192,200,120,80,160,160,0,720
27193,190,120,120,80,160,320,990
27194,170,80,80,160,160,320,970
27195,180,120,160,240,320,320,1340
27196,170,100,120,80,0,0,470
27197,200,120,80,80,160,320,960
27198,200,140,120,80,0,0,540
27199,170,100,120,80,0,0,470
27200,190,120,120,80,160,0,670
27201,230,80,80,80,0,0,470
27202,190,120,120,80,160,0,670
27203,190,120,120,80,0,0,510
27204,200,120,240,160,0,0,720
27205,190,120,120,160,160,0,750
27206,180,140,200,240,320,320,1400
27207,180,160,120,80,160,0,700
27208,200,140,80,0,0,0,420
27209,210,100,80,80,160,0,630
27210,200,120,80,0,0,0,400
27211,220,160,120,240,0,0,740
27212,190,60,80,80,0,0,410
27213,210,140,80,80,160,0,670
27214,200,100,80,0,0,0,380
27215,210,100,40,80,160,0,590
27216,200,140,120,160,160,0,780
27217,170,100,40,80,160,0,550
27218,180,140,160,160,160,0,800
27219,210,120,120,80,160,0,690
27220,140,100,120,80,160,0,600
27221,220,140,80,80,0,0,520
27222,210,120,120,240,0,0,690
27223,190,160,200,160,320,0,1030
27224,220,100,80,80,160,0,640
27225,190,120,80,80,160,320,950
27226,220,100,80,0,0,0,400
27227,230,140,120,160,160,0,810
27228,230,180,160,80,0,0,650
27229,240,140,80,160,160,0,780
27230,240,160,160,0,0,0,560
27231,180,120,80,80,0,0,460
27232,190,160,120,160,0,0,630
27233,230,100,80,0,0,0,410
27234,190,100,120,240,160,320,1130
27235,180,80,40,80,160,0,540
27236,180,120,80,80,0,0,460
27237,180,140,120,80,160,320,1000
27238,140,80,80,160,320,320,1100
27239,190,120,80,80,160,0,630
27240,230,120,80,80,0,0,510
27241,210,120,160,240,160,0,890
27242,240,160,120,0,0,0,520
27243,260,100,120,160,320,320,1280
27244,180,160,80,0,0,0,420
27245,210,80,40,0,0,0,330
27246,200,100,120,80,0,0,500
27247,160,120,160,160,160,0,760
27248,220,140,120,80,0,0,560
27249,170,120,80,160,320,0,850
27250,160,120,80,80,160,0,600
27251,220,160,0,0,0,0,380
27252,260,160,120,0,0,0,540
27253,210,140,120,240,160,0,870
27254,190,120,80,80,0,0,470
27255,200,120,80,160,320,0,880
27256,220,120,80,80,160,0,660
27257,210,80,40,80,160,0,570
27258,200,120,120,160,320,320,1240
27259,180,80,120,80,0,0,460
27260,180,100,120,160,160,0,720
27261,200,180,160,240,320,0,1100
27262,210,200,160,160,0,0,730
27263,190,60,40,0,0,0,290
27264,180,140,160,80,0,0,560
27265,200,140,80,80,160,0,660
27266,210,180,200,160,160,0,910
27267,190,100,80,80,0,0,450
27268,210,140,200,80,160,320,1110
27269,220,100,80,160,160,0,720
27270,200,120,80,80,0,0,480
27271,220,100,160,240,160,0,880
27272,240,160,120,160,160,0,840
27273,210,100,80,160,320,0,870
27274,180,80,160,160,160,0,740
27275,170,120,120,80,160,0,650
27276,180,100,40,80,160,0,560
27277,200,60,80,0,0,0,340
27278,180,120,40,80,160,0,580
27279,190,100,120,80,160,0,650
27280,210,100,120,80,160,0,670
27281,170,120,120,80,160,0,650
27282,180,140,120,160,320,0,920
27283,240,120,120,80,0,0,560
27284,180,140,120,80,0,0,520
27285,230,120,120,160,160,0,790
27286,160,160,160,0,0,0,480
27287,190,100,40,0,0,0,330
27288,220,120,80,80,0,0,500
27289,180,100,80,0,0,0,360
27290,180,100,120,0,0,0,400
27291,150,80,80,0,0,0,310
27292,230,160,80,0,0,0,470
27293,220,140,120,160,0,0,640
27294,170,120,120,80,160,0,650
27295,200,120,120,160,0,0,600
27296,200,120,40,80,0,0,440
27297,210,160,120,80,0,0,570
27298,160,140,40,80,0,0,420
27299,160,140,80,0,0,0,380
27300,220,160,160,80,0,0,620
27301,190,120,120,80,160,0,670
27302,210,180,160,80,0,0,630
27303,210,100,120,80,160,320,990
27304,220,120,120,80,0,0,540
27305,200,140,80,80,160,0,660
27306,200,120,160,80,160,0,720
27307,220,140,160,80,0,0,600
27308,200,100,120,240,320,320,1300
27309,220,220,80,160,0,0,680
27310,230,160,80,80,160,320,1030
27311,200,140,80,80,160,0,660
27312,230,100,120,160,160,320,1090
27313,210,80,80,0,0,0,370
27314,200,140,160,80,0,0,580
27315,220,140,120,160,160,0,800
27316,210,100,40,0,0,0,350
27317,200,160,200,160,160,0,880
27318,190,100,0,0,0,0,290
27319,210,160,120,80,0,0,570
27320,220,180,120,80,160,0,760
27321,190,120,40,0,0,0,350
27322,210,160,160,160,320,0,1010
27323,220,80,80,160,160,0,700
27324,180,80,80,80,160,0,580
27325,190,140,40,80,0,0,450
27326,200,100,120,160,160,0,740
27327,180,120,0,0,0,0,300
27328,150,100,120,160,320,0,850
27329,190,120,80,0,0,0,390
27330,210,140,160,160,0,0,670
27331,210,140,120,160,320,320,1270
27332,150,120,120,160,160,0,710
27333,160,160,120,80,0,0,520
27334,230,120,160,160,160,0,830
27335,210,120,200,240,160,0,930
27336,190,80,0,0,0,0,270
27337,240,180,160,160,160,0,900
27338,170,100,120,0,0,0,390
27339,200,140,120,80,160,0,700
27340,220,200,120,0,0,0,540
27341,260,140,200,160,0,0,760
27342,220,80,80,160,320,0,860
27343,180,100,80,0,0,0,360
27344,200,100,80,0,0,0,380
27345,210,140,160,160,320,0,990
27346,230,120,160,160,160,0,830
27347,180,120,200,160,160,320,1140
27348,230,140,120,80,160,0,730
27349,240,180,240,160,160,0,980
27350,190,160,80,160,160,0,750
27351,200,100,80,160,320,320,1180
27352,230,100,80,80,160,320,970
27353,220,100,80,80,160,320,960
27354,200,80,40,80,0,0,400
27355,220,140,80,80,0,0,520
27356,210,140,120,160,320,0,950
27357,210,100,80,80,0,0,470
27358,200,40,40,80,0,0,360
27359,180,160,120,80,0,0,540
27360,180,160,120,160,160,320,1100
27361,170,80,120,80,160,0,610
27362,160,100,40,0,0,0,300
27363,170,120,120,0,0,0,410
27364,200,120,80,160,320,0,880
27365,200,80,80,80,160,0,600
27366,190,120,120,160,160,0,750
27367,230,100,80,80,160,0,650
27368,190,120,80,80,0,0,470
27369,170,140,160,160,160,0,790
27370,200,120,80,160,0,0,560
27371,170,60,40,80,0,0,350
27372,190,140,160,240,320,0,1050
27373,200,80,80,0,0,0,360
27374,200,160,80,160,320,320,1240
27375,150,80,80,80,0,0,390
27376,170,180,120,80,0,0,550
27377,230,120,120,160,160,0,790
27378,190,140,200,160,160,0,850
27379,220,140,80,80,160,0,680
27380,180,80,80,160,320,320,1140
27381,200,140,80,80,160,0,660
27382,180,100,160,160,160,0,760
27383,210,200,160,160,320,320,1370
27384,160,80,80,160,320,0,800
27385,220,140,160,80,0,0,600
27386,160,80,120,160,160,320,1000
27387,180,80,160,80,160,320,980
27388,220,120,160,240,160,0,900
27389,180,40,40,0,0,0,260
27390,190,100,80,0,0,0,370
27391,180,120,120,160,0,0,580
27392,240,140,160,160,160,320,1180
27393,210,140,200,160,160,0,870
27394,200,80,80,0,0,0,360
27395,170,140,80,80,160,0,630
27396,210,80,40,80,0,0,410
27397,160,120,160,160,160,320,1080
27398,230,120,80,0,0,0,430
27399,220,120,120,0,0,0,460
27400,180,140,120,160,160,0,760
27401,200,140,120,80,160,0,700
27402,230,100,80,160,160,320,1050
27403,200,120,120,160,320,0,920
27404,190,140,120,80,160,320,1010
27405,190,120,160,80,0,0,550
27406,210,100,80,80,0,0,470
27407,200,100,120,80,160,320,980
27408,180,140,160,80,160,0,720
27409,210,160,40,0,0,0,410
27410,180,120,160,160,160,0,780
27411,240,80,80,80,160,320,960
27412,180,120,120,160,0,0,580
27413,230,100,40,0,0,0,370
27414,190,160,120,80,160,0,710
27415,210,120,120,160,0,0,610
27416,190,160,160,160,160,0,830
27417,170,180,160,160,0,0,670
27418,170,80,120,80,160,0,610
27419,190,120,120,80,160,320,990
27420,180,140,80,0,0,0,400
27421,190,80,80,160,160,320,990
27422,180,120,120,80,160,0,660
27423,200,120,120,0,0,0,440
27424,180,160,80,160,160,0,740
27425,170,180,120,80,0,0,550
27426,180,80,40,80,160,0,540
27427,180,120,120,160,320,320,1220
27428,210,100,160,80,0,0,550
27429,170,140,120,80,0,0,510
27430,160,120,120,80,160,0,640
27431,180,60,80,160,320,0,800
27432,250,140,40,80,160,320,990
27433,190,80,120,80,0,0,470
27434,210,140,200,240,0,0,790
27435,170,100,120,80,0,0,470
27436,210,120,40,0,0,0,370
27437,200,100,80,160,160,320,1020
27438,200,160,0,0,0,0,360
27439,220,180,160,160,160,0,880
27440,180,140,120,80,160,0,680
27441,200,100,80,160,160,0,700
27442,160,100,120,160,160,0,700
27443,200,120,80,0,0,0,400
27444,160,60,40,0,0,0,260
27445,210,140,80,160,160,0,750
27446,230,160,120,80,0,0,590
27447,190,100,120,160,320,0,890
27448,210,160,160,240,320,320,1410
27449,190,100,120,80,160,0,650
27450,210,100,120,80,160,320,990
27451,200,120,120,80,0,0,520
27452,170,140,80,80,0,0,470
27453,230,160,160,80,0,0,630
27454,220,160,160,160,160,320,1180
27455,170,140,160,0,0,0,470
27456,190,120,120,0,0,0,430
27457,240,140,120,80,160,0,740
27458,170,100,80,80,160,0,590
27459,180,160,160,160,160,0,820
27460,160,100,120,160,160,0,700
27461,200,120,120,160,320,0,920
27462,210,140,40,80,160,0,630
27463,200,140,120,160,160,0,780
27464,210,180,160,160,320,0,1030
27465,160,60,40,80,160,320,820
27466,180,120,160,160,160,0,780
27467,180,160,120,80,160,0,700
27468,160,40,40,80,160,0,480
27469,200,80,40,0,0,0,320
27470,190,120,120,80,0,0,510
27471,180,120,80,80,160,0,620
27472,170,140,80,160,320,0,870
27473,190,180,200,240,320,0,1130
27474,210,120,80,80,0,0,490
27475,180,80,80,80,160,0,580
27476,190,120,120,80,160,0,670
27477,200,100,80,80,160,320,940
27478,180,100,40,0,0,0,320
27479,210,140,160,160,160,320,1150
27480,170,120,120,80,160,0,650
27481,230,100,80,80,160,0,650
27482,170,100,80,80,0,0,430
27483,250,120,80,80,0,0,530
27484,250,200,80,80,160,0,770
27485,160,120,160,0,0,0,440
27486,170,40,40,80,0,0,330
27487,200,120,120,80,160,0,680
27488,240,160,120,160,0,0,680
27489,200,140,160,160,320,320,1300
27490,150,40,80,80,160,0,510
27491,160,100,40,0,0,0,300
27492,240,120,120,80,0,0,560
27493,200,120,160,160,160,0,800
27494,180,120,120,80,160,320,980
27495,200,140,120,0,0,0,460
27496,160,100,40,0,0,0,300
27497,200,100,80,160,160,0,700
27498,200,100,120,0,0,0,420
27499,200,120,200,240,160,0,920
27500,220,140,160,160,160,0,840
27501,230,100,40,80,0,0,450
27502,200,120,120,80,0,0,520
27503,170,120,120,160,160,0,730
27504,210,140,120,80,160,320,1030
27505,180,120,120,160,160,0,740
27506,210,120,120,160,320,0,930
27507,170,80,40,80,160,0,530
27508,200,80,40,80,0,0,400
27509,190,120,120,160,160,0,750
27510,190,160,120,80,160,0,710
27511,180,140,200,160,160,0,840
27512,190,160,200,80,0,0,630
27513,200,100,80,160,160,0,700
27514,200,100,160,80,160,0,700
27515,160,120,120,80,160,0,640
27516,160,100,80,80,160,0,580
27517,200,60,80,80,0,0,420
27518,190,160,120,240,160,320,1190
27519,220,100,80,160,0,0,560
27520,160,80,40,80,160,0,520
27521,220,140,80,0,0,0,440
27522,170,100,120,160,320,0,870
27523,200,200,160,240,320,0,1120
27524,200,140,40,0,0,0,380
27525,240,120,160,80,160,0,760
27526,180,120,120,0,0,0,420
27527,210,140,80,80,160,0,670
27528,200,160,80,160,160,0,760
27529,190,100,80,80,160,0,610
27530,210,120,120,160,160,0,770
27531,190,180,80,80,160,0,690
27532,240,120,120,80,160,0,720
27533,190,120,120,80,0,0,510
27534,210,80,40,0,0,0,330
27535,200,160,160,160,0,0,680
27536,200,120,160,160,160,0,800
27537,160,80,120,160,320,0,840
27538,220,140,80,0,0,0,440
27539,200,160,80,80,160,0,680
27540,190,180,40,0,0,0,410
27541,170,40,40,80,0,0,330
27542,200,160,160,160,160,320,1160
27543,190,140,160,160,320,0,970
27544,180,140,120,160,160,320,1080
27545,220,140,80,160,160,0,760
27546,270,140,0,0,0,0,410
27547,130,60,80,160,160,0,590
27548,180,160,80,80,0,0,500
27549,190,160,160,80,0,0,590
27550,220,100,80,80,160,0,640
27551,220,120,120,80,0,0,540
27552,170,120,120,80,160,320,970
27553,170,200,120,160,320,0,970
27554,180,140,120,80,0,0,520
27555,170,80,40,80,160,0,530
27556,210,160,120,80,160,0,730
27557,170,140,120,160,0,0,590
27558,190,140,120,80,160,0,690
27559,200,140,40,80,160,0,620
27560,210,160,80,80,0,0,530
27561,200,120,120,160,160,0,760
27562,210,140,40,80,160,0,630
27563,210,140,40,80,160,0,630
27564,200,100,160,160,320,0,940
27565,160,100,80,80,0,0,420
27566,200,180,80,80,160,0,700
27567,180,140,80,80,0,0,480
27568,200,120,80,160,320,0,880
27569,190,120,120,80,160,0,670
27570,200,160,120,160,0,0,640
27571,180,120,80,160,160,0,700
27572,230,180,160,80,0,0,650
27573,170,140,120,160,160,0,750
27574,220,140,160,160,320,0,1000
27575,200,40,40,80,160,320,840
27576,150,80,0,0,0,0,230
27577,200,60,80,160,320,0,820
27578,230,120,40,80,0,0,470
27579,240,140,120,160,160,320,1140
27580,220,100,120,160,320,320,1240
27581,230,220,120,240,160,0,970
27582,210,120,80,80,0,0,490
27583,220,180,160,0,0,0,560
27584,240,140,160,80,0,0,620
27585,190,60,40,80,160,0,530
27586,170,120,160,80,160,0,690
27587,240,100,80,0,0,0,420
27588,170,100,120,160,320,0,870
27589,190,100,160,160,160,0,770
27590,210,120,200,0,0,0,530
27591,250,140,40,80,0,0,510
27592,160,100,160,160,0,0,580
27593,160,140,120,160,160,0,740
27594,180,100,80,80,160,320,920
27595,180,120,160,160,320,320,1260
27596,180,100,80,80,0,0,440
27597,210,180,160,80,0,0,630
27598,180,80,40,80,160,0,540
27599,230,120,80,80,0,0,510
27600,180,180,160,160,160,0,840
27601,190,140,80,80,0,0,490
27602,190,120,80,0,0,0,390
27603,140,120,120,80,160,0,620
27604,200,140,120,80,160,0,700
27605,260,140,80,160,320,0,960
27606,190,120,80,80,0,0,470
27607,250,140,120,80,160,0,750
27608,200,140,120,160,0,0,620
27609,180,60,80,80,0,0,400
27610,160,120,80,80,160,320,920
27611,200,140,80,80,0,0,500
27612,190,140,120,160,160,0,770
27613,200,140,120,80,0,0,540
27614,180,120,80,80,0,0,460
27615,200,140,120,160,320,0,940
27616,230,180,120,80,160,0,770
27617,200,40,0,0,0,0,240
27618,200,140,80,80,160,0,660
27619,220,160,80,80,160,0,700
27620,230,180,160,80,160,320,1130
27621,200,80,80,160,160,0,680
27622,210,180,120,240,320,320,1390
27623,210,80,40,80,160,320,890
27624,200,100,120,80,0,0,500
27625,160,100,40,80,160,320,860
27626,190,120,120,160,160,0,750
27627,220,160,120,160,160,0,820
27628,180,240,200,80,0,0,700
27629,150,100,80,0,0,0,330
27630,190,120,80,80,160,0,630
27631,230,140,120,80,160,0,730
27632,190,40,80,80,0,0,390
27633,170,180,120,160,320,0,950
27634,180,100,80,80,0,0,440
27635,160,120,120,80,0,0,480
27636,230,140,80,160,160,0,770
27637,210,160,160,160,160,0,850
27638,180,120,80,160,320,0,860
27639,210,120,120,80,0,0,530
27640,180,120,80,160,160,320,1020
27641,220,100,80,80,160,0,640
27642,200,120,40,80,160,0,600
27643,190,140,120,160,160,0,770
27644,220,120,80,80,0,0,500
27645,200,80,40,80,160,0,560
27646,200,140,120,80,0,0,540
27647,150,120,120,160,160,0,710
27648,210,160,120,80,160,0,730
27649,210,120,80,0,0,0,410
27650,170,100,80,80,160,0,590
27651,230,180,160,160,0,0,730
27652,210,120,40,0,0,0,370
27653,190,160,160,160,160,0,830
27654,180,100,80,0,0,0,360
27655,200,160,200,160,160,0,880
27656,210,100,160,160,160,0,790
27657,170,100,80,0,0,0,350
27658,170,100,160,160,160,0,750
27659,200,160,200,240,160,0,960
27660,220,60,0,0,0,0,280
27661,220,160,120,80,160,320,1060
27662,180,80,40,80,160,320,860
27663,230,140,120,0,0,0,490
27664,220,140,80,80,160,0,680
27665,180,100,80,160,160,0,680
27666,220,120,80,160,0,0,580
27667,190,180,80,80,0,0,530
27668,180,120,80,80,0,0,460
27669,170,120,80,80,0,0,450
27670,230,120,160,160,0,0,670
27671,200,100,0,0,0,0,300
27672,180,120,120,80,160,0,660
27673,210,120,120,160,160,0,770
27674,160,100,80,160,320,0,820
27675,250,120,120,160,160,0,810
27676,240,140,160,80,0,0,620
27677,180,120,160,160,0,0,620
27678,170,80,80,80,160,0,570
27679,190,120,120,0,0,0,430
27680,200,160,120,160,160,0,800
27681,210,80,40,0,0,0,330
27682,160,120,80,80,160,0,600
27683,200,160,160,160,320,320,1320
27684,170,120,80,80,0,0,450
27685,170,120,160,240,160,0,850
27686,220,120,120,160,0,0,620
27687,190,140,160,160,160,0,810
27688,190,120,200,160,320,0,990
27689,220,100,120,80,0,0,520
27690,180,120,120,80,160,320,980
27691,170,120,40,80,160,0,570
27692,200,140,80,160,0,0,580
27693,160,100,160,240,160,0,820
27694,230,220,120,240,160,0,970
27695,250,140,200,240,320,320,1470
27696,230,100,120,80,0,0,530
27697,190,100,160,80,0,0,530
27698,180,140,160,80,0,0,560
27699,180,160,160,80,160,0,740
27700,160,100,120,0,0,0,380
27701,170,100,120,80,0,0,470
27702,180,100,160,160,160,0,760
27703,200,120,80,80,160,0,640
27704,190,140,80,0,0,0,410
27705,190,100,80,80,160,0,610
27706,240,120,120,0,0,0,480
27707,180,100,80,0,0,0,360
27708,180,120,80,80,0,0,460
27709,220,80,80,80,0,0,460
27710,210,140,200,240,320,0,1110
27711,190,140,80,80,160,0,650
27712,260,180,120,80,0,0,640
27713,220,80,120,80,160,0,660
27714,150,140,120,80,0,0,490
27715,180,80,0,0,0,0,260
27716,200,80,80,160,160,0,680
27717,210,140,160,160,320,0,990
27718,220,140,160,240,320,0,1080
27719,140,60,80,0,0,0,280
27720,190,160,160,160,320,0,990
27721,190,120,80,0,0,0,390
27722,220,180,160,240,160,320,1280
27723,220,120,160,240,320,320,1380
27724,200,120,120,80,160,0,680
27725,180,100,40,80,160,0,560
27726,180,140,80,80,160,320,960
27727,210,160,80,80,0,0,530
27728,150,80,120,0,0,0,350
27729,190,180,80,80,0,0,530
27730,160,120,160,80,160,0,680
27731,250,160,160,80,160,0,810
27732,210,100,160,160,160,0,790
27733,220,100,80,80,160,0,640
27734,190,160,80,160,160,0,750
27735,220,120,0,0,0,0,340
27736,160,120,80,80,160,320,920
27737,190,100,80,0,0,0,370
27738,210,120,160,80,0,0,570
27739,220,160,200,160,160,320,1220
27740,220,120,80,80,160,0,660
27741,200,80,80,80,160,0,600
27742,210,120,80,80,0,0,490
27743,250,60,120,160,160,0,750
27744,200,120,80,80,0,0,480
27745,250,140,80,0,0,0,470
27746,240,120,120,0,0,0,480
27747,130,100,120,160,0,0,510
27748,180,160,160,240,160,0,900
27749,200,60,80,80,160,0,580
27750,200,120,160,80,160,320,1040
27751,190,120,200,240,320,0,1070
27752,180,120,80,160,160,0,700
27753,190,100,80,0,0,0,370
27754,170,120,120,80,160,0,650
27755,210,100,120,160,320,320,1230
27756,220,120,80,80,0,0,500
27757,240,180,160,80,0,0,660
27758,160,80,120,80,0,0,440
27759,200,100,160,160,160,0,780
27760,210,100,0,0,0,0,310
27761,210,40,40,0,0,0,290
27762,200,180,120,80,160,0,740
27763,150,80,80,80,160,0,550
27764,170,120,160,80,160,0,690
27765,190,120,160,80,0,0,550
27766,230,80,120,0,0,0,430
27767,190,80,80,80,160,0,590
27768,200,160,160,80,160,0,760
27769,240,160,160,160,0,0,720
27770,200,100,160,160,160,0,780
27771,190,140,80,80,0,0,490
27772,190,120,80,160,160,0,710
27773,160,100,120,0,0,0,380
27774,190,100,160,80,0,0,530
27775,200,60,120,80,0,0,460
27776,220,80,0,0,0,0,300
27777,200,100,40,0,0,0,340
27778,180,100,160,240,160,0,840
27779,150,140,80,160,160,0,690
27780,220,100,120,80,160,0,680
27781,240,160,160,80,160,0,800
27782,190,60,40,0,0,0,290
27783,170,100,120,80,160,0,630
27784,190,140,80,80,160,320,970
27785,190,100,120,80,0,0,490
27786,210,140,80,0,0,0,430
27787,230,160,120,160,320,0,990
27788,200,120,80,80,0,0,480
27789,220,160,160,0,0,0,540
27790,210,140,120,80,160,0,710
27791,210,160,200,160,160,0,890
27792,200,100,80,80,160,0,620
27793,190,180,240,160,160,320,1250
27794,240,140,40,0,0,0,420
27795,220,120,120,160,320,320,1260
27796,170,100,40,0,0,0,310
27797,190,80,40,0,0,0,310
27798,210,100,80,0,0,0,390
27799,240,120,160,240,160,0,920
27800,200,120,80,80,160,0,640
27801,210,80,80,160,160,0,690
27802,210,120,80,80,160,0,650
27803,190,140,160,160,160,320,1130
27804,210,120,160,80,160,0,730
27805,220,120,40,0,0,0,380
27806,210,140,120,160,160,0,790
27807,200,200,160,160,160,320,1200
27808,190,120,120,80,160,0,670
27809,170,40,40,80,0,0,330
27810,210,100,40,80,160,320,910
27811,160,140,120,160,0,0,580
27812,210,160,160,80,160,0,770
27813,180,120,80,80,0,0,460
27814,210,160,240,240,160,0,1010
27815,180,80,120,160,160,0,700
27816,140,100,40,80,0,0,360
27817,190,80,120,160,320,320,1190
27818,200,100,80,0,0,0,380
27819,230,180,200,240,320,320,1490
27820,140,120,80,160,160,0,660
27821,160,140,160,0,0,0,460
27822,200,100,80,0,0,0,380
27823,190,80,80,0,0,0,350
27824,190,120,0,0,0,0,310
27825,180,140,80,80,0,0,480
27826,160,160,120,80,0,0,520
27827,180,120,120,80,0,0,500
27828,190,120,80,80,160,0,630
27829,160,60,80,80,160,320,860
27830,210,160,120,160,320,320,1290
27831,190,120,160,80,0,0,550
27832,150,80,120,160,320,320,1150
27833,240,160,160,160,0,0,720
27834,220,100,200,160,160,0,840
27835,140,60,80,80,160,320,840
27836,170,100,40,80,0,0,390
27837,150,160,120,160,160,0,750
27838,230,140,160,240,320,0,1090
27839,200,40,0,0,0,0,240
27840,160,100,80,0,0,0,340
27841,180,40,40,80,0,0,340
27842,150,120,160,80,160,320,990
27843,210,160,120,0,0,0,490
27844,190,120,200,240,160,0,910
27845,180,120,120,160,160,0,740
27846,220,140,40,80,0,0,480
27847,200,120,80,0,0,0,400
27848,190,180,40,0,0,0,410
27849,210,120,120,80,0,0,530
27850,210,120,120,80,0,0,530
27851,200,160,80,80,160,0,680
27852,220,180,120,80,160,0,760
27853,170,120,40,80,160,320,890
27854,220,120,80,80,160,0,660
27855,230,160,160,80,0,0,630
27856,210,120,160,80,0,0,570
27857,210,160,120,160,160,0,810
27858,190,140,40,0,0,0,370
27859,180,120,40,80,0,0,420
27860,150,160,80,80,160,0,630
27861,210,140,160,0,0,0,510
27862,180,100,80,160,160,0,680
27863,180,160,40,0,0,0,380
27864,210,140,200,240,160,0,950
27865,240,160,120,160,160,0,840
27866,170,60,0,0,0,0,230
27867,200,220,160,160,0,0,740
27868,180,120,160,80,160,0,700
27869,270,160,160,160,0,0,750
27870,220,180,120,160,160,0,840
27871,190,100,160,0,0,0,450
27872,250,140,80,80,160,0,710
27873,200,120,160,160,320,0,960
27874,170,60,80,0,0,0,310
27875,230,140,120,80,0,0,570
27876,220,160,120,80,160,0,740
27877,180,100,80,80,0,0,440
27878,170,80,40,80,160,0,530
27879,160,140,40,80,0,0,420
27880,170,100,80,80,0,0,430
27881,170,100,80,0,0,0,350
27882,200,140,80,160,160,0,740
27883,210,200,120,80,160,320,1090
27884,210,120,160,160,160,0,810
27885,240,160,200,160,0,0,760
27886,180,100,160,80,160,0,680
27887,200,120,160,80,160,0,720
27888,170,120,120,0,0,0,410
27889,200,100,160,0,0,0,460
27890,170,60,40,0,0,0,270
27891,190,120,80,0,0,0,390
27892,190,100,160,240,160,0,850
27893,200,80,80,0,0,0,360
27894,180,100,40,0,0,0,320
27895,200,200,120,160,320,320,1320
27896,220,80,40,80,0,0,420
27897,210,160,120,80,0,0,570
27898,210,180,160,80,160,0,790
27899,230,100,40,80,0,0,450
27900,180,120,80,160,160,0,700
27901,240,140,80,80,160,0,700
27902,240,140,80,160,160,0,780
27903,190,100,40,0,0,0,330
27904,180,120,120,80,160,0,660
27905,190,120,80,160,0,0,550
27906,230,120,80,80,160,0,670
27907,200,100,200,160,160,0,820
27908,200,140,80,80,160,0,660
27909,190,140,120,80,0,0,530
27910,180,140,120,0,0,0,440
27911,250,120,80,80,160,0,690
27912,160,120,120,160,320,320,1200
27913,200,120,120,80,160,320,1000
27914,130,140,80,80,160,0,590
27915,200,140,80,80,160,320,980
27916,220,120,120,160,160,0,780
27917,200,160,120,160,160,0,800
27918,210,120,80,160,320,320,1210
27919,170,80,80,0,0,0,330
27920,220,160,160,160,160,0,860
27921,180,160,120,80,160,0,700
27922,200,140,120,160,160,0,780
27923,170,120,120,160,160,0,730
27924,190,160,200,240,320,0,1110
27925,200,140,160,80,0,0,580
27926,220,140,160,160,160,320,1160
27927,200,220,200,160,0,0,780
27928,180,120,160,160,320,320,1260
27929,180,100,120,80,160,0,640
27930,230,80,80,80,0,0,470
27931,180,100,120,160,160,320,1040
27932,200,100,80,160,160,0,700
27933,210,140,160,240,160,0,910
27934,210,140,40,0,0,0,390
27935,180,160,160,80,0,0,580
27936,210,200,200,160,320,0,1090
27937,220,120,160,240,320,0,1060
27938,180,160,120,80,160,0,700
27939,180,100,120,80,160,0,640
27940,220,120,160,160,160,0,820
27941,200,120,120,160,320,320,1240
27942,180,140,80,80,160,0,640
27943,190,160,120,160,160,0,790
27944,220,160,120,80,160,0,740
27945,200,160,160,160,320,0,1000
27946,170,140,120,80,0,0,510
27947,180,100,120,160,160,0,720
27948,180,160,120,160,0,0,620
27949,170,140,120,160,0,0,590
27950,220,120,120,80,0,0,540
27951,200,120,160,160,160,0,800
27952,160,120,80,80,0,0,440
27953,210,120,40,0,0,0,370
27954,160,120,120,160,160,0,720
27955,190,160,200,160,160,0,870
27956,190,100,80,160,0,0,530
27957,220,80,40,0,0,0,340
27958,210,140,120,160,320,0,950
27959,220,140,80,80,160,0,680
27960,230,60,80,80,160,0,610
27961,180,100,40,80,160,0,560
27962,200,100,40,80,160,0,580
27963,200,180,40,0,0,0,420
27964,220,140,120,160,160,0,800
27965,190,120,160,80,160,320,1030
27966,200,160,80,80,0,0,520
27967,190,100,80,80,0,0,450
27968,210,100,80,80,160,0,630
27969,230,160,120,160,160,0,830
27970,170,120,160,80,160,0,690
27971,200,80,80,80,160,0,600
27972,180,100,120,160,320,0,880
27973,210,100,80,80,160,0,630
27974,170,160,160,160,320,320,1290
27975,210,100,80,80,160,0,630
27976,210,80,40,0,0,0,330
27977,160,160,160,160,0,0,640
27978,170,100,160,160,320,320,1230
27979,190,120,120,80,0,0,510
27980,210,100,40,80,160,0,590
27981,220,100,80,0,0,0,400
27982,220,120,160,160,0,0,660
27983,200,100,80,0,0,0,380
27984,180,100,40,0,0,0,320
27985,180,120,80,80,160,0,620
27986,170,120,120,80,0,0,490
27987,170,180,120,0,0,0,470
27988,190,140,160,80,160,0,730
27989,180,140,160,160,160,320,1120
27990,220,160,80,80,160,0,700
27991,240,180,160,160,160,320,1220
27992,230,200,120,160,160,0,870
27993,210,140,80,80,160,0,670
27994,160,140,80,0,0,0,380
27995,230,80,40,80,160,320,910
27996,190,80,80,80,0,0,430
27997,230,140,120,80,160,0,730
27998,220,140,120,80,0,0,560
27999,200,80,0,0,0,0,280
28000,140,140,160,160,320,320,1240
28001,180,100,80,80,0,0,440
28002,200,80,80,80,0,0,440
28003,210,120,80,80,0,0,490
28004,200,160,120,160,160,0,800
28005,190,140,160,160,320,0,970
28006,190,60,120,160,320,0,850
28007,190,100,80,80,160,0,610
28008,210,80,40,80,160,0,570
28009,130,120,120,80,160,0,610
28010,250,80,80,80,160,0,650
28011,180,120,120,160,320,320,1220
28012,220,140,160,80,160,0,760
28013,170,140,160,240,320,0,1030
28014,200,80,120,160,0,0,560
28015,180,140,120,80,0,0,520
28016,190,100,40,80,160,320,890
28017,160,100,80,80,160,320,900
28018,210,100,120,160,160,0,750
28019,180,120,120,160,320,320,1220
28020,220,80,120,160,160,0,740
28021,170,40,40,0,0,0,250
28022,230,160,80,0,0,0,470
28023,210,80,80,80,160,0,610
28024,200,100,80,80,160,0,620
28025,190,120,120,80,160,0,670
28026,220,100,40,0,0,0,360
28027,200,140,80,80,160,0,660
28028,200,100,120,80,160,0,660
28029,190,100,80,0,0,0,370
28030,190,160,160,160,0,0,670
28031,180,160,200,240,160,0,940
28032,210,80,80,80,160,320,930
28033,230,140,120,80,0,0,570
28034,180,120,80,80,160,0,620
28035,200,160,160,160,320,0,1000
28036,210,100,80,160,160,320,1030
28037,160,100,120,160,320,320,1180
28038,240,160,160,80,160,320,1120
28039,170,100,160,160,160,0,750
28040,190,80,40,0,0,0,310
28041,170,120,120,0,0,0,410
28042,230,140,40,0,0,0,410
28043,230,180,120,240,160,0,930
28044,180,80,40,80,0,0,380
28045,220,140,80,160,160,0,760
28046,190,120,80,0,0,0,390
28047,160,60,40,0,0,0,260
28048,160,140,40,80,0,0,420
28049,190,140,40,0,0,0,370
28050,220,180,80,80,160,0,720
28051,260,180,120,80,160,0,800
28052,210,180,160,160,320,0,1030
28053,180,140,160,160,320,320,1280
28054,210,100,80,0,0,0,390
28055,160,80,120,80,160,0,600
28056,210,140,120,80,160,0,710
28057,190,120,120,80,160,0,670
28058,180,100,80,80,160,0,600
28059,180,80,80,80,160,0,580
28060,170,160,40,0,0,0,370
28061,180,40,80,0,0,0,300
28062,240,120,120,160,0,0,640
28063,210,140,120,80,160,320,1030
28064,190,120,80,160,160,320,1030
28065,240,180,160,80,160,0,820
28066,230,140,120,80,0,0,570
28067,200,100,120,160,160,0,740
28068,210,100,40,80,160,320,910
28069,200,180,160,0,0,0,540
28070,210,160,200,160,160,0,890
28071,180,80,80,160,320,0,820
28072,220,140,80,80,0,0,520
28073,230,100,80,0,0,0,410
28074,200,200,120,80,160,320,1080
28075,160,100,40,80,160,0,540
28076,210,200,120,80,0,0,610
28077,190,140,160,160,320,0,970
28078,160,80,40,80,0,0,360
28079,210,100,40,0,0,0,350
28080,180,60,80,160,320,320,1120
28081,160,140,80,0,0,0,380
28082,190,200,160,80,160,0,790
28083,190,140,120,80,0,0,530
28084,150,100,120,160,320,0,850
28085,200,120,120,0,0,0,440
28086,220,100,120,0,0,0,440
28087,220,160,120,160,0,0,660
28088,210,160,40,0,0,0,410
28089,220,160,160,160,160,0,860
28090,210,120,80,0,0,0,410
28091,200,140,80,80,0,0,500
28092,230,100,120,80,160,0,690
28093,170,100,160,160,160,0,750
28094,180,120,80,0,0,0,380
28095,230,140,80,0,0,0,450
28096,230,100,80,80,160,0,650
28097,170,100,40,80,0,0,390
28098,150,100,40,0,0,0,290
28099,180,120,160,160,160,320,1100
28100,210,160,80,160,160,320,1090
28101,210,100,80,0,0,0,390
28102,220,120,80,160,320,320,1220
28103,210,140,160,80,0,0,590
28104,230,140,160,80,0,0,610
28105,230,80,0,0,0,0,310
28106,200,80,80,160,160,0,680
28107,190,80,120,160,160,0,710
28108,210,140,160,160,160,0,830
28109,250,140,120,160,160,0,830
28110,200,80,80,80,160,0,600
28111,210,80,120,80,0,0,490
28112,180,100,0,0,0,0,280
28113,190,120,120,160,0,0,590
28114,240,120,40,80,160,0,640
28115,230,140,40,0,0,0,410
28116,180,80,40,80,0,0,380
28117,190,140,160,160,160,0,810
28118,160,100,120,160,160,0,700
28119,200,160,120,160,0,0,640
28120,230,100,120,240,0,0,690
28121,180,80,80,160,160,0,660
28122,200,160,120,160,160,0,800
28123,170,120,80,80,160,0,610
28124,190,140,160,80,0,0,570
28125,240,100,120,160,320,0,940
28126,240,140,120,80,160,0,740
28127,210,120,160,160,160,0,810
28128,210,160,120,80,160,0,730
28129,200,100,80,80,160,0,620
28130,180,120,120,80,0,0,500
28131,190,160,80,80,160,0,670
28132,210,140,120,80,0,0,550
28133,220,80,80,0,0,0,380
28134,160,140,80,80,160,0,620
28135,150,160,120,240,160,0,830
28136,170,100,80,80,160,320,910
28137,200,180,160,80,0,0,620
28138,220,160,240,240,0,0,860
28139,200,120,120,160,320,0,920
28140,210,160,120,80,160,320,1050
28141,180,80,160,160,160,0,740
28142,200,100,80,0,0,0,380
28143,210,180,200,80,160,0,830
28144,190,80,40,80,0,0,390
28145,160,80,120,0,0,0,360
28146,170,120,80,160,160,0,690
28147,260,100,80,80,0,0,520
28148,180,140,160,240,320,0,1040
28149,190,120,120,160,160,0,750
28150,180,120,120,160,320,0,900
28151,180,160,160,160,160,0,820
28152,170,120,80,80,160,0,610
28153,140,80,80,80,160,320,860
28154,200,160,200,160,320,0,1040
28155,200,140,120,80,160,0,700
28156,250,80,80,80,0,0,490
28157,200,120,160,160,0,0,640
28158,240,120,120,160,0,0,640
28159,170,100,120,160,320,0,870
28160,220,100,120,80,0,0,520
28161,210,160,80,160,160,320,1090
28162,170,120,40,80,160,0,570
28163,140,60,120,80,160,0,560
28164,180,100,40,0,0,0,320
28165,220,160,80,0,0,0,460
28166,170,100,40,80,160,0,550
28167,190,220,200,160,160,0,930
28168,170,160,160,80,160,0,730
28169,190,200,200,160,320,0,1070
28170,240,160,120,160,160,0,840
28171,170,140,120,80,160,0,670
28172,180,40,0,0,0,0,220
28173,190,120,80,160,320,0,870
28174,160,100,160,0,0,0,420
28175,250,180,80,160,160,0,830
28176,200,60,40,80,0,0,380
28177,200,180,160,80,160,320,1100
28178,200,120,120,80,0,0,520
28179,170,80,160,160,160,320,1050
28180,140,100,0,0,0,0,240
28181,190,100,120,160,160,0,730
28182,190,140,120,80,160,0,690
28183,180,160,160,80,0,0,580
28184,220,180,120,160,160,0,840
28185,200,100,80,80,160,320,940
28186,180,100,120,80,160,0,640
28187,190,120,80,160,320,0,870
28188,210,80,120,80,160,0,650
28189,220,100,80,80,0,0,480
28190,220,140,160,80,0,0,600
28191,210,120,80,80,0,0,490
28192,160,140,200,240,320,0,1060
28193,210,140,80,0,0,0,430
28194,210,160,80,0,0,0,450
28195,160,80,40,0,0,0,280
28196,170,180,200,160,160,320,1190
28197,220,100,80,160,320,0,880
28198,220,160,80,0,0,0,460
28199,190,100,120,80,160,0,650
28200,220,140,40,80,0,0,480
28201,200,100,120,240,320,0,980
28202,200,160,80,160,0,0,600
28203,220,100,40,0,0,0,360
28204,170,120,120,160,160,0,730
28205,200,100,80,80,0,0,460
28206,230,160,200,0,0,0,590
28207,220,140,120,80,160,0,720
28208,160,100,40,0,0,0,300
28209,210,120,120,80,160,320,1010
28210,230,160,160,160,160,0,870
28211,200,120,120,0,0,0,440
28212,220,100,120,160,160,0,760
28213,200,160,120,160,0,0,640
28214,190,80,40,80,160,320,870
28215,170,140,120,80,0,0,510
28216,210,100,80,80,0,0,470
28217,200,100,80,0,0,0,380
28218,220,140,120,240,160,0,880
28219,220,140,40,80,0,0,480
28220,210,160,120,0,0,0,490
28221,230,160,200,240,160,320,1310
28222,190,140,160,320,160,0,970
28223,190,160,160,80,0,0,590
28224,210,120,80,160,0,0,570
28225,180,120,160,80,0,0,540
28226,190,100,80,0,0,0,370
28227,220,140,200,160,320,0,1040
28228,260,160,120,0,0,0,540
28229,180,160,120,160,160,0,780
28230,230,160,160,240,160,0,950
28231,150,100,80,160,320,320,1130
28232,200,120,40,80,160,320,920
28233,190,60,80,160,160,0,650
28234,210,60,80,0,0,0,350
28235,170,120,80,0,0,0,370
28236,190,80,120,80,0,0,470
28237,190,160,120,0,0,0,470
28238,210,120,120,160,160,0,770
28239,200,80,80,160,160,0,680
28240,200,140,80,0,0,0,420
28241,220,160,120,160,0,0,660
28242,200,160,160,160,160,0,840
28243,180,80,120,160,320,0,860
28244,190,160,160,80,160,320,1070
28245,240,180,80,80,160,320,1060
28246,240,160,40,80,160,0,680
28247,190,100,120,80,160,0,650
28248,190,160,120,80,160,0,710
28249,170,140,200,160,0,0,670
28250,190,140,80,80,160,0,650
28251,210,160,80,160,0,0,610
28252,200,100,80,160,160,0,700
28253,150,100,160,160,0,0,570
28254,220,100,120,80,160,0,680
28255,190,100,80,80,160,0,610
28256,200,140,80,80,160,0,660
28257,220,100,80,80,160,0,640
28258,220,120,160,160,160,0,820
28259,200,120,80,80,0,0,480
28260,180,140,80,80,0,0,480
28261,180,120,120,160,0,0,580
28262,220,120,200,160,160,0,860
28263,210,120,80,160,160,0,730
28264,220,100,120,160,160,0,760
28265,200,140,40,80,160,0,620
28266,190,120,120,160,160,320,1070
28267,230,120,80,160,320,0,910
28268,220,200,240,160,320,0,1140
28269,180,120,120,80,0,0,500
28270,180,140,120,240,160,0,840
28271,180,100,120,80,160,0,640
28272,170,140,80,0,0,0,390
28273,190,140,120,160,320,320,1250
28274,230,180,160,0,0,0,570
28275,210,80,0,0,0,0,290
28276,180,120,120,160,0,0,580
28277,180,120,120,160,320,0,900
28278,170,140,120,80,0,0,510
28279,180,100,160,240,160,320,1160
28280,180,100,160,160,160,0,760
28281,230,100,0,0,0,0,330
28282,170,80,120,0,0,0,370
28283,200,120,40,80,160,0,600
28284,190,120,160,160,160,320,1110
28285,210,140,120,160,160,0,790
28286,190,120,120,160,160,0,750
28287,190,160,80,80,160,0,670
28288,220,120,80,80,0,0,500
28289,220,120,120,0,0,0,460
28290,150,100,40,80,160,0,530
28291,190,80,0,0,0,0,270
28292,210,80,80,0,0,0,370
28293,180,100,80,80,160,0,600
28294,170,140,120,80,160,0,670
28295,200,160,120,80,160,0,720
28296,180,100,80,0,0,0,360
28297,210,80,80,160,160,0,690
28298,140,120,160,160,160,320,1060
28299,180,120,40,80,160,0,580
28300,200,80,80,80,160,0,600
28301,170,100,120,160,320,0,870
28302,210,100,160,0,0,0,470
28303,180,120,40,0,0,0,340
28304,180,180,120,0,0,0,480
28305,210,120,120,80,0,0,530
28306,170,120,120,80,0,0,490
28307,190,120,160,160,160,0,790
28308,180,80,80,160,160,0,660
28309,190,60,80,80,0,0,410
28310,210,180,200,160,0,0,750
28311,200,140,120,80,160,0,700
28312,200,120,40,0,0,0,360
28313,200,100,120,160,160,0,740
28314,230,120,40,80,0,0,470
28315,180,140,120,160,0,0,600
28316,170,60,0,0,0,0,230
28317,230,80,40,0,0,0,350
28318,220,160,120,80,0,0,580
28319,250,160,160,160,160,0,890
28320,230,180,120,80,160,0,770
28321,220,140,40,80,160,0,640
28322,180,140,160,80,160,0,720
28323,230,140,160,160,160,0,850
28324,170,80,40,0,0,0,290
28325,190,120,120,160,160,0,750
28326,210,80,160,160,160,0,770
28327,210,140,80,0,0,0,430
28328,240,140,160,80,160,0,780
28329,190,80,120,160,0,0,550
28330,190,100,120,80,0,0,490
28331,160,100,80,80,0,0,420
28332,200,120,160,160,160,320,1120
28333,200,180,120,160,320,320,1300
28334,240,120,120,80,0,0,560
28335,220,80,40,0,0,0,340
28336,210,140,160,240,0,0,750
28337,190,120,80,80,0,0,470
28338,220,80,0,0,0,0,300
28339,190,100,120,160,160,0,730
28340,220,120,80,80,0,0,500
28341,220,80,120,160,160,0,740
28342,220,160,200,240,320,0,1140
28343,210,140,120,80,160,320,1030
28344,200,180,160,160,0,0,700
28345,180,40,40,80,160,0,500
28346,180,140,200,320,160,0,1000
28347,190,120,120,160,160,0,750
28348,210,160,160,160,160,0,850
28349,160,120,80,160,160,320,1000
28350,170,100,80,160,160,320,990
28351,200,60,80,0,0,0,340
28352,210,120,80,80,160,0,650
28353,240,80,40,0,0,0,360
28354,160,100,40,80,160,0,540
28355,210,180,80,80,0,0,550
28356,190,140,160,160,320,320,1290
28357,180,120,80,80,0,0,460
28358,250,120,160,160,160,0,850
28359,210,100,40,0,0,0,350
28360,230,180,40,0,0,0,450
28361,190,140,160,160,320,320,1290
28362,180,100,80,80,160,0,600
28363,200,80,80,80,0,0,440
28364,210,100,80,0,0,0,390
28365,190,100,120,160,0,0,570
28366,180,120,160,160,160,0,780
28367,170,100,40,80,160,0,550
28368,200,140,120,240,320,0,1020
28369,170,160,80,80,0,0,490
28370,210,100,120,80,160,320,990
28371,200,120,120,80,0,0,520
28372,210,120,120,160,320,0,930
28373,180,80,80,0,0,0,340
28374,190,180,200,80,0,0,650
28375,210,120,120,80,160,320,1010
28376,210,100,80,80,0,0,470
28377,240,140,120,160,320,0,980
28378,220,140,160,160,0,0,680
28379,180,80,160,160,0,0,580
28380,210,100,80,80,160,0,630
28381,210,140,160,160,160,0,830
28382,190,80,80,160,160,320,990
28383,230,140,80,0,0,0,450
28384,180,140,80,80,0,0,480
28385,210,140,120,80,0,0,550
28386,200,140,80,80,160,0,660
28387,230,200,160,160,160,0,910
28388,160,100,80,80,160,0,580
28389,220,120,120,80,0,0,540
28390,190,120,120,160,0,0,590
28391,220,200,200,160,160,0,940
28392,200,220,160,80,0,0,660
28393,180,120,80,80,160,0,620
28394,210,140,40,80,0,0,470
28395,200,120,120,0,0,0,440
28396,230,100,80,80,160,0,650
28397,190,160,120,160,160,320,1110
28398,220,120,120,160,320,0,940
28399,180,80,0,0,0,0,260
28400,220,120,80,0,0,0,420
28401,190,140,120,80,160,0,690
28402,190,140,40,0,0,0,370
28403,180,80,120,160,0,0,540
28404,190,120,120,80,160,0,670
28405,210,100,40,0,0,0,350
28406,200,140,80,0,0,0,420
28407,240,180,160,160,160,320,1220
28408,190,120,40,80,160,0,590
28409,180,100,120,80,0,0,480
28410,160,100,120,80,160,0,620
28411,190,100,160,160,0,0,610
28412,200,100,120,240,160,0,820
28413,230,100,40,0,0,0,370
28414,190,140,120,240,320,0,1010
28415,180,120,40,80,160,320,900
28416,170,120,120,0,0,0,410
28417,180,120,160,80,0,0,540
28418,180,80,40,0,0,0,300
28419,160,120,160,160,160,320,1080
28420,160,120,80,0,0,0,360
28421,170,100,80,160,160,0,670
28422,160,100,120,160,320,0,860
28423,190,160,200,80,0,0,630
28424,210,180,160,160,320,0,1030
28425,190,160,120,240,160,0,870
28426,210,120,80,80,0,0,490
28427,190,120,40,80,160,0,590
28428,180,140,120,160,160,0,760
28429,220,120,80,80,0,0,500
28430,200,80,80,80,160,0,600
28431,210,120,80,80,0,0,490
28432,190,120,80,160,0,0,550
28433,230,140,160,160,320,0,1010
28434,210,140,160,80,160,0,750
28435,190,120,120,160,320,320,1230
28436,200,160,160,80,160,320,1080
28437,230,120,120,0,0,0,470
28438,180,140,120,160,320,0,920
28439,210,160,160,160,0,0,690
28440,210,160,200,160,160,0,890
28441,180,120,80,0,0,0,380
28442,200,100,80,160,0,0,540
28443,190,80,80,160,160,0,670
28444,190,80,80,80,160,0,590
28445,180,120,120,160,160,320,1060
28446,220,160,120,160,160,0,820
28447,210,120,80,160,320,320,1210
28448,190,80,80,160,0,0,510
28449,220,160,160,160,320,0,1020
28450,180,140,80,160,320,320,1200
28451,190,140,120,240,160,320,1170
28452,180,100,160,240,160,0,840
28453,150,120,160,80,0,0,510
28454,200,40,40,0,0,0,280
28455,200,80,80,0,0,0,360
28456,190,60,40,80,160,0,530
28457,180,80,120,240,160,0,780
28458,220,180,120,80,0,0,600
28459,180,100,80,0,0,0,360
28460,180,140,80,0,0,0,400
28461,190,160,80,80,160,0,670
28462,200,120,80,80,160,0,640
28463,180,80,80,80,160,320,900
28464,220,100,120,80,160,320,1000
28465,210,120,120,160,160,320,1090
28466,150,80,120,160,0,0,510
28467,220,180,240,240,160,0,1040
28468,170,120,40,0,0,0,330
28469,220,100,80,80,0,0,480
28470,210,120,120,80,160,0,690
28471,170,120,120,80,0,0,490
28472,180,120,80,0,0,0,380
28473,210,140,120,80,160,0,710
28474,180,80,40,0,0,0,300
28475,200,120,80,80,0,0,480
28476,210,100,120,80,0,0,510
28477,210,140,120,160,160,0,790
28478,190,100,80,160,160,0,690
28479,250,200,120,160,0,0,730
28480,220,180,200,160,0,0,760
28481,190,100,120,160,0,0,570
28482,180,140,160,160,320,320,1280
28483,230,140,120,80,0,0,570
28484,190,160,160,80,0,0,590
28485,200,100,80,0,0,0,380
28486,190,140,160,80,0,0,570
28487,190,120,160,0,0,0,470
28488,160,100,80,160,160,0,660
28489,210,120,80,80,160,0,650
28490,190,180,160,160,160,0,850
28491,170,120,80,160,160,320,1010
28492,230,120,160,80,0,0,590
28493,210,200,200,80,160,320,1170
28494,220,120,80,80,160,0,660
28495,170,100,120,80,160,0,630
28496,190,60,80,160,0,0,490
28497,130,60,80,0,0,0,270
28498,210,160,120,160,320,0,970
28499,180,80,120,80,160,320,940
28500,160,140,80,0,0,0,380
28501,180,120,80,80,160,0,620
28502,190,140,160,240,160,0,890
28503,260,120,160,160,320,320,1340
28504,200,120,160,160,0,0,640
28505,180,140,160,80,0,0,560
28506,170,120,80,160,320,0,850
28507,230,140,120,160,160,0,810
28508,170,100,80,80,160,0,590
28509,230,140,120,240,320,320,1370
28510,190,100,80,80,160,0,610
28511,190,140,160,240,0,0,730
28512,150,100,120,0,0,0,370
28513,240,180,200,80,0,0,700
28514,230,80,40,0,0,0,350
28515,190,140,120,80,160,0,690
28516,190,160,80,80,0,0,510
28517,180,80,40,0,0,0,300
28518,240,120,80,160,320,320,1240
28519,180,140,160,160,160,320,1120
28520,180,120,120,80,160,320,980
28521,240,120,80,0,0,0,440
28522,210,120,80,80,160,320,970
28523,200,120,120,160,0,0,600
28524,230,160,120,0,0,0,510
28525,230,120,80,80,160,0,670
28526,210,100,120,240,160,320,1150
28527,200,120,80,160,0,0,560
28528,200,140,120,80,160,0,700
28529,230,80,120,160,160,0,750
28530,160,100,80,160,320,0,820
28531,240,160,160,80,160,0,800
28532,160,120,40,0,0,0,320
28533,230,140,120,160,320,320,1290
28534,190,140,80,0,0,0,410
28535,200,140,160,80,160,0,740
28536,220,140,80,80,0,0,520
28537,190,180,160,80,160,0,770
28538,230,80,0,0,0,0,310
28539,160,100,200,160,160,0,780
28540,210,100,80,0,0,0,390
28541,210,160,120,160,0,0,650
28542,230,180,80,80,0,0,570
28543,240,60,40,80,160,0,580
28544,170,120,160,160,320,0,930
28545,210,160,120,80,160,320,1050
28546,190,140,120,80,160,320,1010
28547,190,100,160,160,0,0,610
28548,200,120,160,160,160,320,1120
28549,210,120,160,160,160,0,810
28550,220,100,80,80,160,320,960
28551,210,200,200,160,320,0,1090
28552,180,100,120,160,320,0,880
28553,210,180,160,80,160,320,1110
28554,160,120,80,80,160,0,600
28555,200,160,160,160,160,0,840
28556,210,60,80,0,0,0,350
28557,200,80,80,80,0,0,440
28558,220,140,80,80,160,0,680
28559,210,140,80,80,160,0,670
28560,210,140,120,80,160,320,1030
28561,210,140,120,80,0,0,550
28562,210,140,160,80,160,320,1070
28563,160,140,120,160,160,0,740
28564,210,100,160,160,160,0,790
28565,190,100,80,160,320,0,850
28566,230,100,80,80,160,0,650
28567,230,80,0,0,0,0,310
28568,200,100,80,80,160,0,620
28569,200,100,160,80,0,0,540
28570,210,100,120,240,320,0,990
28571,240,120,80,80,160,0,680
28572,230,160,80,0,0,0,470
28573,180,140,200,240,160,0,920
28574,230,80,120,80,160,0,670
28575,190,80,40,0,0,0,310
28576,200,140,80,80,160,0,660
28577,190,120,120,0,0,0,430
28578,240,180,160,240,320,0,1140
28579,180,100,80,0,0,0,360
28580,180,80,120,80,160,0,620
28581,200,100,160,240,160,0,860
28582,190,120,160,80,160,320,1030
28583,210,160,80,80,160,0,690
28584,170,80,0,0,0,0,250
28585,140,100,80,80,160,0,560
28586,210,180,120,160,320,0,990
28587,170,140,200,160,160,0,830
28588,200,120,40,80,160,0,600
28589,190,120,160,80,0,0,550
28590,210,140,120,80,160,0,710
28591,200,120,80,160,320,0,880
28592,190,140,40,80,160,0,610
28593,190,140,160,160,160,0,810
28594,220,60,40,0,0,0,320
28595,190,140,80,80,160,0,650
28596,210,200,80,80,0,0,570
28597,220,120,40,80,160,0,620
28598,240,120,120,80,0,0,560
28599,200,140,80,80,0,0,500
28600,190,160,160,160,0,0,670
28601,180,160,120,160,0,0,620
28602,190,120,80,80,160,0,630
28603,210,160,120,80,160,0,730
28604,190,140,80,0,0,0,410
28605,200,160,200,160,320,320,1360
28606,200,120,120,80,160,0,680
28607,180,100,80,80,160,320,920
28608,230,100,80,80,160,0,650
28609,200,160,160,80,0,0,600
28610,160,100,80,160,160,0,660
28611,220,140,120,160,0,0,640
28612,200,80,40,0,0,0,320
28613,210,100,40,80,0,0,430
28614,220,200,160,80,160,0,820
28615,250,120,80,0,0,0,450
28616,170,140,120,160,0,0,590
28617,170,80,40,80,0,0,370
28618,180,160,200,160,0,0,700
28619,170,120,40,0,0,0,330
28620,190,140,80,80,160,0,650
28621,220,160,160,80,160,0,780
28622,220,60,80,80,160,0,600
28623,220,160,160,80,0,0,620
28624,200,180,200,240,160,0,980
28625,190,160,120,80,0,0,550
28626,210,180,120,80,160,0,750
28627,180,100,80,80,160,0,600
28628,210,140,120,80,160,0,710
28629,180,100,80,80,0,0,440
28630,210,80,40,80,160,0,570
28631,190,140,120,160,320,0,930
28632,210,140,120,80,160,0,710
28633,180,80,40,0,0,0,300
28634,200,120,40,0,0,0,360
28635,170,140,120,160,160,0,750
28636,170,100,160,80,0,0,510
28637,210,120,80,80,160,0,650
28638,210,100,80,0,0,0,390
28639,230,120,80,80,0,0,510
28640,190,140,120,0,0,0,450
28641,160,60,80,160,160,320,940
28642,190,160,160,160,160,0,830
28643,190,80,120,160,160,0,710
28644,180,80,80,0,0,0,340
28645,210,120,160,160,160,0,810
28646,190,100,120,160,0,0,570
28647,220,80,80,80,160,320,940
28648,190,120,120,0,0,0,430
28649,180,120,80,160,320,0,860
28650,180,140,80,80,160,0,640
28651,220,100,120,160,320,320,1240
28652,240,200,200,160,160,320,1280
28653,220,120,80,0,0,0,420
28654,200,100,40,0,0,0,340
28655,200,160,120,80,160,0,720
28656,160,140,160,80,160,0,700
28657,210,100,160,80,160,320,1030
28658,200,80,80,80,160,0,600
28659,210,140,120,160,160,0,790
28660,150,80,80,0,0,0,310
28661,170,100,120,240,320,320,1270
28662,230,120,120,80,160,0,710
28663,150,100,120,160,160,0,690
28664,200,180,160,80,160,0,780
28665,210,140,40,80,160,0,630
28666,230,100,40,0,0,0,370
28667,200,140,120,160,160,0,780
28668,180,60,40,0,0,0,280
28669,200,80,80,80,160,0,600
28670,150,80,80,80,160,0,550
28671,200,140,160,160,160,0,820
28672,190,140,160,160,160,0,810
28673,190,160,160,160,160,0,830
28674,200,140,120,160,160,0,780
28675,210,140,80,160,320,320,1230
28676,230,180,40,80,160,0,690
28677,230,100,80,80,160,0,650
28678,180,120,80,80,0,0,460
28679,230,120,40,80,0,0,470
28680,180,120,160,160,320,320,1260
28681,220,180,120,160,320,0,1000
28682,230,160,200,240,0,0,830
28683,190,100,80,0,0,0,370
28684,200,40,40,80,160,0,520
28685,210,100,80,160,160,320,1030
28686,210,140,120,160,160,0,790
28687,200,180,120,160,160,320,1140
28688,190,80,40,80,0,0,390
28689,220,140,240,160,0,0,760
28690,210,140,120,160,320,0,950
28691,210,100,80,80,160,0,630
28692,200,120,80,160,320,320,1200
28693,220,160,120,80,160,0,740
28694,210,80,40,0,0,0,330
28695,210,120,40,0,0,0,370
28696,180,140,80,0,0,0,400
28697,230,140,160,160,160,320,1170
28698,210,120,80,80,160,0,650
28699,180,140,40,0,0,0,360
28700,190,120,80,160,320,0,870
28701,230,120,120,160,160,0,790
28702,210,140,160,160,160,0,830
28703,200,140,120,240,160,0,860
28704,190,140,120,80,160,0,690
28705,230,100,80,80,160,0,650
28706,190,140,120,160,160,0,770
28707,190,120,80,0,0,0,390
28708,170,140,120,80,160,0,670
28709,160,100,80,160,0,0,500
28710,170,120,40,80,160,0,570
28711,210,120,80,80,160,0,650
28712,200,180,160,160,0,0,700
28713,190,180,200,160,320,0,1050
28714,190,140,160,80,0,0,570
28715,190,140,160,160,160,0,810
28716,220,140,80,80,160,0,680
28717,180,100,160,160,160,0,760
28718,220,180,200,240,320,0,1160
28719,200,100,120,80,160,0,660
28720,200,140,160,160,160,0,820
28721,190,120,80,0,0,0,390
28722,200,160,160,80,0,0,600
28723,250,120,120,0,0,0,490
28724,200,120,160,160,0,0,640
28725,190,140,40,80,0,0,450
28726,250,120,80,80,160,0,690
28727,210,140,80,80,160,0,670
28728,220,180,40,0,0,0,440
28729,200,100,200,160,160,0,820
28730,170,100,120,80,160,0,630
28731,200,100,80,0,0,0,380
28732,230,140,120,160,160,0,810
28733,230,100,120,80,0,0,530
28734,210,120,160,240,160,320,1210
28735,170,60,120,80,160,320,910
28736,210,140,160,160,320,0,990
28737,210,80,80,0,0,0,370
28738,240,120,200,160,160,320,1200
28739,210,140,40,80,160,0,630
28740,210,60,0,0,0,0,270
28741,210,120,80,80,160,0,650
28742,150,120,80,160,160,320,990
28743,240,140,80,80,160,0,700
28744,190,120,160,160,160,320,1110
28745,210,100,120,80,160,320,990
28746,150,100,120,80,0,0,450
28747,220,80,120,160,0,0,580
28748,190,120,120,160,160,0,750
28749,240,120,160,160,0,0,680
28750,150,80,120,0,0,0,350
28751,200,160,160,0,0,0,520
28752,170,80,80,80,160,0,570
28753,200,80,80,80,0,0,440
28754,230,80,80,160,320,0,870
28755,200,120,160,160,160,0,800
28756,180,80,80,80,0,0,420
28757,220,140,120,80,160,0,720
28758,180,100,120,80,0,0,480
28759,220,80,120,0,0,0,420
28760,170,120,80,0,0,0,370
28761,140,100,80,0,0,0,320
28762,220,220,120,80,0,0,640
28763,150,100,120,80,0,0,450
28764,230,100,160,80,160,320,1050
28765,240,80,120,0,0,0,440
28766,180,100,160,160,0,0,600
28767,220,100,120,160,160,320,1080
28768,200,120,80,80,0,0,480
28769,240,80,40,80,0,0,440
28770,220,100,80,0,0,0,400
28771,200,160,120,0,0,0,480
28772,190,120,40,80,160,0,590
28773,220,140,80,0,0,0,440
28774,170,140,160,80,0,0,550
28775,200,160,120,240,320,320,1360
28776,190,160,200,160,160,0,870
28777,220,120,120,80,0,0,540
28778,170,100,80,0,0,0,350
28779,170,120,80,80,0,0,450
28780,150,160,80,0,0,0,390
28781,230,160,80,80,160,320,1030
28782,200,140,120,80,160,320,1020
28783,190,120,80,0,0,0,390
28784,210,180,160,80,0,0,630
28785,170,140,120,160,160,0,750
28786,200,120,160,160,160,0,800
28787,180,100,160,80,160,0,680
28788,180,120,80,80,0,0,460
28789,160,80,40,0,0,0,280
28790,210,100,120,160,320,0,910
28791,200,80,0,0,0,0,280
28792,210,120,200,160,0,0,690
28793,180,140,160,160,160,0,800
28794,160,100,120,160,0,0,540
28795,130,80,80,0,0,0,290
28796,220,160,120,80,0,0,580
28797,170,120,160,80,0,0,530
28798,230,120,80,0,0,0,430
28799,220,60,80,0,0,0,360
28800,180,120,40,80,160,0,580
28801,170,60,120,240,320,0,910
28802,240,100,80,80,160,320,980
28803,150,120,40,0,0,0,310
28804,210,120,80,160,0,0,570
28805,170,60,40,80,160,320,830
28806,200,100,80,160,320,0,860
28807,200,100,40,0,0,0,340
28808,190,80,80,80,0,0,430
28809,160,140,120,0,0,0,420
28810,200,160,120,80,0,0,560
28811,140,100,120,160,160,0,680
28812,200,60,120,160,160,0,700
28813,180,100,160,160,0,0,600
28814,220,120,160,160,160,0,820
28815,210,120,80,0,0,0,410
28816,170,100,120,80,160,0,630
28817,200,140,200,240,160,0,940
28818,130,60,120,80,160,0,550
28819,220,160,120,80,160,0,740
28820,200,140,160,160,160,0,820
28821,150,120,120,240,320,0,950
28822,210,120,160,80,0,0,570
28823,200,100,40,0,0,0,340
28824,190,100,120,160,160,320,1050
28825,150,140,120,80,160,0,650
28826,170,120,80,80,160,0,610
28827,230,140,80,80,0,0,530
28828,240,140,120,80,0,0,580
28829,240,180,120,0,0,0,540
28830,180,80,80,80,0,0,420
28831,190,140,80,80,160,0,650
28832,220,220,160,160,160,0,920
28833,170,100,80,160,160,0,670
28834,190,140,80,80,160,320,970
28835,210,140,80,160,160,0,750
28836,160,140,160,160,0,0,620
28837,200,80,80,0,0,0,360
28838,160,80,80,160,160,0,640
28839,220,80,40,0,0,0,340
28840,220,160,80,0,0,0,460
28841,200,100,80,80,0,0,460
28842,150,120,160,160,160,0,750
28843,180,140,40,80,160,320,920
28844,200,120,40,80,160,320,920
28845,160,140,200,240,160,0,900
28846,150,80,160,160,320,0,870
28847,210,120,80,80,160,0,650
28848,190,180,160,80,0,0,610
28849,200,100,160,160,320,0,940
28850,210,100,80,160,320,320,1190
28851,210,100,160,160,320,320,1270
28852,160,100,80,80,0,0,420
28853,220,120,80,0,0,0,420
28854,180,140,120,160,160,0,760
28855,210,60,80,160,160,0,670
28856,210,120,120,0,0,0,450
28857,210,140,160,160,160,0,830
28858,240,160,160,160,160,0,880
28859,230,160,160,160,0,0,710
28860,200,140,160,80,160,0,740
28861,190,80,120,80,0,0,470
28862,210,160,200,240,160,0,970
28863,190,140,40,80,160,0,610
28864,200,80,80,80,160,0,600
28865,210,140,160,160,160,0,830
28866,220,120,40,0,0,0,380
28867,220,120,0,0,0,0,340
28868,180,140,120,80,0,0,520
28869,190,80,160,160,320,0,910
28870,190,100,80,80,0,0,450
28871,160,140,120,80,0,0,500
28872,200,120,120,160,320,0,920
28873,210,140,40,80,0,0,470
28874,220,140,160,80,160,0,760
28875,180,100,120,80,0,0,480
28876,200,80,120,80,160,320,960
28877,150,120,160,0,0,0,430
28878,210,100,80,0,0,0,390
28879,180,140,120,0,0,0,440
28880,240,180,200,240,160,0,1020
28881,170,120,120,160,0,0,570
28882,190,40,40,80,160,0,510
28883,230,120,80,0,0,0,430
28884,200,140,160,80,0,0,580
28885,150,140,120,80,160,0,650
28886,190,140,120,80,160,0,690
28887,200,100,80,80,0,0,460
28888,230,140,40,0,0,0,410
28889,160,100,80,160,320,0,820
28890,170,140,160,80,0,0,550
28891,230,140,40,0,0,0,410
28892,200,120,160,80,0,0,560
28893,190,140,40,80,160,0,610
28894,210,60,40,0,0,0,310
28895,180,160,160,160,160,320,1140
28896,210,140,120,80,160,0,710
28897,210,140,120,160,160,0,790
28898,210,120,160,80,0,0,570
28899,210,120,40,0,0,0,370
28900,170,80,120,160,320,0,850
28901,170,120,160,160,160,0,770
28902,160,140,80,160,0,0,540
28903,230,140,120,160,160,320,1130
28904,200,100,80,80,0,0,460
28905,190,140,120,80,160,0,690
28906,160,140,80,80,160,0,620
28907,160,80,80,160,0,0,480
28908,160,120,120,80,0,0,480
28909,210,180,120,0,0,0,510
28910,190,140,40,80,160,0,610
28911,160,60,40,80,160,0,500
28912,190,120,40,80,160,0,590
28913,210,140,120,160,160,320,1110
28914,210,60,80,80,160,0,590
28915,180,100,120,80,160,0,640
28916,200,80,80,80,160,0,600
28917,240,140,120,80,0,0,580
28918,230,180,200,160,160,0,930
28919,170,140,160,160,320,0,950
28920,250,180,120,160,160,320,1190
28921,200,120,80,160,160,0,720
28922,180,100,80,160,160,320,1000
28923,200,120,80,80,160,0,640
28924,210,120,120,240,160,0,850
28925,200,140,160,160,160,0,820
28926,170,120,120,160,160,0,730
28927,190,120,120,160,320,0,910
28928,210,120,120,160,160,0,770
28929,220,140,120,160,0,0,640
28930,210,140,120,160,320,0,950
28931,210,120,80,80,160,0,650
28932,170,100,120,160,320,0,870
28933,200,120,120,160,320,320,1240
28934,230,140,80,160,160,320,1090
28935,170,120,80,80,0,0,450
28936,210,160,120,80,160,320,1050
28937,210,140,80,160,160,0,750
28938,220,120,120,80,160,0,700
28939,190,80,80,160,160,0,670
28940,200,160,120,160,0,0,640
28941,180,100,80,0,0,0,360
28942,190,120,200,80,160,0,750
28943,220,140,200,80,160,0,800
28944,180,120,120,80,160,320,980
28945,160,120,80,80,160,0,600
28946,240,200,160,160,160,0,920
28947,240,100,40,80,0,0,460
28948,200,120,80,80,0,0,480
28949,170,100,80,160,0,0,510
28950,210,40,0,0,0,0,250
28951,210,160,160,160,160,320,1170
28952,230,180,200,160,160,320,1250
28953,200,140,160,160,320,320,1300
28954,240,140,200,80,160,0,820
28955,170,140,120,80,160,0,670
28956,190,80,40,80,0,0,390
28957,210,200,120,160,160,0,850
28958,190,100,80,80,0,0,450
28959,230,120,160,80,0,0,590
28960,160,160,120,160,160,0,760
28961,210,140,120,80,160,320,1030
28962,190,80,40,80,0,0,390
28963,170,100,160,240,320,320,1310
28964,180,120,160,240,320,320,1340
28965,200,80,80,0,0,0,360
28966,190,100,80,0,0,0,370
28967,220,140,80,80,0,0,520
28968,230,160,120,0,0,0,510
28969,220,160,200,80,160,0,820
28970,220,140,120,0,0,0,480
28971,210,120,120,160,160,320,1090
28972,180,80,80,80,0,0,420
28973,200,160,160,160,320,0,1000
28974,220,100,120,160,160,0,760
28975,190,140,120,160,160,320,1090
28976,160,140,80,160,160,0,700
28977,170,100,120,0,0,0,390
28978,180,180,0,0,0,0,360
28979,180,120,120,160,160,0,740
28980,190,100,120,80,0,0,490
28981,220,80,80,160,160,0,700
28982,230,100,120,80,160,320,1010
28983,230,200,120,160,160,0,870
28984,220,120,160,80,160,320,1060
28985,250,120,40,0,0,0,410
28986,180,100,80,80,0,0,440
28987,200,100,120,160,160,0,740
28988,170,140,160,160,160,0,790
28989,180,60,40,0,0,0,280
28990,210,140,160,240,160,0,910
28991,210,80,80,0,0,0,370
28992,170,100,160,80,160,0,670
28993,170,140,120,0,0,0,430
28994,190,140,160,160,160,320,1130
28995,230,120,80,80,0,0,510
28996,170,120,160,160,0,0,610
28997,210,60,40,80,160,0,550
28998,180,80,40,0,0,0,300
28999,130,160,80,80,160,0,610
29000,230,160,80,80,0,0,550
29001,180,180,120,160,320,0,960
29002,210,120,40,80,160,0,610
29003,240,100,40,0,0,0,380
29004,150,80,120,80,0,0,430
29005,210,140,160,80,160,0,750
29006,230,160,120,160,320,0,990
29007,210,180,200,160,0,0,750
29008,210,140,120,80,0,0,550
29009,180,100,40,80,160,0,560
29010,220,160,40,80,160,320,980
29011,230,160,120,160,160,0,830
29012,210,80,80,0,0,0,370
29013,210,160,160,80,0,0,610
29014,190,180,40,80,160,0,650
29015,160,40,0,0,0,0,200
29016,190,60,80,80,160,0,570
29017,160,120,120,80,0,0,480
29018,190,160,160,160,0,0,670
29019,200,120,120,160,160,320,1080
29020,200,140,200,160,160,0,860
29021,220,120,80,80,0,0,500
29022,180,120,120,160,320,320,1220
29023,180,120,80,80,0,0,460
29024,200,80,80,160,160,0,680
29025,190,120,120,160,160,0,750
29026,200,180,80,80,160,0,700
29027,160,120,120,80,0,0,480
29028,180,120,40,0,0,0,340
29029,200,160,200,160,160,0,880
29030,200,120,120,80,160,0,680
29031,220,140,160,0,0,0,520
29032,190,80,120,160,160,320,1030
29033,180,140,40,0,0,0,360
29034,190,180,80,0,0,0,450
29035,180,120,160,160,0,0,620
29036,160,100,80,80,0,0,420
29037,190,100,80,160,160,0,690
29038,220,120,160,80,0,0,580
29039,170,120,120,80,0,0,490
29040,200,120,40,0,0,0,360
29041,190,60,40,80,160,0,530
29042,210,140,80,0,0,0,430
29043,190,140,80,80,160,0,650
29044,200,140,80,80,0,0,500
29045,220,200,160,240,160,320,1300
29046,210,120,120,0,0,0,450
29047,210,140,160,160,320,0,990
29048,230,160,80,80,0,0,550
29049,180,60,80,160,0,0,480
29050,190,120,120,160,0,0,590
29051,130,100,160,160,320,0,870
29052,170,100,120,80,0,0,470
29053,220,180,200,160,160,0,920
29054,190,120,80,0,0,0,390
29055,220,160,200,240,320,0,1140
29056,230,200,80,80,160,0,750
29057,160,100,120,0,0,0,380
29058,210,180,120,160,320,0,990
29059,190,100,120,240,320,0,970
29060,170,160,160,80,0,0,570
29061,210,120,80,80,0,0,490
29062,230,100,40,80,160,0,610
29063,180,100,80,0,0,0,360
29064,230,180,80,80,0,0,570
29065,180,100,80,160,0,0,520
29066,200,160,160,80,0,0,600
29067,180,140,160,80,160,0,720
29068,130,120,120,80,160,0,610
29069,210,60,80,0,0,0,350
29070,130,60,40,80,160,0,470
29071,190,200,40,80,160,320,990
29072,180,60,40,80,0,0,360
29073,220,80,40,0,0,0,340
29074,220,200,160,160,320,320,1380
29075,160,120,120,80,0,0,480
29076,200,100,120,160,160,0,740
29077,200,100,120,80,0,0,500
29078,200,140,160,160,160,0,820
29079,200,140,160,160,160,320,1140
29080,210,120,0,0,0,0,330
29081,210,140,80,160,160,0,750
29082,230,140,200,160,0,0,730
29083,160,100,0,0,0,0,260
29084,220,120,80,160,0,0,580
29085,220,120,80,0,0,0,420
29086,170,100,120,80,0,0,470
29087,230,180,120,160,160,0,850
29088,210,140,200,240,0,0,790
29089,210,80,80,80,160,0,610
29090,200,120,120,160,160,0,760
29091,210,160,200,0,0,0,570
29092,220,120,160,80,0,0,580
29093,200,120,120,160,0,0,600
29094,220,80,40,0,0,0,340
29095,230,140,160,240,320,320,1410
29096,210,100,40,80,0,0,430
29097,210,140,120,160,320,320,1270
29098,220,180,160,0,0,0,560
29099,240,140,160,160,320,0,1020
29100,170,140,120,160,160,0,750
29101,220,120,80,160,160,0,740
29102,230,180,160,240,320,0,1130
29103,200,100,120,80,160,0,660
29104,160,80,80,0,0,0,320
29105,190,120,80,80,0,0,470
29106,210,80,120,240,160,0,810
29107,160,60,40,80,160,320,820
29108,200,120,80,80,0,0,480
29109,180,80,80,80,160,0,580
29110,180,160,120,80,0,0,540
29111,210,120,80,160,160,0,730
29112,240,200,200,160,160,0,960
29113,200,100,40,80,0,0,420
29114,180,140,120,160,320,0,920
29115,210,100,40,80,160,0,590
29116,220,180,120,80,160,0,760
29117,210,100,80,80,160,0,630
29118,210,140,120,240,320,320,1350
29119,150,100,80,80,0,0,410
29120,220,100,160,160,160,320,1120
29121,210,100,120,160,160,0,750
29122,190,120,120,160,160,0,750
29123,250,160,80,160,160,0,810
29124,170,120,160,80,0,0,530
29125,210,140,80,80,160,320,990
29126,210,100,120,80,0,0,510
29127,210,120,120,160,160,0,770
29128,180,120,40,0,0,0,340
29129,190,160,120,80,160,320,1030
29130,230,60,120,0,0,0,410
29131,160,60,40,80,160,0,500
29132,200,100,80,80,160,0,620
29133,200,120,120,80,160,0,680
29134,200,160,120,80,0,0,560
29135,160,120,160,80,160,0,680
29136,210,180,80,80,160,0,710
29137,210,100,80,80,0,0,470
29138,180,120,160,160,320,0,940
29139,240,80,80,80,0,0,480
29140,180,140,160,240,0,0,720
29141,180,180,120,160,160,0,800
29142,160,120,80,80,0,0,440
29143,200,120,40,0,0,0,360
29144,160,100,40,80,160,0,540
29145,230,180,0,0,0,0,410
29146,170,120,80,80,160,0,610
29147,190,80,120,80,160,0,630
29148,240,180,120,80,160,0,780
29149,220,140,120,160,0,0,640
29150,160,140,120,240,320,320,1300
29151,220,160,160,80,0,0,620
29152,210,100,120,160,0,0,590
29153,240,140,120,160,320,320,1300
29154,150,140,120,160,160,0,730
29155,200,100,120,160,0,0,580
29156,160,100,120,80,160,320,940
29157,210,220,120,160,160,0,870
29158,200,140,160,80,0,0,580
29159,210,140,120,80,0,0,550
29160,150,80,40,80,0,0,350
29161,180,140,120,160,160,0,760
29162,190,160,160,160,0,0,670
29163,240,120,40,80,160,0,640
29164,210,80,80,160,160,0,690
29165,170,140,120,80,0,0,510
29166,190,100,80,0,0,0,370
29167,210,100,40,80,0,0,430
29168,250,180,160,80,160,0,830
29169,190,120,160,240,160,0,870
29170,200,100,120,160,160,0,740
29171,210,140,80,160,160,0,750
29172,180,120,120,80,0,0,500
29173,210,120,80,0,0,0,410
29174,190,80,80,160,160,0,670
29175,230,140,80,80,160,320,1010
29176,200,60,80,160,160,0,660
29177,200,80,120,80,160,0,640
29178,180,140,80,80,160,320,960
29179,220,160,240,160,160,0,940
29180,210,140,160,160,0,0,670
29181,230,160,160,160,160,0,870
29182,200,80,40,80,0,0,400
29183,230,200,200,160,160,0,950
29184,160,120,40,80,160,0,560
29185,230,140,80,80,160,0,690
29186,190,140,200,160,0,0,690
29187,190,160,120,80,0,0,550
29188,200,140,120,160,160,320,1100
29189,210,180,160,80,0,0,630
29190,230,140,120,240,320,320,1370
29191,170,120,120,240,160,0,810
29192,170,100,160,0,0,0,430
29193,200,120,120,80,160,0,680
29194,230,100,40,0,0,0,370
29195,170,160,80,0,0,0,410
29196,210,160,80,80,160,0,690
29197,180,140,160,160,160,0,800
29198,210,100,120,160,160,0,750
29199,220,100,120,80,0,0,520
29200,150,120,40,80,160,0,550
29201,240,180,120,160,160,0,860
29202,200,120,120,240,0,0,680
29203,180,140,200,0,0,0,520
29204,190,140,80,80,0,0,490
29205,210,60,80,80,160,0,590
29206,210,140,120,160,160,320,1110
29207,200,80,80,80,0,0,440
29208,170,60,80,160,320,320,1110
29209,190,80,80,80,0,0,430
29210,220,120,80,80,160,0,660
29211,230,160,80,80,0,0,550
29212,210,140,80,80,160,320,990
29213,200,140,120,80,160,0,700
29214,180,40,40,80,160,320,820
29215,180,140,80,160,0,0,560
29216,190,100,120,240,160,320,1130
29217,190,100,120,240,160,0,810
29218,180,120,120,0,0,0,420
29219,200,80,80,80,160,0,600
29220,200,160,200,160,0,0,720
29221,170,100,40,80,0,0,390
29222,180,140,160,240,320,0,1040
29223,190,180,120,160,0,0,650
29224,210,140,120,80,0,0,550
29225,200,180,160,240,0,0,780
29226,180,80,120,80,0,0,460
29227,210,140,40,0,0,0,390
29228,160,60,40,80,160,0,500
29229,230,120,80,80,0,0,510
29230,160,120,80,80,160,0,600
29231,190,140,120,80,0,0,530
29232,170,100,120,160,320,0,870
29233,200,140,160,80,160,320,1060
29234,160,120,120,80,0,0,480
29235,190,140,200,160,160,0,850
29236,130,100,120,160,160,0,670
29237,200,200,200,240,320,320,1480
29238,210,120,160,160,160,0,810
29239,210,120,200,160,160,0,850
29240,190,120,40,80,160,320,910
29241,190,120,160,160,160,0,790
29242,160,120,80,80,160,0,600
29243,190,160,120,160,0,0,630
29244,210,100,120,80,160,0,670
29245,160,160,160,240,160,0,880
29246,210,100,80,160,320,320,1190
29247,160,120,80,160,320,0,840
29248,210,120,120,80,160,0,690
29249,210,180,80,80,160,0,710
29250,230,140,80,160,160,0,770
29251,250,160,120,0,0,0,530
29252,170,80,40,80,160,0,530
29253,230,140,120,160,160,0,810
29254,160,60,40,0,0,0,260
29255,170,100,80,0,0,0,350
29256,150,80,120,160,320,0,830
29257,200,100,120,160,320,320,1220
29258,200,160,160,160,320,0,1000
29259,190,140,160,80,160,0,730
29260,200,140,80,160,160,320,1060
29261,230,180,200,240,160,0,1010
29262,170,140,160,80,160,0,710
29263,200,120,200,80,0,0,600
29264,200,180,120,240,160,0,900
29265,220,140,160,240,160,0,920
29266,210,120,120,80,160,0,690
29267,220,180,120,80,160,0,760
29268,200,200,200,240,320,0,1160
29269,180,160,160,240,160,320,1220
29270,210,80,80,80,0,0,450
29271,180,100,120,80,0,0,480
29272,210,140,40,80,160,0,630
29273,230,140,0,0,0,0,370
29274,220,160,120,80,0,0,580
29275,230,60,80,80,160,0,610
29276,190,60,80,160,0,0,490
29277,130,60,120,80,0,0,390
29278,220,100,80,0,0,0,400
29279,200,160,80,0,0,0,440
29280,220,200,80,0,0,0,500
29281,210,120,80,0,0,0,410
29282,200,120,40,0,0,0,360
29283,190,100,80,0,0,0,370
29284,220,120,160,160,160,0,820
29285,140,140,80,0,0,0,360
29286,230,180,120,160,320,0,1010
29287,170,140,120,80,0,0,510
29288,200,140,40,0,0,0,380
29289,180,80,80,160,320,320,1140
29290,200,120,40,80,160,0,600
29291,190,160,160,160,160,320,1150
29292,150,140,80,0,0,0,370
29293,180,120,120,160,320,0,900
29294,180,100,120,80,160,0,640
29295,210,160,160,160,320,0,1010
29296,180,80,80,80,0,0,420
29297,230,180,80,0,0,0,490
29298,230,200,80,80,160,0,750
29299,210,100,0,0,0,0,310
29300,220,140,160,80,160,0,760
29301,220,80,40,80,160,0,580
29302,250,160,160,160,160,0,890
29303,180,100,40,80,0,0,400
29304,250,140,160,160,320,320,1350
29305,190,140,120,80,160,0,690
29306,210,80,80,80,0,0,450
29307,170,120,160,80,160,320,1010
29308,200,120,80,0,0,0,400
29309,160,120,120,240,320,0,960
29310,200,80,160,160,160,0,760
29311,190,140,120,240,0,0,690
29312,180,100,120,160,160,320,1040
29313,200,140,160,160,0,0,660
29314,170,120,80,160,320,320,1170
29315,140,100,40,80,0,0,360
29316,200,100,80,80,0,0,460
29317,210,120,160,80,160,0,730
29318,210,140,120,0,0,0,470
29319,150,140,80,80,160,0,610
29320,180,160,40,80,0,0,460
29321,180,140,120,160,320,0,920
29322,200,100,80,80,160,0,620
29323,190,120,160,160,0,0,630
29324,190,160,120,160,160,0,790
29325,190,120,80,0,0,0,390
29326,210,160,80,0,0,0,450
29327,190,100,120,80,160,0,650
29328,210,120,80,80,160,320,970
29329,190,140,40,0,0,0,370
29330,190,140,120,160,160,0,770
29331,250,120,80,160,0,0,610
29332,160,120,160,80,160,0,680
29333,180,180,120,160,160,320,1120
29334,220,140,120,0,0,0,480
29335,190,140,240,160,0,0,730
29336,180,160,160,160,160,0,820
29337,200,120,120,0,0,0,440
29338,170,160,120,160,160,0,770
29339,190,120,120,160,160,0,750
29340,220,100,120,160,0,0,600
29341,230,160,160,240,320,0,1110
29342,220,140,120,160,160,320,1120
29343,160,80,40,80,0,0,360
29344,180,120,80,80,160,0,620
29345,220,80,80,80,160,0,620
29346,180,160,120,160,160,0,780
29347,200,120,40,0,0,0,360
29348,190,80,120,80,0,0,470
29349,200,120,160,80,0,0,560
29350,220,160,120,80,160,0,740
29351,190,180,80,80,160,0,690
29352,230,200,160,160,320,0,1070
29353,190,140,160,160,160,0,810
29354,160,120,120,160,0,0,560
29355,200,80,120,80,0,0,480
29356,200,120,40,80,160,0,600
29357,190,140,120,80,160,0,690
29358,190,120,120,160,160,0,750
29359,190,100,120,160,160,0,730
29360,220,160,160,240,0,0,780
29361,180,160,120,80,160,320,1020
29362,170,80,80,160,160,0,650
29363,210,80,80,0,0,0,370
29364,180,180,80,80,0,0,520
29365,190,140,120,160,160,320,1090
29366,180,100,80,80,160,0,600
29367,220,140,120,80,0,0,560
29368,190,140,120,0,0,0,450
29369,190,120,80,160,160,0,710
29370,240,140,80,80,160,0,700
29371,220,160,160,80,0,0,620
29372,210,160,80,160,320,0,930
29373,200,100,40,0,0,0,340
29374,180,100,120,160,160,0,720
29375,230,160,160,160,320,320,1350
29376,210,140,120,80,0,0,550
29377,190,120,80,80,0,0,470
29378,170,120,80,80,160,0,610
29379,220,140,120,80,160,0,720
29380,240,140,120,80,160,0,740
29381,190,100,40,0,0,0,330
29382,210,140,120,240,160,0,870
29383,190,140,80,80,160,320,970
29384,200,100,80,80,160,0,620
29385,190,80,40,0,0,0,310
29386,210,120,40,80,160,0,610
29387,190,160,120,80,160,320,1030
29388,200,120,0,0,0,0,320
29389,200,140,120,80,0,0,540
29390,170,120,120,80,0,0,490
29391,160,160,120,80,160,0,680
29392,170,80,80,0,0,0,330
29393,160,120,120,160,0,0,560
29394,220,120,120,160,160,0,780
29395,220,100,40,0,0,0,360
29396,230,140,120,160,320,0,970
29397,190,100,80,80,160,0,610
29398,190,140,120,0,0,0,450
29399,210,100,80,80,0,0,470
29400,230,160,160,80,160,320,1110
29401,160,140,160,160,160,0,780
29402,200,120,80,80,0,0,480
29403,200,200,160,80,0,0,640
29404,180,140,160,80,160,320,1040
29405,180,160,80,80,0,0,500
29406,170,140,80,80,160,0,630
29407,230,160,120,80,0,0,590
29408,170,100,120,160,320,0,870
29409,200,120,120,80,0,0,520
29410,200,180,120,160,0,0,660
29411,230,100,120,80,0,0,530
29412,210,180,160,160,160,0,870
29413,160,140,160,160,320,0,940
29414,180,120,120,80,160,0,660
29415,180,140,120,80,160,320,1000
29416,200,120,80,160,160,0,720
29417,210,120,120,160,160,0,770
29418,230,140,120,80,160,0,730
29419,160,100,120,160,320,0,860
29420,190,80,40,80,0,0,390
29421,140,120,120,160,320,0,860
29422,200,140,120,80,0,0,540
29423,180,160,80,80,0,0,500
29424,210,80,80,80,160,0,610
29425,220,160,160,160,160,0,860
29426,200,80,40,80,160,320,880
29427,230,120,40,80,160,0,630
29428,190,140,120,80,160,320,1010
29429,200,100,40,80,160,320,900
29430,220,140,120,160,320,320,1280
29431,210,60,40,80,160,320,870
29432,200,80,80,80,0,0,440
29433,200,60,80,80,0,0,420
29434,180,60,80,0,0,0,320
29435,220,120,80,80,160,0,660
29436,220,120,160,160,320,0,980
29437,210,160,160,80,0,0,610
29438,180,140,120,0,0,0,440
29439,170,80,120,80,160,0,610
29440,200,160,200,160,160,0,880
29441,210,100,80,160,160,0,710
29442,180,120,120,160,320,0,900
29443,170,60,0,0,0,0,230
29444,190,120,80,160,0,0,550
29445,180,140,80,0,0,0,400
29446,240,100,80,160,0,0,580
29447,220,60,80,80,160,0,600
29448,200,140,80,160,160,320,1060
29449,210,140,120,80,0,0,550
29450,130,80,120,0,0,0,330
29451,170,40,80,0,0,0,290
29452,210,120,160,320,160,0,970
29453,190,80,80,80,0,0,430
29454,220,120,40,0,0,0,380
29455,180,140,120,80,160,0,680
29456,180,80,80,160,160,320,980
29457,170,140,200,160,160,0,830
29458,180,120,120,80,0,0,500
29459,210,100,40,0,0,0,350
29460,200,100,80,160,320,0,860
29461,180,40,80,0,0,0,300
29462,230,140,120,160,320,0,970
29463,200,160,80,0,0,0,440
29464,230,140,120,160,160,0,810
29465,170,100,40,80,0,0,390
29466,190,160,120,80,0,0,550
29467,180,80,80,0,0,0,340
29468,190,100,120,0,0,0,410
29469,190,80,40,0,0,0,310
29470,200,60,120,160,160,0,700
29471,160,80,40,80,0,0,360
29472,150,140,80,0,0,0,370
29473,190,120,200,160,160,320,1150
29474,200,80,0,0,0,0,280
29475,200,160,40,80,160,0,640
29476,230,140,80,80,160,320,1010
29477,170,80,40,0,0,0,290
29478,190,80,120,160,160,0,710
29479,200,80,40,80,0,0,400
29480,200,120,160,240,0,0,720
29481,160,100,80,0,0,0,340
29482,200,80,120,80,0,0,480
29483,230,120,160,160,0,0,670
29484,200,60,40,0,0,0,300
29485,180,120,120,160,160,320,1060
29486,190,120,40,0,0,0,350
29487,200,120,40,80,0,0,440
29488,230,160,160,80,0,0,630
29489,200,100,80,80,0,0,460
29490,170,100,80,80,160,320,910
29491,160,100,120,80,160,0,620
29492,240,140,80,80,0,0,540
29493,210,160,80,160,320,0,930
29494,200,160,80,0,0,0,440
29495,200,120,40,0,0,0,360
29496,180,160,200,160,160,0,860
29497,210,160,120,80,0,0,570
29498,190,160,120,80,160,0,710
29499,180,80,120,160,320,0,860
29500,230,160,120,80,160,0,750
29501,180,120,80,80,160,0,620
29502,190,100,80,160,320,320,1170
29503,210,140,160,160,160,0,830
29504,200,120,120,160,160,0,760
29505,180,120,120,160,160,0,740
29506,210,140,120,0,0,0,470
29507,210,80,40,80,0,0,410
29508,240,200,200,160,160,0,960
29509,160,100,120,160,320,0,860
29510,180,100,160,160,160,0,760
29511,200,120,40,80,160,0,600
29512,200,140,160,160,0,0,660
29513,160,100,80,80,0,0,420
29514,180,120,160,160,0,0,620
29515,190,100,120,160,160,320,1050
29516,180,120,80,0,0,0,380
29517,210,160,120,160,160,0,810
29518,210,160,120,80,0,0,570
29519,190,60,80,160,320,0,810
29520,190,140,160,80,160,0,730
29521,140,80,40,80,160,320,820
29522,230,160,120,160,160,0,830
29523,210,100,40,0,0,0,350
29524,200,180,80,80,160,0,700
29525,190,120,160,160,160,0,790
29526,180,100,120,80,0,0,480
29527,190,100,80,80,160,0,610
29528,220,140,120,240,0,0,720
29529,220,160,240,160,160,0,940
29530,210,80,40,80,0,0,410
29531,210,140,160,160,320,0,990
29532,190,180,120,160,320,320,1290
29533,210,100,160,160,160,0,790
29534,190,100,80,160,320,0,850
29535,230,120,120,80,0,0,550
29536,190,100,120,0,0,0,410
29537,210,180,120,80,160,0,750
29538,190,120,200,160,320,320,1310
29539,200,140,40,80,0,0,460
29540,200,140,160,160,320,0,980
29541,200,80,80,80,160,0,600
29542,210,120,80,80,160,0,650
29543,210,100,120,160,160,0,750
29544,190,120,120,160,160,0,750
29545,200,160,160,160,160,0,840
29546,190,120,80,80,0,0,470
29547,210,120,80,160,0,0,570
29548,210,120,80,0,0,0,410
29549,170,120,80,80,0,0,450
29550,230,180,80,80,160,0,730
29551,190,140,120,160,0,0,610
29552,180,160,160,160,0,0,660
29553,190,120,120,80,160,0,670
29554,180,100,80,80,160,0,600
29555,230,140,120,160,160,320,1130
29556,230,120,40,80,0,0,470
29557,220,160,160,80,0,0,620
29558,180,60,80,160,160,0,640
29559,220,160,160,160,160,0,860
29560,240,160,80,80,0,0,560
29561,240,140,200,240,0,0,820
29562,180,60,80,0,0,0,320
29563,240,140,120,80,0,0,580
29564,210,100,80,80,0,0,470
29565,190,160,120,160,160,0,790
29566,190,140,40,0,0,0,370
29567,160,100,0,0,0,0,260
29568,210,80,40,0,0,0,330
29569,180,180,160,0,0,0,520
29570,200,140,160,160,160,0,820
29571,190,120,160,160,160,0,790
29572,200,100,200,160,160,0,820
29573,200,140,120,160,160,0,780
29574,200,140,80,0,0,0,420
29575,200,80,80,80,160,320,920
29576,160,140,120,160,160,0,740
29577,210,100,80,0,0,0,390
29578,170,100,80,160,0,0,510
29579,210,160,200,160,0,0,730
29580,200,120,160,160,160,0,800
29581,200,160,120,160,160,0,800
29582,190,100,0,0,0,0,290
29583,240,160,0,0,0,0,400
29584,190,180,120,160,160,320,1130
29585,230,80,80,80,160,0,630
29586,210,120,80,160,320,0,890
29587,210,120,120,0,0,0,450
29588,200,160,160,160,0,0,680
29589,180,100,80,80,160,320,920
29590,210,80,80,80,0,0,450
29591,190,140,120,80,160,320,1010
29592,180,120,120,240,160,0,820
29593,160,100,120,80,160,0,620
29594,200,120,120,80,160,0,680
29595,250,140,160,160,320,0,1030
29596,180,160,80,0,0,0,420
29597,180,60,0,0,0,0,240
29598,180,160,120,160,0,0,620
29599,190,80,80,0,0,0,350
29600,240,200,120,160,160,0,880
29601,240,180,120,80,0,0,620
29602,230,80,80,0,0,0,390
29603,230,160,80,80,160,0,710
29604,200,120,120,160,160,0,760
29605,210,80,40,80,160,320,890
29606,200,140,200,80,0,0,620
29607,200,80,40,80,160,0,560
29608,210,100,120,240,0,0,670
29609,230,220,160,160,160,0,930
29610,200,160,120,0,0,0,480
29611,160,140,80,0,0,0,380
29612,220,140,80,80,0,0,520
29613,180,80,40,0,0,0,300
29614,160,80,40,80,160,320,840
29615,150,100,80,80,0,0,410
29616,190,80,80,80,0,0,430
29617,210,200,160,80,160,0,810
29618,160,120,40,80,0,0,400
29619,260,200,160,160,0,0,780
29620,190,140,160,160,160,0,810
29621,200,140,40,80,0,0,460
29622,210,140,160,240,160,0,910
29623,190,160,160,160,160,0,830
29624,210,80,120,240,320,0,970
29625,240,160,160,160,320,0,1040
29626,190,120,120,80,0,0,510
29627,200,120,120,80,0,0,520
29628,180,100,120,80,160,0,640
29629,170,160,80,80,160,0,650
29630,200,100,80,80,160,0,620
29631,230,140,80,160,0,0,610
29632,210,60,80,80,160,0,590
29633,240,180,120,80,0,0,620
29634,240,160,160,160,320,320,1360
29635,210,160,160,80,0,0,610
29636,200,180,160,160,0,0,700
29637,200,100,120,240,320,0,980
29638,200,200,200,240,320,0,1160
29639,220,120,80,80,160,0,660
29640,150,60,80,80,0,0,370
29641,240,180,200,240,160,0,1020
29642,190,140,160,160,0,0,650
29643,190,120,200,160,160,0,830
29644,170,140,120,80,160,0,670
29645,220,160,160,240,320,320,1420
29646,210,120,80,80,160,0,650
29647,190,80,80,160,160,0,670
29648,160,100,40,0,0,0,300
29649,210,160,40,80,0,0,490
29650,180,160,120,80,0,0,540
29651,190,80,120,80,160,320,950
29652,200,120,120,160,160,0,760
29653,180,100,80,80,160,0,600
29654,190,120,120,80,0,0,510
29655,220,120,40,0,0,0,380
29656,210,80,80,0,0,0,370
29657,200,60,80,0,0,0,340
29658,190,120,160,160,160,0,790
29659,200,140,80,80,0,0,500
29660,200,120,120,80,160,0,680
29661,210,100,120,80,160,0,670
29662,210,100,40,80,0,0,430
29663,180,120,200,160,0,0,660
29664,210,100,120,0,0,0,430
29665,210,180,120,80,160,320,1070
29666,160,140,40,0,0,0,340
29667,190,100,120,0,0,0,410
29668,190,100,40,80,0,0,410
29669,160,120,160,0,0,0,440
29670,220,160,160,160,160,0,860
29671,160,100,80,0,0,0,340
29672,180,140,40,80,160,0,600
29673,170,160,120,80,160,0,690
29674,190,120,80,160,0,0,550
29675,190,140,120,80,160,0,690
29676,150,140,80,80,160,0,610
29677,130,120,80,80,160,0,570
29678,180,120,120,80,0,0,500
29679,230,180,240,160,320,0,1130
29680,230,160,160,160,320,320,1350
29681,200,120,120,80,0,0,520
29682,240,180,200,240,320,0,1180
29683,210,140,160,160,160,320,1150
29684,150,140,200,80,0,0,570
29685,200,80,80,80,160,320,920
29686,190,160,120,80,160,320,1030
29687,180,180,80,80,160,320,1000
29688,190,200,160,80,0,0,630
29689,250,60,40,0,0,0,350
29690,210,200,120,160,320,320,1330
29691,210,140,80,0,0,0,430
29692,170,160,200,160,160,320,1170
29693,240,140,80,80,160,0,700
29694,250,180,160,160,0,0,750
29695,180,100,120,240,160,0,800
29696,200,100,80,80,160,0,620
29697,200,120,80,160,160,0,720
29698,210,140,120,80,160,0,710
29699,180,100,40,80,0,0,400
29700,210,200,120,0,0,0,530
29701,180,160,120,160,320,0,940
29702,150,100,120,160,0,0,530
29703,210,100,80,80,160,0,630
29704,180,80,80,160,0,0,500
29705,210,120,160,160,160,0,810
29706,200,140,200,240,160,0,940
29707,170,120,120,160,320,0,890
29708,180,100,80,80,160,0,600
29709,220,80,120,80,160,0,660
29710,150,100,160,160,160,0,730
29711,210,120,120,160,160,0,770
29712,190,120,80,160,320,0,870
29713,190,140,80,0,0,0,410
29714,200,120,80,80,160,0,640
29715,160,100,120,80,0,0,460
29716,190,120,120,160,160,0,750
29717,220,160,120,240,160,320,1220
29718,210,120,40,0,0,0,370
29719,210,180,120,80,0,0,590
29720,230,160,160,80,160,0,790
29721,150,100,200,160,160,0,770
29722,130,60,80,160,160,0,590
29723,180,100,160,80,160,320,1000
29724,200,80,80,160,160,0,680
29725,220,160,120,0,0,0,500
29726,200,100,40,0,0,0,340
29727,180,80,40,0,0,0,300
29728,230,180,200,240,160,0,1010
29729,190,100,40,0,0,0,330
29730,160,100,80,160,0,0,500
29731,200,80,40,0,0,0,320
29732,170,80,120,80,0,0,450
29733,210,80,80,80,160,0,610
29734,220,80,80,80,160,0,620
29735,200,160,120,80,160,0,720
29736,240,140,120,80,0,0,580
29737,160,100,40,0,0,0,300
29738,220,140,160,160,160,0,840
29739,180,120,80,160,320,0,860
29740,150,100,120,80,160,0,610
29741,250,160,80,0,0,0,490
29742,190,140,80,0,0,0,410
29743,260,140,160,160,0,0,720
29744,200,100,80,0,0,0,380
29745,260,180,120,0,0,0,560
29746,210,140,120,240,160,0,870
29747,170,80,80,0,0,0,330
29748,220,140,120,80,160,0,720
29749,190,140,120,0,0,0,450
29750,190,120,160,240,160,0,870
29751,140,40,0,0,0,0,180
29752,190,140,120,0,0,0,450
29753,210,120,160,160,0,0,650
29754,170,120,80,160,160,0,690
29755,180,80,120,160,320,320,1180
29756,200,100,120,80,160,320,980
29757,160,100,80,160,320,0,820
29758,220,160,40,80,160,320,980
29759,170,80,80,160,160,320,970
29760,220,140,120,160,320,0,960
29761,210,180,160,0,0,0,550
29762,190,80,40,80,0,0,390
29763,200,180,280,160,160,0,980
29764,150,100,120,160,160,0,690
29765,200,200,160,160,160,0,880
29766,210,140,160,160,0,0,670
29767,190,140,200,80,160,0,770
29768,200,120,160,160,0,0,640
29769,170,120,160,160,0,0,610
29770,200,140,160,0,0,0,500
29771,230,100,40,0,0,0,370
29772,230,120,200,240,320,320,1430
29773,220,120,40,0,0,0,380
29774,200,80,40,0,0,0,320
29775,190,120,120,240,320,320,1310
29776,180,100,120,80,160,0,640
29777,210,140,200,80,160,0,790
29778,180,120,40,0,0,0,340
29779,190,100,80,160,320,0,850
29780,200,140,80,80,160,320,980
29781,210,180,160,0,0,0,550
29782,180,80,80,80,160,0,580
29783,200,160,120,160,0,0,640
29784,170,140,160,80,0,0,550
29785,170,80,40,0,0,0,290
29786,250,160,160,160,320,320,1370
29787,200,120,80,80,160,320,960
29788,190,140,120,240,160,320,1170
29789,210,100,80,0,0,0,390
29790,210,120,80,80,160,0,650
29791,200,100,80,160,160,320,1020
29792,210,140,120,160,160,320,1110
29793,180,100,80,80,160,0,600
29794,200,140,80,80,160,320,980
29795,220,160,120,240,320,0,1060
29796,170,140,160,240,320,0,1030
29797,190,140,120,240,320,320,1330
29798,200,120,120,0,0,0,440
29799,190,160,160,160,320,0,990
29800,140,100,80,80,160,0,560
29801,170,100,0,0,0,0,270
29802,220,120,40,80,160,0,620
29803,150,160,200,80,160,0,750
29804,180,120,40,80,160,0,580
29805,230,100,80,80,0,0,490
29806,140,80,40,80,160,0,500
29807,220,120,80,0,0,0,420
29808,200,160,120,160,320,0,960
29809,210,160,160,80,0,0,610
29810,190,140,120,160,160,0,770
29811,170,80,120,160,320,0,850
29812,250,180,160,160,320,0,1070
29813,210,120,0,0,0,0,330
29814,170,40,40,0,0,0,250
29815,200,100,120,80,0,0,500
29816,190,120,120,80,160,0,670
29817,170,120,160,160,160,0,770
29818,220,120,120,160,160,320,1100
29819,190,160,240,240,0,0,830
29820,200,160,120,160,160,0,800
29821,210,120,120,160,160,0,770
29822,220,80,80,80,0,0,460
29823,200,140,200,0,0,0,540
29824,170,100,120,80,0,0,470
29825,230,100,80,160,160,0,730
29826,190,120,120,80,0,0,510
29827,250,140,40,80,160,0,670
29828,240,140,80,160,160,0,780
29829,200,140,160,160,160,320,1140
29830,190,40,80,0,0,0,310
29831,210,100,80,80,0,0,470
29832,150,140,160,240,320,320,1330
29833,190,80,120,80,160,0,630
29834,220,140,120,160,160,320,1120
29835,170,120,120,80,160,320,970
29836,180,160,120,80,0,0,540
29837,240,120,120,80,160,0,720
29838,190,120,80,160,320,0,870
29839,180,140,120,80,0,0,520
29840,190,180,120,80,160,320,1050
29841,200,80,80,80,160,0,600
29842,170,100,80,160,0,0,510
29843,210,100,40,80,0,0,430
29844,210,120,80,80,160,0,650
29845,210,160,240,80,0,0,690
29846,160,80,40,80,0,0,360
29847,200,140,120,160,160,0,780
29848,190,160,80,80,0,0,510
29849,230,180,160,240,160,0,970
29850,170,160,120,160,160,0,770
29851,230,180,200,0,0,0,610
29852,210,160,160,160,0,0,690
29853,220,100,120,0,0,0,440
29854,240,80,80,0,0,0,400
29855,220,160,160,160,0,0,700
29856,180,120,160,240,320,320,1340
29857,210,160,160,160,0,0,690
29858,220,120,80,80,0,0,500
29859,190,120,120,80,0,0,510
29860,230,160,120,80,160,0,750
29861,200,140,200,160,160,0,860
29862,200,80,80,160,320,0,840
29863,170,100,80,0,0,0,350
29864,200,140,80,80,0,0,500
29865,200,100,120,80,0,0,500
29866,200,160,120,240,160,0,880
29867,190,160,160,160,160,0,830
29868,240,180,120,160,0,0,700
29869,210,80,40,0,0,0,330
29870,210,140,120,80,0,0,550
29871,170,100,0,0,0,0,270
29872,170,80,80,80,160,0,570
29873,210,120,120,160,0,0,610
29874,170,80,120,160,160,0,690
29875,170,120,120,160,0,0,570
29876,210,60,80,80,0,0,430
29877,220,160,160,80,160,0,780
29878,150,140,160,80,0,0,530
29879,180,120,160,240,320,0,1020
29880,240,100,80,80,0,0,500
29881,200,100,80,80,160,0,620
29882,190,80,80,80,0,0,430
29883,220,140,120,160,160,0,800
29884,190,120,80,160,0,0,550
29885,180,100,120,160,160,320,1040
29886,200,140,120,160,160,0,780
29887,200,120,80,0,0,0,400
29888,190,100,160,160,160,0,770
29889,260,160,200,80,160,0,860
29890,230,160,240,160,160,0,950
29891,200,80,120,160,0,0,560
29892,210,100,80,0,0,0,390
29893,170,80,120,80,0,0,450
29894,210,120,80,160,160,0,730
29895,190,140,160,160,0,0,650
29896,210,140,160,80,160,0,750
29897,170,160,120,160,0,0,610
29898,210,140,0,0,0,0,350
29899,210,120,80,80,0,0,490
29900,160,60,80,80,160,0,540
29901,220,180,120,80,160,0,760
29902,170,140,80,160,320,320,1190
29903,180,120,80,80,160,320,940
29904,190,120,80,0,0,0,390
29905,220,140,160,80,0,0,600
29906,230,140,120,80,0,0,570
29907,180,120,160,0,0,0,460
29908,190,140,160,80,0,0,570
29909,160,120,80,80,0,0,440
29910,200,120,120,0,0,0,440
29911,240,140,80,80,160,0,700
29912,210,60,40,0,0,0,310
29913,190,180,80,80,160,320,1010
29914,240,100,80,80,160,0,660
29915,190,100,40,0,0,0,330
29916,190,180,160,160,160,0,850
29917,180,140,160,160,160,0,800
29918,190,100,80,80,160,0,610
29919,150,100,80,80,0,0,410
29920,200,220,120,80,0,0,620
29921,220,80,40,0,0,0,340
29922,220,100,160,160,160,320,1120
29923,220,140,80,80,0,0,520
29924,260,200,160,240,160,0,1020
29925,170,140,80,80,160,0,630
29926,200,120,120,80,160,0,680
29927,230,120,80,160,320,0,910
29928,160,140,80,160,160,320,1020
29929,210,140,120,80,160,0,710
29930,180,60,80,160,160,0,640
29931,200,100,40,80,160,0,580
29932,200,120,120,80,160,0,680
29933,200,180,160,160,160,0,860
29934,200,100,0,0,0,0,300
29935,150,80,40,80,160,0,510
29936,220,120,120,160,160,0,780
29937,200,120,120,160,320,0,920
29938,210,120,120,80,160,0,690
29939,230,60,40,80,0,0,410
29940,190,140,120,80,160,0,690
29941,180,100,80,80,0,0,440
29942,210,140,120,80,160,0,710
29943,200,140,80,80,160,320,980
29944,190,80,80,80,0,0,430
29945,190,60,40,0,0,0,290
29946,210,100,80,160,0,0,550
29947,190,140,80,80,160,0,650
29948,220,140,120,240,160,0,880
29949,200,120,80,0,0,0,400
29950,210,180,120,240,160,320,1230
29951,200,40,0,0,0,0,240
29952,210,160,120,80,160,0,730
29953,140,100,40,0,0,0,280
29954,210,180,120,160,0,0,670
29955,150,140,120,80,0,0,490
29956,190,120,80,80,0,0,470
29957,190,140,160,240,320,0,1050
29958,190,180,200,80,0,0,650
29959,200,180,120,80,0,0,580
29960,180,120,120,160,160,320,1060
29961,210,120,120,80,160,320,1010
29962,200,160,120,80,0,0,560
29963,200,200,120,160,160,0,840
29964,180,80,40,80,160,320,860
29965,210,100,120,80,160,0,670
29966,190,140,160,80,0,0,570
29967,230,160,160,160,160,0,870
29968,150,160,160,160,0,0,630
29969,200,140,80,0,0,0,420
29970,190,140,200,160,320,0,1010
29971,170,160,160,160,160,0,810
29972,200,80,80,80,0,0,440
29973,190,60,40,0,0,0,290
29974,230,100,40,80,160,0,610
29975,180,100,120,160,160,0,720
29976,180,80,80,160,320,0,820
29977,170,120,80,160,160,320,1010
29978,180,80,80,0,0,0,340
29979,230,140,120,240,160,320,1210
29980,210,120,160,160,0,0,650
29981,200,120,160,160,160,0,800
29982,230,180,200,240,160,320,1330
29983,190,140,120,80,160,0,690
29984,200,120,40,0,0,0,360
29985,150,60,40,0,0,0,250
29986,220,40,40,80,160,0,540
29987,180,160,160,80,0,0,580
29988,170,120,160,160,160,0,770
29989,190,120,80,80,0,0,470
29990,210,120,120,160,160,0,770
29991,190,100,120,240,320,0,970
29992,160,140,80,160,160,0,700
29993,190,180,120,0,0,0,490
29994,210,160,120,240,320,0,1050
29995,190,100,40,0,0,0,330
29996,220,180,160,240,320,0,1120
29997,180,80,40,80,160,320,860
29998,200,120,120,160,160,0,760
29999,180,120,80,80,0,0,460
30000,170,120,40,0,0,0,330
30001,190,120,120,80,0,0,510
30002,190,160,120,160,160,0,790
30003,210,100,160,160,160,0,790
30004,200,100,120,240,160,0,820
30005,210,100,40,80,160,0,590
30006,160,100,160,80,160,0,660
30007,180,60,40,80,160,320,840
30008,220,100,120,160,160,0,760
30009,230,140,80,0,0,0,450
30010,190,140,120,0,0,0,450
30011,190,120,80,80,160,0,630
30012,170,80,40,80,0,0,370
30013,170,120,80,0,0,0,370
30014,220,160,120,80,160,320,1060
30015,210,160,80,160,160,320,1090
30016,200,120,80,0,0,0,400
30017,200,160,120,160,0,0,640
30018,170,120,80,80,160,320,930
30019,170,80,80,160,0,0,490
30020,200,100,120,80,0,0,500
30021,180,80,40,80,0,0,380
30022,180,140,120,80,160,0,680
30023,230,160,120,80,0,0,590
30024,160,80,40,80,0,0,360
30025,180,140,120,80,0,0,520
30026,220,140,120,160,0,0,640
30027,200,100,120,160,0,0,580
30028,200,140,120,160,160,320,1100
30029,220,120,120,80,0,0,540
30030,190,80,120,0,0,0,390
30031,150,80,120,80,0,0,430
30032,200,100,120,240,160,320,1140
30033,200,160,160,240,320,0,1080
30034,180,120,120,80,160,0,660
30035,240,140,160,160,0,0,700
30036,180,120,120,80,160,320,980
30037,180,120,80,80,160,0,620
30038,230,180,80,0,0,0,490
30039,220,100,40,0,0,0,360
30040,170,100,80,0,0,0,350
30041,170,140,40,0,0,0,350
30042,180,120,200,240,320,0,1060
30043,190,160,120,240,320,0,1030
30044,200,160,40,80,0,0,480
30045,150,100,80,80,160,0,570
30046,180,120,160,80,160,0,700
30047,200,80,40,0,0,0,320
30048,220,140,160,160,160,0,840
30049,210,160,120,80,160,0,730
30050,220,120,160,240,160,0,900
30051,210,100,40,0,0,0,350
30052,170,120,120,80,0,0,490
30053,190,80,80,0,0,0,350
30054,170,140,120,160,160,0,750
30055,190,140,120,160,160,0,770
30056,200,140,120,160,0,0,620
30057,180,120,120,160,320,0,900
30058,180,140,200,240,0,0,760
30059,180,100,120,160,160,0,720
30060,200,80,80,0,0,0,360
30061,160,120,160,160,160,0,760
30062,200,100,80,80,0,0,460
30063,160,80,40,80,160,0,520
30064,220,140,120,80,160,0,720
30065,220,100,80,160,160,0,720
30066,190,160,80,80,0,0,510
30067,140,80,120,160,160,0,660
30068,210,120,120,0,0,0,450
30069,210,100,120,80,160,0,670
30070,240,100,80,0,0,0,420
30071,150,100,80,80,160,0,570
30072,190,120,80,80,0,0,470
30073,240,80,40,80,0,0,440
30074,190,140,120,160,160,320,1090
30075,160,140,160,160,320,320,1260
30076,200,120,160,80,160,320,1040
30077,160,100,120,80,0,0,460
30078,200,160,120,160,320,0,960
30079,200,160,80,80,160,0,680
30080,160,100,80,0,0,0,340
30081,190,120,120,80,160,0,670
30082,200,100,80,160,0,0,540
30083,210,180,240,160,0,0,790
30084,200,140,160,160,320,320,1300
30085,210,120,80,80,0,0,490
30086,220,180,160,80,160,0,800
30087,190,120,80,80,160,0,630
30088,200,120,120,80,0,0,520
30089,170,60,0,0,0,0,230
30090,200,140,120,160,0,0,620
30091,160,80,80,80,160,0,560
30092,200,80,0,0,0,0,280
30093,200,120,80,0,0,0,400
30094,170,120,80,160,320,320,1170
30095,250,80,80,80,0,0,490
30096,140,100,120,80,160,0,600
30097,190,80,80,80,160,0,590
30098,160,120,120,80,0,0,480
30099,190,140,80,0,0,0,410
30100,230,120,80,0,0,0,430
30101,200,100,40,80,160,0,580
30102,200,180,160,240,320,0,1100
30103,220,160,80,160,320,320,1260
30104,210,120,120,160,160,0,770
30105,190,80,40,80,160,0,550
30106,220,120,40,80,160,0,620
30107,190,140,160,160,0,0,650
30108,190,120,80,80,160,0,630
30109,210,120,160,160,0,0,650
30110,180,120,40,80,0,0,420
30111,170,160,160,240,320,0,1050
30112,160,120,80,80,160,0,600
30113,220,100,120,160,0,0,600
30114,190,140,160,80,0,0,570
30115,240,160,120,80,160,0,760
30116,190,100,160,160,160,0,770
30117,150,120,80,80,0,0,430
30118,200,160,120,80,160,0,720
30119,130,100,0,0,0,0,230
30120,220,140,120,160,160,0,800
30121,210,160,120,80,160,0,730
30122,190,140,160,160,160,0,810
30123,180,140,120,80,160,0,680
30124,200,120,200,240,320,320,1400
30125,170,160,80,80,160,0,650
30126,170,140,80,80,160,0,630
30127,200,180,200,80,160,0,820
30128,190,120,120,160,0,0,590
30129,180,100,160,160,160,0,760
30130,140,140,200,80,0,0,560
30131,200,80,80,80,160,320,920
30132,200,140,160,240,320,0,1060
30133,170,120,80,80,0,0,450
30134,180,160,160,80,0,0,580
30135,190,120,40,80,160,320,910
30136,200,100,120,160,160,0,740
30137,240,140,120,160,0,0,660
30138,180,100,80,0,0,0,360
30139,190,120,80,80,0,0,470
30140,220,180,80,80,160,0,720
30141,240,120,80,0,0,0,440
30142,240,140,80,160,320,0,940
30143,180,180,160,160,160,0,840
30144,190,60,80,0,0,0,330
30145,230,140,40,80,0,0,490
30146,210,140,200,160,320,320,1350
30147,180,120,80,0,0,0,380
30148,190,200,80,80,160,0,710
30149,240,200,120,160,160,0,880
30150,200,160,80,80,160,0,680
30151,210,120,40,0,0,0,370
30152,180,140,120,240,160,320,1160
30153,220,120,80,160,160,0,740
30154,210,140,80,160,160,0,750
30155,200,140,80,160,160,0,740
30156,190,100,80,0,0,0,370
30157,190,80,120,80,160,0,630
30158,230,160,80,80,0,0,550
30159,230,100,120,80,0,0,530
30160,200,120,40,80,0,0,440
30161,200,160,200,160,0,0,720
30162,210,140,40,80,0,0,470
30163,200,160,80,160,160,0,760
30164,200,120,160,80,160,0,720
30165,190,40,0,0,0,0,230
30166,230,140,120,80,0,0,570
30167,190,120,120,0,0,0,430
30168,200,80,80,160,320,320,1160
30169,230,180,240,240,320,320,1530
30170,200,60,80,80,0,0,420
30171,210,100,80,80,160,0,630
30172,210,160,160,80,0,0,610
30173,220,140,120,80,0,0,560
30174,180,120,80,160,160,0,700
30175,180,100,80,80,160,0,600
30176,210,140,120,160,320,0,950
30177,200,60,40,0,0,0,300
30178,210,140,120,80,0,0,550
30179,210,200,200,240,320,320,1490
30180,190,80,80,160,160,0,670
30181,200,120,120,0,0,0,440
30182,130,140,200,240,160,0,870
30183,190,80,120,160,320,320,1190
30184,220,100,160,160,0,0,640
30185,200,100,120,80,160,0,660
30186,170,80,80,0,0,0,330
30187,200,140,80,0,0,0,420
30188,170,100,80,80,160,0,590
30189,250,160,200,160,160,0,930
30190,190,160,120,80,160,320,1030
30191,190,120,120,160,160,0,750
30192,180,120,120,80,160,0,660
30193,190,120,40,80,0,0,430
30194,150,120,120,160,160,0,710
30195,160,100,80,160,160,0,660
30196,220,180,120,160,0,0,680
30197,210,140,160,240,160,320,1230
30198,210,120,80,160,0,0,570
30199,170,140,120,80,160,0,670
30200,180,140,120,80,0,0,520
30201,200,100,40,80,160,0,580
30202,150,80,160,80,160,0,630
30203,190,80,120,80,160,0,630
30204,210,80,80,160,320,320,1170
30205,190,140,120,80,0,0,530
30206,200,100,80,0,0,0,380
30207,220,80,80,80,160,320,940
30208,180,100,80,80,160,320,920
30209,210,160,120,80,0,0,570
30210,180,60,120,160,160,0,680
30211,190,140,200,160,160,320,1170
30212,180,120,200,160,160,0,820
30213,190,100,80,0,0,0,370
30214,180,80,40,0,0,0,300
30215,190,140,120,80,160,0,690
30216,230,120,160,80,160,0,750
30217,180,120,80,160,160,0,700
30218,210,120,120,80,160,0,690
30219,220,160,80,160,160,320,1100
30220,230,160,80,0,0,0,470
30221,220,120,80,0,0,0,420
30222,200,160,200,160,160,320,1200
30223,210,120,200,240,320,0,1090
30224,200,100,120,80,160,0,660
30225,190,120,80,80,160,0,630
30226,210,180,160,240,0,0,790
30227,180,120,120,160,160,0,740
30228,160,80,120,160,320,0,840
30229,160,80,160,160,160,0,720
30230,210,140,160,80,160,320,1070
30231,200,140,160,160,160,0,820
30232,210,120,120,160,320,0,930
30233,160,80,120,80,0,0,440
30234,230,180,80,80,0,0,570
30235,230,140,80,80,160,0,690
30236,210,120,40,80,0,0,450
30237,170,140,160,160,160,0,790
30238,190,180,160,160,0,0,690
30239,210,140,80,80,0,0,510
30240,190,180,120,80,160,0,730
30241,190,80,40,80,160,0,550
30242,170,140,120,160,160,0,750
30243,200,200,120,80,160,0,760
30244,220,80,120,160,320,0,900
30245,190,120,80,80,0,0,470
30246,180,140,120,160,160,320,1080
30247,180,140,120,240,320,320,1320
30248,190,80,80,0,0,0,350
30249,140,80,120,80,160,320,900
30250,210,120,200,160,160,320,1170
30251,200,120,160,240,320,0,1040
30252,220,120,80,80,160,0,660
30253,220,120,80,160,0,0,580
30254,200,140,160,80,0,0,580
30255,190,160,160,80,160,320,1070
30256,160,140,200,80,160,0,740
30257,210,100,120,0,0,0,430
30258,180,100,40,0,0,0,320
30259,230,120,120,80,160,0,710
30260,230,180,160,160,320,320,1370
30261,190,100,40,80,160,0,570
30262,170,140,160,160,160,0,790
30263,220,140,80,80,160,320,1000
30264,210,140,120,0,0,0,470
30265,210,140,160,240,160,0,910
30266,260,100,120,0,0,0,480
30267,220,100,40,80,160,0,600
30268,200,140,120,240,160,0,860
30269,190,100,80,80,160,0,610
30270,170,140,80,160,160,320,1030
30271,200,140,0,0,0,0,340
30272,210,120,120,80,0,0,530
30273,200,100,80,80,0,0,460
30274,190,160,160,160,320,320,1310
30275,170,100,80,160,0,0,510
30276,220,100,40,80,0,0,440
30277,180,160,120,80,160,0,700
30278,250,140,120,160,0,0,670
30279,200,100,80,80,0,0,460
30280,200,80,40,80,160,320,880
30281,160,100,120,160,320,320,1180
30282,180,120,160,80,160,0,700
30283,160,40,40,0,0,0,240
30284,190,120,40,0,0,0,350
30285,150,120,80,80,0,0,430
30286,200,160,120,160,160,0,800
30287,230,120,80,0,0,0,430
30288,180,160,40,80,160,0,620
30289,230,100,160,80,0,0,570
30290,200,200,160,160,320,320,1360
30291,150,80,80,160,320,0,790
30292,190,140,40,80,0,0,450
30293,190,80,120,0,0,0,390
30294,190,100,80,160,160,0,690
30295,240,140,160,240,320,0,1100
30296,180,140,120,160,0,0,600
30297,180,140,80,0,0,0,400
30298,180,100,160,0,0,0,440
30299,170,120,80,80,160,0,610
30300,180,80,80,160,320,0,820
30301,210,120,80,160,160,0,730
30302,200,100,80,80,160,0,620
30303,240,120,120,160,320,0,960
30304,140,140,80,80,160,0,600
30305,170,140,200,80,160,0,750
30306,160,140,80,160,320,0,860
30307,190,120,120,80,0,0,510
30308,240,120,80,80,0,0,520
30309,240,140,120,80,0,0,580
30310,210,160,160,0,0,0,530
30311,170,140,200,160,0,0,670
30312,190,100,80,0,0,0,370
30313,210,140,80,80,160,0,670
30314,200,60,80,80,160,0,580
30315,190,60,80,0,0,0,330
30316,220,140,80,80,160,0,680
30317,190,60,80,0,0,0,330
30318,190,100,80,80,160,0,610
30319,230,140,120,240,160,0,890
30320,220,80,40,0,0,0,340
30321,200,100,120,160,160,0,740
30322,210,160,40,80,0,0,490
30323,200,60,80,0,0,0,340
30324,190,80,120,160,160,0,710
30325,240,120,80,80,0,0,520
30326,170,120,80,0,0,0,370
30327,170,120,120,160,160,0,730
30328,200,60,80,80,160,0,580
30329,210,120,40,0,0,0,370
30330,170,160,120,160,0,0,610
30331,190,160,80,80,160,0,670
30332,190,120,120,80,160,0,670
30333,230,120,160,240,320,0,1070
30334,220,160,120,160,0,0,660
30335,190,180,160,240,160,0,930
30336,220,140,80,0,0,0,440
30337,190,120,80,0,0,0,390
30338,230,140,160,160,160,0,850
30339,210,120,120,160,160,0,770
30340,190,120,40,80,0,0,430
30341,210,120,120,160,160,0,770
30342,220,100,80,80,160,0,640
30343,240,140,80,160,0,0,620
30344,190,80,80,0,0,0,350
30345,220,120,120,240,160,0,860
30346,190,120,40,80,160,0,590
30347,200,120,120,160,160,0,760
30348,190,120,200,160,0,0,670
30349,200,100,40,80,160,0,580
30350,150,100,120,240,320,0,930
30351,170,80,120,160,320,320,1170
30352,240,180,120,80,0,0,620
30353,200,80,40,80,160,0,560
30354,160,100,40,80,160,0,540
30355,180,120,120,80,160,0,660
30356,140,100,120,160,160,320,1000
30357,210,120,120,160,320,0,930
30358,200,120,80,80,160,0,640
30359,190,120,120,80,0,0,510
30360,140,100,200,80,160,0,680
30361,200,100,120,160,320,0,900
30362,190,160,120,160,0,0,630
30363,200,80,80,160,160,0,680
30364,220,180,160,160,320,0,1040
30365,190,140,120,160,160,0,770
30366,210,120,80,80,160,0,650
30367,190,100,120,80,0,0,490
30368,180,140,160,240,320,0,1040
30369,160,100,80,80,0,0,420
30370,200,140,120,160,160,0,780
30371,210,120,120,80,160,0,690
30372,170,160,120,0,0,0,450
30373,230,120,120,240,160,0,870
30374,180,160,160,0,0,0,500
30375,170,100,120,80,0,0,470
30376,190,120,200,160,160,0,830
30377,200,140,120,80,0,0,540
30378,190,100,120,80,160,0,650
30379,200,180,40,0,0,0,420
30380,200,120,120,80,0,0,520
30381,200,80,40,80,160,0,560
30382,190,120,120,80,160,0,670
30383,210,120,120,0,0,0,450
30384,200,120,80,80,160,0,640
30385,180,100,40,80,0,0,400
30386,160,120,120,80,160,0,640
30387,210,160,0,0,0,0,370
30388,180,100,80,0,0,0,360
30389,210,140,120,80,160,0,710
30390,240,140,120,80,0,0,580
30391,220,60,80,80,160,320,920
30392,170,140,200,240,320,0,1070
30393,180,40,40,80,160,0,500
30394,200,180,120,240,320,0,1060
30395,200,100,160,160,160,0,780
30396,200,140,120,80,0,0,540
30397,180,120,80,80,0,0,460
30398,180,40,80,80,160,320,860
30399,210,120,80,160,0,0,570
30400,200,80,80,160,160,0,680
30401,210,100,160,160,160,0,790
30402,170,100,40,80,160,0,550
30403,150,80,40,0,0,0,270
30404,200,120,160,0,0,0,480
30405,190,160,160,80,160,0,750
30406,250,80,80,80,160,0,650
30407,210,160,120,160,320,0,970
30408,210,100,120,160,320,0,910
30409,200,120,80,0,0,0,400
30410,180,120,120,240,320,0,980
30411,150,120,160,240,320,320,1310
30412,200,200,160,160,320,320,1360
30413,220,120,80,0,0,0,420
30414,220,160,80,80,160,0,700
30415,210,120,40,80,160,320,930
30416,220,120,80,160,160,320,1060
30417,220,140,120,80,160,0,720
30418,220,160,80,80,160,0,700
30419,150,120,120,160,320,0,870
30420,220,100,40,80,160,0,600
30421,190,100,120,80,160,320,970
30422,180,80,40,0,0,0,300
30423,160,80,40,80,160,0,520
30424,210,140,120,240,160,0,870
30425,210,160,200,240,160,0,970
30426,210,120,120,80,160,0,690
30427,190,100,80,80,160,0,610
30428,190,140,160,160,320,320,1290
30429,170,140,160,240,160,0,870
30430,190,80,40,0,0,0,310
30431,200,120,120,0,0,0,440
30432,180,60,40,80,160,0,520
30433,170,80,120,80,0,0,450
30434,180,120,160,80,160,0,700
30435,180,100,120,160,160,0,720
30436,200,160,160,160,160,0,840
30437,200,200,200,80,160,0,840
30438,190,160,160,0,0,0,510
30439,190,140,160,240,160,0,890
30440,190,80,120,160,160,0,710
30441,190,160,160,160,320,0,990
30442,200,120,160,160,160,320,1120
30443,200,160,120,160,320,0,960
30444,170,120,120,80,160,0,650
30445,180,40,40,0,0,0,260
30446,200,180,120,80,160,0,740
30447,180,120,160,160,160,0,780
30448,190,100,120,80,160,0,650
30449,200,120,40,0,0,0,360
30450,190,180,80,80,0,0,530
30451,210,160,160,160,160,0,850
30452,220,80,40,80,160,0,580
30453,190,140,120,0,0,0,450
30454,160,160,160,160,0,0,640
30455,160,120,200,80,0,0,560
30456,250,180,200,160,320,320,1430
30457,170,100,80,80,160,320,910
30458,200,60,40,0,0,0,300
30459,220,160,80,80,160,0,700
30460,180,80,120,80,0,0,460
30461,190,120,80,160,160,0,710
30462,190,100,80,80,0,0,450
30463,210,160,120,80,0,0,570
30464,190,180,160,160,160,0,850
30465,190,100,80,160,160,320,1010
30466,190,120,120,160,160,320,1070
30467,230,180,120,0,0,0,530
30468,190,100,80,80,160,0,610
30469,190,100,120,80,160,0,650
30470,220,120,120,160,160,0,780
30471,180,100,80,0,0,0,360
30472,190,60,40,0,0,0,290
30473,200,100,120,160,320,0,900
30474,210,120,120,160,0,0,610
30475,140,100,120,160,160,0,680
30476,170,140,160,160,160,0,790
30477,210,160,80,80,160,0,690
30478,220,140,160,160,160,0,840
30479,200,100,0,0,0,0,300
30480,200,120,120,80,0,0,520
30481,220,180,160,80,160,0,800
30482,230,100,80,80,160,0,650
30483,190,140,80,80,160,320,970
30484,200,140,80,0,0,0,420
30485,210,100,80,80,0,0,470
30486,230,160,80,80,160,0,710
30487,210,100,80,80,0,0,470
30488,190,180,120,160,320,0,970
30489,200,100,80,80,160,0,620
30490,190,160,80,80,0,0,510
30491,190,140,120,80,160,0,690
30492,180,120,160,240,0,0,700
30493,200,180,40,80,160,0,660
30494,190,80,40,0,0,0,310
30495,180,80,160,160,160,0,740
30496,160,100,80,80,0,0,420
30497,200,140,120,160,160,0,780
30498,160,100,80,80,160,0,580
30499,210,160,160,240,160,0,930
30500,230,140,80,80,0,0,530
30501,170,60,80,0,0,0,310
30502,180,20,40,80,160,0,480
30503,180,160,120,160,320,0,940
30504,220,160,120,80,160,0,740
30505,180,80,80,80,160,0,580
30506,210,160,200,160,160,320,1210
30507,210,80,80,80,160,320,930
30508,170,140,120,80,160,0,670
30509,180,160,120,160,160,0,780
30510,210,140,120,0,0,0,470
30511,220,140,160,160,160,0,840
30512,190,120,120,80,160,0,670
30513,190,100,80,80,160,0,610
30514,170,160,120,80,0,0,530
30515,160,120,120,160,320,0,880
30516,190,180,120,160,320,0,970
30517,240,180,200,160,160,0,940
30518,220,180,120,80,0,0,600
30519,190,160,80,80,0,0,510
30520,150,100,80,80,0,0,410
30521,200,120,80,0,0,0,400
30522,200,100,40,80,0,0,420
30523,180,100,160,80,0,0,520
30524,220,100,0,0,0,0,320
30525,190,100,40,0,0,0,330
30526,180,120,40,0,0,0,340
30527,170,140,80,80,160,0,630
30528,240,160,120,160,0,0,680
30529,160,120,120,0,0,0,400
30530,210,120,80,160,160,0,730
30531,210,120,120,80,0,0,530
30532,190,140,80,80,0,0,490
30533,180,80,40,0,0,0,300
30534,240,140,120,160,160,0,820
30535,190,120,80,80,160,0,630
30536,170,100,120,160,320,0,870
30537,200,120,120,160,160,320,1080
30538,210,80,80,80,160,0,610
30539,230,200,120,80,0,0,630
30540,180,200,160,160,160,0,860
30541,210,100,160,80,160,0,710
30542,200,140,80,80,160,0,660
30543,150,120,120,160,320,0,870
30544,180,100,40,80,160,0,560
30545,180,120,0,0,0,0,300
30546,230,140,200,160,160,0,890
30547,180,100,80,0,0,0,360
30548,160,140,200,160,0,0,660
30549,180,120,120,80,0,0,500
30550,190,140,80,80,160,0,650
30551,170,100,120,0,0,0,390
30552,260,160,200,160,160,320,1260
30553,180,60,80,80,0,0,400
30554,200,100,40,80,160,0,580
30555,210,140,80,0,0,0,430
30556,220,140,120,240,0,0,720
30557,220,120,80,80,0,0,500
30558,210,120,160,80,160,0,730
30559,160,140,80,160,160,0,700
30560,210,160,120,80,0,0,570
30561,190,100,80,80,160,0,610
30562,210,100,80,80,0,0,470
30563,190,120,80,0,0,0,390
30564,230,180,240,240,320,0,1210
30565,190,80,80,80,160,320,910
30566,150,100,80,0,0,0,330
30567,180,160,80,80,160,0,660
30568,220,120,120,160,160,0,780
30569,210,60,40,0,0,0,310
30570,200,120,80,80,0,0,480
30571,200,60,80,80,160,0,580
30572,200,120,120,80,0,0,520
30573,230,140,120,240,320,0,1050
30574,200,160,40,80,0,0,480
30575,250,160,120,80,160,0,770
30576,190,140,160,160,160,320,1130
30577,160,80,80,80,160,0,560
30578,190,60,80,0,0,0,330
30579,170,80,80,0,0,0,330
30580,160,20,0,0,0,0,180
30581,210,60,80,80,0,0,430
30582,190,120,120,160,320,320,1230
30583,210,100,120,80,160,0,670
30584,240,140,120,0,0,0,500
30585,200,80,0,0,0,0,280
30586,200,140,80,80,160,0,660
30587,190,120,40,80,160,0,590
30588,180,100,120,160,0,0,560
30589,240,120,120,80,160,0,720
30590,190,140,120,0,0,0,450
30591,180,120,80,80,0,0,460
30592,200,120,160,240,320,320,1360
30593,180,120,200,160,160,0,820
30594,210,100,80,80,160,0,630
30595,210,120,40,0,0,0,370
30596,200,140,80,80,160,0,660
30597,210,100,40,0,0,0,350
30598,210,120,160,0,0,0,490
30599,220,80,120,80,0,0,500
30600,220,120,200,160,160,0,860
30601,180,80,40,80,0,0,380
30602,210,120,80,160,320,320,1210
30603,200,120,160,240,320,0,1040
30604,190,80,120,80,0,0,470
30605,230,140,80,80,0,0,530
30606,160,120,120,0,0,0,400
30607,180,60,80,160,160,320,960
30608,170,80,80,0,0,0,330
30609,210,100,160,160,160,0,790
30610,160,60,80,160,320,320,1100
30611,160,100,40,0,0,0,300
30612,210,100,40,80,0,0,430
30613,200,100,120,0,0,0,420
30614,180,140,120,80,160,320,1000
30615,200,120,120,160,160,0,760
30616,220,120,40,0,0,0,380
30617,200,120,120,160,0,0,600
30618,180,120,120,80,160,0,660
30619,190,160,160,80,0,0,590
30620,230,140,120,80,0,0,570
30621,190,160,200,160,160,0,870
30622,170,80,80,0,0,0,330
30623,240,120,120,80,0,0,560
30624,190,100,120,80,0,0,490
30625,180,140,160,80,0,0,560
30626,180,100,40,80,160,0,560
30627,210,140,120,160,160,320,1110
30628,220,140,80,80,0,0,520
30629,220,120,160,240,320,0,1060
30630,190,100,0,0,0,0,290
30631,210,120,160,160,160,0,810
30632,200,160,40,0,0,0,400
30633,210,100,80,0,0,0,390
30634,180,120,40,0,0,0,340
30635,190,40,40,80,0,0,350
30636,170,100,40,80,0,0,390
30637,250,140,120,160,160,0,830
30638,190,120,120,160,320,0,910
30639,160,120,200,160,160,0,800
30640,150,100,80,160,160,0,650
30641,160,60,80,80,0,0,380
30642,190,100,40,0,0,0,330
30643,130,100,120,80,160,320,910
30644,210,120,80,80,0,0,490
30645,220,160,120,160,0,0,660
30646,230,180,120,80,160,0,770
30647,200,120,120,0,0,0,440
30648,230,160,0,0,0,0,390
30649,190,80,120,160,160,0,710
30650,230,180,120,160,160,0,850
30651,200,100,80,160,320,320,1180
30652,220,140,160,80,160,320,1080
30653,160,100,40,80,0,0,380
30654,150,120,120,160,160,0,710
30655,180,80,80,80,0,0,420
30656,190,100,120,80,160,320,970
30657,170,160,160,160,320,320,1290
30658,210,140,40,0,0,0,390
30659,170,100,80,0,0,0,350
30660,180,120,200,80,0,0,580
30661,210,80,80,80,0,0,450
30662,200,100,80,0,0,0,380
30663,220,140,120,80,160,320,1040
30664,250,160,160,160,160,320,1210
30665,200,100,120,160,0,0,580
30666,220,160,120,160,160,0,820
30667,200,80,80,80,160,0,600
30668,190,120,160,80,160,0,710
30669,230,120,200,160,160,0,870
30670,220,140,200,80,0,0,640
30671,170,140,120,160,160,0,750
30672,220,120,80,0,0,0,420
30673,200,120,120,80,0,0,520
30674,190,80,80,80,0,0,430
30675,200,120,80,80,0,0,480
30676,170,140,40,0,0,0,350
30677,210,140,80,160,160,0,750
30678,190,140,120,80,160,0,690
30679,170,120,80,160,160,0,690
30680,190,80,120,80,0,0,470
30681,240,120,80,0,0,0,440
30682,190,80,80,160,160,0,670
30683,210,100,160,160,160,0,790
30684,170,40,80,80,0,0,370
30685,210,120,80,160,0,0,570
30686,210,120,160,240,320,0,1050
30687,250,100,160,80,160,0,750
30688,200,40,40,0,0,0,280
30689,210,120,120,160,160,0,770
30690,190,120,160,160,320,0,950
30691,170,180,120,80,160,320,1030
30692,180,120,80,80,0,0,460
30693,210,120,120,80,0,0,530
30694,170,120,160,160,320,0,930
30695,180,140,80,160,320,0,880
30696,180,80,80,80,160,0,580
30697,170,120,160,80,160,0,690
30698,180,120,160,80,0,0,540
30699,180,120,80,80,0,0,460
30700,190,80,80,80,160,0,590
30701,230,160,160,80,160,0,790
30702,160,120,40,0,0,0,320
30703,230,180,160,160,160,0,890
30704,150,120,160,160,160,320,1070
30705,220,180,120,160,320,0,1000
30706,220,140,120,160,160,0,800
30707,220,140,80,160,0,0,600
30708,200,120,80,80,0,0,480
30709,210,120,160,80,0,0,570
30710,210,120,80,160,320,320,1210
30711,170,160,80,80,160,320,970
30712,190,120,120,240,160,0,830
30713,200,120,120,0,0,0,440
30714,190,120,160,160,0,0,630
30715,160,160,160,240,320,320,1360
30716,200,200,120,80,160,0,760
30717,200,100,40,0,0,0,340
30718,200,140,80,160,320,320,1220
30719,180,100,120,160,160,0,720
30720,190,140,120,80,160,320,1010
30721,190,120,160,80,160,0,710
30722,220,200,120,80,160,0,780
30723,180,60,40,0,0,0,280
30724,220,140,120,80,0,0,560
30725,150,140,120,80,160,0,650
30726,190,140,160,160,160,0,810
30727,190,180,80,80,160,0,690
30728,160,120,120,80,160,320,960
30729,170,100,120,160,160,320,1030
30730,180,140,120,0,0,0,440
30731,200,140,120,80,160,0,700
30732,170,120,120,80,0,0,490
30733,190,140,160,240,160,0,890
30734,210,160,160,240,160,320,1250
30735,210,180,160,160,0,0,710
30736,200,100,40,80,160,320,900
30737,200,80,80,80,0,0,440
30738,210,100,160,240,160,0,870
30739,190,100,160,80,0,0,530
30740,200,60,40,0,0,0,300
30741,180,100,120,160,320,320,1200
30742,190,100,40,80,160,0,570
30743,230,140,120,80,160,0,730
30744,180,140,160,240,320,0,1040
30745,180,140,120,80,0,0,520
30746,180,120,160,160,0,0,620
30747,160,100,120,0,0,0,380
30748,220,120,160,80,160,0,740
30749,210,140,80,160,160,0,750
30750,210,160,80,80,160,0,690
30751,240,120,40,80,0,0,480
30752,220,140,160,80,160,0,760
30753,190,100,80,80,0,0,450
30754,220,100,120,160,0,0,600
30755,190,180,200,80,160,0,810
30756,220,100,80,80,160,320,960
30757,180,120,80,80,160,0,620
30758,200,140,120,80,160,0,700
30759,230,100,40,80,0,0,450
30760,220,160,120,80,160,0,740
30761,200,140,120,80,0,0,540
30762,200,100,80,0,0,0,380
30763,210,180,160,160,160,0,870
30764,200,120,80,0,0,0,400
30765,180,120,80,0,0,0,380
30766,240,160,120,80,160,320,1080
30767,210,140,120,80,160,0,710
30768,210,160,80,160,0,0,610
30769,180,80,120,0,0,0,380
30770,200,140,160,160,320,0,980
30771,220,140,120,160,160,0,800
30772,210,100,120,80,160,0,670
30773,220,100,120,80,160,0,680
30774,220,180,80,80,0,0,560
30775,220,140,80,80,160,0,680
30776,210,160,80,160,160,0,770
30777,150,120,80,0,0,0,350
30778,210,100,40,80,160,0,590
30779,200,160,160,160,160,0,840
30780,190,120,40,0,0,0,350
30781,200,140,160,160,160,0,820
30782,220,100,80,80,160,0,640
30783,240,120,40,0,0,0,400
30784,210,140,80,80,160,0,670
30785,240,140,120,80,0,0,580
30786,190,100,120,160,320,0,890
30787,200,160,200,160,160,0,880
30788,240,160,80,80,0,0,560
30789,180,140,120,160,320,0,920
30790,200,80,80,80,160,0,600
30791,140,100,40,0,0,0,280
30792,160,80,0,0,0,0,240
30793,190,60,80,80,160,0,570
30794,190,120,80,80,160,0,630
30795,190,140,80,80,0,0,490
30796,160,120,80,160,160,0,680
30797,180,80,40,80,160,0,540
30798,230,160,160,160,320,0,1030
30799,220,200,200,160,160,0,940
30800,170,80,80,80,160,0,570
30801,200,120,160,160,0,0,640
30802,190,120,160,160,160,0,790
30803,160,100,120,80,0,0,460
30804,190,140,120,80,0,0,530
30805,210,120,80,80,160,0,650
30806,210,140,80,80,0,0,510
30807,190,140,80,80,0,0,490
30808,240,160,160,80,0,0,640
30809,200,80,80,80,0,0,440
30810,170,80,120,80,0,0,450
30811,180,40,40,80,0,0,340
30812,150,100,120,80,160,0,610
30813,210,140,160,160,160,0,830
30814,200,160,120,0,0,0,480
30815,210,180,160,160,0,0,710
30816,190,80,120,240,320,0,950
30817,150,80,120,80,0,0,430
30818,190,120,80,80,160,0,630
30819,200,160,160,240,160,320,1240
30820,210,140,40,0,0,0,390
30821,190,120,120,160,320,320,1230
30822,200,120,120,160,0,0,600
30823,170,100,120,80,160,0,630
30824,180,140,80,80,160,0,640
30825,190,140,120,80,0,0,530
30826,180,100,160,160,160,0,760
30827,180,160,120,0,0,0,460
30828,190,100,80,80,160,0,610
30829,210,120,80,0,0,0,410
30830,270,160,120,80,0,0,630
30831,220,140,120,80,0,0,560
30832,240,160,80,160,0,0,640
30833,180,140,120,160,320,0,920
30834,210,160,160,80,160,320,1090
30835,220,140,160,240,160,0,920
30836,210,80,0,0,0,0,290
30837,170,60,80,160,160,0,630
30838,160,140,160,80,160,0,700
30839,200,40,80,160,160,0,640
30840,220,180,80,80,0,0,560
30841,210,120,160,160,160,0,810
30842,140,80,40,80,0,0,340
30843,230,100,160,160,320,0,970
30844,220,140,120,80,0,0,560
30845,220,140,40,80,160,0,640
30846,200,120,120,160,0,0,600
30847,220,100,120,160,160,320,1080
30848,170,60,40,0,0,0,270
30849,150,60,0,0,0,0,210
30850,200,120,160,160,160,0,800
30851,160,140,120,160,0,0,580
30852,220,140,160,160,0,0,680
30853,210,120,40,0,0,0,370
30854,190,100,80,80,160,0,610
30855,200,120,120,160,160,0,760
30856,230,120,120,160,0,0,630
30857,190,60,80,80,0,0,410
30858,230,80,80,160,160,320,1030
30859,190,100,40,80,0,0,410
30860,210,140,160,80,160,0,750
30861,230,180,200,160,0,0,770
30862,200,60,80,160,0,0,500
30863,160,160,80,80,0,0,480
30864,220,160,80,160,320,320,1260
30865,260,140,80,160,160,0,800
30866,210,120,120,160,160,0,770
30867,240,80,160,160,160,0,800
30868,170,120,80,80,0,0,450
30869,180,160,80,160,160,0,740
30870,200,120,120,80,160,0,680
30871,200,120,120,160,320,0,920
30872,220,140,120,0,0,0,480
30873,220,160,120,80,160,0,740
30874,230,140,120,160,0,0,650
30875,170,100,80,160,320,320,1150
30876,210,100,120,160,320,0,910
30877,210,100,160,160,0,0,630
30878,210,120,80,80,0,0,490
30879,230,140,120,240,320,320,1370
30880,220,180,120,80,160,0,760
30881,170,80,0,0,0,0,250
30882,200,120,160,240,160,0,880
30883,220,200,120,80,160,0,780
30884,190,100,160,80,0,0,530
30885,190,100,120,160,160,0,730
30886,170,120,120,240,160,320,1130
30887,220,200,200,160,0,0,780
30888,200,100,80,80,160,320,940
30889,190,80,80,0,0,0,350
30890,140,140,200,80,0,0,560
30891,200,120,80,80,160,0,640
30892,210,100,80,160,160,0,710
30893,200,80,160,160,160,0,760
30894,230,120,120,80,160,0,710
30895,190,100,120,80,0,0,490
30896,250,60,0,0,0,0,310
30897,230,180,120,80,160,0,770
30898,220,140,120,0,0,0,480
30899,200,140,120,160,160,0,780
30900,180,100,120,80,160,0,640
30901,190,100,80,80,0,0,450
30902,210,120,80,160,160,0,730
30903,220,100,40,0,0,0,360
30904,240,100,80,80,0,0,500
30905,200,140,160,160,0,0,660
30906,220,160,160,0,0,0,540
30907,230,140,160,80,160,0,770
30908,180,100,80,0,0,0,360
30909,160,140,80,80,0,0,460
30910,220,80,40,0,0,0,340
30911,190,140,80,80,0,0,490
30912,210,140,80,80,160,0,670
30913,180,140,120,80,0,0,520
30914,230,120,160,160,160,320,1150
30915,190,80,0,0,0,0,270
30916,170,180,200,160,160,0,870
30917,210,140,160,160,0,0,670
30918,160,100,200,160,320,0,940
30919,240,200,200,160,320,320,1440
30920,200,140,120,160,160,320,1100
30921,210,160,160,240,320,0,1090
30922,200,140,160,160,320,0,980
30923,220,120,80,160,320,320,1220
30924,210,120,120,80,160,0,690
30925,210,140,80,160,160,0,750
30926,170,140,160,240,160,0,870
30927,200,100,160,160,160,0,780
30928,220,100,160,240,160,0,880
30929,190,160,40,80,0,0,470
30930,220,140,120,160,320,320,1280
30931,210,200,200,160,160,0,930
30932,170,100,40,0,0,0,310
30933,210,100,40,80,160,0,590
30934,210,180,200,160,160,0,910
30935,180,160,160,160,160,0,820
30936,190,120,40,0,0,0,350
30937,150,120,80,80,160,0,590
30938,180,120,120,80,0,0,500
30939,170,140,120,160,0,0,590
30940,180,120,120,160,320,0,900
30941,160,120,120,160,160,0,720
30942,210,60,120,160,160,0,710
30943,230,180,120,160,160,0,850
30944,210,140,160,160,160,0,830
30945,210,160,120,160,160,0,810
30946,210,140,120,160,320,320,1270
30947,220,140,120,80,0,0,560
30948,170,120,200,240,160,320,1210
30949,200,180,160,160,160,0,860
30950,220,120,40,80,160,0,620
30951,240,140,120,0,0,0,500
30952,200,100,120,80,160,0,660
30953,210,120,80,0,0,0,410
30954,190,100,160,80,160,0,690
30955,200,120,120,160,320,0,920
30956,230,180,200,160,0,0,770
30957,180,100,80,80,160,0,600
30958,180,100,80,80,160,0,600
30959,200,100,80,80,0,0,460
30960,180,140,160,80,0,0,560
30961,160,80,120,240,320,320,1240
30962,240,200,120,80,160,0,800
30963,250,100,120,160,0,0,630
30964,190,140,120,80,0,0,530
30965,190,120,160,240,160,0,870
30966,190,140,120,80,160,0,690
30967,190,100,40,0,0,0,330
30968,190,100,120,160,0,0,570
30969,150,100,120,80,160,0,610
30970,200,200,160,160,160,0,880
30971,180,120,120,160,320,0,900
30972,210,160,200,160,160,0,890
30973,200,160,120,80,160,0,720
30974,160,160,160,160,320,0,960
30975,210,100,40,80,160,0,590
30976,200,200,120,160,160,0,840
30977,200,100,80,80,160,320,940
30978,200,120,80,80,0,0,480
30979,190,100,80,80,160,320,930
30980,180,100,120,80,160,320,960
30981,220,180,120,80,0,0,600
30982,220,100,80,0,0,0,400
30983,190,120,120,160,160,0,750
30984,190,100,40,80,0,0,410
30985,210,100,120,80,0,0,510
30986,180,120,120,160,160,0,740
30987,190,100,120,160,160,0,730
30988,230,140,200,240,160,0,970
30989,210,140,80,0,0,0,430
30990,160,100,80,160,160,0,660
30991,200,140,120,160,160,0,780
30992,210,120,120,240,0,0,690
30993,200,120,120,0,0,0,440
30994,170,140,120,160,160,0,750
30995,200,140,160,80,160,0,740
30996,210,80,120,80,160,320,970
30997,190,180,200,80,160,0,810
30998,180,100,120,240,320,0,960
30999,190,120,120,0,0,0,430
31000,180,60,80,0,0,0,320
31001,190,160,120,80,160,0,710
31002,210,140,80,0,0,0,430
31003,190,160,80,80,160,0,670
31004,200,140,120,160,0,0,620
31005,210,140,80,80,160,0,670
31006,200,140,160,160,160,0,820
31007,170,140,120,160,160,0,750
31008,220,140,80,80,160,0,680
31009,170,100,0,0,0,0,270
31010,180,100,120,160,160,0,720
31011,180,160,200,240,320,0,1100
31012,160,120,80,80,0,0,440
31013,190,160,200,240,320,0,1110
31014,230,100,80,80,0,0,490
31015,200,100,40,0,0,0,340
31016,190,140,160,160,320,0,970
31017,230,120,120,80,160,0,710
31018,210,140,160,240,320,320,1390
31019,170,120,120,160,0,0,570
31020,250,200,160,0,0,0,610
31021,180,80,0,0,0,0,260
31022,220,120,40,80,0,0,460
31023,210,120,120,80,0,0,530
31024,210,100,40,80,0,0,430
31025,170,100,160,160,160,0,750
31026,130,100,80,80,0,0,390
31027,240,140,120,160,0,0,660
31028,180,120,80,0,0,0,380
31029,210,120,80,80,0,0,490
31030,230,140,80,80,160,0,690
31031,230,100,80,80,160,0,650
31032,180,120,80,80,160,0,620
31033,160,120,80,80,160,0,600
31034,190,100,120,80,160,0,650
31035,210,140,80,160,160,0,750
31036,150,80,80,80,160,320,870
31037,170,60,40,80,160,0,510
31038,180,100,0,0,0,0,280
31039,170,120,120,80,160,0,650
31040,170,140,120,0,0,0,430
31041,230,100,0,0,0,0,330
31042,170,140,80,80,160,0,630
31043,210,80,40,80,160,0,570
31044,150,80,40,80,160,0,510
31045,170,140,120,80,0,0,510
31046,170,100,80,80,160,0,590
31047,230,160,40,80,160,320,990
31048,220,100,80,80,160,0,640
31049,190,140,120,80,160,0,690
31050,170,40,40,80,0,0,330
31051,200,100,120,80,160,0,660
31052,220,120,80,160,0,0,580
31053,200,120,160,80,0,0,560
31054,220,160,120,160,160,0,820
31055,230,100,80,160,160,0,730
31056,190,160,200,80,0,0,630
31057,210,160,160,160,160,0,850
31058,210,140,200,240,320,320,1430
31059,190,160,120,80,160,0,710
31060,160,120,80,160,320,0,840
31061,200,100,120,160,160,0,740
31062,200,140,120,80,0,0,540
31063,240,120,120,160,320,0,960
31064,180,140,120,160,160,0,760
31065,210,100,80,80,0,0,470
31066,170,140,160,80,0,0,550
31067,190,120,120,160,160,0,750
31068,230,100,80,160,0,0,570
31069,200,120,80,0,0,0,400
31070,190,160,160,160,160,0,830
31071,170,160,80,80,0,0,490
31072,150,120,120,80,0,0,470
31073,180,140,80,160,160,0,720
31074,180,100,80,0,0,0,360
31075,220,120,120,80,0,0,540
31076,230,160,120,80,0,0,590
31077,200,40,40,80,0,0,360
31078,140,60,40,80,160,320,800
31079,210,120,120,80,160,320,1010
31080,210,100,80,160,160,0,710
31081,200,140,80,80,160,0,660
31082,180,160,40,0,0,0,380
31083,180,140,80,80,0,0,480
31084,210,140,120,80,0,0,550
31085,190,140,160,160,160,0,810
31086,230,160,200,240,160,0,990
31087,190,80,80,80,0,0,430
31088,210,140,160,160,160,320,1150
31089,180,120,80,80,0,0,460
31090,220,120,40,0,0,0,380
31091,200,100,80,80,0,0,460
31092,200,80,0,0,0,0,280
31093,130,100,120,80,0,0,430
31094,200,140,160,80,160,0,740
31095,230,160,120,80,0,0,590
31096,160,120,80,80,0,0,440
31097,200,80,120,160,0,0,560
31098,170,80,40,0,0,0,290
31099,190,100,120,160,0,0,570
31100,220,120,120,80,160,0,700
31101,200,140,160,160,320,0,980
31102,210,140,120,0,0,0,470
31103,190,100,80,80,160,0,610
31104,200,100,120,80,160,0,660
31105,170,120,40,80,160,0,570
31106,180,80,120,80,160,0,620
31107,180,100,40,0,0,0,320
31108,190,100,80,160,320,0,850
31109,180,100,80,80,0,0,440
31110,150,100,80,0,0,0,330
31111,230,160,120,160,160,0,830
31112,200,100,80,160,160,0,700
31113,210,160,80,80,160,0,690
31114,200,160,80,0,0,0,440
31115,180,60,40,0,0,0,280
31116,200,160,80,160,320,320,1240
31117,220,140,120,80,0,0,560
31118,220,140,80,80,160,0,680
31119,240,140,200,160,160,0,900
31120,230,180,120,160,160,0,850
31121,190,100,120,160,160,0,730
31122,210,80,120,80,160,0,650
31123,210,100,80,0,0,0,390
31124,180,120,80,80,160,0,620
31125,160,120,120,240,160,0,800
31126,130,60,80,160,320,0,750
31127,190,120,120,160,320,0,910
31128,230,100,120,80,160,0,690
31129,170,140,120,80,0,0,510
31130,190,120,200,160,160,0,830
31131,230,140,80,80,160,0,690
31132,190,140,80,160,160,320,1050
31133,230,160,160,80,0,0,630
31134,190,120,80,80,160,320,950
31135,170,120,80,80,160,0,610
31136,200,160,200,80,0,0,640
31137,200,180,40,80,0,0,500
31138,230,140,120,80,0,0,570
31139,170,80,80,80,0,0,410
31140,190,100,80,80,160,0,610
31141,150,140,160,160,160,320,1090
31142,190,60,40,80,160,0,530
31143,200,140,160,80,0,0,580
31144,240,120,80,80,0,0,520
31145,190,100,40,0,0,0,330
31146,160,100,120,160,160,0,700
31147,220,140,80,0,0,0,440
31148,190,120,120,0,0,0,430
31149,230,100,40,80,160,0,610
31150,210,120,80,0,0,0,410
31151,200,140,80,80,160,320,980
31152,210,140,120,160,160,0,790
31153,200,60,80,0,0,0,340
31154,210,160,200,160,160,0,890
31155,210,100,120,80,0,0,510
31156,180,180,120,80,160,0,720
31157,190,100,80,160,320,0,850
31158,200,120,80,80,0,0,480
31159,180,100,200,240,320,320,1360
31160,200,80,40,80,160,0,560
31161,260,160,120,240,160,0,940
31162,210,160,160,80,160,0,770
31163,210,100,160,80,0,0,550
31164,230,120,80,80,0,0,510
31165,220,120,120,160,0,0,620
31166,220,120,80,80,160,0,660
31167,230,80,160,240,0,0,710
31168,210,160,80,80,160,0,690
31169,190,160,120,160,0,0,630
31170,210,100,40,80,160,0,590
31171,180,120,160,160,320,0,940
31172,190,100,200,80,0,0,570
31173,200,120,120,80,0,0,520
31174,210,120,160,240,320,0,1050
31175,200,100,40,80,0,0,420
31176,190,80,80,80,160,0,590
31177,190,100,160,0,0,0,450
31178,200,120,120,80,160,0,680
31179,180,120,160,240,160,0,860
31180,170,80,120,160,160,0,690
31181,200,120,120,160,160,0,760
31182,190,120,160,160,160,320,1110
31183,230,120,120,240,320,320,1350
31184,210,120,120,80,0,0,530
31185,180,180,120,80,160,0,720
31186,190,100,120,160,160,320,1050
31187,170,140,80,0,0,0,390
31188,200,120,120,160,160,0,760
31189,220,100,160,160,160,0,800
31190,230,100,80,80,160,0,650
31191,180,120,120,160,160,0,740
31192,190,140,120,80,160,0,690
31193,250,180,160,0,0,0,590
31194,200,100,120,80,0,0,500
31195,220,180,80,80,160,0,720
31196,150,120,40,80,0,0,390
31197,240,120,80,160,0,0,600
31198,220,120,40,0,0,0,380
31199,200,160,0,0,0,0,360
31200,230,140,160,160,160,0,850
31201,190,100,80,80,160,0,610
31202,200,100,40,0,0,0,340
31203,180,140,160,160,160,0,800
31204,170,120,80,0,0,0,370
31205,190,140,80,80,160,0,650
31206,230,180,200,320,320,0,1250
31207,180,140,200,160,160,0,840
31208,200,120,120,80,0,0,520
31209,230,100,40,0,0,0,370
31210,250,100,160,160,160,0,830
31211,200,100,40,0,0,0,340
31212,210,120,40,80,160,0,610
31213,200,80,80,80,0,0,440
31214,210,120,80,80,0,0,490
31215,190,140,160,160,160,0,810
31216,200,100,120,160,160,0,740
31217,200,100,80,160,320,0,860
31218,180,80,80,160,320,0,820
31219,180,120,120,80,160,0,660
31220,200,100,80,80,160,0,620
31221,210,120,120,160,320,0,930
31222,210,160,120,80,160,0,730
31223,200,140,80,80,0,0,500
31224,190,120,80,80,0,0,470
31225,190,140,120,80,0,0,530
31226,160,120,160,160,0,0,600
31227,220,160,160,160,320,320,1340
31228,170,80,0,0,0,0,250
31229,200,140,200,160,0,0,700
31230,170,80,120,80,160,320,930
31231,220,180,120,80,0,0,600
31232,230,100,120,160,160,0,770
31233,180,120,200,80,0,0,580
31234,180,80,160,160,320,0,900
31235,180,100,120,160,0,0,560
31236,220,120,40,0,0,0,380
31237,200,140,120,80,160,320,1020
31238,160,140,80,160,0,0,540
31239,190,120,120,240,160,0,830
31240,260,160,120,80,0,0,620
31241,200,80,40,80,0,0,400
31242,210,160,200,160,320,0,1050
31243,170,120,80,160,320,320,1170
31244,190,120,40,0,0,0,350
31245,190,140,80,80,160,0,650
31246,150,80,0,0,0,0,230
31247,170,160,160,240,160,0,890
31248,220,60,80,80,160,0,600
31249,190,160,40,80,160,0,630
31250,210,120,120,160,0,0,610
31251,200,180,160,240,320,320,1420
31252,180,100,80,160,160,0,680
31253,160,120,160,80,160,0,680
31254,200,60,40,80,160,320,860
31255,190,140,40,80,160,0,610
31256,210,140,120,160,160,0,790
31257,190,120,120,0,0,0,430
31258,200,40,0,0,0,0,240
31259,190,100,80,80,160,0,610
31260,220,140,160,80,0,0,600
31261,180,100,120,160,320,320,1200
31262,200,160,120,0,0,0,480
31263,190,160,160,160,160,0,830
31264,210,140,80,80,160,0,670
31265,180,140,160,80,160,0,720
31266,180,160,120,80,160,0,700
31267,190,100,120,0,0,0,410
31268,190,100,120,160,320,0,890
31269,210,80,80,80,160,0,610
31270,110,100,80,80,160,0,530
31271,160,100,40,80,160,320,860
31272,190,120,120,0,0,0,430
31273,220,80,80,80,0,0,460
31274,180,120,80,80,160,0,620
31275,160,60,120,80,160,0,580
31276,190,120,160,160,160,0,790
31277,200,140,120,160,160,0,780
31278,180,140,160,80,160,0,720
31279,180,140,160,160,160,0,800
31280,190,140,80,0,0,0,410
31281,200,160,80,0,0,0,440
31282,190,140,80,0,0,0,410
31283,190,140,160,160,0,0,650
31284,160,120,120,80,160,0,640
31285,220,160,160,160,0,0,700
31286,160,80,80,80,160,0,560
31287,180,120,120,80,160,0,660
31288,160,100,120,160,160,0,700
31289,180,80,80,80,160,0,580
31290,220,180,120,160,160,320,1160
31291,160,40,80,160,160,0,600
31292,170,120,80,0,0,0,370
31293,210,80,80,80,0,0,450
31294,180,100,80,80,160,0,600
31295,230,160,160,80,160,0,790
31296,210,120,120,80,160,320,1010
31297,210,140,200,80,160,0,790
31298,230,160,120,80,0,0,590
31299,200,120,40,80,0,0,440
31300,200,20,0,0,0,0,220
31301,190,100,40,80,160,0,570
31302,200,180,80,80,160,0,700
31303,160,80,120,80,160,0,600
31304,210,120,120,0,0,0,450
31305,150,120,120,80,160,320,950
31306,240,140,120,80,160,0,740
31307,180,100,40,80,160,0,560
31308,210,80,80,0,0,0,370
31309,190,160,160,80,160,0,750
31310,200,120,40,80,160,0,600
31311,210,60,40,0,0,0,310
31312,190,120,160,240,320,0,1030
31313,230,80,80,80,160,0,630
31314,230,160,160,80,160,320,1110
31315,190,140,120,80,0,0,530
31316,210,160,160,160,160,0,850
31317,150,80,40,80,160,0,510
31318,180,100,80,80,0,0,440
31319,180,120,40,0,0,0,340
31320,200,180,160,160,160,0,860
31321,200,200,200,160,320,320,1400
31322,180,140,80,160,160,0,720
31323,180,100,160,160,160,0,760
31324,180,200,240,80,0,0,700
31325,210,140,120,0,0,0,470
31326,190,100,120,80,160,0,650
31327,180,100,40,80,160,0,560
31328,210,100,80,0,0,0,390
31329,200,120,160,80,160,0,720
31330,150,120,160,160,160,0,750
31331,180,180,120,80,160,0,720
31332,210,180,120,0,0,0,510
31333,210,140,160,160,0,0,670
31334,190,120,80,80,160,0,630
31335,170,120,40,0,0,0,330
31336,170,80,80,80,160,320,890
31337,190,80,80,80,160,0,590
31338,200,140,160,80,0,0,580
31339,180,100,40,0,0,0,320
31340,180,120,120,80,160,0,660
31341,190,100,120,160,160,0,730
31342,190,140,80,80,0,0,490
31343,250,200,120,160,160,0,890
31344,170,120,120,160,320,320,1210
31345,220,160,120,80,160,0,740
31346,220,120,120,80,0,0,540
31347,210,120,80,0,0,0,410
31348,200,120,200,160,160,0,840
31349,180,120,80,0,0,0,380
31350,190,140,160,160,0,0,650
31351,170,100,120,80,160,0,630
31352,210,100,80,80,160,320,950
31353,210,120,80,0,0,0,410
31354,210,160,80,0,0,0,450
31355,170,80,40,80,160,0,530
31356,230,140,120,160,160,0,810
31357,230,160,40,80,160,0,670
31358,200,120,120,160,0,0,600
31359,210,100,0,0,0,0,310
31360,210,140,120,0,0,0,470
31361,190,80,120,160,160,0,710
31362,210,140,80,80,160,0,670
31363,250,140,160,240,320,320,1430
31364,240,100,0,0,0,0,340
31365,220,100,80,80,0,0,480
31366,170,80,40,80,160,0,530
31367,210,140,200,160,160,0,870
31368,220,140,80,160,160,0,760
31369,200,100,120,80,0,0,500
31370,230,100,120,160,320,320,1250
31371,180,100,120,160,0,0,560
31372,190,140,160,80,160,0,730
31373,190,180,160,80,160,0,770
31374,210,100,160,80,0,0,550
31375,190,160,200,240,320,320,1430
31376,220,180,160,160,320,0,1040
31377,210,60,80,160,160,320,990
31378,200,160,0,0,0,0,360
31379,220,180,120,80,160,0,760
31380,190,140,200,160,320,0,1010
31381,160,100,80,80,160,0,580
31382,220,140,160,240,160,0,920
31383,200,100,80,80,160,0,620
31384,250,120,40,80,160,0,650
31385,220,140,120,0,0,0,480
31386,210,160,200,160,320,0,1050
31387,210,160,160,80,0,0,610
31388,220,120,40,80,0,0,460
31389,230,160,120,80,160,0,750
31390,170,160,80,80,160,0,650
31391,190,140,160,160,160,0,810
31392,190,100,80,80,160,320,930
31393,200,80,120,80,0,0,480
31394,170,120,120,80,0,0,490
31395,190,60,0,0,0,0,250
31396,190,80,40,80,160,0,550
31397,210,140,120,80,160,0,710
31398,180,80,120,160,0,0,540
31399,150,100,40,80,160,0,530
31400,210,160,200,160,0,0,730
31401,160,80,80,0,0,0,320
31402,210,100,80,80,0,0,470
31403,210,160,120,80,160,320,1050
31404,170,140,240,80,160,0,790
31405,200,140,160,160,160,0,820
31406,210,140,80,80,160,0,670
31407,180,100,40,80,0,0,400
31408,200,140,160,80,160,0,740
31409,200,180,160,160,160,0,860
31410,210,140,200,240,0,0,790
31411,170,80,80,0,0,0,330
31412,230,140,120,160,160,0,810
31413,170,100,40,0,0,0,310
31414,190,160,120,0,0,0,470
31415,150,140,80,160,160,0,690
31416,220,120,40,80,160,0,620
31417,250,220,80,80,160,0,790
31418,200,140,80,160,160,320,1060
31419,180,100,80,160,160,0,680
31420,180,140,120,160,160,320,1080
31421,160,120,120,160,160,0,720
31422,200,140,80,80,160,0,660
31423,230,100,40,0,0,0,370
31424,160,140,160,240,160,0,860
31425,210,100,40,0,0,0,350
31426,160,100,80,80,160,0,580
31427,200,80,80,160,320,0,840
31428,180,80,120,160,320,320,1180
31429,200,180,80,80,160,0,700
31430,200,120,0,0,0,0,320
31431,190,140,200,160,160,0,850
31432,220,180,200,240,320,320,1480
31433,190,40,40,0,0,0,270
31434,170,140,240,240,160,0,950
31435,180,120,80,0,0,0,380
31436,220,160,80,0,0,0,460
31437,220,160,80,80,0,0,540
31438,160,120,80,80,0,0,440
31439,190,120,160,240,320,0,1030
31440,170,100,120,80,160,320,950
31441,210,180,120,80,160,0,750
31442,240,120,80,80,160,0,680
31443,200,180,80,0,0,0,460
31444,200,160,160,80,160,0,760
31445,220,120,120,80,160,0,700
31446,220,120,160,80,0,0,580
31447,160,120,120,80,160,0,640
31448,190,140,160,160,160,320,1130
31449,220,140,120,80,160,0,720
31450,180,100,160,80,0,0,520
31451,180,120,160,80,160,0,700
31452,180,140,160,80,160,0,720
31453,250,160,120,160,320,0,1010
31454,220,100,120,0,0,0,440
31455,190,120,40,0,0,0,350
31456,210,120,40,80,160,0,610
31457,200,120,80,80,160,0,640
31458,200,120,80,80,0,0,480
31459,210,120,120,80,0,0,530
31460,200,180,40,0,0,0,420
31461,170,140,120,80,160,0,670
31462,180,140,120,80,160,0,680
31463,220,180,160,80,160,0,800
31464,250,160,160,160,160,0,890
31465,210,220,160,80,160,0,830
31466,200,140,80,80,0,0,500
31467,160,120,120,80,0,0,480
31468,190,140,120,80,0,0,530
31469,170,100,120,80,160,0,630
31470,210,100,80,80,160,0,630
31471,170,140,160,80,160,0,710
31472,140,60,120,160,320,0,800
31473,230,140,120,160,160,320,1130
31474,210,80,40,0,0,0,330
31475,210,100,120,80,0,0,510
31476,220,180,120,80,160,0,760
31477,220,140,120,80,0,0,560
31478,180,140,40,0,0,0,360
31479,180,100,160,240,160,0,840
31480,210,160,160,80,160,0,770
31481,190,120,120,80,0,0,510
31482,220,140,120,160,320,0,960
31483,150,60,40,80,160,0,490
31484,190,120,120,160,320,320,1230
31485,200,180,120,160,160,0,820
31486,210,120,160,160,320,0,970
31487,220,120,160,80,160,0,740
31488,180,140,120,0,0,0,440
31489,170,100,0,0,0,0,270
31490,190,100,160,240,320,0,1010
31491,190,100,120,240,160,0,810
31492,220,120,80,80,0,0,500
31493,170,140,160,160,320,320,1270
31494,190,120,40,80,160,0,590
31495,190,160,120,80,160,0,710
31496,180,120,120,240,320,0,980
31497,150,60,40,80,160,0,490
31498,220,160,80,80,0,0,540
31499,180,140,160,160,160,0,800
31500,190,120,120,240,160,320,1150
31501,180,120,80,160,320,320,1180
31502,190,120,160,240,320,0,1030
31503,180,100,40,0,0,0,320
31504,190,80,120,80,0,0,470
31505,170,80,120,160,160,0,690
31506,200,120,120,160,0,0,600
31507,200,140,120,80,160,0,700
31508,220,120,120,160,160,320,1100
31509,200,140,160,80,160,0,740
31510,160,80,80,80,160,0,560
31511,230,160,160,80,160,0,790
31512,200,160,160,160,320,320,1320
31513,210,140,120,80,160,320,1030
31514,210,80,80,80,160,0,610
31515,210,160,120,160,320,320,1290
31516,210,180,120,80,0,0,590
31517,200,80,120,160,320,0,880
31518,210,120,160,240,320,320,1370
31519,200,140,120,0,0,0,460
31520,140,60,80,80,160,320,840
31521,210,140,120,160,160,0,790
31522,170,140,80,80,160,0,630
31523,210,140,80,80,160,0,670
31524,170,80,120,80,160,0,610
31525,210,180,240,160,160,0,950
31526,180,120,200,160,320,0,980
31527,180,120,80,80,160,0,620
31528,150,100,120,160,0,0,530
31529,180,100,40,0,0,0,320
31530,190,60,80,0,0,0,330
31531,200,140,40,80,160,0,620
31532,170,120,80,80,160,0,610
31533,200,160,160,80,0,0,600
31534,210,140,80,160,160,0,750
31535,200,140,120,0,0,0,460
31536,160,120,80,80,0,0,440
31537,190,100,120,80,160,0,650
31538,200,100,80,160,320,320,1180
31539,190,120,80,80,160,320,950
31540,200,120,80,0,0,0,400
31541,170,100,80,0,0,0,350
31542,180,80,80,80,160,320,900
31543,200,100,80,80,0,0,460
31544,190,140,80,80,0,0,490
31545,230,180,120,160,320,320,1330
31546,200,100,40,0,0,0,340
31547,190,80,120,80,0,0,470
31548,170,120,160,160,160,320,1090
31549,200,140,120,240,160,0,860
31550,170,140,120,160,0,0,590
31551,170,40,40,80,160,0,490
31552,220,140,120,80,160,0,720
31553,180,220,40,80,0,0,520
31554,200,140,120,0,0,0,460
31555,220,160,200,160,160,0,900
31556,190,180,200,240,160,320,1290
31557,150,160,80,80,0,0,470
31558,200,200,160,160,160,0,880
31559,180,140,160,80,0,0,560
31560,180,80,80,80,0,0,420
31561,170,140,120,80,160,320,990
31562,180,100,120,80,0,0,480
31563,160,80,120,0,0,0,360
31564,160,100,120,160,160,0,700
31565,170,120,80,80,160,0,610
31566,220,120,160,160,320,0,980
31567,170,100,40,80,0,0,390
31568,190,140,160,160,0,0,650
31569,190,100,80,80,0,0,450
31570,190,160,40,0,0,0,390
31571,210,160,120,160,160,320,1130
31572,170,80,80,80,160,0,570
31573,160,80,80,80,0,0,400
31574,170,100,40,80,160,0,550
31575,220,100,80,0,0,0,400
31576,190,100,80,160,320,320,1170
31577,230,120,120,240,160,0,870
31578,210,140,40,0,0,0,390
31579,170,120,160,160,320,320,1250
31580,220,100,120,0,0,0,440
31581,180,120,120,0,0,0,420
31582,190,100,80,80,0,0,450
31583,190,180,120,80,0,0,570
31584,200,100,120,80,0,0,500
31585,200,160,200,160,320,0,1040
31586,210,120,40,80,0,0,450
31587,200,140,120,80,160,0,700
31588,190,80,40,0,0,0,310
31589,190,100,120,80,160,0,650
31590,270,80,80,0,0,0,430
31591,210,100,120,80,0,0,510
31592,200,140,80,80,0,0,500
31593,230,100,160,0,0,0,490
31594,210,160,160,160,0,0,690
31595,230,120,80,0,0,0,430
31596,180,100,80,80,160,0,600
31597,200,120,80,80,0,0,480
31598,220,60,80,80,160,0,600
31599,180,140,40,80,160,320,920
31600,180,160,120,80,160,0,700
31601,170,100,160,80,160,0,670
31602,220,160,120,160,160,0,820
31603,190,100,80,80,0,0,450
31604,170,120,120,80,160,0,650
31605,180,120,80,160,0,0,540
31606,210,100,120,160,320,0,910
31607,230,120,40,80,160,0,630
31608,210,180,160,160,0,0,710
31609,190,120,80,160,0,0,550
31610,190,120,120,80,160,0,670
31611,190,160,120,160,0,0,630
31612,190,180,120,80,160,320,1050
31613,190,100,120,160,160,0,730
31614,160,100,120,80,160,0,620
31615,200,160,80,0,0,0,440
31616,210,120,40,0,0,0,370
31617,220,100,80,160,160,0,720
31618,190,140,120,80,160,0,690
31619,180,100,80,0,0,0,360
31620,200,60,80,80,160,0,580
31621,190,100,40,80,160,0,570
31622,200,140,40,0,0,0,380
31623,220,120,160,160,0,0,660
31624,190,120,120,80,160,320,990
31625,220,100,40,0,0,0,360
31626,170,160,80,80,0,0,490
31627,190,100,80,160,0,0,530
31628,190,160,160,160,320,0,990
31629,220,120,160,80,0,0,580
31630,160,80,160,80,0,0,480
31631,150,120,80,80,160,0,590
31632,210,100,40,80,160,0,590
31633,160,100,80,80,160,0,580
31634,210,120,40,80,160,0,610
31635,210,100,40,80,0,0,430
31636,210,180,240,160,160,0,950
31637,180,100,120,240,160,0,800
31638,200,120,120,0,0,0,440
31639,260,160,40,0,0,0,460
31640,170,80,160,80,160,0,650
31641,170,80,80,160,0,0,490
31642,190,160,160,160,160,320,1150
31643,220,120,120,0,0,0,460
31644,170,100,120,80,0,0,470
31645,200,120,80,80,160,0,640
31646,210,120,120,160,160,0,770
31647,220,120,120,80,0,0,540
31648,190,60,40,0,0,0,290
31649,190,120,120,80,160,0,670
31650,180,160,120,80,160,0,700
31651,200,120,120,80,0,0,520
31652,190,100,40,80,0,0,410
31653,190,100,80,160,160,0,690
31654,210,140,80,80,160,0,670
31655,170,120,120,80,160,0,650
31656,190,100,80,0,0,0,370
31657,180,80,80,80,160,0,580
31658,170,120,120,80,0,0,490
31659,190,160,200,240,160,320,1270
31660,180,60,80,0,0,0,320
31661,180,140,200,80,0,0,600
31662,190,160,200,80,0,0,630
31663,200,100,80,0,0,0,380
31664,200,80,40,0,0,0,320
31665,160,100,120,160,160,0,700
31666,220,80,160,160,160,0,780
31667,180,140,240,240,320,0,1120
31668,200,60,40,0,0,0,300
31669,190,120,80,0,0,0,390
31670,190,40,0,0,0,0,230
31671,220,120,80,160,320,0,900
31672,200,180,80,80,0,0,540
31673,230,160,200,160,320,320,1390
31674,280,120,120,80,0,0,600
31675,200,140,80,80,0,0,500
31676,200,180,120,160,160,0,820
31677,150,100,160,80,0,0,490
31678,170,140,120,0,0,0,430
31679,170,120,120,80,160,0,650
31680,190,140,80,80,160,0,650
31681,170,100,160,160,320,320,1230
31682,210,120,40,80,160,0,610
31683,200,100,80,80,160,0,620
31684,190,160,200,80,160,0,790
31685,190,140,120,80,160,0,690
31686,220,120,200,160,0,0,700
31687,180,80,120,80,160,0,620
31688,150,120,80,160,160,0,670
31689,220,100,80,80,160,0,640
31690,230,120,80,160,0,0,590
31691,180,120,120,80,160,0,660
31692,180,120,80,80,160,0,620
31693,190,160,160,160,160,0,830
31694,230,80,80,80,0,0,470
31695,210,140,40,80,0,0,470
31696,170,160,80,160,0,0,570
31697,210,80,120,160,160,0,730
31698,180,100,160,80,0,0,520
31699,140,120,120,80,160,320,940
31700,200,180,120,80,160,0,740
31701,170,160,80,80,0,0,490
31702,220,140,160,80,0,0,600
31703,200,100,80,160,0,0,540
31704,200,60,40,0,0,0,300
31705,170,120,160,240,160,0,850
31706,180,100,120,80,0,0,480
31707,240,80,120,160,0,0,600
31708,190,120,80,0,0,0,390
31709,220,100,160,80,160,0,720
31710,190,60,0,0,0,0,250
31711,180,180,200,80,0,0,640
31712,180,80,80,80,0,0,420
31713,210,160,80,80,0,0,530
31714,220,120,0,0,0,0,340
31715,190,180,80,160,160,0,770
31716,210,120,120,80,160,320,1010
31717,170,60,40,0,0,0,270
31718,210,180,120,160,0,0,670
31719,230,140,120,160,320,0,970
31720,170,160,120,80,0,0,530
31721,210,80,80,0,0,0,370
31722,200,80,120,160,160,0,720
31723,210,100,80,80,0,0,470
31724,210,60,40,80,160,0,550
31725,200,160,160,0,0,0,520
31726,180,120,120,80,160,0,660
31727,190,100,120,80,160,0,650
31728,220,80,80,160,160,0,700
31729,200,80,80,160,0,0,520
31730,190,100,120,80,160,320,970
31731,210,140,160,240,160,0,910
31732,170,80,80,80,0,0,410
31733,190,140,40,0,0,0,370
31734,230,160,200,160,160,0,910
31735,220,140,160,240,160,320,1240
31736,170,140,160,160,320,0,950
31737,230,100,80,80,0,0,490
31738,160,140,120,80,0,0,500
31739,180,100,80,80,0,0,440
31740,250,140,120,80,0,0,590
31741,190,140,80,160,0,0,570
31742,220,180,160,80,160,0,800
31743,220,140,120,0,0,0,480
31744,220,160,200,80,0,0,660
31745,170,140,120,160,320,320,1230
31746,190,160,80,80,160,0,670
31747,180,100,120,80,0,0,480
31748,220,100,120,240,160,0,840
31749,200,140,80,80,160,320,980
31750,190,100,120,160,160,0,730
31751,220,160,80,80,0,0,540
31752,180,120,120,0,0,0,420
31753,210,180,160,160,320,0,1030
31754,150,100,120,0,0,0,370
31755,240,140,80,80,160,0,700
31756,210,140,40,0,0,0,390
31757,240,160,80,160,320,0,960
31758,190,120,160,240,160,0,870
31759,210,100,80,160,320,0,870
31760,200,100,160,160,160,0,780
31761,210,100,160,160,160,320,1110
31762,210,80,80,160,160,320,1010
31763,190,100,120,0,0,0,410
31764,200,120,80,160,160,320,1040
31765,170,80,80,80,160,0,570
31766,230,140,120,80,0,0,570
31767,170,100,40,0,0,0,310
31768,220,120,200,160,160,0,860
31769,220,120,160,160,160,320,1140
31770,180,100,80,0,0,0,360
31771,190,160,160,80,160,0,750
31772,180,100,200,240,160,0,880
31773,180,120,120,80,160,0,660
31774,220,80,80,160,160,0,700
31775,200,120,80,80,160,0,640
31776,220,100,120,160,0,0,600
31777,240,140,120,80,160,0,740
31778,200,140,120,160,160,320,1100
31779,210,160,160,240,320,320,1410
31780,160,100,120,160,160,0,700
31781,210,120,200,80,0,0,610
31782,180,40,40,80,0,0,340
31783,160,160,80,160,160,0,720
31784,230,180,80,0,0,0,490
31785,220,180,240,80,0,0,720
31786,220,140,80,160,320,320,1240
31787,210,80,120,160,160,0,730
31788,190,120,80,80,0,0,470
31789,160,140,40,0,0,0,340
31790,200,120,160,80,160,0,720
31791,180,100,120,160,160,0,720
31792,190,120,80,80,160,0,630
31793,150,80,40,80,160,320,830
31794,190,140,120,80,160,0,690
31795,190,100,40,80,0,0,410
31796,220,100,120,160,320,0,920
31797,180,160,80,0,0,0,420
31798,240,80,80,160,160,0,720
31799,220,100,80,160,160,0,720
31800,180,120,160,240,160,0,860
31801,170,100,80,80,0,0,430
31802,210,100,40,0,0,0,350
31803,150,80,80,80,160,0,550
31804,160,80,80,160,0,0,480
31805,210,120,120,160,160,0,770
31806,160,180,120,0,0,0,460
31807,190,140,120,160,0,0,610
31808,200,120,80,80,0,0,480
31809,200,120,120,160,320,0,920
31810,210,140,80,80,160,320,990
31811,160,80,120,160,160,0,680
31812,220,100,120,160,0,0,600
31813,190,100,80,160,160,0,690
31814,170,80,120,80,160,0,610
31815,200,80,80,80,160,0,600
31816,200,120,80,80,160,0,640
31817,200,100,160,160,160,0,780
31818,220,80,80,0,0,0,380
31819,190,100,120,80,0,0,490
31820,210,80,120,0,0,0,410
31821,210,160,40,80,0,0,490
31822,210,160,40,0,0,0,410
31823,180,80,40,80,160,320,860
31824,230,160,160,80,160,0,790
31825,160,120,40,80,160,0,560
31826,180,80,120,160,320,320,1180
31827,130,100,160,160,0,0,550
31828,180,80,80,160,0,0,500
31829,220,120,80,80,0,0,500
31830,190,120,120,80,160,320,990
31831,250,140,120,0,0,0,510
31832,210,120,40,0,0,0,370
31833,180,120,120,160,320,0,900
31834,200,100,40,80,0,0,420
31835,170,80,80,80,160,0,570
31836,220,160,40,80,160,0,660
31837,230,140,80,80,160,0,690
31838,160,100,80,0,0,0,340
31839,210,140,80,160,320,0,910
31840,200,180,120,80,160,0,740
31841,190,100,40,80,160,320,890
31842,160,80,40,80,160,0,520
31843,210,160,80,0,0,0,450
31844,220,180,160,0,0,0,560
31845,230,120,120,160,160,0,790
31846,220,100,80,80,160,320,960
31847,190,100,120,0,0,0,410
31848,220,100,120,160,160,0,760
31849,220,160,120,80,160,0,740
31850,210,140,120,0,0,0,470
31851,180,160,120,160,160,320,1100
31852,210,180,120,80,0,0,590
31853,180,80,80,160,320,0,820
31854,180,80,40,0,0,0,300
31855,200,160,80,0,0,0,440
31856,170,80,120,80,160,0,610
31857,170,120,160,240,320,0,1010
31858,180,140,160,160,160,320,1120
31859,200,120,40,80,0,0,440
31860,210,180,120,80,0,0,590
31861,180,100,80,0,0,0,360
31862,160,80,40,0,0,0,280
31863,180,120,80,0,0,0,380
31864,230,80,0,0,0,0,310
31865,150,100,80,160,320,0,810
31866,240,180,200,160,320,0,1100
31867,180,120,40,0,0,0,340
31868,170,140,160,160,160,0,790
31869,210,120,80,80,160,320,970
31870,220,180,120,80,160,0,760
31871,170,100,120,160,160,0,710
31872,150,120,80,0,0,0,350
31873,200,140,120,160,160,0,780
31874,190,120,120,160,160,0,750
31875,200,100,160,80,0,0,540
31876,210,120,200,240,160,0,930
31877,230,160,200,0,0,0,590
31878,190,160,160,80,0,0,590
31879,170,120,120,0,0,0,410
31880,210,180,160,160,320,320,1350
31881,240,160,160,160,160,320,1200
31882,210,120,120,160,320,0,930
31883,210,100,120,160,160,0,750
31884,180,120,120,80,0,0,500
31885,230,80,40,80,0,0,430
31886,210,180,200,160,160,0,910
31887,200,120,120,0,0,0,440
31888,190,180,240,80,0,0,690
31889,170,100,80,160,160,0,670
31890,180,80,80,80,160,0,580
31891,230,140,40,80,160,0,650
31892,210,100,120,160,0,0,590
31893,230,140,120,80,160,0,730
31894,180,100,120,80,160,0,640
31895,200,100,80,0,0,0,380
31896,180,160,120,160,160,0,780
31897,200,100,80,80,0,0,460
31898,150,100,80,80,160,320,890
31899,220,140,200,0,0,0,560
31900,210,120,160,160,320,0,970
31901,220,120,80,0,0,0,420
31902,210,140,160,160,160,0,830
31903,180,160,160,160,0,0,660
31904,200,80,120,160,0,0,560
31905,160,120,160,160,160,0,760
31906,190,100,160,240,160,0,850
31907,210,140,80,80,160,0,670
31908,190,140,80,160,0,0,570
31909,160,100,120,160,320,0,860
31910,200,100,120,80,160,320,980
31911,210,160,160,160,320,0,1010
31912,180,60,80,80,0,0,400
31913,220,160,120,80,160,0,740
31914,190,140,80,80,160,320,970
31915,190,180,200,80,160,0,810
31916,180,140,80,80,0,0,480
31917,220,140,120,80,0,0,560
31918,210,140,120,80,160,320,1030
31919,180,160,80,0,0,0,420
31920,230,140,120,80,160,320,1050
31921,180,120,200,160,160,320,1140
31922,190,120,80,80,0,0,470
31923,200,180,120,160,160,320,1140
31924,190,140,120,160,160,0,770
31925,220,120,120,80,160,0,700
31926,170,120,80,80,160,320,930
31927,210,120,200,80,160,320,1090
31928,150,100,120,0,0,0,370
31929,180,100,80,80,160,320,920
31930,210,160,120,80,160,320,1050
31931,230,100,80,80,0,0,490
31932,210,100,160,160,0,0,630
31933,250,120,120,160,160,320,1130
31934,230,180,120,160,160,0,850
31935,170,140,160,80,160,0,710
31936,180,140,160,240,160,0,880
31937,210,140,120,240,320,320,1350
31938,220,140,120,80,0,0,560
31939,160,140,120,160,320,0,900
31940,220,140,160,160,320,0,1000
31941,230,140,120,160,160,0,810
31942,190,100,40,80,160,0,570
31943,200,140,80,80,160,0,660
31944,210,80,120,80,160,0,650
31945,180,100,80,80,160,320,920
31946,200,100,80,80,0,0,460
31947,220,180,120,80,160,0,760
31948,190,140,120,160,320,320,1250
31949,200,120,200,160,160,0,840
31950,190,100,120,160,320,0,890
31951,210,120,120,80,0,0,530
31952,170,120,120,160,0,0,570
31953,150,100,160,160,0,0,570
31954,190,120,200,240,160,0,910
31955,170,100,40,80,160,320,870
31956,180,100,80,80,160,0,600
31957,200,140,120,160,0,0,620
31958,210,140,80,80,160,0,670
31959,200,140,120,80,160,0,700
31960,220,140,160,0,0,0,520
31961,160,80,80,80,160,0,560
31962,190,120,120,160,320,320,1230
31963,170,120,120,160,160,0,730
31964,190,80,120,160,320,320,1190
31965,200,160,120,80,0,0,560
31966,170,100,80,80,0,0,430
31967,190,160,160,80,160,0,750
31968,240,140,120,160,160,0,820
31969,180,120,120,80,160,320,980
31970,230,100,80,0,0,0,410
31971,220,140,120,0,0,0,480
31972,180,80,40,80,160,0,540
31973,170,100,120,80,160,0,630
31974,190,180,40,0,0,0,410
31975,250,180,120,0,0,0,550
31976,200,60,80,160,160,0,660
31977,170,120,200,80,160,0,730
31978,240,200,160,80,160,320,1160
31979,250,180,120,80,160,320,1110
31980,190,140,120,160,160,0,770
31981,240,140,40,0,0,0,420
31982,200,140,120,160,0,0,620
31983,190,120,120,0,0,0,430
31984,190,100,80,160,160,0,690
31985,210,180,120,160,160,0,830
31986,210,100,120,160,0,0,590
31987,130,80,160,160,160,0,690
31988,230,160,160,240,160,0,950
31989,210,120,80,80,0,0,490
31990,200,140,160,80,0,0,580
31991,160,80,0,0,0,0,240
31992,200,140,80,80,160,320,980
31993,170,180,160,160,320,0,990
31994,220,160,120,160,160,0,820
31995,240,160,80,160,320,0,960
31996,220,140,120,0,0,0,480
31997,230,100,120,80,160,0,690
31998,220,160,120,160,160,320,1140
31999,190,120,120,0,0,0,430
32000,190,140,120,160,0,0,610
32001,180,120,160,160,0,0,620
32002,180,100,120,80,0,0,480
32003,180,100,160,240,320,320,1320
32004,150,100,80,80,160,0,570
32005,220,140,80,80,160,0,680
32006,200,160,160,80,160,0,760
32007,220,140,120,80,0,0,560
32008,200,100,80,0,0,0,380
32009,170,80,80,80,0,0,410
32010,180,100,120,160,160,0,720
32011,200,100,120,80,0,0,500
32012,230,160,80,0,0,0,470
32013,190,160,160,240,160,0,910
32014,200,100,120,80,160,320,980
32015,260,160,160,160,0,0,740
32016,170,100,40,0,0,0,310
32017,180,100,80,80,160,0,600
32018,180,160,120,80,160,0,700
32019,180,100,80,160,320,320,1160
32020,220,120,120,160,160,320,1100
32021,250,120,80,0,0,0,450
32022,180,120,120,160,160,0,740
32023,180,140,160,80,160,0,720
32024,210,180,200,80,0,0,670
32025,170,120,200,160,160,320,1130
32026,160,120,120,160,160,320,1040
32027,240,160,80,80,160,0,720
32028,170,120,80,80,160,320,930
32029,200,180,160,160,160,0,860
32030,160,100,80,80,160,0,580
32031,240,140,80,0,0,0,460
32032,190,160,40,80,0,0,470
32033,220,80,120,160,320,320,1220
32034,190,100,80,80,0,0,450
32035,210,160,120,160,0,0,650
32036,220,140,160,80,0,0,600
32037,200,80,80,80,160,0,600
32038,200,100,80,0,0,0,380
32039,210,160,160,240,160,0,930
32040,190,120,40,0,0,0,350
32041,240,120,160,160,0,0,680
32042,210,120,160,80,160,320,1050
32043,220,100,120,160,320,0,920
32044,200,160,80,0,0,0,440
32045,210,160,200,80,160,0,810
32046,210,120,160,160,320,320,1290
32047,170,100,120,80,160,0,630
32048,180,120,160,240,160,0,860
32049,220,140,80,80,0,0,520
32050,220,120,160,240,320,0,1060
32051,150,140,80,0,0,0,370
32052,190,140,120,160,160,0,770
32053,200,100,0,0,0,0,300
32054,190,100,120,0,0,0,410
32055,200,140,160,160,0,0,660
32056,220,140,120,80,0,0,560
32057,190,80,40,0,0,0,310
32058,240,160,120,160,160,0,840
32059,210,120,80,80,160,0,650
32060,230,120,120,160,160,0,790
32061,150,120,200,240,160,0,870
32062,160,120,160,80,160,0,680
32063,160,140,40,80,0,0,420
32064,250,80,80,0,0,0,410
32065,190,120,80,160,160,320,1030
32066,200,120,160,160,0,0,640
32067,170,100,120,160,160,0,710
32068,190,120,80,0,0,0,390
32069,210,80,120,240,160,0,810
32070,230,220,240,160,160,320,1330
32071,200,140,80,0,0,0,420
32072,210,120,80,80,160,320,970
32073,250,140,160,240,320,320,1430
32074,170,120,0,0,0,0,290
32075,210,120,80,80,160,0,650
32076,190,80,40,80,0,0,390
32077,170,140,160,160,160,0,790
32078,200,120,120,160,160,320,1080
32079,210,140,160,240,160,0,910
32080,130,100,80,80,0,0,390
32081,210,120,120,80,160,320,1010
32082,200,100,120,160,160,0,740
32083,240,180,160,160,160,0,900
32084,230,140,120,80,160,0,730
32085,210,160,160,160,320,0,1010
32086,190,40,40,0,0,0,270
32087,210,140,160,80,0,0,590
32088,220,160,160,80,160,0,780
32089,180,140,40,0,0,0,360
32090,160,120,120,80,0,0,480
32091,190,120,80,160,0,0,550
32092,220,80,120,160,0,0,580
32093,210,200,240,240,160,320,1370
32094,170,60,80,80,160,320,870
32095,190,160,80,80,160,0,670
32096,170,120,160,160,320,320,1250
32097,210,120,80,80,0,0,490
32098,240,160,40,80,0,0,520
32099,200,100,40,80,0,0,420
32100,200,100,80,80,160,0,620
32101,230,100,80,160,160,0,730
32102,180,60,40,80,160,320,840
32103,190,180,200,240,320,320,1450
32104,190,140,160,240,160,0,890
32105,180,140,160,240,160,0,880
32106,180,120,120,160,160,0,740
32107,220,180,160,160,320,0,1040
32108,220,100,0,0,0,0,320
32109,200,160,160,160,320,0,1000
32110,240,120,120,80,160,0,720
32111,230,160,160,160,0,0,710
32112,220,140,80,160,160,0,760
32113,170,120,120,0,0,0,410
32114,220,120,120,160,320,0,940
32115,190,120,120,160,320,320,1230
32116,220,140,120,0,0,0,480
32117,190,140,40,0,0,0,370
32118,200,80,80,80,160,0,600
32119,240,120,120,80,0,0,560
32120,160,100,80,80,160,0,580
32121,200,140,80,80,160,320,980
32122,180,120,80,80,0,0,460
32123,250,160,80,80,160,0,730
32124,240,160,120,80,0,0,600
32125,230,160,160,160,160,0,870
32126,220,200,160,160,160,0,900
32127,230,100,160,240,0,0,730
32128,170,80,120,160,0,0,530
32129,220,160,80,80,160,0,700
32130,220,80,80,0,0,0,380
32131,230,100,80,80,0,0,490
32132,220,100,120,160,160,320,1080
32133,170,120,160,160,320,0,930
32134,200,160,200,240,320,0,1120
32135,170,120,40,0,0,0,330
32136,230,160,120,160,320,0,990
32137,190,160,80,80,160,0,670
32138,200,100,120,160,160,0,740
32139,180,80,120,80,0,0,460
32140,210,120,80,80,160,0,650
32141,170,140,160,160,0,0,630
32142,220,120,160,80,0,0,580
32143,220,140,0,0,0,0,360
32144,200,140,80,80,0,0,500
32145,240,120,160,0,0,0,520
32146,160,80,80,160,160,320,960
32147,230,140,80,80,160,320,1010
32148,230,180,160,80,160,0,810
32149,230,60,80,0,0,0,370
32150,160,120,80,80,0,0,440
32151,220,100,120,160,160,0,760
32152,190,120,160,160,0,0,630
32153,220,120,120,160,160,0,780
32154,150,140,160,240,320,320,1330
32155,230,160,160,160,320,0,1030
32156,220,80,120,160,320,0,900
32157,180,100,160,80,160,0,680
32158,250,160,200,80,0,0,690
32159,190,120,160,160,160,0,790
32160,200,140,80,0,0,0,420
32161,220,120,120,160,160,0,780
32162,210,120,120,160,160,0,770
32163,210,80,40,0,0,0,330
32164,200,160,160,160,160,0,840
32165,180,140,200,160,160,0,840
32166,150,120,160,240,0,0,670
32167,170,120,120,160,160,0,730
32168,190,80,40,0,0,0,310
32169,170,180,200,160,160,0,870
32170,190,120,120,160,320,0,910
32171,170,120,120,80,160,0,650
32172,170,180,160,0,0,0,510
32173,200,140,160,80,160,0,740
32174,180,140,120,80,0,0,520
32175,240,100,40,80,160,0,620
32176,220,120,120,80,160,320,1020
32177,210,120,120,160,0,0,610
32178,180,100,160,160,320,320,1240
32179,150,120,120,80,160,0,630
32180,200,80,80,80,160,0,600
32181,200,120,120,0,0,0,440
32182,190,80,40,80,160,320,870
32183,160,80,80,80,160,320,880
32184,180,80,120,160,160,0,700
32185,180,100,120,80,0,0,480
32186,220,180,120,160,160,0,840
32187,190,60,40,80,160,320,850
32188,170,140,160,160,0,0,630
32189,180,120,40,0,0,0,340
32190,240,160,200,160,0,0,760
32191,230,140,120,160,160,0,810
32192,170,100,160,240,320,320,1310
32193,190,120,120,0,0,0,430
32194,190,80,80,80,160,0,590
32195,170,120,120,80,160,0,650
32196,130,120,80,0,0,0,330
32197,170,60,80,160,160,0,630
32198,180,160,120,160,160,320,1100
32199,140,120,120,160,160,320,1020
32200,200,100,40,0,0,0,340
32201,160,100,120,0,0,0,380
32202,200,160,160,160,320,320,1320
32203,170,120,40,80,160,0,570
32204,150,100,80,80,160,0,570
32205,220,120,40,0,0,0,380
32206,210,140,160,160,160,0,830
32207,170,140,160,80,0,0,550
32208,170,80,80,0,0,0,330
32209,220,220,160,160,160,0,920
32210,240,140,80,0,0,0,460
32211,180,140,120,240,0,0,680
32212,240,200,120,160,0,0,720
32213,190,100,40,0,0,0,330
32214,180,140,120,80,160,0,680
32215,170,100,80,0,0,0,350
32216,180,200,160,160,0,0,700
32217,190,140,120,80,160,0,690
32218,210,140,120,80,160,0,710
32219,230,160,200,80,160,0,830
32220,220,140,160,80,0,0,600
32221,230,140,200,240,160,320,1290
32222,210,120,120,80,160,0,690
32223,220,120,120,80,0,0,540
32224,220,140,80,0,0,0,440
32225,180,60,80,160,160,0,640
32226,180,140,120,80,0,0,520
32227,190,140,240,160,160,0,890
32228,200,120,160,160,160,0,800
32229,200,140,120,0,0,0,460
32230,230,100,40,80,160,0,610
32231,220,160,80,0,0,0,460
32232,160,80,80,80,160,0,560
32233,220,120,120,80,160,0,700
32234,200,40,0,0,0,0,240
32235,220,160,120,160,0,0,660
32236,180,160,120,80,160,0,700
32237,160,100,80,0,0,0,340
32238,200,200,40,80,0,0,520
32239,160,120,40,0,0,0,320
32240,210,120,120,80,160,0,690
32241,200,120,80,80,160,0,640
32242,180,60,120,160,320,0,840
32243,200,100,80,80,160,0,620
32244,210,140,120,0,0,0,470
32245,240,140,120,160,160,0,820
32246,210,80,40,80,0,0,410
32247,220,140,80,160,160,0,760
32248,210,80,80,0,0,0,370
32249,170,80,120,80,0,0,450
32250,220,100,120,160,160,0,760
32251,220,120,80,80,160,0,660
32252,180,180,200,240,320,0,1120
32253,220,180,80,80,160,0,720
32254,160,120,80,80,160,0,600
32255,210,160,160,80,0,0,610
32256,210,100,0,0,0,0,310
32257,170,120,120,160,160,0,730
32258,180,100,80,0,0,0,360
32259,160,100,80,160,160,0,660
32260,220,120,80,80,160,0,660
32261,190,80,80,80,160,0,590
32262,190,100,40,80,0,0,410
32263,170,100,160,160,160,0,750
32264,200,120,120,80,0,0,520
32265,210,120,120,240,0,0,690
32266,160,100,40,80,160,0,540
32267,170,120,160,80,160,0,690
32268,190,80,120,160,320,0,870
32269,230,160,80,80,160,0,710
32270,190,100,80,160,0,0,530
32271,200,80,80,80,160,0,600
32272,210,60,40,80,0,0,390
32273,210,160,80,80,0,0,530
32274,240,160,160,80,160,0,800
32275,230,100,80,80,0,0,490
32276,220,140,200,240,160,0,960
32277,210,100,120,80,160,0,670
32278,210,160,120,0,0,0,490
32279,170,120,120,0,0,0,410
32280,190,160,160,160,320,0,990
32281,230,160,120,80,0,0,590
32282,160,140,80,0,0,0,380
32283,190,140,160,160,160,0,810
32284,220,180,120,80,0,0,600
32285,180,120,120,240,320,0,980
32286,210,140,160,240,160,0,910
32287,200,160,160,80,160,0,760
32288,200,80,120,80,160,0,640
32289,220,200,160,80,160,320,1140
32290,180,80,40,80,0,0,380
32291,200,140,120,80,160,0,700
32292,170,120,80,80,160,320,930
32293,190,140,40,0,0,0,370
32294,180,120,120,160,320,320,1220
32295,220,100,120,0,0,0,440
32296,160,80,80,0,0,0,320
32297,170,100,120,80,160,0,630
32298,220,100,120,80,0,0,520
32299,180,100,80,160,160,0,680
32300,230,100,80,80,160,0,650
32301,200,100,80,0,0,0,380
32302,200,100,0,0,0,0,300
32303,210,60,80,0,0,0,350
32304,210,100,40,80,160,0,590
32305,160,80,120,0,0,0,360
32306,210,120,40,0,0,0,370
32307,190,100,160,0,0,0,450
32308,150,120,80,80,160,0,590
32309,150,140,120,160,320,320,1210
32310,190,100,40,80,160,0,570
32311,200,80,120,80,0,0,480
32312,200,80,120,80,160,0,640
32313,230,120,120,80,160,320,1030
32314,180,140,120,80,160,0,680
32315,170,80,120,80,160,0,610
32316,210,140,120,240,160,320,1190
32317,240,140,120,80,0,0,580
32318,180,140,80,160,160,0,720
32319,170,100,80,160,160,0,670
32320,180,60,40,80,160,0,520
32321,200,140,120,80,0,0,540
32322,190,180,80,80,160,0,690
32323,170,100,120,0,0,0,390
32324,190,120,160,160,160,0,790
32325,150,120,80,80,0,0,430
32326,170,80,120,80,0,0,450
32327,180,100,120,160,160,320,1040
32328,210,160,160,80,160,0,770
32329,210,180,80,160,160,0,790
32330,220,100,40,80,160,320,920
32331,200,140,160,80,160,0,740
32332,210,140,80,160,0,0,590
32333,200,60,80,80,160,0,580
32334,170,100,120,80,160,0,630
32335,220,180,120,80,0,0,600
32336,190,80,80,80,0,0,430
32337,210,120,120,80,0,0,530
32338,190,160,160,160,0,0,670
32339,150,100,80,80,0,0,410
32340,190,140,120,160,160,0,770
32341,170,100,120,160,320,0,870
32342,190,120,160,240,320,0,1030
32343,180,100,160,160,320,320,1240
32344,160,140,160,240,160,0,860
32345,160,100,120,80,160,0,620
32346,220,160,120,80,0,0,580
32347,170,120,120,160,160,0,730
32348,180,140,120,80,160,320,1000
32349,190,100,80,160,160,0,690
32350,160,100,120,80,0,0,460
32351,190,160,120,0,0,0,470
32352,200,80,80,160,160,320,1000
32353,190,100,120,80,160,320,970
32354,160,100,160,80,160,320,980
32355,210,100,160,0,0,0,470
32356,180,140,120,160,0,0,600
32357,200,200,200,80,0,0,680
32358,170,120,120,80,0,0,490
32359,180,100,120,80,160,320,960
32360,160,140,160,160,320,320,1260
32361,220,80,40,80,0,0,420
32362,200,80,80,80,160,0,600
32363,200,180,40,80,160,320,980
32364,170,80,80,80,160,0,570
32365,160,80,80,80,0,0,400
32366,210,140,40,0,0,0,390
32367,180,100,80,80,160,0,600
32368,170,120,200,160,320,0,970
32369,200,160,160,160,160,0,840
32370,220,160,160,80,0,0,620
32371,190,120,80,80,0,0,470
32372,180,140,120,80,0,0,520
32373,180,100,80,160,320,320,1160
32374,220,160,80,80,160,0,700
32375,180,140,120,80,0,0,520
32376,170,160,120,160,0,0,610
32377,180,80,80,160,160,0,660
32378,200,80,40,80,160,0,560
32379,150,120,120,80,160,0,630
32380,200,180,200,160,320,320,1380
32381,190,160,120,160,0,0,630
32382,190,160,120,0,0,0,470
32383,240,140,120,160,160,0,820
32384,210,60,40,80,160,0,550
32385,160,100,120,240,160,320,1100
32386,200,160,120,0,0,0,480
32387,250,140,120,80,0,0,590
32388,170,120,200,240,160,0,890
32389,190,120,80,0,0,0,390
32390,150,120,120,0,0,0,390
32391,200,120,80,0,0,0,400
32392,200,100,80,160,160,0,700
32393,220,160,120,80,0,0,580
32394,160,80,0,0,0,0,240
32395,110,120,120,80,160,0,590
32396,190,140,200,80,160,0,770
32397,150,160,120,80,160,0,670
32398,230,100,0,0,0,0,330
32399,150,120,160,240,320,0,990
32400,180,140,160,160,320,320,1280
32401,200,120,160,80,160,0,720
32402,230,140,200,80,0,0,650
32403,170,120,80,0,0,0,370
32404,190,100,120,80,160,0,650
32405,170,160,120,160,160,0,770
32406,150,80,80,160,160,320,950
32407,190,180,240,160,160,0,930
32408,200,120,160,80,160,0,720
32409,190,100,80,160,160,0,690
32410,180,120,80,0,0,0,380
32411,220,120,80,160,160,320,1060
32412,200,140,120,240,320,0,1020
32413,220,160,160,160,160,320,1180
32414,200,160,120,80,160,0,720
32415,190,100,120,80,160,0,650
32416,180,80,40,80,160,0,540
32417,180,160,120,160,160,0,780
32418,220,160,80,80,160,0,700
32419,200,120,120,80,0,0,520
32420,170,140,80,0,0,0,390
32421,240,100,120,160,320,320,1260
32422,250,200,160,240,0,0,850
32423,200,120,120,160,320,0,920
32424,200,140,80,80,160,0,660
32425,180,180,200,160,320,0,1040
32426,220,160,120,80,0,0,580
32427,190,120,160,160,0,0,630
32428,200,100,80,160,320,0,860
32429,190,100,120,80,0,0,490
32430,200,100,40,0,0,0,340
32431,180,120,120,80,160,0,660
32432,210,100,40,0,0,0,350
32433,170,160,160,160,160,0,810
32434,170,160,160,160,320,0,970
32435,170,100,120,160,320,0,870
32436,220,100,80,160,320,320,1200
32437,190,80,80,80,0,0,430
32438,190,160,80,160,320,0,910
32439,240,120,80,80,160,0,680
32440,200,120,160,80,160,0,720
32441,210,100,40,0,0,0,350
32442,190,140,120,80,160,0,690
32443,180,120,160,160,160,0,780
32444,200,100,120,80,160,320,980
32445,230,120,120,160,320,0,950
32446,190,140,120,80,160,320,1010
32447,190,120,200,160,320,0,990
32448,160,120,40,80,0,0,400
32449,170,140,80,80,160,320,950
32450,190,120,120,160,160,320,1070
32451,190,100,120,0,0,0,410
32452,230,180,120,0,0,0,530
32453,220,160,160,80,160,0,780
32454,160,120,160,240,320,320,1320
32455,170,160,160,80,160,0,730
32456,210,120,120,160,0,0,610
32457,230,140,120,80,160,320,1050
32458,240,140,40,80,160,0,660
32459,200,160,80,0,0,0,440
32460,190,140,120,80,0,0,530
32461,190,100,120,160,160,320,1050
32462,190,100,0,0,0,0,290
32463,230,100,120,160,0,0,610
32464,190,160,120,240,160,0,870
32465,180,120,80,80,0,0,460
32466,200,100,80,80,160,0,620
32467,200,120,120,80,0,0,520
32468,190,100,120,160,160,0,730
32469,180,100,40,80,160,0,560
32470,200,80,120,80,160,0,640
32471,220,100,40,0,0,0,360
32472,230,120,120,160,160,0,790
32473,200,120,80,160,160,0,720
32474,160,80,80,80,160,320,880
32475,220,120,80,80,0,0,500
32476,160,80,80,0,0,0,320
32477,200,160,160,80,160,0,760
32478,220,120,120,0,0,0,460
32479,240,180,200,160,320,320,1420
32480,160,100,120,160,160,320,1020
32481,160,140,200,160,160,0,820
32482,220,140,120,240,320,0,1040
32483,220,160,0,0,0,0,380
32484,180,60,80,80,0,0,400
32485,170,100,160,80,160,320,990
32486,210,120,80,160,160,320,1050
32487,190,100,120,0,0,0,410
32488,180,100,120,80,0,0,480
32489,230,200,200,160,0,0,790
32490,170,120,120,240,320,320,1290
32491,210,140,120,160,160,0,790
32492,170,100,120,80,160,320,950
32493,210,140,120,160,160,320,1110
32494,200,100,40,80,160,0,580
32495,190,140,80,80,160,0,650
32496,170,80,80,0,0,0,330
32497,200,120,160,240,160,0,880
32498,170,120,120,160,160,320,1050
32499,220,140,40,80,0,0,480
32500,200,160,160,160,320,0,1000
32501,190,140,80,0,0,0,410
32502,170,100,80,80,160,0,590
32503,240,160,120,0,0,0,520
32504,220,100,80,80,160,0,640
32505,180,120,40,0,0,0,340
32506,240,140,120,80,160,0,740
32507,210,180,40,80,160,0,670
32508,190,140,200,240,160,320,1250
32509,170,140,120,80,0,0,510
32510,210,120,80,80,160,320,970
32511,200,160,160,160,160,0,840
32512,220,160,160,240,0,0,780
32513,220,180,80,0,0,0,480
32514,240,100,120,80,160,0,700
32515,220,100,0,0,0,0,320
32516,150,60,40,80,160,0,490
32517,220,120,80,80,160,0,660
32518,210,120,80,80,0,0,490
32519,190,120,120,160,160,0,750
32520,160,60,40,0,0,0,260
32521,180,100,80,160,320,320,1160
32522,170,160,200,240,160,320,1250
32523,230,100,40,0,0,0,370
32524,240,180,160,80,0,0,660
32525,190,140,160,160,320,0,970
32526,170,140,120,160,320,0,910
32527,190,140,200,240,160,320,1250
32528,200,120,160,240,320,320,1360
32529,190,140,120,160,320,320,1250
32530,190,140,200,160,160,0,850
32531,170,100,40,80,160,0,550
32532,210,120,80,80,160,320,970
32533,200,100,120,80,0,0,500
32534,220,120,120,80,160,0,700
32535,200,160,40,80,0,0,480
32536,180,80,120,240,160,0,780
32537,180,140,120,80,0,0,520
32538,200,160,160,80,160,0,760
32539,210,100,80,160,160,320,1030
32540,220,100,80,160,320,320,1200
32541,250,120,120,240,160,0,890
32542,170,100,120,160,160,0,710
32543,170,120,120,80,0,0,490
32544,210,120,40,80,160,0,610
32545,170,100,80,0,0,0,350
32546,200,120,120,80,160,320,1000
32547,170,160,120,80,160,320,1010
32548,240,120,80,80,160,0,680
32549,160,140,160,0,0,0,460
32550,200,80,80,0,0,0,360
32551,220,160,160,240,160,320,1260
32552,180,80,80,160,320,320,1140
32553,200,160,120,160,160,0,800
32554,200,180,200,160,0,0,740
32555,200,140,160,80,160,0,740
32556,190,100,120,240,320,0,970
32557,140,80,80,160,160,0,620
32558,190,160,160,160,160,0,830
32559,200,160,120,80,160,0,720
32560,200,120,80,80,0,0,480
32561,200,120,40,80,160,0,600
32562,220,120,160,160,160,320,1140
32563,170,100,160,160,160,0,750
32564,180,100,80,160,160,0,680
32565,170,140,120,160,320,320,1230
32566,190,100,120,80,0,0,490
32567,200,80,40,80,160,0,560
32568,230,140,160,240,0,0,770
32569,230,160,80,80,0,0,550
32570,150,120,80,160,320,0,830
32571,210,100,40,80,0,0,430
32572,210,100,40,0,0,0,350
32573,170,140,120,80,0,0,510
32574,160,120,0,0,0,0,280
32575,190,140,120,240,160,0,850
32576,150,100,120,160,320,320,1170
32577,170,120,120,80,160,0,650
32578,200,100,120,80,160,0,660
32579,200,120,120,160,160,0,760
32580,180,120,80,80,160,0,620
32581,170,80,120,80,0,0,450
32582,200,120,40,80,0,0,440
32583,180,120,80,80,0,0,460
32584,210,100,80,0,0,0,390
32585,180,140,160,0,0,0,480
32586,210,100,160,160,320,320,1270
32587,150,80,40,0,0,0,270
32588,200,120,80,160,160,320,1040
32589,200,120,160,80,160,0,720
32590,220,140,120,80,160,0,720
32591,210,100,80,80,0,0,470
32592,160,100,160,160,0,0,580
32593,170,120,80,80,160,0,610
32594,200,100,40,0,0,0,340
32595,220,80,80,80,0,0,460
32596,220,60,0,0,0,0,280
32597,210,140,160,160,160,0,830
32598,170,120,80,0,0,0,370
32599,190,80,120,80,160,0,630
32600,160,80,80,80,0,0,400
32601,220,140,80,80,0,0,520
32602,190,100,80,160,160,0,690
32603,210,120,160,160,160,0,810
32604,210,100,80,80,0,0,470
32605,130,120,120,80,160,0,610
32606,200,120,160,160,160,0,800
32607,210,100,80,80,0,0,470
32608,210,100,80,160,160,320,1030
32609,220,120,40,0,0,0,380
32610,190,100,160,160,320,0,930
32611,210,120,120,80,0,0,530
32612,180,80,120,80,0,0,460
32613,180,200,240,160,160,0,940
32614,160,140,160,160,160,320,1100
32615,240,180,80,80,160,0,740
32616,210,140,80,80,0,0,510
32617,210,120,80,80,0,0,490
32618,260,160,160,160,320,320,1380
32619,210,160,120,80,160,0,730
32620,180,120,120,80,160,0,660
32621,190,100,40,0,0,0,330
32622,230,120,80,0,0,0,430
32623,180,140,80,160,0,0,560
32624,200,180,120,160,160,0,820
32625,220,120,120,160,320,320,1260
32626,170,120,160,160,160,0,770
32627,190,120,120,80,160,0,670
32628,180,160,200,160,160,0,860
32629,200,120,160,240,160,0,880
32630,210,140,120,80,160,0,710
32631,190,100,120,160,160,0,730
32632,180,140,160,160,160,0,800
32633,220,120,40,0,0,0,380
32634,180,40,0,0,0,0,220
32635,250,200,160,160,320,320,1410
32636,180,120,120,80,0,0,500
32637,230,220,160,0,0,0,610
32638,250,180,120,80,160,0,790
32639,180,120,80,0,0,0,380
32640,230,100,0,0,0,0,330
32641,190,120,80,80,0,0,470
32642,130,100,0,0,0,0,230
32643,210,120,80,80,160,0,650
32644,200,140,160,160,160,0,820
32645,230,100,40,80,0,0,450
32646,180,140,160,240,0,0,720
32647,160,120,120,240,160,0,800
32648,170,120,120,160,160,0,730
32649,190,180,80,0,0,0,450
32650,200,140,120,80,160,320,1020
32651,180,80,160,160,0,0,580
32652,200,160,120,160,160,0,800
32653,220,200,160,80,0,0,660
32654,190,160,200,80,0,0,630
32655,150,120,200,240,160,0,870
32656,200,120,80,80,160,0,640
32657,170,80,80,160,160,320,970
32658,230,120,120,80,0,0,550
32659,180,140,80,0,0,0,400
32660,160,140,120,80,160,0,660
32661,200,40,40,0,0,0,280
32662,210,120,120,80,0,0,530
32663,200,160,160,160,160,320,1160
32664,200,140,120,80,160,0,700
32665,230,180,120,80,160,0,770
32666,190,80,80,80,160,0,590
32667,200,160,40,80,0,0,480
32668,240,140,120,80,0,0,580
32669,200,160,80,80,160,0,680
32670,170,120,40,80,160,0,570
32671,220,120,120,240,160,0,860
32672,220,140,120,0,0,0,480
32673,240,120,160,160,160,0,840
32674,180,160,120,160,320,0,940
32675,220,120,80,80,160,320,980
32676,210,100,160,160,160,0,790
32677,170,140,40,80,160,0,590
32678,210,140,160,160,160,0,830
32679,210,100,80,80,160,0,630
32680,200,140,80,0,0,0,420
32681,220,100,80,80,0,0,480
32682,180,100,120,160,320,320,1200
32683,200,180,160,0,0,0,540
32684,170,140,160,240,320,0,1030
32685,190,100,120,160,160,0,730
32686,190,100,160,160,160,320,1090
32687,210,160,120,80,160,320,1050
32688,180,140,160,160,0,0,640
32689,220,120,120,160,160,0,780
32690,200,120,120,160,160,320,1080
32691,170,160,120,160,320,320,1250
32692,120,60,40,0,0,0,220
32693,180,100,80,80,160,0,600
32694,200,100,160,240,320,0,1020
32695,170,100,80,0,0,0,350
32696,170,140,200,240,320,0,1070
32697,220,100,40,0,0,0,360
32698,200,140,80,0,0,0,420
32699,250,160,80,160,0,0,650
32700,180,120,120,160,320,0,900
32701,180,120,80,80,0,0,460
32702,170,180,160,80,160,0,750
32703,230,140,200,160,0,0,730
32704,200,160,160,80,0,0,600
32705,160,100,120,160,320,0,860
32706,190,120,80,80,160,0,630
32707,180,140,200,160,160,0,840
32708,180,100,80,0,0,0,360
32709,170,140,0,0,0,0,310
32710,200,80,40,80,160,0,560
32711,200,160,200,160,320,0,1040
32712,190,80,80,160,160,0,670
32713,220,140,120,0,0,0,480
32714,240,160,120,160,320,0,1000
32715,230,160,160,160,160,320,1190
32716,190,120,120,160,160,0,750
32717,170,120,120,160,160,320,1050
32718,210,120,120,160,160,0,770
32719,180,60,80,80,160,0,560
32720,200,180,120,80,0,0,580
32721,170,120,160,160,0,0,610
32722,190,140,200,80,160,320,1090
32723,200,140,40,80,160,0,620
32724,210,160,120,80,160,0,730
32725,160,100,160,160,160,320,1060
32726,230,160,120,80,160,0,750
32727,200,100,120,0,0,0,420
32728,180,120,120,160,160,0,740
32729,210,140,120,80,160,0,710
32730,200,100,120,80,160,0,660
32731,170,160,120,80,160,0,690
32732,180,140,120,80,0,0,520
32733,190,100,80,80,0,0,450
32734,220,100,80,0,0,0,400
32735,240,180,240,160,0,0,820
32736,260,100,40,0,0,0,400
32737,170,60,80,80,160,0,550
32738,210,160,80,160,160,0,770
32739,210,100,120,240,160,0,830
32740,200,100,120,0,0,0,420
32741,200,100,80,0,0,0,380
32742,210,180,240,80,0,0,710
32743,170,140,160,160,160,0,790
32744,210,160,80,80,0,0,530
32745,200,120,80,80,160,0,640
32746,170,160,160,240,320,320,1370
32747,210,140,120,80,160,320,1030
32748,160,100,40,0,0,0,300
32749,210,140,160,160,160,0,830
32750,170,80,120,160,160,0,690
32751,200,120,80,0,0,0,400
32752,240,140,40,80,0,0,500
32753,160,160,160,240,320,0,1040
32754,180,100,120,80,160,0,640
32755,200,180,120,80,160,0,740
32756,190,140,80,80,0,0,490
32757,180,100,80,80,160,0,600
32758,210,120,160,80,160,0,730
32759,210,140,160,160,160,0,830
32760,150,80,80,80,0,0,390
32761,230,120,80,80,0,0,510
32762,200,120,160,240,160,0,880
32763,230,120,120,160,320,320,1270
32764,220,80,80,160,160,0,700
32765,190,120,80,160,160,0,710
32766,220,120,160,160,320,0,980
32767,210,140,160,80,160,0,750
32768,130,140,160,80,0,0,510
32769,200,120,80,80,0,0,480
32770,160,100,80,0,0,0,340
32771,180,80,40,80,0,0,380
32772,240,180,120,160,160,0,860
32773,220,100,120,160,0,0,600
32774,190,140,80,160,160,0,730
32775,170,120,120,240,320,320,1290
32776,160,120,80,0,0,0,360
32777,220,160,120,160,160,0,820
32778,180,140,120,240,320,0,1000
32779,220,160,160,240,320,0,1100
32780,190,100,160,160,160,0,770
32781,140,80,120,160,320,0,820
32782,170,80,40,80,160,0,530
32783,180,120,40,80,160,320,900
32784,230,160,120,160,160,0,830
32785,230,120,160,160,160,0,830
32786,230,120,40,0,0,0,390
32787,200,120,120,160,320,320,1240
32788,210,200,160,160,0,0,730
32789,210,120,120,80,0,0,530
32790,230,120,120,80,160,0,710
32791,190,80,120,160,160,0,710
32792,230,120,80,80,0,0,510
32793,180,180,120,160,320,320,1280
32794,200,160,160,160,160,0,840
32795,180,120,120,240,160,0,820
32796,210,120,120,160,160,320,1090
32797,220,100,120,160,160,0,760
32798,190,120,80,80,0,0,470
32799,230,140,40,80,160,0,650
32800,150,140,120,160,160,0,730
32801,200,120,120,160,160,0,760
32802,230,140,40,0,0,0,410
32803,200,100,80,80,160,0,620
32804,220,200,120,80,0,0,620
32805,190,60,40,80,160,0,530
32806,180,100,80,0,0,0,360
32807,220,120,120,80,160,0,700
32808,180,80,40,80,0,0,380
32809,200,140,40,0,0,0,380
32810,190,120,120,80,160,0,670
32811,200,160,80,80,0,0,520
32812,200,140,120,160,0,0,620
32813,160,160,160,160,320,320,1280
32814,230,160,80,80,160,0,710
32815,160,100,80,0,0,0,340
32816,160,40,0,0,0,0,200
32817,200,120,80,0,0,0,400
32818,190,120,40,80,160,0,590
32819,190,140,160,80,160,0,730
32820,130,100,80,0,0,0,310
32821,190,120,160,160,320,0,950
32822,190,100,80,160,160,320,1010
32823,190,120,80,80,0,0,470
32824,200,140,160,80,0,0,580
32825,170,140,200,80,0,0,590
32826,230,120,40,80,160,320,950
32827,180,120,40,0,0,0,340
32828,210,120,120,80,160,0,690
32829,190,80,40,80,160,0,550
32830,220,120,120,240,320,0,1020
32831,220,140,120,160,160,320,1120
32832,200,160,80,80,160,0,680
32833,170,140,80,80,160,0,630
32834,220,120,120,80,0,0,540
32835,200,120,120,80,0,0,520
32836,250,120,80,80,160,320,1010
32837,200,160,160,80,160,0,760
32838,210,120,120,160,320,0,930
32839,220,60,40,80,160,0,560
32840,220,100,120,80,0,0,520
32841,180,100,80,0,0,0,360
32842,150,140,120,160,0,0,570
32843,190,100,80,80,160,320,930
32844,200,160,160,80,160,320,1080
32845,230,80,120,80,0,0,510
32846,190,140,120,80,160,0,690
32847,210,140,160,160,160,0,830
32848,170,80,40,80,0,0,370
32849,200,120,160,240,160,0,880
32850,180,160,160,160,160,0,820
32851,180,100,80,0,0,0,360
32852,220,140,160,240,160,0,920
32853,200,80,120,80,160,0,640
32854,230,100,80,80,0,0,490
32855,200,120,160,80,0,0,560
32856,210,180,200,320,160,0,1070
32857,180,120,80,80,160,0,620
32858,170,100,160,160,320,0,910
32859,170,180,200,160,160,0,870
32860,170,80,120,80,160,0,610
32861,190,100,120,80,160,0,650
32862,160,140,120,240,320,320,1300
32863,160,160,120,160,160,320,1080
32864,210,140,80,0,0,0,430
32865,170,120,80,80,0,0,450
32866,190,100,120,80,0,0,490
32867,190,100,120,80,160,320,970
32868,200,160,120,80,0,0,560
32869,170,180,120,160,0,0,630
32870,200,200,160,160,160,320,1200
32871,210,80,80,80,160,0,610
32872,170,80,80,160,160,0,650
32873,200,140,200,80,160,0,780
32874,180,120,80,80,160,0,620
32875,160,120,160,160,320,0,920
32876,210,120,80,80,0,0,490
32877,240,180,120,0,0,0,540
32878,170,100,120,80,160,0,630
32879,200,100,200,80,0,0,580
32880,230,140,40,0,0,0,410
32881,220,120,80,80,0,0,500
32882,210,180,160,160,160,0,870
32883,150,80,80,80,160,0,550
32884,170,100,120,80,160,0,630
32885,180,160,0,0,0,0,340
32886,230,100,160,80,0,0,570
32887,230,100,120,160,320,0,930
32888,200,60,0,0,0,0,260
32889,190,80,80,0,0,0,350
32890,180,100,120,160,160,0,720
32891,220,100,120,160,320,0,920
32892,220,140,160,80,160,0,760
32893,190,140,160,240,0,0,730
32894,220,160,160,160,160,0,860
32895,190,100,40,80,160,0,570
32896,210,120,40,80,0,0,450
32897,170,140,80,0,0,0,390
32898,220,160,160,160,320,0,1020
32899,190,120,120,160,160,0,750
32900,210,120,80,80,0,0,490
32901,170,140,120,160,160,0,750
32902,210,120,160,160,160,320,1130
32903,230,120,120,240,320,320,1350
32904,220,60,80,80,160,0,600
32905,230,100,120,160,0,0,610
32906,200,120,80,160,160,0,720
32907,200,120,120,80,160,0,680
32908,190,140,120,80,0,0,530
32909,220,180,120,160,160,0,840
32910,200,100,120,80,160,0,660
32911,180,80,80,80,160,0,580
32912,200,120,160,160,0,0,640
32913,190,140,200,160,160,0,850
32914,150,120,120,80,0,0,470
32915,210,160,80,160,160,0,770
32916,230,160,160,80,0,0,630
32917,180,140,160,80,160,0,720
32918,200,120,80,80,0,0,480
32919,170,80,160,80,0,0,490
32920,220,160,80,80,160,0,700
32921,190,140,80,80,160,0,650
32922,180,100,80,80,0,0,440
32923,190,60,80,80,0,0,410
32924,180,160,160,80,160,0,740
32925,150,100,40,80,160,0,530
32926,230,120,160,160,160,0,830
32927,200,120,160,160,320,320,1280
32928,200,100,160,160,160,0,780
32929,180,120,200,240,320,320,1380
32930,200,120,200,160,160,0,840
32931,190,120,80,0,0,0,390
32932,190,100,80,80,160,0,610
32933,160,100,120,80,0,0,460
32934,190,120,200,160,0,0,670
32935,170,100,120,80,160,0,630
32936,230,120,160,160,160,0,830
32937,190,80,120,160,320,0,870
32938,210,140,80,80,160,0,670
32939,190,100,40,80,0,0,410
32940,160,100,80,160,320,320,1140
32941,180,160,200,160,160,0,860
32942,190,80,80,160,160,0,670
32943,180,160,160,160,160,0,820
32944,210,120,160,0,0,0,490
32945,190,60,80,0,0,0,330
32946,200,140,80,80,160,0,660
32947,220,100,160,0,0,0,480
32948,180,100,80,0,0,0,360
32949,170,100,80,80,0,0,430
32950,170,140,200,240,160,0,910
32951,210,160,120,80,0,0,570
32952,190,80,120,80,160,320,950
32953,180,120,120,80,0,0,500
32954,210,160,120,80,0,0,570
32955,230,120,80,80,160,0,670
32956,180,100,80,80,0,0,440
32957,180,120,120,80,160,0,660
32958,240,160,80,80,0,0,560
32959,190,100,80,0,0,0,370
32960,200,120,160,80,0,0,560
32961,200,100,80,80,0,0,460
32962,190,100,40,0,0,0,330
32963,170,120,80,160,160,0,690
32964,210,200,160,160,160,320,1210
32965,160,100,120,80,0,0,460
32966,240,100,40,0,0,0,380
32967,200,100,40,80,160,0,580
32968,180,100,120,80,160,320,960
32969,160,80,120,160,160,0,680
32970,150,80,80,80,160,320,870
32971,210,120,80,80,0,0,490
32972,190,200,160,240,320,320,1430
32973,210,120,40,0,0,0,370
32974,200,80,120,80,0,0,480
32975,180,140,120,80,0,0,520
32976,180,100,80,80,160,320,920
32977,210,180,160,80,160,0,790
32978,160,80,160,160,160,0,720
32979,140,80,120,80,0,0,420
32980,160,120,80,80,160,0,600
32981,190,60,120,160,160,0,690
32982,200,140,120,160,160,0,780
32983,190,60,40,0,0,0,290
32984,170,100,120,160,0,0,550
32985,210,60,40,80,160,0,550
32986,200,80,120,240,320,0,960
32987,170,140,160,240,0,0,710
32988,130,80,40,80,160,0,490
32989,210,120,120,80,0,0,530
32990,190,120,40,0,0,0,350
32991,220,140,80,160,0,0,600
32992,170,120,120,160,160,0,730
32993,180,120,80,160,320,0,860
32994,220,100,80,160,0,0,560
32995,190,140,160,0,0,0,490
32996,190,100,40,80,160,0,570
32997,210,140,40,80,160,0,630
32998,200,140,80,80,160,0,660
32999,240,140,120,0,0,0,500
33000,170,120,160,80,160,0,690
33001,200,140,80,80,0,0,500
33002,190,140,80,160,320,320,1210
33003,200,180,80,80,160,0,700
33004,160,60,80,80,160,0,540
33005,190,120,120,160,320,0,910
33006,190,140,200,160,320,320,1330
33007,210,120,80,80,160,0,650
33008,190,160,200,160,0,0,710
33009,210,100,80,80,0,0,470
33010,230,100,40,0,0,0,370
33011,160,80,40,80,160,0,520
33012,170,140,40,80,160,0,590
33013,170,80,80,80,160,0,570
33014,200,100,120,160,320,320,1220
33015,180,140,80,80,0,0,480
33016,200,100,40,80,160,0,580
33017,170,100,40,80,160,0,550
33018,210,80,80,80,160,0,610
33019,190,120,80,0,0,0,390
33020,220,220,120,80,160,0,800
33021,200,140,160,160,320,0,980
33022,230,140,120,80,0,0,570
33023,210,80,80,80,0,0,450
33024,200,160,80,80,160,0,680
33025,250,180,80,80,0,0,590
33026,230,140,160,240,320,320,1410
33027,210,80,120,0,0,0,410
33028,180,80,80,80,160,0,580
33029,200,160,120,160,160,0,800
33030,170,120,80,0,0,0,370
33031,190,80,40,80,160,0,550
33032,180,80,0,0,0,0,260
33033,180,80,40,80,160,0,540
33034,240,80,120,240,160,0,840
33035,230,100,80,160,160,320,1050
33036,160,80,80,80,0,0,400
33037,180,100,120,160,160,320,1040
33038,190,120,120,0,0,0,430
33039,180,120,200,160,160,320,1140
33040,220,140,120,80,0,0,560
33041,250,160,120,80,160,0,770
33042,210,80,80,80,160,0,610
33043,200,80,40,0,0,0,320
33044,170,140,80,80,160,0,630
33045,200,160,160,160,0,0,680
33046,240,80,0,0,0,0,320
33047,170,140,80,80,160,0,630
33048,140,120,160,160,0,0,580
33049,190,180,200,160,160,320,1210
33050,160,120,80,0,0,0,360
33051,170,100,160,240,160,320,1150
33052,200,80,40,80,160,320,880
33053,210,100,40,80,160,0,590
33054,230,120,80,80,0,0,510
33055,190,120,80,80,0,0,470
33056,240,120,120,160,160,0,800
33057,210,120,80,80,160,320,970
33058,210,160,200,160,0,0,730
33059,210,80,80,80,160,0,610
33060,190,160,80,80,160,0,670
33061,220,80,80,160,160,0,700
33062,210,100,120,160,160,0,750
33063,270,140,160,160,160,0,890
33064,230,80,80,160,160,320,1030
33065,230,100,80,0,0,0,410
33066,200,120,80,80,160,0,640
33067,190,160,120,80,160,0,710
33068,190,140,80,80,160,0,650
33069,160,160,160,160,160,0,800
33070,210,180,120,160,320,320,1310
33071,220,100,80,80,0,0,480
33072,170,60,120,160,160,0,670
33073,220,160,160,80,160,0,780
33074,180,140,80,80,0,0,480
33075,190,120,80,80,160,0,630
33076,210,120,160,240,160,320,1210
33077,220,140,160,240,160,0,920
33078,200,140,80,80,0,0,500
33079,230,180,200,80,0,0,690
33080,160,80,80,160,320,320,1120
33081,210,100,80,80,160,0,630
33082,200,120,120,160,160,320,1080
33083,190,160,160,80,0,0,590
33084,190,100,160,160,0,0,610
33085,190,180,120,80,160,0,730
33086,210,120,40,80,160,0,610
33087,240,160,80,80,160,0,720
33088,170,120,80,80,0,0,450
33089,170,140,120,160,160,0,750
33090,190,80,0,0,0,0,270
33091,160,100,40,80,160,0,540
33092,220,80,80,80,160,0,620
33093,200,80,40,0,0,0,320
33094,230,160,120,160,0,0,670
33095,250,80,160,160,0,0,650
33096,220,60,40,0,0,0,320
33097,180,120,120,80,0,0,500
33098,160,80,120,80,160,0,600
33099,240,160,160,80,160,0,800
33100,210,180,120,80,160,320,1070
33101,180,140,80,160,320,320,1200
33102,170,120,80,0,0,0,370
33103,200,100,120,160,0,0,580
33104,190,80,80,80,160,0,590
33105,210,140,80,80,0,0,510
33106,190,80,40,80,160,0,550
33107,230,100,120,160,320,0,930
33108,220,140,160,240,160,320,1240
33109,220,80,80,80,160,0,620
33110,190,100,80,80,160,0,610
33111,240,100,40,80,0,0,460
33112,180,140,120,80,0,0,520
33113,250,120,80,160,160,320,1090
33114,170,200,160,80,160,0,770
33115,190,140,200,160,160,0,850
33116,150,40,80,160,160,0,590
33117,210,120,120,80,160,0,690
33118,200,120,160,160,160,0,800
33119,210,120,0,0,0,0,330
33120,210,160,120,160,0,0,650
33121,200,100,40,0,0,0,340
33122,220,160,160,80,160,320,1100
33123,200,120,80,80,160,0,640
33124,190,120,40,80,0,0,430
33125,190,100,160,160,0,0,610
33126,140,40,40,80,160,0,460
33127,170,120,80,80,0,0,450
33128,190,140,160,80,0,0,570
33129,190,80,40,80,0,0,390
33130,200,140,0,0,0,0,340
33131,210,120,40,80,160,0,610
33132,220,120,120,80,0,0,540
33133,200,160,160,240,0,0,760
33134,200,120,80,80,160,0,640
33135,220,80,40,0,0,0,340
33136,180,80,160,80,160,0,660
33137,160,80,80,160,160,0,640
33138,200,180,120,80,0,0,580
33139,260,160,120,0,0,0,540
33140,200,120,80,80,0,0,480
33141,200,160,200,240,160,0,960
33142,200,80,80,80,160,0,600
33143,200,140,160,160,320,0,980
33144,190,80,80,80,160,0,590
33145,190,120,160,160,160,0,790
33146,200,160,80,0,0,0,440
33147,160,140,160,240,160,320,1180
33148,180,100,80,160,320,0,840
33149,210,140,120,160,160,0,790
33150,150,80,40,80,0,0,350
33151,240,140,160,160,160,0,860
33152,220,160,80,80,160,0,700
33153,180,140,40,0,0,0,360
33154,200,160,200,160,0,0,720
33155,190,120,80,0,0,0,390
33156,210,80,80,80,0,0,450
33157,180,100,80,80,0,0,440
33158,240,60,80,80,0,0,460
33159,210,100,120,0,0,0,430
33160,180,100,80,80,160,0,600
33161,230,80,80,0,0,0,390
33162,190,100,80,80,0,0,450
33163,230,160,120,80,0,0,590
33164,180,80,80,0,0,0,340
33165,190,160,80,80,0,0,510
33166,230,140,40,80,0,0,490
33167,240,80,40,0,0,0,360
33168,190,80,0,0,0,0,270
33169,200,100,120,80,160,0,660
33170,190,120,160,160,160,320,1110
33171,250,180,120,160,320,320,1350
33172,200,80,40,80,0,0,400
33173,170,100,120,160,160,0,710
33174,190,120,80,0,0,0,390
33175,180,120,120,240,160,0,820
33176,200,100,0,0,0,0,300
33177,210,80,40,0,0,0,330
33178,230,160,120,160,160,0,830
33179,150,120,160,160,160,320,1070
33180,220,120,80,80,160,0,660
33181,220,120,40,0,0,0,380
33182,190,80,80,160,320,0,830
33183,250,160,120,80,160,0,770
33184,210,100,120,160,160,0,750
33185,200,160,160,240,0,0,760
33186,170,100,160,160,160,0,750
33187,220,100,120,0,0,0,440
33188,220,140,160,160,320,0,1000
33189,190,140,120,160,320,0,930
33190,180,80,40,80,160,320,860
33191,210,80,80,0,0,0,370
33192,220,160,160,240,320,320,1420
33193,190,140,80,80,0,0,490
33194,230,180,120,80,160,0,770
33195,180,120,160,80,160,0,700
33196,200,120,120,160,320,0,920
33197,220,140,160,80,0,0,600
33198,200,60,40,0,0,0,300
33199,190,120,120,80,0,0,510
33200,180,100,40,0,0,0,320
33201,230,160,120,160,160,0,830
33202,200,160,160,80,160,0,760
33203,220,100,120,160,160,320,1080
33204,190,100,40,80,0,0,410
33205,230,140,200,240,320,0,1130
33206,190,100,80,80,0,0,450
33207,180,140,120,160,320,0,920
33208,190,80,40,80,0,0,390
33209,190,120,40,80,0,0,430
33210,190,120,80,0,0,0,390
33211,190,160,80,80,0,0,510
33212,200,80,80,160,160,0,680
33213,230,140,200,160,320,320,1370
33214,160,100,80,0,0,0,340
33215,160,100,40,80,0,0,380
33216,170,120,120,240,320,0,970
33217,220,100,120,160,160,0,760
33218,230,100,120,0,0,0,450
33219,180,60,80,80,160,0,560
33220,220,120,80,160,160,0,740
33221,130,60,40,80,160,0,470
33222,230,60,120,160,0,0,570
33223,160,120,120,160,320,0,880
33224,190,160,80,0,0,0,430
33225,190,120,0,0,0,0,310
33226,180,80,120,80,160,0,620
33227,220,120,80,80,160,0,660
33228,160,100,120,160,320,0,860
33229,210,140,80,160,320,0,910
33230,220,100,160,0,0,0,480
33231,230,160,40,0,0,0,430
33232,190,160,160,240,160,0,910
33233,150,100,160,160,160,0,730
33234,210,100,40,0,0,0,350
33235,150,60,80,160,0,0,450
33236,230,140,120,80,160,320,1050
33237,200,120,80,160,320,0,880
33238,180,120,120,160,160,0,740
33239,190,100,80,80,160,0,610
33240,200,220,200,240,160,0,1020
33241,180,100,40,80,0,0,400
33242,160,100,40,0,0,0,300
33243,160,100,80,160,160,0,660
33244,200,120,120,80,160,0,680
33245,220,160,160,240,320,0,1100
33246,170,100,40,80,160,0,550
33247,200,140,80,80,160,0,660
33248,190,120,40,0,0,0,350
33249,170,140,120,80,160,0,670
33250,210,140,120,160,320,0,950
33251,190,120,80,0,0,0,390
33252,180,80,80,160,160,0,660
33253,210,100,120,160,160,0,750
33254,180,120,120,160,320,320,1220
33255,200,80,40,0,0,0,320
33256,220,180,240,240,160,320,1360
33257,190,100,80,0,0,0,370
33258,200,140,120,80,160,0,700
33259,250,200,120,80,160,320,1130
33260,200,160,200,160,160,0,880
33261,150,60,80,80,0,0,370
33262,200,80,80,160,160,0,680
33263,190,80,120,80,0,0,470
33264,200,80,40,0,0,0,320
33265,200,100,120,80,0,0,500
33266,200,60,120,0,0,0,380
33267,180,100,80,80,160,0,600
33268,200,180,80,80,160,0,700
33269,200,100,120,80,160,320,980
33270,200,120,120,160,320,0,920
33271,210,140,120,80,160,0,710
33272,230,120,120,0,0,0,470
33273,180,140,120,0,0,0,440
33274,180,160,120,160,0,0,620
33275,250,100,80,80,0,0,510
33276,180,120,80,80,160,0,620
33277,180,100,160,240,160,0,840
33278,190,120,120,160,0,0,590
33279,210,160,200,160,160,320,1210
33280,220,140,160,160,160,0,840
33281,190,120,80,80,160,0,630
33282,230,120,200,80,160,0,790
33283,190,160,160,80,160,0,750
33284,210,180,160,160,320,0,1030
33285,210,120,160,160,160,0,810
33286,180,100,80,80,0,0,440
33287,220,100,120,80,160,0,680
33288,210,140,120,160,160,320,1110
33289,230,140,40,80,160,0,650
33290,170,140,120,80,160,320,990
33291,120,80,80,0,0,0,280
33292,190,60,0,0,0,0,250
33293,200,100,80,80,0,0,460
33294,220,80,40,80,160,0,580
33295,240,160,120,0,0,0,520
33296,170,180,200,160,160,0,870
33297,240,100,120,80,0,0,540
33298,180,140,120,160,0,0,600
33299,190,140,40,0,0,0,370
33300,220,80,80,80,160,0,620
33301,190,60,40,80,160,0,530
33302,180,100,40,80,0,0,400
33303,190,140,80,80,160,0,650
33304,210,80,40,80,160,0,570
33305,200,100,120,160,160,320,1060
33306,210,100,80,160,160,0,710
33307,240,140,80,160,320,320,1260
33308,190,160,200,160,160,0,870
33309,200,160,200,240,320,0,1120
33310,190,140,40,80,160,0,610
33311,200,120,80,160,160,0,720
33312,200,100,40,0,0,0,340
33313,240,160,120,0,0,0,520
33314,230,80,0,0,0,0,310
33315,240,160,160,160,160,0,880
33316,200,140,80,80,0,0,500
33317,160,120,80,80,0,0,440
33318,180,60,80,80,0,0,400
33319,210,180,200,240,320,0,1150
33320,210,140,120,80,160,0,710
33321,210,120,40,80,0,0,450
33322,150,60,40,80,160,320,810
33323,190,140,120,80,0,0,530
33324,160,140,160,80,160,0,700
33325,190,160,160,240,320,0,1070
33326,160,180,120,160,160,0,780
33327,150,100,120,0,0,0,370
33328,220,140,160,160,160,0,840
33329,180,100,80,80,0,0,440
33330,230,100,120,240,160,0,850
33331,230,180,80,80,160,0,730
33332,230,120,80,160,160,0,750
33333,190,80,40,0,0,0,310
33334,190,100,80,0,0,0,370
33335,200,180,160,80,0,0,620
33336,250,120,40,80,160,0,650
33337,200,160,120,80,160,0,720
33338,210,160,200,160,160,0,890
33339,220,60,40,0,0,0,320
33340,150,80,40,80,160,0,510
33341,220,140,0,0,0,0,360
33342,180,140,120,160,160,0,760
33343,230,140,80,80,160,0,690
33344,210,140,80,160,160,320,1070
33345,180,60,80,80,160,0,560
33346,170,100,120,160,160,320,1030
33347,220,120,120,160,160,0,780
33348,210,180,200,0,0,0,590
33349,180,120,80,80,160,0,620
33350,180,80,120,160,160,320,1020
33351,210,140,80,80,0,0,510
33352,200,140,240,160,160,0,900
33353,180,100,160,160,0,0,600
33354,140,140,120,160,160,0,720
33355,200,100,40,0,0,0,340
33356,190,80,40,80,0,0,390
33357,210,120,0,0,0,0,330
33358,200,160,160,160,160,320,1160
33359,180,100,120,80,0,0,480
33360,160,60,80,80,160,0,540
33361,190,140,160,0,0,0,490
33362,170,60,80,80,0,0,390
33363,210,120,40,0,0,0,370
33364,230,180,160,160,0,0,730
33365,220,140,160,160,320,320,1320
33366,220,80,40,80,160,0,580
33367,200,120,160,160,160,0,800
33368,200,120,40,0,0,0,360
33369,180,120,160,80,0,0,540
33370,200,120,120,80,160,0,680
33371,190,140,40,0,0,0,370
33372,200,80,40,80,160,0,560
33373,200,160,80,80,0,0,520
33374,220,60,80,160,160,0,680
33375,210,140,80,80,160,0,670
33376,210,160,80,160,160,0,770
33377,190,20,0,0,0,0,210
33378,220,80,160,80,0,0,540
33379,190,120,120,0,0,0,430
33380,160,140,120,160,160,0,740
33381,210,160,120,80,0,0,570
33382,240,140,200,80,160,0,820
33383,170,120,80,160,160,0,690
33384,220,120,120,80,160,0,700
33385,160,60,0,0,0,0,220
33386,230,140,80,80,0,0,530
33387,230,100,80,80,160,0,650
33388,210,180,120,80,0,0,590
33389,190,180,160,160,0,0,690
33390,230,200,120,160,320,0,1030
33391,150,80,40,0,0,0,270
33392,200,120,200,160,160,0,840
33393,200,160,200,240,160,0,960
33394,180,120,80,160,320,320,1180
33395,190,140,80,80,160,0,650
33396,170,100,80,160,160,0,670
33397,170,140,80,80,0,0,470
33398,230,140,160,240,320,320,1410
33399,130,60,80,80,160,0,510
33400,180,120,80,80,0,0,460
33401,200,160,40,0,0,0,400
33402,200,140,120,80,160,0,700
33403,190,120,120,80,0,0,510
33404,200,100,160,160,160,0,780
33405,190,100,80,80,160,0,610
33406,210,120,160,160,320,0,970
33407,180,120,160,80,160,0,700
33408,150,120,120,80,160,0,630
33409,170,100,120,240,320,0,950
33410,180,120,160,160,160,0,780
33411,180,160,200,240,160,0,940
33412,210,160,160,240,320,0,1090
33413,150,140,160,160,160,320,1090
33414,210,120,120,160,160,0,770
33415,210,180,240,160,160,0,950
33416,170,140,80,80,0,0,470
33417,190,100,80,0,0,0,370
33418,210,140,200,160,160,0,870
33419,200,160,200,80,0,0,640
33420,190,80,120,80,160,0,630
33421,210,160,160,0,0,0,530
33422,190,140,120,80,0,0,530
33423,210,120,120,160,160,0,770
33424,170,100,80,0,0,0,350
33425,190,120,80,80,160,0,630
33426,190,140,120,80,160,0,690
33427,180,120,40,0,0,0,340
33428,200,140,160,160,160,0,820
33429,210,140,160,160,160,320,1150
33430,190,120,120,80,0,0,510
33431,190,120,120,160,160,320,1070
33432,230,80,40,0,0,0,350
33433,240,140,160,160,160,320,1180
33434,180,80,120,0,0,0,380
33435,230,140,160,80,160,320,1090
33436,190,40,80,80,160,0,550
33437,190,140,120,80,160,320,1010
33438,200,120,160,160,160,0,800
33439,180,140,120,160,320,320,1240
33440,180,120,80,80,160,320,940
33441,180,80,40,80,0,0,380
33442,240,120,40,0,0,0,400
33443,170,100,80,80,160,0,590
33444,160,120,160,160,160,320,1080
33445,210,120,40,80,160,320,930
33446,210,120,120,80,160,0,690
33447,210,100,120,160,0,0,590
33448,160,120,120,80,160,320,960
33449,210,140,120,160,320,0,950
33450,240,120,120,0,0,0,480
33451,190,60,120,160,320,0,850
33452,220,180,80,160,160,0,800
33453,200,100,80,160,320,320,1180
33454,240,160,160,160,160,0,880
33455,210,120,200,160,0,0,690
33456,220,80,80,80,160,0,620
33457,160,160,80,0,0,0,400
33458,170,100,40,80,160,0,550
33459,210,140,120,160,320,0,950
33460,160,100,160,160,160,0,740
33461,220,140,120,160,160,0,800
33462,180,100,120,80,0,0,480
33463,180,140,40,0,0,0,360
33464,200,60,80,80,160,0,580
33465,170,140,160,160,160,320,1110
33466,180,100,80,80,0,0,440
33467,140,60,40,0,0,0,240
33468,190,80,120,80,0,0,470
33469,150,80,80,80,160,0,550
33470,200,140,160,80,160,320,1060
33471,180,120,120,80,0,0,500
33472,210,60,80,160,320,0,830
33473,230,120,80,160,320,0,910
33474,190,120,80,160,320,0,870
33475,140,120,160,160,320,0,900
33476,170,140,120,80,0,0,510
33477,210,160,40,0,0,0,410
33478,150,80,120,160,160,0,670
33479,190,160,160,80,0,0,590
33480,180,200,200,80,160,0,820
33481,190,120,120,160,320,320,1230
33482,200,140,120,160,160,0,780
33483,170,60,80,80,160,320,870
33484,200,160,120,80,160,0,720
33485,230,140,120,80,0,0,570
33486,210,140,40,80,0,0,470
33487,190,120,80,0,0,0,390
33488,200,140,120,80,160,0,700
33489,180,120,80,160,160,0,700
33490,190,100,80,160,320,0,850
33491,120,20,0,0,0,0,140
33492,190,100,120,80,0,0,490
33493,160,120,40,0,0,0,320
33494,160,100,80,160,0,0,500
33495,220,120,80,160,320,320,1220
33496,200,60,80,80,0,0,420
33497,220,40,80,0,0,0,340
33498,170,220,200,160,160,320,1230
33499,210,160,120,160,160,0,810
33500,250,140,120,160,320,0,990
33501,190,140,120,160,0,0,610
33502,190,120,80,80,160,0,630
33503,210,100,80,160,160,0,710
33504,230,180,40,0,0,0,450
33505,200,120,80,80,160,320,960
33506,180,120,80,80,160,0,620
33507,180,80,80,0,0,0,340
33508,220,140,160,160,320,0,1000
33509,200,160,0,0,0,0,360
33510,170,40,40,80,160,0,490
33511,170,100,120,80,0,0,470
33512,220,240,280,80,160,0,980
33513,200,140,120,0,0,0,460
33514,180,160,80,160,160,0,740
33515,170,120,120,80,0,0,490
33516,190,120,120,0,0,0,430
33517,200,80,80,80,160,0,600
33518,190,120,40,0,0,0,350
33519,190,160,120,80,160,0,710
33520,220,140,80,160,320,320,1240
33521,190,120,80,160,320,320,1190
33522,140,100,120,80,0,0,440
33523,210,160,80,80,160,0,690
33524,230,100,40,0,0,0,370
33525,210,160,80,80,0,0,530
33526,250,180,120,80,0,0,630
33527,150,80,160,160,160,320,1030
33528,230,180,80,80,160,0,730
33529,190,100,40,0,0,0,330
33530,170,100,120,240,160,0,790
33531,170,100,80,80,160,320,910
33532,190,120,120,80,160,0,670
33533,210,160,120,80,160,320,1050
33534,140,40,40,80,160,0,460
33535,210,140,80,160,320,0,910
33536,220,160,160,80,160,0,780
33537,180,60,80,0,0,0,320
33538,240,160,160,160,320,0,1040
33539,230,140,120,160,0,0,650
33540,200,100,120,80,160,0,660
33541,220,120,120,160,320,320,1260
33542,220,100,120,0,0,0,440
33543,230,100,40,80,0,0,450
33544,150,120,120,160,160,0,710
33545,200,140,160,160,160,0,820
33546,200,120,120,80,160,0,680
33547,180,140,80,80,160,0,640
33548,190,120,120,160,0,0,590
33549,220,100,120,80,0,0,520
33550,190,120,120,160,320,0,910
33551,190,120,80,0,0,0,390
33552,170,80,80,160,160,0,650
33553,220,140,120,0,0,0,480
33554,250,100,80,80,0,0,510
33555,210,80,40,80,160,320,890
33556,180,100,160,160,320,320,1240
33557,150,120,80,0,0,0,350
33558,200,120,160,160,160,320,1120
33559,200,120,80,80,160,0,640
33560,190,120,80,80,0,0,470
33561,200,100,40,80,0,0,420
33562,180,120,120,160,160,0,740
33563,210,120,80,80,160,0,650
33564,150,160,120,160,160,0,750
33565,190,100,120,160,320,0,890
33566,220,140,80,0,0,0,440
33567,160,80,80,0,0,0,320
33568,190,120,120,160,0,0,590
33569,180,140,120,80,160,0,680
33570,180,140,40,80,160,0,600
33571,180,120,40,80,160,0,580
33572,240,100,40,0,0,0,380
33573,190,60,0,0,0,0,250
33574,220,160,160,240,320,0,1100
33575,210,220,80,160,320,0,990
33576,210,120,120,160,160,0,770
33577,210,160,40,0,0,0,410
33578,180,120,160,160,0,0,620
33579,220,80,40,80,0,0,420
33580,180,100,120,160,0,0,560
33581,240,160,80,80,160,0,720
33582,250,120,80,80,160,320,1010
33583,220,140,160,160,320,0,1000
33584,230,160,120,160,160,0,830
33585,240,60,40,80,0,0,420
33586,210,80,40,80,160,0,570
33587,240,120,40,0,0,0,400
33588,210,40,0,0,0,0,250
33589,220,160,120,160,320,0,980
33590,200,160,40,0,0,0,400
33591,150,100,40,80,160,0,530
33592,200,100,80,80,160,0,620
33593,210,100,80,0,0,0,390
33594,190,160,200,80,160,0,790
33595,200,120,80,80,160,0,640
33596,180,80,40,80,160,0,540
33597,200,160,200,160,0,0,720
33598,160,60,80,80,160,0,540
33599,170,120,80,160,0,0,530
33600,190,140,120,80,0,0,530
33601,180,120,120,160,0,0,580
33602,230,160,80,160,160,0,790
33603,180,60,40,80,0,0,360
33604,240,120,120,160,160,320,1120
33605,200,120,120,80,160,320,1000
33606,200,140,80,80,160,320,980
33607,180,120,40,80,160,0,580
33608,210,140,160,160,160,0,830
33609,190,60,40,80,0,0,370
33610,190,100,120,80,160,0,650
33611,190,100,80,80,160,320,930
33612,210,160,120,80,0,0,570
33613,240,60,120,80,0,0,500
33614,140,140,120,160,160,0,720
33615,180,160,160,160,320,0,980
33616,200,160,120,160,0,0,640
33617,200,160,40,80,160,0,640
33618,200,140,120,160,160,0,780
33619,230,160,40,0,0,0,430
33620,180,120,80,80,0,0,460
33621,170,80,40,80,160,0,530
33622,190,100,120,80,0,0,490
33623,220,100,120,160,160,0,760
33624,190,120,40,0,0,0,350
33625,200,80,40,0,0,0,320
33626,150,100,40,80,160,0,530
33627,190,100,80,80,160,0,610
33628,220,120,160,160,320,0,980
33629,210,120,40,0,0,0,370
33630,190,180,160,240,0,0,770
33631,220,160,80,0,0,0,460
33632,200,140,120,160,0,0,620
33633,190,160,160,240,160,0,910
33634,200,120,160,160,160,0,800
33635,210,160,160,240,0,0,770
33636,220,140,120,160,320,0,960
33637,210,140,80,80,0,0,510
33638,220,180,200,160,160,320,1240
33639,220,120,80,0,0,0,420
33640,170,120,80,0,0,0,370
33641,190,100,80,0,0,0,370
33642,200,140,80,0,0,0,420
33643,190,120,120,160,320,320,1230
33644,200,180,160,160,160,0,860
33645,180,180,160,160,160,0,840
33646,190,180,200,160,160,0,890
33647,180,120,160,160,320,0,940
33648,140,100,80,160,320,320,1120
33649,250,160,40,80,0,0,530
33650,180,100,40,0,0,0,320
33651,200,180,80,80,0,0,540
33652,190,160,120,160,320,320,1270
33653,200,120,120,160,0,0,600
33654,180,40,80,80,0,0,380
33655,190,140,120,80,0,0,530
33656,210,120,120,80,0,0,530
33657,160,80,80,0,0,0,320
33658,230,200,160,160,320,0,1070
33659,170,160,120,160,0,0,610
33660,200,80,80,80,160,0,600
33661,190,120,80,80,0,0,470
33662,190,80,40,80,160,320,870
33663,170,100,120,160,160,320,1030
33664,210,80,80,160,320,320,1170
33665,160,160,200,160,0,0,680
33666,180,100,120,160,160,0,720
33667,220,140,120,80,160,0,720
33668,180,100,80,0,0,0,360
33669,200,80,160,240,160,0,840
33670,160,100,120,80,160,0,620
33671,160,180,200,240,320,320,1420
33672,200,80,80,160,160,0,680
33673,180,120,80,80,160,320,940
33674,250,100,120,160,160,0,790
33675,230,120,120,80,160,0,710
33676,170,120,80,160,320,0,850
33677,210,140,80,80,160,0,670
33678,140,40,80,160,0,0,420
33679,190,180,80,80,0,0,530
33680,200,120,120,80,0,0,520
33681,180,120,0,0,0,0,300
33682,210,120,40,80,0,0,450
33683,200,120,160,160,0,0,640
33684,190,120,80,80,160,0,630
33685,180,100,40,80,0,0,400
33686,170,140,80,160,0,0,550
33687,210,100,80,160,160,0,710
33688,200,120,80,80,0,0,480
33689,210,80,40,0,0,0,330
33690,150,80,120,160,160,0,670
33691,230,160,160,0,0,0,550
33692,190,120,80,80,0,0,470
33693,210,140,120,80,160,0,710
33694,190,120,120,0,0,0,430
33695,200,120,80,0,0,0,400
33696,190,100,80,160,320,320,1170
33697,190,100,120,80,0,0,490
33698,170,100,120,160,0,0,550
33699,200,60,80,0,0,0,340
33700,210,120,80,0,0,0,410
33701,210,140,120,160,160,320,1110
33702,210,200,80,80,160,0,730
33703,190,120,40,80,0,0,430
33704,180,160,160,160,0,0,660
33705,190,160,160,240,0,0,750
33706,180,40,40,80,160,0,500
33707,220,160,160,160,0,0,700
33708,180,100,120,80,0,0,480
33709,200,120,80,80,160,0,640
33710,180,140,120,0,0,0,440
33711,180,160,160,0,0,0,500
33712,220,160,160,160,0,0,700
33713,160,140,160,80,160,0,700
33714,230,120,80,80,160,0,670
33715,190,140,40,80,0,0,450
33716,210,120,80,160,320,320,1210
33717,200,120,40,80,160,0,600
33718,210,180,80,80,160,320,1030
33719,150,100,120,80,160,0,610
33720,190,120,120,80,0,0,510
33721,200,160,120,160,160,0,800
33722,200,80,40,0,0,0,320
33723,220,140,120,80,0,0,560
33724,230,160,200,160,320,320,1390
33725,170,120,120,80,160,320,970
33726,230,140,80,80,160,0,690
33727,230,100,40,80,160,320,930
33728,180,140,160,80,160,0,720
33729,160,120,160,160,160,320,1080
33730,220,120,160,160,160,0,820
33731,210,80,40,80,0,0,410
33732,200,200,200,160,0,0,760
33733,210,180,160,160,320,0,1030
33734,230,100,80,160,160,0,730
33735,220,200,160,160,160,0,900
33736,180,140,120,160,160,0,760
33737,220,160,160,160,0,0,700
33738,190,120,120,160,160,0,750
33739,220,40,40,0,0,0,300
33740,140,120,80,160,160,0,660
33741,230,160,120,80,160,0,750
33742,210,100,120,160,320,0,910
33743,210,120,200,160,160,320,1170
33744,180,140,120,0,0,0,440
33745,210,140,120,80,0,0,550
33746,180,140,120,0,0,0,440
33747,190,120,240,80,160,0,790
33748,170,140,80,160,320,0,870
33749,230,120,40,80,160,0,630
33750,200,100,120,80,160,320,980
33751,170,140,160,80,0,0,550
33752,180,100,40,80,160,0,560
33753,240,100,120,160,320,0,940
33754,180,140,120,80,160,320,1000
33755,190,120,120,80,0,0,510
33756,240,160,200,240,160,0,1000
33757,220,140,40,80,160,0,640
33758,200,140,160,160,160,0,820
33759,180,120,120,80,160,0,660
33760,210,180,160,160,160,0,870
33761,200,140,120,240,160,0,860
33762,190,60,80,160,320,320,1130
33763,170,140,120,160,160,0,750
33764,210,100,80,0,0,0,390
33765,240,200,80,80,160,0,760
33766,170,180,200,240,320,0,1110
33767,220,140,200,160,0,0,720
33768,200,140,120,80,160,320,1020
33769,230,180,120,80,160,0,770
33770,200,160,160,160,160,0,840
33771,210,100,80,160,160,0,710
33772,160,80,120,0,0,0,360
33773,220,180,200,160,0,0,760
33774,210,120,80,0,0,0,410
33775,220,120,160,160,160,0,820
33776,210,80,40,80,160,0,570
33777,210,140,160,80,0,0,590
33778,210,160,200,80,0,0,650
33779,220,140,160,160,160,0,840
33780,150,80,40,80,0,0,350
33781,180,120,120,80,160,0,660
33782,220,100,40,80,160,0,600
33783,210,160,160,240,320,0,1090
33784,200,60,40,80,160,0,540
33785,240,60,40,0,0,0,340
33786,210,180,120,80,160,0,750
33787,220,100,200,240,160,320,1240
33788,210,100,40,0,0,0,350
33789,200,100,160,80,160,320,1020
33790,150,120,40,0,0,0,310
33791,160,140,200,240,160,0,900
33792,220,120,120,240,320,320,1340
33793,200,120,120,80,0,0,520
33794,210,160,200,80,0,0,650
33795,190,140,160,160,160,320,1130
33796,210,120,120,80,0,0,530
33797,210,120,40,80,0,0,450
33798,190,100,0,0,0,0,290
33799,210,100,160,160,320,0,950
33800,200,120,80,160,320,0,880
33801,230,100,120,240,320,320,1330
33802,180,100,0,0,0,0,280
33803,230,180,120,80,160,320,1090
33804,220,160,40,80,0,0,500
33805,190,120,80,80,160,0,630
33806,260,100,120,160,0,0,640
33807,250,200,120,80,160,0,810
33808,210,140,120,240,160,0,870
33809,190,120,120,80,160,0,670
33810,160,120,160,160,0,0,600
33811,180,100,80,80,0,0,440
33812,160,140,40,80,160,0,580
33813,200,140,80,0,0,0,420
33814,180,180,120,160,160,0,800
33815,190,100,80,0,0,0,370
33816,230,140,120,80,160,0,730
33817,170,120,80,80,160,0,610
33818,200,80,80,80,0,0,440
33819,210,160,80,160,160,0,770
33820,190,60,0,0,0,0,250
33821,220,140,80,80,160,0,680
33822,230,100,120,0,0,0,450
33823,200,120,80,80,160,0,640
33824,220,140,80,80,160,0,680
33825,170,80,80,80,0,0,410
33826,210,160,200,240,320,0,1130
33827,200,140,80,0,0,0,420
33828,220,140,120,160,0,0,640
33829,230,140,120,0,0,0,490
33830,210,140,80,0,0,0,430
33831,200,140,40,0,0,0,380
33832,210,140,80,0,0,0,430
33833,210,100,80,80,160,320,950
33834,230,200,200,160,160,0,950
33835,220,160,160,80,160,320,1100
33836,230,120,40,80,160,0,630
33837,200,140,120,80,0,0,540
33838,180,140,160,160,0,0,640
33839,260,120,160,240,160,0,940
33840,200,120,80,0,0,0,400
33841,160,60,40,80,160,0,500
33842,220,120,80,80,160,0,660
33843,180,100,80,160,320,0,840
33844,200,100,120,160,0,0,580
33845,190,180,160,160,160,0,850
33846,210,160,80,80,0,0,530
33847,180,80,80,0,0,0,340
33848,180,140,80,160,160,320,1040
33849,140,120,120,160,320,0,860
33850,200,180,200,0,0,0,580
33851,160,120,0,0,0,0,280
33852,200,120,120,160,0,0,600
33853,180,140,40,80,160,0,600
33854,200,140,120,80,160,0,700
33855,220,100,120,160,320,320,1240
33856,200,160,200,160,0,0,720
33857,170,80,80,80,160,0,570
33858,220,160,160,160,0,0,700
33859,220,180,120,0,0,0,520
33860,150,140,40,80,160,320,890
33861,220,120,120,0,0,0,460
33862,160,140,80,160,0,0,540
33863,210,200,120,80,0,0,610
33864,190,120,40,80,0,0,430
33865,180,120,160,160,160,0,780
33866,190,160,160,80,160,0,750
33867,220,160,120,240,160,0,900
33868,200,100,80,80,0,0,460
33869,190,120,80,160,0,0,550
33870,180,100,120,160,160,0,720
33871,240,140,0,0,0,0,380
33872,170,100,80,80,160,0,590
33873,180,120,160,160,160,0,780
33874,160,80,160,160,320,0,880
33875,230,100,120,80,0,0,530
33876,200,140,160,80,0,0,580
33877,180,80,80,80,0,0,420
33878,220,180,160,160,160,0,880
33879,190,200,160,0,0,0,550
33880,230,140,80,80,160,0,690
33881,190,140,160,240,160,0,890
33882,170,120,120,80,160,0,650
33883,170,180,200,160,160,0,870
33884,190,80,80,160,320,320,1150
33885,180,140,160,80,0,0,560
33886,190,80,40,0,0,0,310
33887,240,200,80,80,160,0,760
33888,160,120,40,80,160,0,560
33889,160,80,120,160,160,0,680
33890,250,140,80,80,160,0,710
33891,190,120,160,160,0,0,630
33892,200,120,40,0,0,0,360
33893,230,80,40,0,0,0,350
33894,200,140,120,0,0,0,460
33895,220,120,80,80,160,0,660
33896,260,180,120,80,160,0,800
33897,160,220,200,240,320,0,1140
33898,210,140,160,80,0,0,590
33899,220,160,120,80,0,0,580
33900,250,160,120,160,320,320,1330
33901,200,100,120,160,320,320,1220
33902,180,140,120,80,0,0,520
33903,210,100,80,80,160,0,630
33904,160,120,0,0,0,0,280
33905,220,140,120,160,320,0,960
33906,190,100,120,80,160,0,650
33907,180,80,80,160,0,0,500
33908,160,100,120,80,160,0,620
33909,170,60,40,80,160,0,510
33910,150,80,40,80,160,0,510
33911,200,80,40,80,160,320,880
33912,170,120,160,240,0,0,690
33913,200,160,80,160,320,0,920
33914,210,120,120,160,0,0,610
33915,220,140,80,160,320,320,1240
33916,210,140,40,0,0,0,390
33917,190,120,120,160,160,0,750
33918,210,120,80,0,0,0,410
33919,170,120,120,80,160,320,970
33920,210,180,200,160,320,320,1390
33921,180,100,120,80,160,0,640
33922,170,140,160,80,160,0,710
33923,210,160,160,160,160,0,850
33924,170,120,120,160,320,0,890
33925,180,120,120,80,160,0,660
33926,190,120,200,160,160,320,1150
33927,230,140,80,80,160,0,690
33928,240,160,120,160,0,0,680
33929,190,140,120,160,160,0,770
33930,170,80,80,80,160,0,570
33931,210,120,120,80,160,0,690
33932,200,120,80,0,0,0,400
33933,190,140,80,0,0,0,410
33934,170,80,80,0,0,0,330
33935,160,160,80,80,160,0,640
33936,160,120,160,80,160,0,680
33937,240,140,160,160,320,0,1020
33938,220,140,120,80,0,0,560
33939,230,160,200,240,160,0,990
33940,200,180,160,160,320,0,1020
33941,170,120,120,160,0,0,570
33942,210,120,80,80,160,320,970
33943,210,140,120,80,0,0,550
33944,260,180,160,80,0,0,680
33945,210,140,80,0,0,0,430
33946,220,120,120,160,160,0,780
33947,180,160,80,160,160,0,740
33948,190,100,80,80,0,0,450
33949,150,140,120,160,320,320,1210
33950,190,140,80,0,0,0,410
33951,160,100,120,0,0,0,380
33952,160,120,160,80,160,320,1000
33953,210,120,120,160,160,0,770
33954,180,80,80,0,0,0,340
33955,180,140,120,160,160,0,760
33956,200,120,120,80,0,0,520
33957,180,160,40,0,0,0,380
33958,200,120,120,80,0,0,520
33959,170,160,160,240,160,0,890
33960,190,140,120,160,320,320,1250
33961,220,80,120,160,160,0,740
33962,200,80,80,0,0,0,360
33963,200,120,200,240,320,0,1080
33964,220,120,120,160,160,0,780
33965,160,140,160,160,0,0,620
33966,190,140,160,80,0,0,570
33967,220,120,120,160,320,0,940
33968,190,120,80,160,160,320,1030
33969,190,100,80,160,160,0,690
33970,190,60,40,0,0,0,290
33971,160,140,80,80,0,0,460
33972,220,100,120,160,160,320,1080
33973,240,100,0,0,0,0,340
33974,180,120,40,0,0,0,340
33975,200,160,160,240,320,0,1080
33976,200,120,120,0,0,0,440
33977,240,160,120,160,160,320,1160
33978,180,100,120,160,160,0,720
33979,180,120,120,160,160,0,740
33980,170,140,160,160,320,0,950
33981,200,140,80,80,0,0,500
33982,210,140,80,160,320,0,910
33983,180,120,160,160,0,0,620
33984,240,200,240,240,160,0,1080
33985,180,80,120,80,160,0,620
33986,220,180,160,160,320,0,1040
33987,170,120,40,80,160,0,570
33988,190,60,80,160,160,0,650
33989,200,140,40,80,160,0,620
33990,220,120,40,0,0,0,380
33991,200,120,40,0,0,0,360
33992,200,160,120,80,160,0,720
33993,210,100,0,0,0,0,310
33994,190,60,80,160,160,320,970
33995,190,220,160,80,160,0,810
33996,180,140,120,160,160,0,760
33997,190,120,80,80,160,0,630
33998,190,120,80,80,0,0,470
33999,160,120,120,160,0,0,560
34000,180,100,40,80,160,0,560
34001,230,140,80,160,0,0,610
34002,180,120,120,160,0,0,580
34003,200,100,40,0,0,0,340
34004,130,120,80,80,0,0,410
34005,220,180,120,80,160,0,760
34006,150,60,80,160,160,0,610
34007,180,100,40,0,0,0,320
34008,190,140,120,160,160,0,770
34009,180,160,120,80,0,0,540
34010,180,100,120,80,160,0,640
34011,230,100,80,80,160,0,650
34012,210,140,160,160,160,320,1150
34013,180,100,160,160,320,320,1240
34014,200,160,200,80,160,0,800
34015,200,140,160,0,0,0,500
34016,210,120,80,0,0,0,410
34017,210,80,80,80,0,0,450
34018,210,80,80,0,0,0,370
34019,160,60,80,80,160,0,540
34020,200,60,80,80,0,0,420
34021,220,140,120,80,160,0,720
34022,220,100,120,160,160,0,760
34023,170,140,160,240,160,0,870
34024,160,100,120,160,0,0,540
34025,220,120,120,80,0,0,540
34026,230,120,120,80,0,0,550
34027,240,60,40,80,160,0,580
34028,190,60,40,0,0,0,290
34029,180,120,160,80,0,0,540
34030,200,100,80,160,160,0,700
34031,180,180,120,0,0,0,480
34032,130,140,200,0,0,0,470
34033,180,100,80,80,160,0,600
34034,210,120,80,0,0,0,410
34035,190,120,40,0,0,0,350
34036,220,120,80,80,0,0,500
34037,220,140,120,240,320,0,1040
34038,180,100,160,160,160,0,760
34039,200,140,120,160,160,0,780
34040,200,100,120,160,160,0,740
34041,220,120,80,80,0,0,500
34042,200,100,80,80,160,0,620
34043,220,160,80,0,0,0,460
34044,200,80,0,0,0,0,280
34045,220,120,80,160,320,0,900
34046,180,100,40,80,160,0,560
34047,170,80,80,80,0,0,410
34048,220,120,80,80,160,320,980
34049,210,80,40,80,160,0,570
34050,180,120,160,0,0,0,460
34051,200,60,40,80,160,0,540
34052,230,160,40,80,160,320,990
34053,220,100,120,80,0,0,520
34054,210,180,80,80,0,0,550
34055,180,80,80,80,0,0,420
34056,190,80,80,160,160,0,670
34057,220,160,120,160,160,0,820
34058,170,120,80,0,0,0,370
34059,200,140,120,160,160,0,780
34060,170,100,80,80,0,0,430
34061,190,140,160,80,160,0,730
34062,250,140,120,80,160,0,750
34063,190,120,80,80,0,0,470
34064,180,100,40,0,0,0,320
34065,210,100,80,80,160,0,630
34066,200,80,40,80,160,0,560
34067,180,120,120,240,160,0,820
34068,200,120,80,0,0,0,400
34069,180,180,80,160,0,0,600
34070,200,120,80,80,160,0,640
34071,190,160,80,80,160,0,670
34072,200,140,160,0,0,0,500
34073,200,80,160,160,160,0,760
34074,210,180,40,80,0,0,510
34075,160,100,120,80,160,0,620
34076,220,140,40,80,160,0,640
34077,180,120,120,80,0,0,500
34078,150,160,120,80,160,0,670
34079,180,120,80,80,0,0,460
34080,170,120,80,80,160,0,610
34081,220,120,200,240,160,0,940
34082,190,140,240,160,0,0,730
34083,190,60,0,0,0,0,250
34084,190,120,120,80,0,0,510
34085,190,140,120,80,0,0,530
34086,190,200,120,160,160,0,830
34087,210,140,120,80,0,0,550
34088,180,160,160,160,160,320,1140
34089,200,140,80,0,0,0,420
34090,190,140,80,80,0,0,490
34091,210,100,80,80,160,320,950
34092,200,140,160,240,320,0,1060
34093,200,80,120,240,0,0,640
34094,190,120,80,80,0,0,470
34095,180,80,40,80,0,0,380
34096,230,160,200,160,320,320,1390
34097,200,100,80,80,160,320,940
34098,240,100,120,80,0,0,540
34099,210,120,160,80,160,0,730
34100,190,140,120,80,0,0,530
34101,200,160,240,80,160,0,840
34102,200,120,40,0,0,0,360
34103,200,120,80,80,160,320,960
34104,180,120,120,80,0,0,500
34105,200,180,200,240,160,320,1300
34106,210,120,160,160,0,0,650
34107,180,120,80,0,0,0,380
34108,160,140,160,0,0,0,460
34109,160,60,80,80,160,0,540
34110,160,120,120,80,0,0,480
34111,160,100,160,240,0,0,660
34112,180,120,120,80,0,0,500
34113,190,120,120,80,0,0,510
34114,170,120,120,160,160,0,730
34115,210,100,120,80,0,0,510
34116,200,80,80,160,320,0,840
34117,210,100,40,80,160,0,590
34118,230,140,120,160,160,0,810
34119,180,80,0,0,0,0,260
34120,200,180,200,160,320,0,1060
34121,180,60,80,80,160,0,560
34122,160,120,80,80,160,320,920
34123,170,160,160,160,0,0,650
34124,230,140,120,80,160,0,730
34125,190,140,120,160,160,0,770
34126,250,160,200,80,160,0,850
34127,180,100,120,160,320,320,1200
34128,170,100,40,80,160,0,550
34129,230,140,80,0,0,0,450
34130,190,100,120,0,0,0,410
34131,200,100,40,80,160,0,580
34132,220,140,120,80,160,0,720
34133,170,120,80,160,160,0,690
34134,200,100,80,80,0,0,460
34135,190,60,40,80,0,0,370
34136,270,140,120,0,0,0,530
34137,240,120,80,0,0,0,440
34138,210,40,40,0,0,0,290
34139,190,160,80,160,160,320,1070
34140,180,120,120,240,320,0,980
34141,190,120,80,0,0,0,390
34142,200,120,200,160,0,0,680
34143,170,100,160,160,320,0,910
34144,180,60,0,0,0,0,240
34145,220,140,80,80,0,0,520
34146,160,80,0,0,0,0,240
34147,210,140,80,80,160,0,670
34148,220,140,160,80,0,0,600
34149,240,120,120,160,320,0,960
34150,230,120,160,160,160,0,830
34151,200,160,120,80,160,0,720
34152,210,160,80,80,0,0,530
34153,200,100,120,80,160,0,660
34154,170,40,40,0,0,0,250
34155,220,100,80,160,160,0,720
34156,210,100,80,80,0,0,470
34157,180,100,160,240,320,0,1000
34158,170,80,0,0,0,0,250
34159,200,120,40,80,0,0,440
34160,220,120,120,80,160,320,1020
34161,210,140,40,80,0,0,470
34162,150,80,80,0,0,0,310
34163,200,100,80,80,0,0,460
34164,200,160,160,80,160,0,760
34165,240,100,0,0,0,0,340
34166,200,120,40,0,0,0,360
34167,150,100,40,80,160,320,850
34168,210,100,80,80,0,0,470
34169,140,100,80,80,0,0,400
34170,160,120,200,240,320,0,1040
34171,190,100,80,80,160,0,610
34172,160,120,40,80,160,320,880
34173,190,200,200,240,320,320,1470
34174,170,80,120,160,160,320,1010
34175,180,160,40,80,0,0,460
34176,190,20,40,0,0,0,250
34177,140,100,80,80,160,0,560
34178,200,100,80,80,0,0,460
34179,220,140,160,160,160,0,840
34180,190,100,0,0,0,0,290
34181,150,100,40,80,160,0,530
34182,210,140,160,160,0,0,670
34183,210,80,40,80,160,0,570
34184,190,100,120,160,160,0,730
34185,220,140,120,80,160,0,720
34186,190,120,160,160,160,0,790
34187,180,120,80,80,160,0,620
34188,180,120,120,80,160,0,660
34189,190,80,80,80,160,0,590
34190,190,120,80,0,0,0,390
34191,210,120,40,80,0,0,450
34192,230,140,120,160,0,0,650
34193,210,120,200,160,160,0,850
34194,150,100,40,80,0,0,370
34195,230,140,80,0,0,0,450
34196,250,120,80,80,0,0,530
34197,170,120,120,160,0,0,570
34198,250,140,200,80,160,0,830
34199,180,120,40,80,160,320,900
34200,190,100,80,80,0,0,450
34201,190,100,120,0,0,0,410
34202,230,120,40,80,160,0,630
34203,210,140,160,80,0,0,590
34204,180,180,160,0,0,0,520
34205,170,40,80,80,160,0,530
34206,150,120,0,0,0,0,270
34207,230,140,80,80,160,0,690
34208,160,120,120,80,160,0,640
34209,210,120,80,0,0,0,410
34210,140,80,40,0,0,0,260
34211,220,120,160,160,160,0,820
34212,190,180,160,80,0,0,610
34213,200,120,40,80,160,0,600
34214,190,120,160,80,0,0,550
34215,220,100,80,80,0,0,480
34216,190,80,120,160,320,0,870
34217,180,180,160,160,160,0,840
34218,200,120,160,160,160,0,800
34219,170,160,80,80,0,0,490
34220,180,40,40,80,160,0,500
34221,200,100,0,0,0,0,300
34222,220,100,120,80,160,0,680
34223,180,160,120,160,160,0,780
34224,190,160,80,80,160,320,990
34225,190,120,160,160,160,0,790
34226,190,100,160,160,160,0,770
34227,150,80,120,0,0,0,350
34228,180,120,160,80,160,0,700
34229,210,100,120,80,160,320,990
34230,220,120,120,80,0,0,540
34231,190,140,40,0,0,0,370
34232,190,140,160,0,0,0,490
34233,230,120,120,160,160,0,790
34234,200,100,40,0,0,0,340
34235,200,60,120,80,0,0,460
34236,220,140,80,80,160,0,680
34237,220,120,120,80,160,320,1020
34238,220,160,80,0,0,0,460
34239,200,140,120,160,160,0,780
34240,200,100,80,0,0,0,380
34241,240,140,40,0,0,0,420
34242,170,80,80,160,0,0,490
34243,190,100,120,160,320,320,1210
34244,230,160,200,160,320,0,1070
34245,190,160,120,240,160,0,870
34246,200,120,120,0,0,0,440
34247,190,120,120,160,320,320,1230
34248,210,120,120,160,320,0,930
34249,180,80,80,80,0,0,420
34250,220,120,40,0,0,0,380
34251,240,140,120,80,0,0,580
34252,190,100,80,160,160,0,690
34253,180,180,120,80,0,0,560
34254,170,120,120,80,0,0,490
34255,210,120,120,0,0,0,450
34256,220,100,40,80,160,0,600
34257,230,160,120,80,160,0,750
34258,170,40,0,0,0,0,210
34259,170,120,120,160,160,0,730
34260,160,140,80,80,160,0,620
34261,210,80,80,80,0,0,450
34262,210,140,120,160,160,0,790
34263,190,80,120,80,0,0,470
34264,210,140,120,80,0,0,550
34265,210,140,80,80,0,0,510
34266,250,120,80,0,0,0,450
34267,180,120,120,160,160,320,1060
34268,200,80,80,0,0,0,360
34269,180,200,160,160,320,320,1340
34270,210,100,80,160,160,0,710
34271,210,120,160,160,160,0,810
34272,220,80,80,80,160,0,620
34273,190,160,200,240,160,0,950
34274,150,120,120,160,160,0,710
34275,200,80,80,80,0,0,440
34276,180,60,80,80,0,0,400
34277,180,180,160,80,160,0,760
34278,200,160,80,80,0,0,520
34279,210,40,40,0,0,0,290
34280,240,200,120,160,320,0,1040
34281,200,80,80,80,0,0,440
34282,170,120,120,160,160,0,730
34283,240,100,120,80,0,0,540
34284,180,100,120,160,320,320,1200
34285,140,120,160,160,320,320,1220
34286,150,100,120,80,160,0,610
34287,200,80,80,80,0,0,440
34288,180,140,120,80,0,0,520
34289,170,40,80,80,0,0,370
34290,220,120,120,160,160,0,780
34291,170,100,120,80,0,0,470
34292,140,120,120,160,160,0,700
34293,190,100,80,0,0,0,370
34294,190,100,80,0,0,0,370
34295,200,140,80,80,0,0,500
34296,170,60,0,0,0,0,230
34297,170,140,120,80,0,0,510
34298,170,120,160,80,0,0,530
34299,220,120,160,160,0,0,660
34300,210,140,120,80,160,0,710
34301,190,100,120,160,160,320,1050
34302,200,160,120,0,0,0,480
34303,140,80,40,0,0,0,260
34304,230,120,80,0,0,0,430
34305,150,80,80,0,0,0,310
34306,200,160,80,80,0,0,520
34307,160,120,160,160,160,0,760
34308,210,160,120,80,160,0,730
34309,150,100,120,80,0,0,450
34310,200,140,120,80,0,0,540
34311,230,100,160,80,160,320,1050
34312,220,100,120,160,160,320,1080
34313,180,180,160,240,160,0,920
34314,230,120,80,80,160,0,670
34315,180,140,160,0,0,0,480
34316,230,120,120,160,0,0,630
34317,180,140,120,80,160,320,1000
34318,230,180,240,80,0,0,730
34319,250,120,160,160,0,0,690
34320,180,140,40,0,0,0,360
34321,180,160,120,80,160,0,700
34322,170,100,120,160,0,0,550
34323,210,140,160,80,0,0,590
34324,190,60,80,0,0,0,330
34325,220,200,200,160,160,0,940
34326,180,140,120,240,320,0,1000
34327,180,80,120,240,320,0,940
34328,190,140,120,80,0,0,530
34329,180,100,40,0,0,0,320
34330,200,120,120,80,160,0,680
34331,210,140,120,80,160,320,1030
34332,160,80,120,160,320,0,840
34333,190,120,120,0,0,0,430
34334,200,160,160,160,160,0,840
34335,210,180,80,80,0,0,550
34336,220,180,120,160,160,0,840
34337,180,140,160,80,0,0,560
34338,180,120,80,160,160,0,700
34339,130,160,120,80,160,0,650
34340,200,160,80,80,160,0,680
34341,180,100,80,80,160,0,600
34342,180,140,120,80,160,0,680
34343,210,100,0,0,0,0,310
34344,190,100,80,80,160,0,610
34345,160,80,80,160,160,320,960
34346,210,140,80,80,0,0,510
34347,160,100,80,160,160,0,660
34348,200,100,80,0,0,0,380
34349,200,140,160,160,320,0,980
34350,190,60,40,80,160,0,530
34351,160,100,80,80,0,0,420
34352,180,120,80,160,160,0,700
34353,210,120,120,240,320,0,1010
34354,170,100,80,80,160,0,590
34355,220,180,80,80,160,0,720
34356,200,140,120,240,320,0,1020
34357,190,100,40,0,0,0,330
34358,210,80,40,80,160,320,890
34359,240,120,80,80,160,320,1000
34360,230,140,80,80,160,0,690
34361,160,120,160,80,0,0,520
34362,230,120,80,0,0,0,430
34363,240,180,160,240,0,0,820
34364,220,160,120,160,0,0,660
34365,210,160,80,80,0,0,530
34366,180,120,80,80,160,320,940
34367,190,160,160,160,320,0,990
34368,220,140,80,0,0,0,440
34369,200,140,80,80,160,0,660
34370,150,60,120,80,160,0,570
34371,210,120,80,0,0,0,410
34372,200,60,80,80,160,0,580
34373,170,60,120,160,160,320,990
34374,220,160,160,160,160,0,860
34375,230,180,240,0,0,0,650
34376,170,80,40,0,0,0,290
34377,220,160,120,80,160,0,740
34378,200,200,80,80,0,0,560
34379,190,100,200,160,0,0,650
34380,220,140,120,0,0,0,480
34381,170,120,80,80,0,0,450
34382,190,100,80,80,160,0,610
34383,200,60,120,80,160,0,620
34384,210,180,80,0,0,0,470
34385,180,140,40,0,0,0,360
34386,200,160,120,80,160,0,720
34387,230,140,160,240,320,0,1090
34388,170,80,40,80,160,0,530
34389,200,120,120,80,160,0,680
34390,200,120,80,80,160,0,640
34391,200,100,40,0,0,0,340
34392,150,160,80,0,0,0,390
34393,190,100,0,0,0,0,290
34394,180,120,120,80,160,0,660
34395,190,140,120,80,0,0,530
34396,190,80,40,0,0,0,310
34397,210,200,200,80,160,320,1170
34398,220,140,80,80,0,0,520
34399,220,120,120,160,160,0,780
34400,210,140,120,0,0,0,470
34401,200,120,0,0,0,0,320
34402,190,160,200,160,160,0,870
34403,210,120,120,160,160,0,770
34404,200,160,160,80,0,0,600
34405,160,120,80,80,0,0,440
34406,180,120,120,240,160,0,820
34407,200,140,160,160,320,0,980
34408,260,100,80,160,160,0,760
34409,170,100,40,80,0,0,390
34410,210,140,80,160,320,0,910
34411,160,140,80,80,160,0,620
34412,220,160,80,80,160,0,700
34413,180,100,80,80,160,320,920
34414,190,160,120,160,0,0,630
34415,250,140,160,80,160,0,790
34416,180,100,80,80,160,0,600
34417,190,140,80,160,160,320,1050
34418,210,100,120,0,0,0,430
34419,180,160,80,160,320,0,900
34420,220,120,160,160,320,320,1300
34421,210,200,160,80,160,0,810
34422,190,120,120,240,160,0,830
34423,200,140,120,160,160,0,780
34424,190,160,120,80,160,320,1030
34425,150,60,80,80,160,0,530
34426,210,120,80,160,160,0,730
34427,200,120,120,160,320,0,920
34428,200,120,200,0,0,0,520
34429,180,100,80,80,160,0,600
34430,210,120,80,80,0,0,490
34431,200,120,120,80,160,0,680
34432,170,140,200,160,160,320,1150
34433,220,180,200,160,160,0,920
34434,200,120,80,80,160,0,640
34435,250,120,160,240,160,0,930
34436,170,100,80,80,160,0,590
34437,160,140,120,160,0,0,580
34438,180,80,40,80,0,0,380
34439,210,120,120,80,0,0,530
34440,200,120,120,80,160,0,680
34441,260,160,80,0,0,0,500
34442,210,180,40,0,0,0,430
34443,190,100,120,160,160,0,730
34444,200,160,120,80,0,0,560
34445,190,120,160,80,160,0,710
34446,210,100,120,240,320,320,1310
34447,220,100,120,160,0,0,600
34448,230,160,160,160,160,0,870
34449,180,120,120,160,320,320,1220
34450,170,120,40,80,160,0,570
34451,210,120,160,160,320,320,1290
34452,150,120,80,80,160,0,590
34453,230,100,120,160,160,0,770
34454,200,140,80,80,0,0,500
34455,190,100,120,80,160,0,650
34456,180,100,40,0,0,0,320
34457,180,100,120,0,0,0,400
34458,200,80,0,0,0,0,280
34459,210,100,80,160,160,0,710
34460,230,120,120,80,0,0,550
34461,220,140,120,160,0,0,640
34462,180,160,160,80,160,320,1060
34463,180,140,160,80,0,0,560
34464,200,100,40,80,160,0,580
34465,200,100,120,160,160,0,740
34466,180,180,200,160,320,0,1040
34467,180,100,80,80,160,0,600
34468,190,140,120,160,160,0,770
34469,190,100,80,80,160,320,930
34470,240,140,120,80,160,320,1060
34471,210,120,80,80,160,0,650
34472,190,140,120,0,0,0,450
34473,180,60,40,80,160,0,520
34474,200,120,120,80,160,0,680
34475,210,160,120,160,160,0,810
34476,220,100,40,80,160,0,600
34477,190,120,80,0,0,0,390
34478,210,120,80,160,0,0,570
34479,210,80,40,80,160,0,570
34480,200,140,160,160,160,0,820
34481,210,120,120,80,160,0,690
34482,180,160,160,160,160,320,1140
34483,180,140,160,0,0,0,480
34484,170,120,120,160,160,320,1050
34485,210,140,160,160,160,0,830
34486,210,120,160,80,0,0,570
34487,190,140,160,80,160,0,730
34488,200,160,120,80,0,0,560
34489,150,160,80,80,160,0,630
34490,230,160,120,80,160,320,1070
34491,190,140,160,80,0,0,570
34492,220,120,160,160,160,0,820
34493,160,100,40,0,0,0,300
34494,180,120,80,0,0,0,380
34495,190,140,120,80,160,0,690
34496,220,140,120,160,320,0,960
34497,170,120,120,160,0,0,570
34498,230,100,80,160,160,0,730
34499,210,120,80,80,160,0,650
34500,180,100,120,160,160,0,720
34501,190,100,80,160,160,0,690
34502,220,100,120,160,0,0,600
34503,160,160,80,80,0,0,480
34504,240,120,80,160,160,0,760
34505,190,100,160,80,160,0,690
34506,230,180,120,0,0,0,530
34507,240,160,120,160,320,320,1320
34508,160,120,120,80,160,0,640
34509,170,40,40,80,160,0,490
34510,190,200,200,160,320,320,1390
34511,240,160,80,80,0,0,560
34512,190,140,160,160,160,0,810
34513,210,140,160,160,160,0,830
34514,170,100,80,80,160,0,590
34515,230,140,0,0,0,0,370
34516,150,100,40,0,0,0,290
34517,200,100,160,240,320,320,1340
34518,200,160,200,240,160,0,960
34519,170,180,200,80,0,0,630
34520,230,160,120,80,160,0,750
34521,180,80,160,80,160,0,660
34522,200,160,200,80,160,320,1120
34523,200,100,80,160,0,0,540
34524,210,140,80,80,160,320,990
34525,160,80,80,160,320,320,1120
34526,210,100,120,80,160,0,670
34527,190,80,0,0,0,0,270
34528,200,100,80,80,160,0,620
34529,200,180,160,160,320,0,1020
34530,210,140,160,240,320,0,1070
34531,160,140,160,80,0,0,540
34532,200,180,160,80,0,0,620
34533,230,140,80,0,0,0,450
34534,190,140,120,160,160,0,770
34535,180,160,120,240,320,0,1020
34536,250,180,120,80,160,320,1110
34537,220,80,80,80,160,0,620
34538,180,140,160,160,160,0,800
34539,210,40,80,160,320,320,1130
34540,190,140,160,80,160,0,730
34541,140,100,120,160,160,0,680
34542,210,100,80,0,0,0,390
34543,210,140,120,80,160,0,710
34544,220,180,160,160,0,0,720
34545,220,180,160,240,160,0,960
34546,200,140,120,240,320,0,1020
34547,180,100,120,160,160,0,720
34548,150,100,120,160,160,0,690
34549,200,80,80,160,320,0,840
34550,220,100,120,160,0,0,600
34551,210,100,0,0,0,0,310
34552,190,80,40,80,160,0,550
34553,180,100,120,160,160,0,720
34554,240,120,80,80,160,0,680
34555,200,80,80,80,160,0,600
34556,190,80,80,80,160,0,590
34557,180,100,120,80,160,0,640
34558,170,80,80,0,0,0,330
34559,220,160,120,80,160,0,740
34560,190,140,120,240,160,320,1170
34561,180,120,120,160,160,0,740
34562,210,200,240,160,0,0,810
34563,180,140,120,80,0,0,520
34564,190,140,80,160,320,0,890
34565,190,80,40,80,0,0,390
34566,200,160,120,160,0,0,640
34567,190,100,80,80,160,0,610
34568,210,120,40,0,0,0,370
34569,170,140,200,240,160,320,1230
34570,210,180,200,160,160,0,910
34571,180,120,160,160,160,320,1100
34572,170,120,120,80,0,0,490
34573,210,100,40,80,160,0,590
34574,210,120,120,160,0,0,610
34575,180,120,120,160,160,0,740
34576,180,100,40,0,0,0,320
34577,190,100,200,240,320,0,1050
34578,170,140,40,0,0,0,350
34579,240,120,120,80,160,0,720
34580,170,120,80,80,160,0,610
34581,210,140,120,80,160,0,710
34582,200,140,80,80,0,0,500
34583,210,80,120,160,160,320,1050
34584,200,140,40,80,0,0,460
34585,160,120,80,80,0,0,440
34586,190,140,120,80,0,0,530
34587,160,100,160,160,160,0,740
34588,210,200,160,80,160,0,810
34589,210,120,120,240,0,0,690
34590,200,120,80,80,160,0,640
34591,210,140,160,0,0,0,510
34592,180,100,80,80,0,0,440
34593,240,160,80,0,0,0,480
34594,170,140,80,80,160,0,630
34595,180,100,160,80,160,0,680
34596,200,120,40,80,160,0,600
34597,200,140,160,160,160,0,820
34598,170,140,120,160,320,0,910
34599,190,80,80,160,160,0,670
34600,190,160,80,160,160,0,750
34601,230,180,200,240,160,0,1010
34602,220,180,160,160,160,0,880
34603,200,120,80,0,0,0,400
34604,210,100,80,160,320,320,1190
34605,190,100,160,160,0,0,610
34606,210,100,120,80,0,0,510
34607,180,180,200,240,160,0,960
34608,200,140,200,160,0,0,700
34609,180,160,80,160,320,0,900
34610,180,100,80,80,160,320,920
34611,170,60,40,80,160,0,510
34612,180,80,120,80,160,0,620
34613,170,140,120,160,320,320,1230
34614,220,120,40,80,160,0,620
34615,210,140,80,160,320,320,1230
34616,190,60,40,0,0,0,290
34617,190,140,200,80,160,0,770
34618,250,120,120,80,160,0,730
34619,250,180,160,80,0,0,670
34620,220,160,120,0,0,0,500
34621,190,100,40,0,0,0,330
34622,250,160,160,80,160,0,810
34623,170,100,120,80,160,0,630
34624,150,60,80,0,0,0,290
34625,130,80,80,80,160,0,530
34626,230,120,80,160,160,0,750
34627,150,100,120,240,160,0,770
34628,200,100,0,0,0,0,300
34629,210,140,120,80,160,320,1030
34630,170,120,120,240,160,0,810
34631,160,140,160,160,320,0,940
34632,170,100,80,80,160,0,590
34633,220,160,160,80,160,0,780
34634,200,140,120,80,160,0,700
34635,220,160,160,160,320,0,1020
34636,200,140,120,80,0,0,540
34637,180,100,40,0,0,0,320
34638,200,80,120,160,320,0,880
34639,160,120,80,80,160,0,600
34640,180,140,40,0,0,0,360
34641,170,60,80,0,0,0,310
34642,180,160,80,80,0,0,500
34643,170,120,40,80,160,0,570
34644,180,100,120,0,0,0,400
34645,170,120,160,80,160,0,690
34646,190,100,120,80,0,0,490
34647,220,160,120,80,160,0,740
34648,210,100,40,0,0,0,350
34649,180,120,120,160,0,0,580
34650,190,140,80,80,0,0,490
34651,250,100,120,80,160,0,710
34652,210,200,200,160,160,0,930
34653,180,100,80,80,160,0,600
34654,140,60,40,0,0,0,240
34655,190,140,40,80,0,0,450
34656,190,100,160,160,160,320,1090
34657,200,140,120,80,160,0,700
34658,190,140,40,80,160,0,610
34659,200,120,80,80,0,0,480
34660,170,140,120,160,0,0,590
34661,180,100,120,80,160,0,640
34662,170,120,40,80,160,320,890
34663,170,100,120,80,0,0,470
34664,210,100,40,80,0,0,430
34665,190,120,160,160,160,0,790
34666,180,140,160,80,160,320,1040
34667,170,140,120,0,0,0,430
34668,200,140,80,80,160,0,660
34669,180,120,120,80,160,320,980
34670,180,80,40,80,0,0,380
34671,180,100,120,160,160,0,720
34672,200,140,80,80,0,0,500
34673,220,180,160,80,160,320,1120
34674,200,160,80,80,0,0,520
34675,200,120,40,80,160,0,600
34676,210,120,80,160,320,0,890
34677,240,180,160,160,160,320,1220
34678,240,120,80,160,320,0,920
34679,250,140,160,160,320,0,1030
34680,170,80,80,80,0,0,410
34681,200,140,120,80,0,0,540
34682,190,180,160,0,0,0,530
34683,190,100,200,80,160,0,730
34684,220,140,120,80,160,0,720
34685,210,140,200,160,160,0,870
34686,180,100,40,80,160,0,560
34687,170,100,120,0,0,0,390
34688,170,100,120,80,0,0,470
34689,190,120,160,80,160,0,710
34690,200,100,120,160,160,320,1060
34691,200,120,80,80,160,0,640
34692,220,160,80,160,320,0,940
34693,200,80,80,0,0,0,360
34694,260,160,160,80,160,0,820
34695,180,80,80,80,160,0,580
34696,170,120,80,80,160,0,610
34697,210,220,160,160,160,0,910
34698,190,140,120,160,0,0,610
34699,190,100,120,160,160,0,730
34700,220,220,240,240,160,0,1080
34701,210,180,160,160,160,0,870
34702,170,100,120,160,0,0,550
34703,180,80,80,80,160,0,580
34704,200,160,160,160,320,0,1000
34705,210,120,160,80,0,0,570
34706,210,100,80,80,160,0,630
34707,200,120,160,240,320,0,1040
34708,210,140,160,160,160,0,830
34709,190,100,40,0,0,0,330
34710,220,120,80,80,0,0,500
34711,170,120,160,0,0,0,450
34712,220,120,120,240,160,0,860
34713,200,140,160,240,160,0,900
34714,190,140,120,160,0,0,610
34715,170,160,80,80,160,0,650
34716,170,60,80,0,0,0,310
34717,140,120,120,80,0,0,460
34718,230,160,200,240,160,0,990
34719,190,140,120,160,320,0,930
34720,140,120,120,80,160,320,940
34721,180,120,80,160,160,320,1020
34722,190,160,120,160,0,0,630
34723,200,100,80,80,0,0,460
34724,190,120,80,160,160,0,710
34725,200,180,200,80,160,0,820
34726,200,160,160,160,160,320,1160
34727,200,140,80,80,160,0,660
34728,210,80,40,80,160,320,890
34729,200,100,40,0,0,0,340
34730,210,120,0,0,0,0,330
34731,210,120,160,80,160,0,730
34732,230,200,160,160,160,0,910
34733,180,100,80,80,0,0,440
34734,160,140,200,80,0,0,580
34735,230,140,80,160,160,0,770
34736,170,120,160,160,0,0,610
34737,220,140,160,80,160,0,760
34738,170,140,120,80,160,0,670
34739,190,120,80,80,160,0,630
34740,210,180,160,80,0,0,630
34741,240,140,160,160,0,0,700
34742,170,140,120,160,320,320,1230
34743,170,100,40,0,0,0,310
34744,180,120,120,160,160,320,1060
34745,180,140,200,240,320,320,1400
34746,210,160,120,80,160,0,730
34747,180,120,120,160,0,0,580
34748,210,100,80,80,0,0,470
34749,210,160,80,0,0,0,450
34750,210,120,80,0,0,0,410
34751,180,120,160,80,160,0,700
34752,150,120,120,240,160,0,790
34753,180,80,40,0,0,0,300
34754,220,100,160,240,160,0,880
34755,210,160,120,240,160,320,1210
34756,190,80,40,80,160,0,550
34757,160,100,120,160,320,0,860
34758,190,100,160,160,160,0,770
34759,180,100,160,160,0,0,600
34760,220,80,80,80,0,0,460
34761,180,140,160,80,0,0,560
34762,200,140,120,160,160,0,780
34763,220,100,40,80,160,0,600
34764,150,140,120,80,0,0,490
34765,200,80,80,160,320,0,840
34766,200,120,160,160,160,0,800
34767,230,180,120,160,160,0,850
34768,190,100,120,160,160,0,730
34769,190,140,200,240,160,320,1250
34770,220,140,160,0,0,0,520
34771,190,120,120,0,0,0,430
34772,190,80,80,80,160,0,590
34773,180,60,120,80,160,0,600
34774,210,120,120,160,160,0,770
34775,190,100,40,0,0,0,330
34776,210,100,120,80,160,0,670
34777,230,120,120,0,0,0,470
34778,200,160,80,80,160,320,1000
34779,180,60,40,80,0,0,360
34780,190,140,120,0,0,0,450
34781,210,100,80,160,320,320,1190
34782,220,80,80,160,160,0,700
34783,210,140,120,80,160,0,710
34784,190,180,120,160,160,0,810
34785,180,160,160,80,0,0,580
34786,190,200,200,160,160,0,910
34787,160,120,120,80,160,0,640
34788,190,100,160,160,0,0,610
34789,200,120,160,160,320,320,1280
34790,210,140,80,80,160,0,670
34791,180,60,40,80,160,0,520
34792,190,100,120,0,0,0,410
34793,190,140,120,80,0,0,530
34794,200,140,80,160,320,320,1220
34795,200,120,80,80,0,0,480
34796,200,120,80,160,160,0,720
34797,180,120,160,160,320,0,940
34798,190,140,120,80,0,0,530
34799,170,80,80,0,0,0,330
34800,220,140,80,80,160,320,1000
34801,200,80,80,80,160,320,920
34802,170,120,120,160,0,0,570
34803,170,80,120,160,160,0,690
34804,170,140,200,160,160,0,830
34805,160,100,0,0,0,0,260
34806,220,120,80,80,0,0,500
34807,200,120,120,80,0,0,520
34808,200,160,160,160,0,0,680
34809,210,160,80,80,160,320,1010
34810,200,160,160,160,160,0,840
34811,180,100,120,160,0,0,560
34812,190,140,160,80,0,0,570
34813,180,140,120,80,0,0,520
34814,170,120,80,80,160,0,610
34815,230,100,120,160,160,0,770
34816,180,160,160,160,0,0,660
34817,200,120,80,80,160,0,640
34818,220,160,160,160,160,0,860
34819,180,120,120,160,320,320,1220
34820,200,100,80,80,0,0,460
34821,180,120,120,0,0,0,420
34822,190,140,200,160,160,0,850
34823,200,140,80,80,0,0,500
34824,200,120,120,160,160,0,760
34825,200,180,200,80,0,0,660
34826,180,80,40,80,0,0,380
34827,180,120,120,160,160,0,740
34828,160,120,160,160,160,0,760
34829,210,160,80,0,0,0,450
34830,180,160,120,80,0,0,540
34831,240,80,40,0,0,0,360
34832,190,100,120,160,160,0,730
34833,190,140,120,240,320,0,1010
34834,190,160,120,80,160,0,710
34835,170,100,160,160,320,320,1230
34836,210,140,80,160,160,320,1070
34837,180,140,80,80,0,0,480
34838,240,120,120,160,0,0,640
34839,190,180,200,160,160,0,890
34840,130,100,120,80,160,0,590
34841,210,120,80,80,160,0,650
34842,180,120,160,160,0,0,620
34843,190,140,120,160,0,0,610
34844,180,160,120,80,0,0,540
34845,190,140,80,80,0,0,490
34846,190,120,120,160,160,0,750
34847,210,120,80,80,160,320,970
34848,180,120,160,80,0,0,540
34849,180,60,80,0,0,0,320
34850,160,140,120,160,320,0,900
34851,210,180,160,80,160,0,790
34852,210,120,120,160,320,0,930
34853,220,180,40,80,0,0,520
34854,190,160,120,160,160,0,790
34855,210,100,80,80,0,0,470
34856,170,80,120,160,320,0,850
34857,200,140,200,160,0,0,700
34858,210,160,120,80,160,320,1050
34859,190,80,40,0,0,0,310
34860,210,140,40,80,160,0,630
34861,180,140,40,0,0,0,360
34862,190,100,40,80,0,0,410
34863,190,140,0,0,0,0,330
34864,230,140,80,80,160,0,690
34865,220,180,120,80,160,0,760
34866,190,140,120,160,160,0,770
34867,110,120,120,160,160,0,670
34868,220,160,160,240,320,0,1100
34869,180,80,40,80,160,0,540
34870,210,160,120,80,0,0,570
34871,140,60,40,80,160,0,480
34872,180,140,120,80,160,320,1000
34873,200,120,160,160,320,320,1280
34874,140,80,40,0,0,0,260
34875,140,80,120,160,320,0,820
34876,220,100,40,80,160,0,600
34877,180,160,160,160,160,320,1140
34878,260,140,80,80,160,320,1040
34879,190,60,80,0,0,0,330
34880,180,160,80,0,0,0,420
34881,210,160,120,80,160,320,1050
34882,200,140,160,160,160,0,820
34883,190,180,80,0,0,0,450
34884,170,140,40,80,0,0,430
34885,170,120,120,160,160,0,730
34886,220,160,200,80,160,0,820
34887,210,120,80,80,0,0,490
34888,210,100,160,240,320,320,1350
34889,210,140,80,80,0,0,510
34890,220,140,80,160,320,0,920
34891,220,120,120,80,160,0,700
34892,160,100,120,240,160,320,1100
34893,190,100,80,0,0,0,370
34894,210,140,200,80,0,0,630
34895,170,140,40,80,0,0,430
34896,200,120,120,80,160,0,680
34897,180,120,120,80,160,0,660
34898,170,100,80,160,320,0,830
34899,190,60,120,0,0,0,370
34900,170,120,160,240,160,0,850
34901,170,100,80,160,160,320,990
34902,230,100,40,80,160,0,610
34903,200,120,120,160,160,0,760
34904,210,160,200,240,160,0,970
34905,140,180,120,160,160,0,760
34906,190,80,80,0,0,0,350
34907,200,40,40,80,0,0,360
34908,230,100,120,80,160,0,690
34909,190,100,160,80,160,320,1010
34910,210,200,200,160,160,0,930
34911,210,140,40,80,0,0,470
34912,210,120,80,80,0,0,490
34913,210,160,120,160,320,320,1290
34914,170,140,160,160,160,320,1110
34915,210,120,80,160,160,0,730
34916,190,80,80,160,0,0,510
34917,200,100,120,160,160,0,740
34918,240,120,80,0,0,0,440
34919,160,120,80,80,0,0,440
34920,210,100,80,160,160,0,710
34921,200,140,120,80,160,320,1020
34922,200,180,120,0,0,0,500
34923,210,80,40,80,0,0,410
34924,210,140,80,80,160,0,670
34925,160,100,120,0,0,0,380
34926,190,100,40,80,160,320,890
34927,210,160,120,160,320,320,1290
34928,230,160,80,0,0,0,470
34929,200,80,120,160,160,0,720
34930,190,180,200,240,160,0,970
34931,210,100,80,80,160,320,950
34932,190,160,120,240,320,0,1030
34933,190,180,120,0,0,0,490
34934,170,120,80,160,160,320,1010
34935,180,140,80,80,160,0,640
34936,180,120,120,80,160,0,660
34937,160,80,40,80,160,0,520
34938,190,140,80,80,0,0,490
34939,190,40,0,0,0,0,230
34940,170,80,80,80,0,0,410
34941,230,180,200,80,160,0,850
34942,200,160,120,80,160,0,720
34943,230,100,80,80,160,0,650
34944,190,140,120,80,0,0,530
34945,190,140,120,0,0,0,450
34946,230,120,40,80,160,0,630
34947,210,80,80,80,160,320,930
34948,190,100,160,240,160,0,850
34949,220,140,0,0,0,0,360
34950,210,200,200,160,160,320,1250
34951,230,140,80,0,0,0,450
34952,210,180,160,160,320,320,1350
34953,210,120,160,80,160,320,1050
34954,180,120,0,0,0,0,300
34955,190,100,120,160,160,320,1050
34956,170,140,200,160,0,0,670
34957,190,120,40,80,160,0,590
34958,180,140,160,240,320,0,1040
34959,190,120,120,160,160,0,750
34960,170,140,120,80,160,0,670
34961,190,80,80,80,160,0,590
34962,220,120,80,80,160,0,660
34963,200,120,120,160,160,320,1080
34964,210,160,160,160,0,0,690
34965,200,140,80,0,0,0,420
34966,200,120,160,240,160,0,880
34967,180,80,40,80,160,0,540
34968,190,60,40,80,0,0,370
34969,200,120,120,160,320,320,1240
34970,200,120,40,80,0,0,440
34971,170,20,0,0,0,0,190
34972,210,100,120,160,160,320,1070
34973,210,200,160,160,160,0,890
34974,170,100,120,160,160,0,710
34975,170,120,80,80,160,0,610
34976,190,100,80,0,0,0,370
34977,220,140,80,80,160,0,680
34978,220,100,80,80,160,320,960
34979,200,120,120,160,160,0,760
34980,200,120,200,160,0,0,680
34981,180,100,120,160,320,0,880
34982,220,100,120,80,160,0,680
34983,190,120,80,160,160,0,710
34984,190,120,40,0,0,0,350
34985,220,120,40,80,160,0,620
34986,200,160,160,80,160,0,760
34987,180,140,120,160,320,320,1240
34988,170,80,40,80,0,0,370
34989,200,120,80,80,160,0,640
34990,190,80,120,0,0,0,390
34991,180,120,80,80,160,0,620
34992,170,100,120,80,160,0,630
34993,190,80,80,80,160,0,590
34994,210,100,80,0,0,0,390
34995,220,160,160,160,0,0,700
34996,200,100,80,80,0,0,460
34997,190,120,80,0,0,0,390
34998,220,120,120,160,320,0,940
34999,200,80,120,80,0,0,480
35000,160,100,80,160,320,320,1140
35001,220,140,40,80,0,0,480
35002,190,80,40,0,0,0,310
35003,210,100,40,80,0,0,430
35004,260,140,120,80,160,0,760
35005,200,120,80,0,0,0,400
35006,210,100,80,80,0,0,470
35007,230,120,80,80,160,0,670
35008,180,100,80,80,0,0,440
35009,210,180,200,160,160,320,1230
35010,180,120,160,160,320,320,1260
35011,220,120,120,0,0,0,460
35012,180,160,160,240,320,320,1380
35013,230,140,40,80,0,0,490
35014,210,140,120,0,0,0,470
35015,220,100,80,0,0,0,400
35016,180,140,120,80,0,0,520
35017,160,100,80,160,320,0,820
35018,190,80,120,80,160,0,630
35019,190,40,0,0,0,0,230
35020,190,120,120,240,160,0,830
35021,160,120,120,160,320,0,880
35022,180,100,40,0,0,0,320
35023,150,80,40,80,160,0,510
35024,140,100,40,80,0,0,360
35025,230,100,80,0,0,0,410
35026,230,120,80,80,0,0,510
35027,230,140,120,160,320,320,1290
35028,220,120,160,80,160,0,740
35029,200,160,120,80,160,0,720
35030,200,160,120,160,320,0,960
35031,190,160,120,160,160,0,790
35032,170,120,160,160,0,0,610
35033,190,140,120,80,0,0,530
35034,210,180,80,0,0,0,470
35035,210,180,120,0,0,0,510
35036,200,140,120,160,0,0,620
35037,170,120,80,80,160,0,610
35038,240,160,200,80,160,0,840
35039,200,160,120,80,160,0,720
35040,240,100,120,80,160,320,1020
35041,190,100,80,0,0,0,370
35042,220,140,120,80,160,0,720
35043,180,80,80,80,0,0,420
35044,220,140,120,160,320,0,960
35045,160,80,0,0,0,0,240
35046,210,160,80,80,160,320,1010
35047,190,160,80,80,160,0,670
35048,160,120,160,160,160,0,760
35049,170,120,40,0,0,0,330
35050,190,60,120,80,160,320,930
35051,220,160,160,80,0,0,620
35052,180,140,200,160,160,320,1160
35053,180,80,80,0,0,0,340
35054,230,120,80,80,0,0,510
35055,210,160,200,240,320,0,1130
35056,170,140,80,0,0,0,390
35057,200,120,120,80,160,0,680
35058,190,160,80,80,0,0,510
35059,220,60,40,0,0,0,320
35060,230,80,80,160,160,0,710
35061,200,140,80,80,0,0,500
35062,220,120,200,80,160,320,1100
35063,200,140,80,80,160,0,660
35064,210,120,120,160,160,0,770
35065,200,160,160,240,320,0,1080
35066,230,160,80,80,160,0,710
35067,220,120,120,80,160,0,700
35068,170,180,240,160,160,320,1230
35069,190,60,0,0,0,0,250
35070,170,140,120,160,320,0,910
35071,190,80,120,80,0,0,470
35072,160,100,120,80,160,0,620
35073,230,120,120,80,160,0,710
35074,210,160,160,80,160,0,770
35075,170,80,80,0,0,0,330
35076,240,120,80,160,160,0,760
35077,190,120,120,80,0,0,510
35078,210,100,80,0,0,0,390
35079,210,140,120,160,320,320,1270
35080,190,140,160,80,0,0,570
35081,220,180,120,160,320,320,1320
35082,170,120,120,0,0,0,410
35083,180,120,80,80,0,0,460
35084,180,120,80,80,0,0,460
35085,220,140,80,160,0,0,600
35086,230,180,120,80,160,0,770
35087,240,120,80,80,160,0,680
35088,190,120,40,80,160,320,910
35089,170,60,120,160,320,0,830
35090,190,120,40,0,0,0,350
35091,190,60,80,80,160,0,570
35092,190,140,40,80,160,0,610
35093,180,140,120,160,0,0,600
35094,200,100,80,0,0,0,380
35095,170,160,120,80,0,0,530
35096,180,140,80,0,0,0,400
35097,200,120,80,80,160,320,960
35098,210,100,120,160,160,0,750
35099,240,160,160,80,160,0,800
35100,190,140,120,160,160,320,1090
35101,200,160,160,240,320,0,1080
35102,210,140,120,160,160,0,790
35103,200,160,120,80,160,0,720
35104,200,140,80,80,0,0,500
35105,210,120,160,160,0,0,650
35106,170,100,40,80,0,0,390
35107,200,80,40,80,0,0,400
35108,200,140,120,80,0,0,540
35109,180,120,120,240,320,0,980
35110,260,160,80,80,160,0,740
35111,210,140,80,160,320,0,910
35112,190,100,40,0,0,0,330
35113,220,140,240,160,160,320,1240
35114,230,140,40,80,160,0,650
35115,180,120,120,80,160,320,980
35116,230,100,160,160,160,0,810
35117,160,120,40,80,160,0,560
35118,180,100,80,0,0,0,360
35119,210,100,80,0,0,0,390
35120,220,180,160,160,160,0,880
35121,210,140,200,240,160,0,950
35122,170,100,80,160,160,0,670
35123,200,160,160,240,160,0,920
35124,180,80,40,0,0,0,300
35125,180,80,0,0,0,0,260
35126,210,120,120,80,0,0,530
35127,200,80,40,80,160,0,560
35128,190,120,80,80,160,0,630
35129,190,120,80,80,0,0,470
35130,230,160,120,0,0,0,510
35131,240,180,120,160,320,320,1340
35132,180,80,80,80,0,0,420
35133,210,100,120,160,0,0,590
35134,250,160,200,240,160,0,1010
35135,180,80,120,160,160,0,700
35136,170,120,80,80,0,0,450
35137,210,160,120,80,160,0,730
35138,160,80,120,0,0,0,360
35139,180,120,200,160,160,0,820
35140,200,160,160,160,320,0,1000
35141,170,60,0,0,0,0,230
35142,200,140,120,80,160,0,700
35143,150,120,120,160,160,0,710
35144,150,60,120,80,160,0,570
35145,170,120,80,160,160,0,690
35146,210,100,120,80,0,0,510
35147,210,140,160,240,320,320,1390
35148,210,60,80,80,0,0,430
35149,190,100,80,160,0,0,530
35150,230,160,120,80,0,0,590
35151,190,140,160,160,320,320,1290
35152,180,140,120,80,160,0,680
35153,160,80,120,80,160,0,600
35154,230,180,120,160,160,320,1170
35155,190,80,80,80,160,320,910
35156,240,120,80,160,160,0,760
35157,200,80,80,80,160,320,920
35158,200,160,80,80,0,0,520
35159,200,100,40,80,0,0,420
35160,230,120,120,160,160,0,790
35161,160,140,160,240,160,0,860
35162,240,80,80,80,160,0,640
35163,180,100,0,0,0,0,280
35164,170,120,80,80,0,0,450
35165,160,140,120,80,0,0,500
35166,210,100,80,0,0,0,390
35167,140,160,80,160,160,0,700
35168,170,160,80,80,160,0,650
35169,180,160,80,80,160,0,660
35170,160,100,0,0,0,0,260
35171,220,160,200,160,160,0,900
35172,150,80,120,160,320,320,1150
35173,170,100,120,240,160,0,790
35174,190,120,40,0,0,0,350
35175,190,100,120,240,320,320,1290
35176,170,140,160,160,320,0,950
35177,190,120,80,80,0,0,470
35178,200,80,80,80,160,320,920
35179,160,100,120,80,160,320,940
35180,180,80,40,0,0,0,300
35181,200,140,120,80,0,0,540
35182,180,80,120,0,0,0,380
35183,220,120,120,160,320,320,1260
35184,160,80,160,160,0,0,560
35185,180,100,120,240,320,320,1280
35186,190,120,200,80,160,0,750
35187,230,140,80,80,0,0,530
35188,160,100,80,80,0,0,420
35189,190,120,160,240,320,0,1030
35190,200,80,160,240,160,0,840
35191,230,120,120,80,0,0,550
35192,250,80,80,160,160,0,730
35193,240,180,160,160,320,320,1380
35194,230,140,80,80,160,0,690
35195,200,140,120,160,320,0,940
35196,200,100,0,0,0,0,300
35197,200,160,120,80,160,0,720
35198,210,200,160,160,160,0,890
35199,210,80,40,80,0,0,410
35200,210,140,120,80,160,0,710
35201,220,140,120,80,160,320,1040
35202,210,140,120,80,0,0,550
35203,220,160,120,80,0,0,580
35204,220,140,120,160,160,0,800
35205,170,100,80,0,0,0,350
35206,150,120,120,80,0,0,470
35207,220,120,160,160,160,0,820
35208,200,100,80,80,0,0,460
35209,190,120,120,160,160,0,750
35210,200,140,80,80,160,320,980
35211,200,120,80,160,0,0,560
35212,210,140,120,80,160,0,710
35213,240,100,120,80,160,0,700
35214,160,140,80,0,0,0,380
35215,160,100,40,0,0,0,300
35216,170,120,120,160,320,0,890
35217,240,100,80,80,0,0,500
35218,200,80,40,80,160,0,560
35219,240,160,160,240,320,0,1120
35220,200,80,40,0,0,0,320
35221,200,140,80,160,160,0,740
35222,140,60,80,160,160,0,600
35223,210,120,160,160,0,0,650
35224,240,140,80,160,160,320,1100
35225,220,100,120,80,160,0,680
35226,190,120,80,0,0,0,390
35227,220,140,160,80,160,0,760
35228,200,200,120,160,160,0,840
35229,210,160,120,80,0,0,570
35230,220,120,120,160,160,320,1100
35231,220,140,160,80,160,0,760
35232,240,160,120,0,0,0,520
35233,140,80,80,80,0,0,380
35234,210,160,40,0,0,0,410
35235,190,100,80,80,0,0,450
35236,180,140,160,160,160,320,1120
35237,220,100,120,80,0,0,520
35238,170,80,40,0,0,0,290
35239,210,160,200,160,160,0,890
35240,160,120,80,160,160,0,680
35241,220,100,40,0,0,0,360
35242,210,140,120,0,0,0,470
35243,170,160,120,240,160,320,1170
35244,190,100,80,80,160,0,610
35245,200,100,40,80,0,0,420
35246,220,120,120,160,320,320,1260
35247,200,120,120,80,0,0,520
35248,210,140,160,240,320,320,1390
35249,240,160,120,80,0,0,600
35250,210,140,120,160,160,0,790
35251,220,140,120,0,0,0,480
35252,160,100,80,80,160,0,580
35253,180,180,160,0,0,0,520
35254,170,80,120,80,160,0,610
35255,200,140,120,160,0,0,620
35256,210,80,80,80,0,0,450
35257,170,100,120,0,0,0,390
35258,210,160,240,160,320,0,1090
35259,200,120,160,240,320,0,1040
35260,210,120,160,240,160,0,890
35261,200,100,40,0,0,0,340
35262,200,140,120,80,160,0,700
35263,190,120,80,160,320,320,1190
35264,230,180,200,240,320,0,1170
35265,190,160,120,160,160,320,1110
35266,220,140,120,0,0,0,480
35267,220,200,120,80,0,0,620
35268,170,120,80,0,0,0,370
35269,240,160,120,160,160,320,1160
35270,200,180,120,0,0,0,500
35271,180,160,200,160,160,0,860
35272,220,120,120,80,0,0,540
35273,210,120,80,160,160,0,730
35274,190,100,160,0,0,0,450
35275,170,140,80,80,160,0,630
35276,180,120,80,160,320,320,1180
35277,220,160,40,0,0,0,420
35278,180,100,120,160,160,0,720
35279,180,120,120,80,160,0,660
35280,180,160,200,80,160,0,780
35281,210,120,80,80,160,0,650
35282,210,180,200,240,160,0,990
35283,190,100,160,80,0,0,530
35284,230,120,80,160,0,0,590
35285,170,120,120,80,160,0,650
35286,190,180,120,160,160,0,810
35287,250,120,80,80,160,0,690
35288,220,120,120,160,320,0,940
35289,180,120,160,80,0,0,540
35290,200,80,120,0,0,0,400
35291,200,140,120,160,0,0,620
35292,180,140,120,160,160,0,760
35293,180,100,80,0,0,0,360
35294,190,160,200,160,320,320,1350
35295,190,100,120,160,160,320,1050
35296,220,160,160,160,0,0,700
35297,200,160,80,80,160,0,680
35298,180,80,40,0,0,0,300
35299,170,80,80,160,320,0,810
35300,170,80,80,160,320,0,810
35301,200,140,160,0,0,0,500
35302,140,120,120,80,160,320,940
35303,210,120,80,80,160,0,650
35304,200,140,80,0,0,0,420
35305,210,100,120,80,160,0,670
35306,220,100,80,80,160,0,640
35307,200,180,120,80,160,320,1060
35308,210,140,120,160,320,320,1270
35309,210,120,120,160,0,0,610
35310,200,80,120,160,160,320,1040
35311,180,120,160,0,0,0,460
35312,200,140,160,240,0,0,740
35313,190,160,120,0,0,0,470
35314,190,80,120,80,160,0,630
35315,210,160,200,240,160,0,970
35316,170,120,40,80,0,0,410
35317,160,140,120,240,160,0,820
35318,190,160,80,80,0,0,510
35319,160,100,80,80,160,0,580
35320,220,120,160,240,320,0,1060
35321,190,160,160,80,160,0,750
35322,240,180,120,160,320,0,1020
35323,220,120,40,80,160,320,940
35324,150,160,80,160,160,0,710
35325,200,180,120,160,320,0,980
35326,210,80,80,80,0,0,450
35327,170,100,80,80,0,0,430
35328,160,80,80,160,160,320,960
35329,180,80,80,80,0,0,420
35330,170,80,40,80,0,0,370
35331,200,160,120,80,160,320,1040
35332,190,140,120,80,160,0,690
35333,200,140,120,160,0,0,620
35334,200,120,0,0,0,0,320
35335,120,80,120,80,160,0,560
35336,160,80,0,0,0,0,240
35337,200,140,160,160,0,0,660
35338,220,120,80,0,0,0,420
35339,150,80,80,80,0,0,390
35340,220,120,120,80,0,0,540
35341,200,160,80,160,160,320,1080
35342,220,100,80,80,160,0,640
35343,230,160,120,80,160,0,750
35344,190,80,80,0,0,0,350
35345,220,180,120,160,320,0,1000
35346,200,120,80,0,0,0,400
35347,210,100,80,80,160,0,630
35348,180,80,80,0,0,0,340
35349,180,100,120,160,160,0,720
35350,210,60,80,160,320,0,830
35351,170,120,160,80,160,0,690
35352,200,140,80,80,0,0,500
35353,240,160,160,160,160,0,880
35354,190,140,120,160,160,0,770
35355,210,140,80,0,0,0,430
35356,180,60,0,0,0,0,240
35357,190,100,120,240,160,0,810
35358,160,120,80,80,160,0,600
35359,190,160,80,80,0,0,510
35360,150,120,160,160,160,0,750
35361,170,100,0,0,0,0,270
35362,200,120,80,80,0,0,480
35363,200,140,80,80,0,0,500
35364,220,180,120,160,320,0,1000
35365,180,140,120,80,160,0,680
35366,190,160,160,160,160,0,830
35367,160,40,40,80,0,0,320
35368,160,80,120,160,0,0,520
35369,240,160,200,240,320,320,1480
35370,170,120,80,160,160,320,1010
35371,220,200,160,80,0,0,660
35372,150,80,40,80,160,0,510
35373,180,140,120,80,0,0,520
35374,210,120,200,160,160,0,850
35375,180,140,120,160,160,0,760
35376,210,100,120,0,0,0,430
35377,220,160,160,80,0,0,620
35378,190,60,40,0,0,0,290
35379,190,140,160,240,160,0,890
35380,200,120,160,240,160,320,1200
35381,170,140,80,80,0,0,470
35382,140,120,80,0,0,0,340
35383,210,120,120,80,160,0,690
35384,140,140,120,160,320,0,880
35385,180,180,200,240,160,0,960
35386,200,140,120,160,160,0,780
35387,210,120,80,80,160,0,650
35388,160,100,80,160,160,0,660
35389,200,100,120,80,0,0,500
35390,220,80,40,80,160,0,580
35391,190,120,80,0,0,0,390
35392,210,140,120,160,160,320,1110
35393,210,100,120,160,160,0,750
35394,160,120,160,80,160,0,680
35395,180,100,120,160,160,0,720
35396,180,60,0,0,0,0,240
35397,220,160,120,80,0,0,580
35398,230,120,80,0,0,0,430
35399,230,120,160,240,320,0,1070
35400,190,80,120,80,160,0,630
35401,210,120,120,80,160,0,690
35402,250,160,120,80,160,320,1090
35403,220,140,120,80,160,0,720
35404,200,100,120,80,160,0,660
35405,170,100,80,80,160,0,590
35406,180,180,120,80,0,0,560
35407,190,140,80,80,0,0,490
35408,150,60,80,80,160,320,850
35409,180,40,40,80,0,0,340
35410,240,160,80,80,160,320,1040
35411,240,120,40,80,0,0,480
35412,180,120,40,80,160,0,580
35413,230,140,160,240,160,320,1250
35414,180,80,40,80,0,0,380
35415,250,120,80,160,160,320,1090
35416,200,140,80,0,0,0,420
35417,230,60,80,0,0,0,370
35418,200,80,80,80,160,0,600
35419,170,60,120,80,160,320,910
35420,210,120,120,160,160,0,770
35421,170,80,160,160,0,0,570
35422,150,120,80,160,320,0,830
35423,200,60,40,0,0,0,300
35424,230,160,120,0,0,0,510
35425,190,140,200,160,320,0,1010
35426,210,80,120,160,0,0,570
35427,170,160,160,80,160,0,730
35428,190,160,160,80,160,0,750
35429,230,160,80,0,0,0,470
35430,190,100,160,160,320,0,930
35431,190,100,120,80,0,0,490
35432,230,140,80,0,0,0,450
35433,210,120,80,80,160,0,650
35434,150,140,160,80,160,0,690
35435,180,100,120,160,320,320,1200
35436,180,180,80,0,0,0,440
35437,180,140,200,80,160,0,760
35438,200,80,80,160,320,0,840
35439,220,160,80,0,0,0,460
35440,220,100,80,80,160,320,960
35441,200,180,120,160,160,0,820
35442,210,220,120,80,160,0,790
35443,180,160,80,80,160,0,660
35444,210,140,120,80,0,0,550
35445,210,140,40,80,160,0,630
35446,210,120,120,80,0,0,530
35447,220,100,40,0,0,0,360
35448,200,140,160,80,0,0,580
35449,160,80,160,160,0,0,560
35450,200,100,40,80,160,320,900
35451,180,60,80,80,0,0,400
35452,220,140,120,240,320,0,1040
35453,200,180,120,160,160,320,1140
35454,180,120,120,80,160,0,660
35455,180,140,120,240,160,0,840
35456,200,120,80,0,0,0,400
35457,240,120,120,80,160,320,1040
35458,170,120,80,160,160,0,690
35459,250,140,120,160,160,0,830
35460,220,100,80,160,160,0,720
35461,170,120,160,160,160,0,770
35462,180,140,120,160,160,320,1080
35463,180,100,160,80,0,0,520
35464,150,60,0,0,0,0,210
35465,170,100,80,0,0,0,350
35466,170,120,80,0,0,0,370
35467,150,120,160,160,160,0,750
35468,180,140,80,80,0,0,480
35469,210,120,40,0,0,0,370
35470,220,60,40,80,0,0,400
35471,210,140,160,160,160,0,830
35472,200,200,200,80,160,0,840
35473,200,160,80,160,160,0,760
35474,260,140,40,0,0,0,440
35475,200,100,40,0,0,0,340
35476,230,100,80,80,0,0,490
35477,200,80,80,0,0,0,360
35478,160,160,160,80,160,320,1040
35479,190,100,40,80,0,0,410
35480,230,140,80,160,160,0,770
35481,220,120,40,80,160,0,620
35482,190,160,120,80,160,0,710
35483,190,140,40,80,160,0,610
35484,210,80,120,160,320,0,890
35485,130,100,80,80,160,0,550
35486,170,160,160,240,0,0,730
35487,200,120,120,80,160,320,1000
35488,230,200,160,240,0,0,830
35489,210,180,120,240,0,0,750
35490,190,140,120,160,160,0,770
35491,200,120,120,0,0,0,440
35492,180,160,80,0,0,0,420
35493,250,120,80,80,0,0,530
35494,170,120,120,80,0,0,490
35495,160,80,40,0,0,0,280
35496,200,100,40,0,0,0,340
35497,160,100,80,160,320,0,820
35498,190,160,80,80,0,0,510
35499,190,140,160,80,160,0,730
35500,190,60,40,80,160,0,530
35501,200,160,160,80,0,0,600
35502,180,160,160,160,160,320,1140
35503,200,140,160,160,320,0,980
35504,190,100,160,160,0,0,610
35505,190,120,80,80,160,0,630
35506,180,100,120,0,0,0,400
35507,210,160,120,160,160,0,810
35508,210,100,80,80,0,0,470
35509,150,140,80,80,0,0,450
35510,190,160,160,0,0,0,510
35511,180,120,120,80,160,0,660
35512,220,160,120,160,320,0,980
35513,190,60,40,0,0,0,290
35514,190,60,80,160,160,0,650
35515,190,140,40,80,0,0,450
35516,200,140,40,80,160,0,620
35517,200,80,80,80,160,0,600
35518,210,180,120,160,160,0,830
35519,190,100,80,80,160,0,610
35520,210,120,120,80,160,0,690
35521,190,120,80,0,0,0,390
35522,160,100,80,80,160,0,580
35523,190,120,120,160,160,0,750
35524,140,120,120,160,160,320,1020
35525,220,120,40,80,160,0,620
35526,190,120,40,80,0,0,430
35527,220,100,120,80,160,320,1000
35528,160,100,160,80,0,0,500
35529,200,80,40,0,0,0,320
35530,190,140,160,160,160,0,810
35531,170,60,0,0,0,0,230
35532,200,140,160,160,0,0,660
35533,160,140,40,0,0,0,340
35534,200,120,160,160,0,0,640
35535,170,120,120,80,160,0,650
35536,190,140,80,0,0,0,410
35537,190,160,120,80,160,0,710
35538,170,100,160,240,0,0,670
35539,190,180,120,160,160,0,810
35540,240,160,120,80,0,0,600
35541,190,80,40,80,160,0,550
35542,220,100,40,0,0,0,360
35543,180,100,120,0,0,0,400
35544,200,140,80,160,320,0,900
35545,210,140,160,160,160,0,830
35546,220,160,160,80,0,0,620
35547,190,100,40,80,0,0,410
35548,200,140,160,160,0,0,660
35549,190,60,120,80,160,0,610
35550,200,80,80,160,160,320,1000
35551,220,100,40,0,0,0,360
35552,220,120,80,80,0,0,500
35553,190,100,80,80,0,0,450
35554,210,160,80,80,0,0,530
35555,170,140,80,80,160,0,630
35556,250,180,160,160,0,0,750
35557,180,100,40,80,0,0,400
35558,210,100,160,80,0,0,550
35559,190,120,120,80,160,0,670
35560,150,60,40,80,160,0,490
35561,170,140,120,0,0,0,430
35562,180,100,120,160,320,0,880
35563,170,60,80,80,160,0,550
35564,210,120,160,160,160,0,810
35565,190,140,80,80,160,0,650
35566,200,100,80,80,160,0,620
35567,200,120,120,80,160,320,1000
35568,220,180,160,80,160,320,1120
35569,180,60,80,0,0,0,320
35570,170,80,120,160,320,0,850
35571,190,120,40,80,160,320,910
35572,170,120,200,160,160,320,1130
35573,170,120,120,80,160,0,650
35574,180,160,160,240,320,320,1380
35575,160,80,40,0,0,0,280
35576,200,140,120,80,0,0,540
35577,200,180,120,80,0,0,580
35578,210,160,120,80,0,0,570
35579,180,100,120,160,320,320,1200
35580,230,160,160,80,0,0,630
35581,220,220,160,160,160,0,920
35582,210,80,80,160,160,0,690
35583,130,60,80,80,160,0,510
35584,190,140,120,80,160,320,1010
35585,170,60,40,0,0,0,270
35586,210,60,80,0,0,0,350
35587,150,100,160,160,0,0,570
35588,220,120,40,0,0,0,380
35589,190,160,120,80,160,0,710
35590,220,100,80,80,0,0,480
35591,180,100,80,80,0,0,440
35592,190,140,160,160,320,0,970
35593,210,60,0,0,0,0,270
35594,240,80,160,240,160,0,880
35595,190,160,80,80,160,0,670
35596,190,200,160,160,160,0,870
35597,230,180,160,160,160,0,890
35598,220,120,40,0,0,0,380
35599,180,160,160,160,160,320,1140
35600,220,120,40,80,0,0,460
35601,210,140,120,160,160,320,1110
35602,170,120,120,160,160,0,730
35603,180,100,80,80,160,0,600
35604,190,120,160,240,320,320,1350
35605,190,140,120,80,0,0,530
35606,220,100,160,80,0,0,560
35607,220,100,80,80,160,0,640
35608,210,160,80,80,160,0,690
35609,180,120,40,80,160,0,580
35610,170,120,80,80,0,0,450
35611,220,160,120,80,0,0,580
35612,180,140,120,80,0,0,520
35613,210,80,40,0,0,0,330
35614,220,140,120,0,0,0,480
35615,180,120,40,0,0,0,340
35616,200,120,160,160,0,0,640
35617,190,140,120,80,0,0,530
35618,160,80,40,80,160,0,520
35619,180,80,80,0,0,0,340
35620,210,140,120,80,0,0,550
35621,190,120,80,80,160,0,630
35622,190,140,160,160,160,0,810
35623,200,120,160,160,0,0,640
35624,220,100,80,80,160,320,960
35625,200,200,80,80,160,0,720
35626,210,100,80,80,0,0,470
35627,180,80,120,80,0,0,460
35628,200,120,160,160,320,0,960
35629,220,140,120,160,320,0,960
35630,210,60,0,0,0,0,270
35631,230,180,160,160,0,0,730
35632,180,160,160,240,160,0,900
35633,180,100,160,240,160,0,840
35634,170,100,80,0,0,0,350
35635,190,40,40,0,0,0,270
35636,220,100,120,160,0,0,600
35637,160,20,0,0,0,0,180
35638,150,100,120,80,0,0,450
35639,190,120,80,80,160,0,630
35640,170,80,80,0,0,0,330
35641,210,160,200,160,160,0,890
35642,210,140,80,0,0,0,430
35643,170,160,120,160,160,0,770
35644,220,160,80,80,160,0,700
35645,190,120,120,80,0,0,510
35646,230,120,120,160,0,0,630
35647,210,100,120,80,160,0,670
35648,200,140,80,160,160,0,740
35649,160,140,80,80,0,0,460
35650,210,180,120,80,0,0,590
35651,160,100,120,80,160,320,940
35652,170,100,80,0,0,0,350
35653,230,160,200,80,160,0,830
35654,220,100,80,80,0,0,480
35655,190,120,80,80,0,0,470
35656,200,100,40,0,0,0,340
35657,170,80,80,80,160,0,570
35658,220,140,240,320,320,0,1240
35659,210,140,80,80,0,0,510
35660,210,80,120,160,160,0,730
35661,160,120,40,0,0,0,320
35662,190,140,160,160,0,0,650
35663,210,80,0,0,0,0,290
35664,160,100,120,240,320,0,940
35665,160,80,80,80,0,0,400
35666,230,120,80,160,160,320,1070
35667,190,80,80,80,160,0,590
35668,210,80,80,0,0,0,370
35669,210,140,80,80,160,0,670
35670,190,100,80,80,0,0,450
35671,200,100,40,0,0,0,340
35672,190,140,120,80,0,0,530
35673,220,140,120,160,160,0,800
35674,230,80,120,0,0,0,430
35675,210,60,40,80,160,320,870
35676,180,140,80,0,0,0,400
35677,220,140,120,160,160,0,800
35678,240,180,200,240,160,0,1020
35679,150,80,120,80,160,320,910
35680,200,80,120,0,0,0,400
35681,210,100,120,160,320,320,1230
35682,200,180,160,80,160,0,780
35683,230,80,120,0,0,0,430
35684,200,140,200,240,320,0,1100
35685,180,60,120,160,160,0,680
35686,170,100,80,80,160,0,590
35687,210,80,80,160,0,0,530
35688,210,100,120,240,320,0,990
35689,200,60,40,80,160,0,540
35690,190,100,40,80,0,0,410
35691,200,140,120,80,0,0,540
35692,160,100,40,0,0,0,300
35693,170,100,0,0,0,0,270
35694,210,140,120,160,0,0,630
35695,170,140,200,160,160,320,1150
35696,200,140,160,80,0,0,580
35697,190,100,40,0,0,0,330
35698,210,120,80,0,0,0,410
35699,170,100,80,160,320,320,1150
35700,190,140,160,320,160,0,970
35701,170,100,120,160,320,320,1190
35702,220,100,120,80,160,0,680
35703,240,200,160,80,0,0,680
35704,230,160,80,0,0,0,470
35705,220,200,200,80,160,0,860
35706,210,40,40,80,0,0,370
35707,220,160,40,80,0,0,500
35708,190,140,160,160,320,320,1290
35709,170,80,40,80,160,0,530
35710,210,160,160,80,0,0,610
35711,220,140,160,80,160,0,760
35712,210,100,80,80,160,0,630
35713,190,80,120,80,160,0,630
35714,200,120,160,80,160,320,1040
35715,230,100,80,80,160,0,650
35716,190,160,160,80,160,320,1070
35717,160,80,80,160,160,0,640
35718,220,100,80,0,0,0,400
35719,180,100,120,80,160,0,640
35720,200,120,120,80,160,0,680
35721,200,120,120,160,160,0,760
35722,170,100,40,0,0,0,310
35723,150,100,80,0,0,0,330
35724,230,120,40,0,0,0,390
35725,210,140,200,240,320,0,1110
35726,210,160,120,0,0,0,490
35727,200,120,80,160,160,320,1040
35728,220,100,120,160,0,0,600
35729,180,100,200,240,160,0,880
35730,210,120,80,160,160,0,730
35731,170,140,200,80,160,320,1070
35732,230,140,160,80,160,0,770
35733,160,80,80,0,0,0,320
35734,210,100,80,160,320,320,1190
35735,210,80,160,240,160,320,1170
35736,200,120,200,80,160,320,1080
35737,160,80,40,80,160,0,520
35738,220,120,160,160,160,320,1140
35739,170,140,160,0,0,0,470
35740,170,180,120,80,0,0,550
35741,150,40,40,80,160,320,790
35742,200,120,120,160,0,0,600
35743,160,60,80,80,0,0,380
35744,180,80,40,80,160,0,540
35745,160,120,80,0,0,0,360
35746,200,120,120,0,0,0,440
35747,230,160,160,160,0,0,710
35748,190,120,120,160,160,320,1070
35749,210,160,120,160,160,0,810
35750,190,100,40,0,0,0,330
35751,180,80,120,80,160,0,620
35752,190,140,160,160,320,320,1290
35753,200,140,120,80,160,320,1020
35754,170,120,120,80,160,0,650
35755,200,80,80,160,160,0,680
35756,190,120,40,80,160,0,590
35757,180,140,80,80,160,0,640
35758,180,100,120,80,160,0,640
35759,220,120,40,80,0,0,460
35760,160,80,40,80,160,0,520
35761,210,80,120,160,160,0,730
35762,210,100,80,80,160,0,630
35763,200,140,80,80,160,0,660
35764,190,40,80,0,0,0,310
35765,180,100,80,0,0,0,360
35766,180,80,80,160,160,0,660
35767,230,120,80,80,160,0,670
35768,180,100,120,0,0,0,400
35769,180,140,160,160,160,0,800
35770,200,120,80,160,160,0,720
35771,210,100,80,160,0,0,550
35772,190,100,40,80,0,0,410
35773,200,120,160,80,160,0,720
35774,240,120,40,80,0,0,480
35775,190,180,120,240,320,320,1370
35776,160,160,200,160,320,0,1000
35777,190,60,40,80,160,0,530
35778,170,100,120,0,0,0,390
35779,200,160,80,80,160,320,1000
35780,180,120,200,240,320,0,1060
35781,210,180,80,160,160,0,790
35782,210,180,120,80,160,0,750
35783,220,160,240,240,160,0,1020
35784,240,120,80,80,0,0,520
35785,240,140,120,80,160,0,740
35786,250,160,200,160,160,0,930
35787,200,80,40,0,0,0,320
35788,220,140,0,0,0,0,360
35789,180,80,80,80,160,0,580
35790,180,120,80,0,0,0,380
35791,220,140,120,80,0,0,560
35792,190,180,80,80,0,0,530
35793,190,160,160,160,0,0,670
35794,240,180,120,240,320,0,1100
35795,150,160,120,0,0,0,430
35796,180,140,120,240,0,0,680
35797,180,100,80,80,0,0,440
35798,190,160,80,160,0,0,590
35799,200,100,40,0,0,0,340
35800,180,140,40,0,0,0,360
35801,180,120,160,80,0,0,540
35802,190,100,160,160,160,320,1090
35803,210,140,120,160,0,0,630
35804,180,100,80,80,160,0,600
35805,180,100,40,0,0,0,320
35806,200,100,120,160,160,0,740
35807,220,140,160,160,320,0,1000
35808,190,140,160,160,160,0,810
35809,210,180,160,80,160,0,790
35810,230,140,80,80,0,0,530
35811,180,100,0,0,0,0,280
35812,210,100,80,80,0,0,470
35813,210,140,80,80,0,0,510
35814,210,100,120,160,160,0,750
35815,190,120,80,160,160,0,710
35816,200,160,160,240,320,320,1400
35817,200,140,160,160,160,320,1140
35818,190,120,80,0,0,0,390
35819,210,140,160,160,160,0,830
35820,190,160,80,160,0,0,590
35821,250,120,80,0,0,0,450
35822,160,80,120,80,0,0,440
35823,160,100,160,240,320,0,980
35824,190,160,200,240,160,0,950
35825,200,160,160,240,160,0,920
35826,170,80,80,80,0,0,410
35827,220,60,120,80,160,0,640
35828,200,40,80,160,320,0,800
35829,150,40,40,80,160,0,470
35830,250,180,160,80,0,0,670
35831,210,100,80,80,0,0,470
35832,200,100,40,80,160,0,580
35833,230,160,200,160,160,0,910
35834,210,140,120,80,0,0,550
35835,190,160,80,0,0,0,430
35836,170,160,80,0,0,0,410
35837,220,160,80,80,160,0,700
35838,210,200,200,0,0,0,610
35839,180,120,80,0,0,0,380
35840,230,160,160,160,0,0,710
35841,220,160,40,80,160,0,660
35842,200,140,160,160,160,320,1140
35843,170,80,80,80,160,0,570
35844,190,160,120,160,160,0,790
35845,250,160,120,80,0,0,610
35846,190,140,80,80,0,0,490
35847,210,140,160,80,160,0,750
35848,200,120,80,0,0,0,400
35849,200,120,120,80,0,0,520
35850,190,140,160,80,0,0,570
35851,250,160,160,240,320,0,1130
35852,220,140,160,160,0,0,680
35853,200,100,80,80,160,0,620
35854,220,100,40,80,160,0,600
35855,170,100,160,240,320,0,990
35856,160,120,80,160,160,320,1000
35857,200,100,120,80,0,0,500
35858,210,160,160,0,0,0,530
35859,180,120,120,0,0,0,420
35860,200,160,200,160,160,0,880
35861,220,140,120,160,0,0,640
35862,210,100,120,80,0,0,510
35863,250,120,120,160,0,0,650
35864,160,120,80,0,0,0,360
35865,200,100,120,80,160,0,660
35866,200,120,80,0,0,0,400
35867,210,120,80,80,160,0,650
35868,160,100,120,160,320,320,1180
35869,180,100,40,0,0,0,320
35870,210,80,40,80,160,320,890
35871,220,120,120,160,160,0,780
35872,220,160,80,0,0,0,460
35873,200,120,80,80,160,0,640
35874,180,140,40,0,0,0,360
35875,190,60,40,0,0,0,290
35876,170,80,80,160,160,0,650
35877,220,100,120,160,320,0,920
35878,180,140,160,160,160,0,800
35879,190,100,80,0,0,0,370
35880,210,80,120,80,0,0,490
35881,200,100,80,80,0,0,460
35882,200,140,80,80,160,0,660
35883,240,120,160,240,320,0,1080
35884,170,100,120,160,320,0,870
35885,200,180,200,160,320,0,1060
35886,170,140,200,80,160,0,750
35887,190,160,200,240,160,0,950
35888,140,120,80,80,0,0,420
35889,200,160,160,0,0,0,520
35890,240,100,80,80,160,320,980
35891,200,120,200,80,0,0,600
35892,150,140,160,160,160,0,770
35893,200,100,120,160,320,0,900
35894,190,160,160,80,160,320,1070
35895,170,140,160,0,0,0,470
35896,200,80,40,0,0,0,320
35897,190,160,40,80,0,0,470
35898,130,60,80,80,160,0,510
35899,190,120,80,0,0,0,390
35900,200,140,80,0,0,0,420
35901,210,140,40,80,160,0,630
35902,190,120,40,0,0,0,350
35903,190,140,120,80,160,0,690
35904,220,100,160,80,0,0,560
35905,230,160,160,80,160,0,790
35906,160,160,120,160,160,0,760
35907,220,180,80,80,0,0,560
35908,160,80,40,0,0,0,280
35909,240,120,120,80,160,0,720
35910,180,60,40,80,160,320,840
35911,190,120,160,160,160,320,1110
35912,210,120,120,80,160,320,1010
35913,260,120,160,0,0,0,540
35914,160,100,80,80,160,320,900
35915,190,120,120,240,320,0,990
35916,190,120,40,80,160,0,590
35917,200,100,80,80,160,0,620
35918,160,120,120,0,0,0,400
35919,210,160,200,80,0,0,650
35920,160,80,80,80,160,320,880
35921,180,140,120,160,320,0,920
35922,190,140,40,80,160,0,610
35923,170,140,40,0,0,0,350
35924,180,60,120,80,0,0,440
35925,190,140,160,80,160,320,1050
35926,240,160,160,160,160,320,1200
35927,220,160,160,160,0,0,700
35928,150,100,80,80,0,0,410
35929,220,120,120,160,0,0,620
35930,190,120,80,80,160,0,630
35931,210,120,80,80,160,0,650
35932,240,180,160,0,0,0,580
35933,200,140,120,160,160,0,780
35934,130,80,80,160,0,0,450
35935,180,120,80,80,160,0,620
35936,210,100,80,80,0,0,470
35937,200,120,80,80,0,0,480
35938,200,80,80,80,160,0,600
35939,200,160,120,160,320,320,1280
35940,160,100,120,80,0,0,460
35941,210,120,120,160,160,0,770
35942,170,80,40,80,160,0,530
35943,140,100,120,240,160,0,760
35944,200,160,160,160,0,0,680
35945,190,160,160,160,160,0,830
35946,220,100,120,160,160,0,760
35947,200,100,120,0,0,0,420
35948,210,120,120,80,160,0,690
35949,170,140,200,160,320,0,990
35950,180,120,80,80,160,0,620
35951,180,140,120,80,0,0,520
35952,210,140,80,80,160,0,670
35953,200,100,120,160,160,320,1060
35954,190,100,160,240,160,0,850
35955,160,180,120,80,160,0,700
35956,200,120,40,80,160,0,600
35957,210,100,80,0,0,0,390
35958,220,120,40,80,0,0,460
35959,190,120,120,80,160,320,990
35960,170,100,160,160,160,0,750
35961,190,100,160,160,320,320,1250
35962,180,120,160,160,160,320,1100
35963,220,140,80,80,160,0,680
35964,200,120,120,80,0,0,520
35965,220,180,80,80,160,320,1040
35966,210,80,120,160,160,0,730
35967,210,80,80,80,0,0,450
35968,240,180,120,80,160,0,780
35969,230,140,160,160,160,0,850
35970,210,120,120,80,160,0,690
35971,230,140,80,80,0,0,530
35972,190,160,120,160,160,320,1110
35973,170,100,160,80,160,320,990
35974,210,160,120,160,0,0,650
35975,180,100,80,80,160,320,920
35976,240,160,80,160,320,0,960
35977,230,140,40,80,0,0,490
35978,170,80,40,80,160,0,530
35979,180,120,80,160,160,0,700
35980,190,120,0,0,0,0,310
35981,210,120,40,0,0,0,370
35982,160,100,40,80,160,0,540
35983,200,120,80,80,160,0,640
35984,230,80,120,80,160,0,670
35985,170,140,80,160,0,0,550
35986,230,180,160,80,160,320,1130
35987,200,80,80,160,320,0,840
35988,200,160,160,80,0,0,600
35989,210,140,120,80,160,0,710
35990,210,120,40,80,160,0,610
35991,190,80,40,0,0,0,310
35992,200,140,80,0,0,0,420
35993,150,80,120,160,160,0,670
35994,170,80,120,160,0,0,530
35995,190,80,0,0,0,0,270
35996,210,140,160,160,160,0,830
35997,190,100,40,0,0,0,330
35998,210,120,120,80,160,0,690
35999,180,100,80,80,0,0,440
36000,180,160,120,160,160,0,780
36001,210,160,160,240,320,0,1090
36002,190,160,80,80,160,0,670
36003,230,140,120,80,0,0,570
36004,200,60,120,0,0,0,380
36005,180,100,80,160,160,0,680
36006,210,100,0,0,0,0,310
36007,200,100,160,80,0,0,540
36008,190,120,200,160,160,0,830
36009,210,80,80,80,160,320,930
36010,180,140,40,0,0,0,360
36011,200,180,40,0,0,0,420
36012,180,120,80,80,0,0,460
36013,200,120,80,160,160,0,720
36014,230,140,80,80,160,0,690
36015,190,100,80,80,160,0,610
36016,210,100,40,80,160,0,590
36017,230,140,80,80,0,0,530
36018,220,160,120,80,0,0,580
36019,200,100,120,240,160,0,820
36020,230,200,200,80,160,0,870
36021,220,160,160,160,160,0,860
36022,200,120,80,0,0,0,400
36023,220,120,80,160,320,0,900
36024,190,100,0,0,0,0,290
36025,210,140,80,160,160,0,750
36026,180,140,160,160,160,320,1120
36027,230,200,160,80,0,0,670
36028,220,180,160,160,160,0,880
36029,260,100,120,80,160,320,1040
36030,190,140,80,0,0,0,410
36031,200,140,200,80,160,0,780
36032,220,120,160,80,160,0,740
36033,180,120,40,80,160,0,580
36034,140,120,120,0,0,0,380
36035,180,120,80,80,0,0,460
36036,190,100,120,80,0,0,490
36037,180,140,120,0,0,0,440
36038,190,80,80,80,0,0,430
36039,190,100,80,0,0,0,370
36040,180,60,0,0,0,0,240
36041,160,100,120,160,160,0,700
36042,200,80,40,80,160,0,560
36043,210,140,200,240,320,320,1430
36044,190,140,80,80,160,0,650
36045,170,120,120,160,0,0,570
36046,250,140,80,80,160,0,710
36047,210,140,160,80,160,0,750
36048,210,100,40,80,160,0,590
36049,200,100,120,80,160,0,660
36050,150,80,120,160,320,320,1150
36051,180,120,120,80,160,0,660
36052,230,120,160,80,160,0,750
36053,160,60,80,80,160,320,860
36054,210,120,120,80,160,0,690
36055,160,80,80,160,320,0,800
36056,190,180,120,80,0,0,570
36057,200,140,120,160,160,320,1100
36058,170,80,120,160,320,0,850
36059,220,180,160,80,0,0,640
36060,190,160,80,80,160,0,670
36061,200,200,120,0,0,0,520
36062,170,120,160,160,160,320,1090
36063,200,140,40,0,0,0,380
36064,210,140,240,320,320,320,1550
36065,210,120,120,80,0,0,530
36066,210,100,80,80,0,0,470
36067,180,120,40,80,160,0,580
36068,190,140,160,160,160,0,810
36069,190,120,40,0,0,0,350
36070,170,140,80,80,160,0,630
36071,180,140,120,80,0,0,520
36072,210,140,120,160,160,320,1110
36073,190,120,40,80,160,0,590
36074,200,80,120,80,0,0,480
36075,220,160,120,0,0,0,500
36076,190,80,80,160,0,0,510
36077,210,160,0,0,0,0,370
36078,220,180,120,240,320,0,1080
36079,230,200,200,80,160,0,870
36080,240,140,120,160,320,0,980
36081,200,120,80,80,160,0,640
36082,180,120,80,0,0,0,380
36083,110,80,120,160,0,0,470
36084,180,80,80,80,160,0,580
36085,170,140,160,240,160,320,1190
36086,190,140,40,80,160,0,610
36087,180,120,200,0,0,0,500
36088,180,120,120,240,160,0,820
36089,200,100,80,160,0,0,540
36090,190,140,200,160,160,0,850
36091,180,140,120,80,0,0,520
36092,240,140,120,160,160,0,820
36093,200,120,80,80,160,0,640
36094,230,180,160,80,0,0,650
36095,250,140,160,80,160,0,790
36096,140,100,40,0,0,0,280
36097,180,140,120,240,160,0,840
36098,220,100,80,80,0,0,480
36099,180,100,80,0,0,0,360
36100,170,140,120,80,0,0,510
36101,240,140,80,160,160,0,780
36102,200,100,160,240,160,0,860
36103,230,120,80,0,0,0,430
36104,170,100,40,80,0,0,390
36105,210,120,200,160,160,0,850
36106,200,140,80,80,160,0,660
36107,230,160,80,80,0,0,550
36108,170,160,160,160,320,0,970
36109,210,120,120,80,160,0,690
36110,200,100,40,80,0,0,420
36111,190,140,120,80,160,0,690
36112,220,80,0,0,0,0,300
36113,160,160,160,160,320,320,1280
36114,240,120,160,160,160,0,840
36115,180,120,120,160,320,320,1220
36116,230,100,80,160,160,0,730
36117,190,140,120,80,160,320,1010
36118,240,160,160,0,0,0,560
36119,210,100,80,160,0,0,550
36120,170,100,80,80,160,0,590
36121,190,140,80,80,0,0,490
36122,160,80,120,240,320,0,920
36123,190,120,160,240,320,0,1030
36124,220,100,120,160,320,320,1240
36125,230,120,40,0,0,0,390
36126,190,160,160,240,160,320,1230
36127,240,140,200,240,160,0,980
36128,210,80,80,0,0,0,370
36129,220,160,160,160,0,0,700
36130,220,140,120,160,160,320,1120
36131,180,100,160,80,160,320,1000
36132,180,60,40,0,0,0,280
36133,230,160,160,160,0,0,710
36134,200,120,160,160,0,0,640
36135,230,160,80,160,160,0,790
36136,170,100,80,80,0,0,430
36137,200,140,160,0,0,0,500
36138,180,140,160,160,160,0,800
36139,210,140,120,80,160,320,1030
36140,170,80,80,0,0,0,330
36141,210,100,80,80,160,0,630
36142,200,60,80,80,0,0,420
36143,200,140,120,160,160,0,780
36144,210,140,80,160,320,0,910
36145,200,140,120,80,0,0,540
36146,200,160,40,0,0,0,400
36147,190,100,120,160,0,0,570
36148,220,100,80,160,320,0,880
36149,170,100,120,160,160,0,710
36150,150,80,80,80,160,0,550
36151,190,120,120,80,160,320,990
36152,190,80,40,80,160,320,870
36153,180,140,120,80,160,0,680
36154,210,80,80,80,0,0,450
36155,170,140,80,80,0,0,470
36156,170,120,120,80,0,0,490
36157,190,180,80,80,0,0,530
36158,150,160,120,80,160,0,670
36159,190,180,80,80,0,0,530
36160,240,140,120,160,0,0,660
36161,200,80,80,80,0,0,440
36162,150,120,120,80,160,0,630
36163,180,120,80,160,0,0,540
36164,200,160,120,240,320,0,1040
36165,170,140,120,160,320,0,910
36166,160,100,0,0,0,0,260
36167,180,120,120,160,320,0,900
36168,180,100,80,80,160,0,600
36169,210,20,40,0,0,0,270
36170,240,160,80,160,160,0,800
36171,180,140,120,160,320,0,920
36172,210,80,120,80,160,320,970
36173,190,20,0,0,0,0,210
36174,180,80,80,160,160,0,660
36175,190,100,80,160,160,320,1010
36176,160,80,80,80,0,0,400
36177,190,140,120,80,0,0,530
36178,230,160,80,80,160,0,710
36179,220,180,200,240,160,0,1000
36180,190,120,40,0,0,0,350
36181,220,140,120,160,320,0,960
36182,160,100,120,0,0,0,380
36183,180,80,120,80,160,0,620
36184,200,140,160,80,0,0,580
36185,200,120,120,80,160,0,680
36186,230,160,80,160,320,0,950
36187,200,160,200,240,160,0,960
36188,180,100,80,80,160,0,600
36189,210,120,120,160,320,0,930
36190,240,180,200,240,0,0,860
36191,210,80,120,80,160,0,650
36192,190,40,0,0,0,0,230
36193,200,180,200,80,0,0,660
36194,190,100,120,80,0,0,490
36195,220,160,160,160,160,0,860
36196,200,100,80,80,160,0,620
36197,210,100,80,160,160,0,710
36198,190,180,160,0,0,0,530
36199,190,120,120,80,160,320,990
36200,180,100,80,80,160,0,600
36201,170,80,40,80,160,0,530
36202,160,140,80,160,320,0,860
36203,180,140,80,0,0,0,400
36204,180,160,120,80,0,0,540
36205,230,120,80,160,0,0,590
36206,220,140,120,80,160,0,720
36207,220,80,80,80,0,0,460
36208,220,120,40,0,0,0,380
36209,180,100,80,160,0,0,520
36210,220,160,120,80,0,0,580
36211,160,140,40,80,0,0,420
36212,210,140,160,160,160,0,830
36213,210,80,40,0,0,0,330
36214,170,120,80,80,160,0,610
36215,200,120,40,0,0,0,360
36216,220,100,120,0,0,0,440
36217,170,80,40,0,0,0,290
36218,180,100,120,160,320,0,880
36219,220,100,120,160,160,320,1080
36220,170,120,160,240,320,0,1010
36221,190,80,40,80,160,0,550
36222,200,140,120,160,160,0,780
36223,230,80,80,80,160,0,630
36224,190,180,160,80,160,0,770
36225,170,140,40,0,0,0,350
36226,190,100,40,0,0,0,330
36227,200,180,160,160,320,0,1020
36228,200,100,0,0,0,0,300
36229,210,120,40,80,0,0,450
36230,180,140,120,80,0,0,520
36231,200,100,120,160,160,320,1060
36232,190,140,160,240,160,320,1210
36233,200,140,80,0,0,0,420
36234,210,140,160,240,160,320,1230
36235,220,100,120,80,160,320,1000
36236,220,120,80,160,320,0,900
36237,210,120,80,80,0,0,490
36238,220,120,80,160,320,0,900
36239,160,140,160,160,0,0,620
36240,190,80,80,0,0,0,350
36241,180,80,80,0,0,0,340
36242,180,100,80,160,0,0,520
36243,240,120,160,80,0,0,600
36244,180,120,120,80,0,0,500
36245,170,80,80,80,0,0,410
36246,210,120,120,160,0,0,610
36247,200,140,160,240,0,0,740
36248,200,100,120,160,160,0,740
36249,190,160,160,80,0,0,590
36250,150,80,80,160,320,0,790
36251,250,180,200,0,0,0,630
36252,180,120,120,160,160,0,740
36253,190,180,120,80,160,0,730
36254,150,120,120,160,160,0,710
36255,180,80,80,80,160,0,580
36256,150,100,80,80,0,0,410
36257,250,100,0,0,0,0,350
36258,190,180,160,160,160,320,1170
36259,190,140,120,160,160,0,770
36260,200,120,200,160,0,0,680
36261,210,120,40,0,0,0,370
36262,180,140,80,0,0,0,400
36263,210,100,160,160,160,0,790
36264,210,100,40,80,160,0,590
36265,210,160,120,160,160,0,810
36266,200,180,120,160,160,320,1140
36267,230,140,120,80,0,0,570
36268,150,100,160,0,0,0,410
36269,210,140,120,80,0,0,550
36270,200,140,120,240,160,0,860
36271,250,140,200,240,160,320,1310
36272,170,100,160,240,160,320,1150
36273,170,80,40,80,160,0,530
36274,220,80,80,80,0,0,460
36275,220,180,160,160,0,0,720
36276,230,120,120,80,160,320,1030
36277,200,100,80,160,320,320,1180
36278,200,100,80,0,0,0,380
36279,220,140,120,80,160,0,720
36280,240,160,200,240,0,0,840
36281,180,120,120,160,160,0,740
36282,240,120,40,80,160,0,640
36283,220,160,200,240,0,0,820
36284,200,220,160,160,160,320,1220
36285,150,140,160,240,320,0,1010
36286,160,80,80,160,160,0,640
36287,250,120,0,0,0,0,370
36288,210,140,160,160,320,0,990
36289,190,140,120,160,160,0,770
36290,210,180,240,240,320,0,1190
36291,230,140,120,80,160,0,730
36292,220,140,200,80,160,0,800
36293,200,100,120,80,0,0,500
36294,200,120,200,240,160,320,1240
36295,220,100,40,80,160,0,600
36296,170,120,120,160,160,0,730
36297,190,160,160,0,0,0,510
36298,200,120,80,80,160,0,640
36299,160,140,80,80,0,0,460
36300,190,120,120,80,0,0,510
36301,170,60,40,80,160,0,510
36302,170,100,40,80,160,0,550
36303,130,140,120,80,160,0,630
36304,160,100,120,160,160,0,700
36305,170,120,80,80,160,0,610
36306,200,120,80,80,0,0,480
36307,190,120,120,80,0,0,510
36308,200,100,120,80,160,320,980
36309,190,180,160,0,0,0,530
36310,170,120,120,160,160,0,730
36311,230,140,80,0,0,0,450
36312,180,100,80,80,0,0,440
36313,180,140,80,80,160,0,640
36314,200,160,120,80,160,320,1040
36315,180,100,120,160,160,0,720
36316,200,160,120,160,320,0,960
36317,190,140,80,80,0,0,490
36318,180,120,160,160,160,0,780
36319,180,80,40,80,160,320,860
36320,160,60,80,80,160,0,540
36321,170,160,80,80,0,0,490
36322,180,80,0,0,0,0,260
36323,200,140,0,0,0,0,340
36324,160,120,120,160,160,0,720
36325,150,80,40,80,0,0,350
36326,190,140,160,160,160,0,810
36327,160,100,120,80,0,0,460
36328,210,80,120,80,160,0,650
36329,200,100,80,80,160,0,620
36330,180,100,160,80,160,320,1000
36331,200,100,120,80,160,0,660
36332,200,100,40,0,0,0,340
36333,190,100,120,80,160,320,970
36334,180,120,120,80,0,0,500
36335,190,140,120,0,0,0,450
36336,210,140,160,160,160,0,830
36337,210,100,120,80,160,0,670
36338,200,140,120,80,0,0,540
36339,200,80,80,0,0,0,360
36340,180,140,40,80,160,0,600
36341,160,160,160,160,160,0,800
36342,210,140,160,80,160,0,750
36343,210,140,120,0,0,0,470
36344,240,180,160,160,0,0,740
36345,180,60,80,160,160,320,960
36346,220,160,80,0,0,0,460
36347,190,160,200,160,160,0,870
36348,200,140,80,80,160,320,980
36349,180,140,40,80,160,0,600
36350,190,100,40,80,160,0,570
36351,190,120,80,80,0,0,470
36352,210,120,160,80,0,0,570
36353,180,80,40,80,160,0,540
36354,180,220,160,80,160,320,1120
36355,170,100,40,80,160,0,550
36356,190,140,120,160,160,0,770
36357,210,120,80,80,160,0,650
36358,150,120,160,240,160,0,830
36359,230,140,80,80,160,320,1010
36360,180,160,120,0,0,0,460
36361,200,60,0,0,0,0,260
36362,180,100,40,80,0,0,400
36363,200,100,80,80,160,0,620
36364,170,100,120,160,0,0,550
36365,210,140,160,240,160,0,910
36366,190,80,40,0,0,0,310
36367,170,140,80,160,320,320,1190
36368,210,100,80,160,0,0,550
36369,160,60,40,80,160,0,500
36370,210,140,160,160,160,0,830
36371,150,100,80,80,0,0,410
36372,220,100,80,0,0,0,400
36373,170,100,80,80,0,0,430
36374,220,120,120,80,160,0,700
36375,200,160,120,80,0,0,560
36376,240,140,80,80,160,320,1020
36377,230,80,80,160,160,0,710
36378,230,120,80,0,0,0,430
36379,180,80,80,80,160,0,580
36380,170,140,120,160,160,0,750
36381,180,140,200,240,320,0,1080
36382,190,120,160,160,160,0,790
36383,250,100,120,240,320,0,1030
36384,180,80,80,80,160,0,580
36385,210,180,160,240,320,320,1430
36386,210,80,80,160,0,0,530
36387,130,140,120,80,160,320,950
36388,200,180,160,160,320,320,1340
36389,170,140,80,80,160,0,630
36390,220,180,160,80,160,0,800
36391,190,100,160,160,320,320,1250
36392,190,100,80,80,0,0,450
36393,200,100,80,160,0,0,540
36394,170,140,120,160,320,0,910
36395,210,120,160,240,320,320,1370
36396,240,160,200,160,0,0,760
36397,200,140,40,0,0,0,380
36398,210,140,160,160,320,320,1310
36399,200,100,40,0,0,0,340
36400,180,120,80,160,160,0,700
36401,180,100,80,80,160,320,920
36402,230,120,80,80,160,320,990
36403,200,80,40,80,160,0,560
36404,210,80,40,0,0,0,330
36405,160,100,80,80,0,0,420
36406,240,220,120,160,160,0,900
36407,200,140,120,80,160,0,700
36408,190,80,80,160,320,0,830
36409,210,120,80,0,0,0,410
36410,220,120,120,80,160,0,700
36411,170,60,40,80,160,0,510
36412,190,80,40,80,160,0,550
36413,210,100,80,0,0,0,390
36414,210,180,120,160,0,0,670
36415,220,180,160,160,160,320,1200
36416,220,120,80,80,0,0,500
36417,220,160,160,160,320,0,1020
36418,150,100,40,0,0,0,290
36419,150,120,160,240,320,320,1310
36420,190,140,160,240,320,0,1050
36421,180,140,80,160,320,0,880
36422,220,160,120,160,0,0,660
36423,160,80,120,160,160,320,1000
36424,200,140,200,240,320,320,1420
36425,220,120,120,80,160,320,1020
36426,180,100,120,160,320,0,880
36427,200,140,160,240,160,0,900
36428,150,80,80,0,0,0,310
36429,150,80,120,160,320,320,1150
36430,190,100,200,240,320,0,1050
36431,220,140,80,80,160,0,680
36432,170,120,160,160,0,0,610
36433,180,140,80,80,160,0,640
36434,220,40,40,80,160,0,540
36435,200,120,80,160,320,0,880
36436,180,80,80,160,160,0,660
36437,220,100,80,160,160,320,1040
36438,150,80,40,80,160,320,830
36439,200,80,120,80,0,0,480
36440,200,160,120,80,160,0,720
36441,210,140,120,80,0,0,550
36442,160,120,160,160,320,0,920
36443,200,160,80,0,0,0,440
36444,190,60,120,160,160,0,690
36445,180,80,160,80,160,0,660
36446,210,100,120,160,160,320,1070
36447,200,120,120,160,0,0,600
36448,220,120,160,80,0,0,580
36449,190,100,80,160,0,0,530
36450,180,160,120,160,160,0,780
36451,180,160,120,0,0,0,460
36452,220,100,200,240,0,0,760
36453,190,140,40,80,0,0,450
36454,210,80,80,160,320,320,1170
36455,210,100,120,80,160,0,670
36456,200,100,160,240,160,320,1180
36457,200,140,120,160,0,0,620
36458,210,120,120,160,0,0,610
36459,220,160,120,160,160,0,820
36460,190,140,120,160,320,0,930
36461,140,40,40,80,160,0,460
36462,190,60,0,0,0,0,250
36463,190,80,40,0,0,0,310
36464,240,120,80,160,160,320,1080
36465,200,120,80,0,0,0,400
36466,230,160,160,80,160,0,790
36467,190,60,120,80,0,0,450
36468,210,140,200,160,160,0,870
36469,190,120,160,160,160,0,790
36470,200,120,40,80,160,0,600
36471,160,80,40,80,160,0,520
36472,210,100,40,80,160,0,590
36473,180,140,160,240,160,0,880
36474,220,100,120,0,0,0,440
36475,180,100,80,0,0,0,360
36476,190,160,80,80,160,320,990
36477,170,160,120,240,320,320,1330
36478,200,120,40,80,160,320,920
36479,190,160,160,240,320,320,1390
36480,150,100,80,80,0,0,410
36481,190,160,120,80,0,0,550
36482,190,140,120,160,320,0,930
36483,170,120,120,80,0,0,490
36484,170,100,80,160,160,0,670
36485,200,140,80,160,320,320,1220
36486,190,100,40,0,0,0,330
36487,170,80,120,80,160,0,610
36488,200,120,120,160,0,0,600
36489,190,80,120,0,0,0,390
36490,240,100,120,160,160,0,780
36491,170,60,40,0,0,0,270
36492,150,100,80,160,320,0,810
36493,190,80,120,80,160,0,630
36494,190,120,80,80,160,0,630
36495,220,180,80,80,0,0,560
36496,210,160,120,160,320,0,970
36497,170,60,40,80,0,0,350
36498,180,140,200,160,160,0,840
36499,240,140,120,80,160,0,740
36500,180,80,120,160,0,0,540
36501,220,140,120,80,160,0,720
36502,160,120,120,160,160,0,720
36503,220,120,40,0,0,0,380
36504,210,60,0,0,0,0,270
36505,180,120,200,160,160,0,820
36506,170,80,40,80,160,320,850
36507,190,100,40,80,160,320,890
36508,180,140,80,80,160,0,640
36509,210,160,80,80,0,0,530
36510,210,80,80,80,160,0,610
36511,260,180,40,80,0,0,560
36512,170,80,80,160,160,0,650
36513,200,120,160,160,0,0,640
36514,240,120,120,160,160,0,800
36515,240,120,80,0,0,0,440
36516,230,160,120,160,160,0,830
36517,200,120,160,160,320,320,1280
36518,170,100,0,0,0,0,270
36519,130,80,80,160,160,320,930
36520,200,140,80,0,0,0,420
36521,210,160,120,160,320,0,970
36522,210,60,80,0,0,0,350
36523,160,100,160,160,160,0,740
36524,200,180,200,80,0,0,660
36525,180,60,80,80,0,0,400
36526,160,80,120,80,160,320,920
36527,210,80,80,160,0,0,530
36528,190,60,80,0,0,0,330
36529,200,80,40,80,160,0,560
36530,210,60,80,80,160,0,590
36531,210,60,40,80,160,320,870
36532,210,100,40,0,0,0,350
36533,170,100,40,0,0,0,310
36534,200,100,160,160,160,0,780
36535,220,60,40,80,0,0,400
36536,200,80,40,80,0,0,400
36537,170,80,120,160,160,0,690
36538,160,80,80,0,0,0,320
36539,180,140,120,0,0,0,440
36540,200,80,80,160,160,0,680
36541,180,140,120,240,160,0,840
36542,190,80,40,80,0,0,390
36543,220,180,240,160,160,0,960
36544,210,140,160,160,160,0,830
36545,230,120,80,0,0,0,430
36546,200,160,120,80,0,0,560
36547,190,100,40,0,0,0,330
36548,180,60,80,80,160,0,560
36549,240,120,80,80,160,0,680
36550,190,140,120,80,0,0,530
36551,240,140,80,80,0,0,540
36552,180,120,80,160,160,0,700
36553,200,160,80,80,160,0,680
36554,190,120,160,160,320,320,1270
36555,180,80,40,80,0,0,380
36556,170,60,40,0,0,0,270
36557,210,60,120,0,0,0,390
36558,160,120,120,80,160,0,640
36559,140,120,80,80,160,0,580
36560,150,120,160,160,0,0,590
36561,180,160,160,240,160,0,900
36562,220,140,120,0,0,0,480
36563,210,120,120,160,160,320,1090
36564,190,120,80,80,160,0,630
36565,200,120,120,80,160,0,680
36566,220,180,80,80,0,0,560
36567,170,80,80,80,160,320,890
36568,210,120,120,240,320,0,1010
36569,170,120,80,80,160,0,610
36570,190,100,120,80,160,0,650
36571,180,120,80,80,0,0,460
36572,230,140,120,80,160,0,730
36573,190,80,160,80,160,0,670
36574,220,100,80,80,0,0,480
36575,200,140,160,160,320,0,980
36576,230,160,120,160,320,0,990
36577,220,180,120,160,0,0,680
36578,180,80,160,160,0,0,580
36579,190,140,120,80,160,320,1010
36580,140,80,40,80,160,320,820
36581,180,200,160,80,160,0,780
36582,220,120,120,0,0,0,460
36583,200,100,160,160,160,0,780
36584,230,140,80,80,160,0,690
36585,220,120,120,160,160,0,780
36586,210,140,120,240,160,0,870
36587,190,120,120,160,0,0,590
36588,200,160,80,0,0,0,440
36589,210,140,120,80,0,0,550
36590,160,100,120,80,160,320,940
36591,180,80,40,80,160,320,860
36592,190,140,160,80,0,0,570
36593,170,140,120,160,160,320,1070
36594,180,80,0,0,0,0,260
36595,160,100,120,240,160,0,780
36596,200,120,120,160,160,0,760
36597,180,140,200,160,160,0,840
36598,170,40,40,80,160,320,810
36599,200,80,40,80,160,0,560
36600,190,140,160,240,160,0,890
36601,200,120,0,0,0,0,320
36602,180,160,80,80,0,0,500
36603,200,80,80,80,160,0,600
36604,190,120,120,160,160,0,750
36605,210,40,40,80,160,0,530
36606,210,100,40,80,0,0,430
36607,210,120,160,80,160,0,730
36608,170,100,120,80,0,0,470
36609,220,140,80,80,160,0,680
36610,200,160,120,160,160,0,800
36611,200,120,160,160,0,0,640
36612,190,80,40,80,0,0,390
36613,220,200,160,80,160,320,1140
36614,180,140,200,160,320,0,1000
36615,220,120,160,80,160,0,740
36616,190,100,120,160,160,320,1050
36617,200,120,80,80,160,0,640
36618,220,160,120,80,160,0,740
36619,200,120,120,160,320,0,920
36620,190,120,40,80,0,0,430
36621,250,120,80,160,160,0,770
36622,210,100,160,80,160,0,710
36623,170,120,160,80,160,320,1010
36624,230,100,120,0,0,0,450
36625,180,60,80,160,320,0,800
36626,220,120,40,0,0,0,380
36627,200,160,80,0,0,0,440
36628,230,120,80,160,160,0,750
36629,180,100,40,0,0,0,320
36630,200,140,80,80,0,0,500
36631,190,120,160,160,320,0,950
36632,210,140,120,80,160,0,710
36633,190,80,80,80,160,0,590
36634,170,120,120,80,160,0,650
36635,200,140,120,160,160,0,780
36636,160,40,40,80,160,0,480
36637,230,100,40,80,0,0,450
36638,190,120,120,80,160,0,670
36639,250,120,120,160,320,320,1290
36640,200,120,120,160,160,0,760
36641,180,120,80,80,160,0,620
36642,210,180,120,80,160,320,1070
36643,180,100,80,80,160,0,600
36644,190,80,80,80,160,0,590
36645,180,100,160,80,160,0,680
36646,220,160,240,160,160,0,940
36647,120,120,160,240,320,0,960
36648,150,80,40,80,0,0,350
36649,220,160,160,80,0,0,620
36650,210,100,40,80,0,0,430
36651,210,120,120,80,160,0,690
36652,200,140,80,160,160,0,740
36653,240,140,120,160,160,320,1140
36654,190,140,120,0,0,0,450
36655,200,140,80,80,160,0,660
36656,190,100,120,240,160,0,810
36657,230,100,120,80,160,320,1010
36658,160,140,120,160,320,320,1220
36659,230,60,80,160,0,0,530
36660,200,140,80,80,160,320,980
36661,220,160,120,80,160,0,740
36662,160,120,80,80,160,0,600
36663,200,100,120,160,160,0,740
36664,170,60,40,0,0,0,270
36665,180,120,160,160,160,0,780
36666,220,160,120,80,160,0,740
36667,210,100,80,160,160,320,1030
36668,170,120,80,80,0,0,450
36669,190,100,80,80,160,0,610
36670,210,120,120,160,320,0,930
36671,200,120,120,80,160,0,680
36672,200,100,120,160,160,0,740
36673,180,100,120,160,160,0,720
36674,190,140,40,80,0,0,450
36675,200,120,80,0,0,0,400
36676,170,140,200,80,0,0,590
36677,210,100,120,80,160,0,670
36678,210,140,120,160,160,0,790
36679,190,140,80,0,0,0,410
36680,200,140,160,160,160,0,820
36681,180,60,40,80,160,320,840
36682,190,100,40,80,160,320,890
36683,180,100,120,80,0,0,480
36684,190,20,40,0,0,0,250
36685,220,160,240,240,320,0,1180
36686,230,120,80,160,0,0,590
36687,180,120,120,240,320,320,1300
36688,230,140,160,160,160,0,850
36689,130,100,120,0,0,0,350
36690,190,140,120,80,0,0,530
36691,210,140,40,80,0,0,470
36692,180,60,80,80,0,0,400
36693,190,140,120,160,0,0,610
36694,170,80,120,160,160,0,690
36695,230,140,160,240,320,0,1090
36696,210,140,120,80,0,0,550
36697,200,100,120,160,160,0,740
36698,150,40,0,0,0,0,190
36699,160,100,80,0,0,0,340
36700,170,140,80,80,0,0,470
36701,260,120,80,80,160,0,700
36702,190,100,80,0,0,0,370
36703,230,180,120,0,0,0,530
36704,190,120,120,0,0,0,430
36705,180,100,120,80,0,0,480
36706,230,140,80,160,320,0,930
36707,160,140,80,80,0,0,460
36708,240,120,80,80,0,0,520
36709,200,160,160,0,0,0,520
36710,230,160,120,80,0,0,590
36711,210,120,80,80,160,0,650
36712,180,80,80,0,0,0,340
36713,200,140,200,240,320,0,1100
36714,200,140,80,80,0,0,500
36715,170,140,160,240,0,0,710
36716,170,140,160,80,160,0,710
36717,160,140,160,160,160,0,780
36718,200,80,80,0,0,0,360
36719,200,100,40,80,160,0,580
36720,170,80,160,160,320,320,1210
36721,210,120,80,80,160,0,650
36722,200,100,80,160,160,0,700
36723,170,100,80,80,160,0,590
36724,180,80,80,0,0,0,340
36725,210,140,120,80,0,0,550
36726,240,140,120,80,160,0,740
36727,180,140,40,0,0,0,360
36728,200,140,200,240,320,0,1100
36729,220,100,40,80,160,0,600
36730,180,60,40,80,160,0,520
36731,250,160,120,160,160,0,850
36732,200,180,120,160,160,320,1140
36733,240,120,80,80,160,0,680
36734,210,120,120,80,0,0,530
36735,220,200,80,80,0,0,580
36736,180,100,0,0,0,0,280
36737,190,180,200,160,160,320,1210
36738,190,120,80,80,0,0,470
36739,200,120,160,80,0,0,560
36740,170,160,80,160,0,0,570
36741,180,120,120,80,160,0,660
36742,180,120,120,160,160,320,1060
36743,190,140,160,80,0,0,570
36744,200,140,120,0,0,0,460
36745,180,100,80,80,160,0,600
36746,210,100,80,0,0,0,390
36747,170,80,120,160,160,320,1010
36748,200,140,80,0,0,0,420
36749,210,120,160,0,0,0,490
36750,230,140,200,240,320,320,1450
36751,230,160,120,80,0,0,590
36752,170,140,80,0,0,0,390
36753,200,100,0,0,0,0,300
36754,210,140,40,80,160,0,630
36755,190,160,200,160,0,0,710
36756,210,100,0,0,0,0,310
36757,210,120,40,0,0,0,370
36758,190,120,80,80,0,0,470
36759,180,100,120,80,160,0,640
36760,210,120,80,0,0,0,410
36761,220,180,240,160,160,320,1280
36762,180,180,120,80,160,0,720
36763,190,100,80,0,0,0,370
36764,170,100,120,0,0,0,390
36765,180,80,0,0,0,0,260
36766,170,100,80,160,320,0,830
36767,220,140,80,80,0,0,520
36768,200,120,80,80,160,0,640
36769,170,120,120,80,0,0,490
36770,250,140,120,80,160,0,750
36771,220,100,80,160,160,0,720
36772,220,100,120,80,160,320,1000
36773,220,140,80,80,160,0,680
36774,220,120,120,80,0,0,540
36775,210,180,200,160,320,0,1070
36776,200,140,40,80,160,0,620
36777,170,120,160,80,160,0,690
36778,210,80,80,80,0,0,450
36779,180,120,120,0,0,0,420
36780,200,60,0,0,0,0,260
36781,190,140,80,160,160,0,730
36782,190,120,80,80,160,0,630
36783,240,180,160,160,320,320,1380
36784,200,120,120,80,160,0,680
36785,200,60,80,80,160,0,580
36786,150,60,40,0,0,0,250
36787,180,80,80,80,160,0,580
36788,210,140,120,80,0,0,550
36789,210,120,160,160,320,0,970
36790,240,100,120,0,0,0,460
36791,230,120,40,80,160,0,630
36792,180,140,160,240,160,0,880
36793,180,120,80,80,160,0,620
36794,230,140,160,160,320,0,1010
36795,200,180,160,80,160,0,780
36796,220,180,80,80,160,0,720
36797,230,160,160,160,160,0,870
36798,170,100,80,0,0,0,350
36799,170,120,80,80,160,0,610
36800,170,120,160,80,0,0,530
36801,170,80,80,80,160,0,570
36802,200,140,80,80,0,0,500
36803,180,160,160,80,160,0,740
36804,220,120,160,240,320,0,1060
36805,220,80,160,160,320,0,940
36806,180,120,120,80,0,0,500
36807,180,80,80,160,160,0,660
36808,200,140,160,80,0,0,580
36809,200,140,160,80,160,0,740
36810,180,120,120,160,160,0,740
36811,230,100,120,0,0,0,450
36812,240,160,80,160,320,0,960
36813,180,100,80,80,0,0,440
36814,150,140,120,160,160,320,1050
36815,170,120,120,0,0,0,410
36816,220,120,80,0,0,0,420
36817,230,160,80,80,160,0,710
36818,170,100,120,80,0,0,470
36819,220,140,160,80,160,0,760
36820,200,140,120,160,160,0,780
36821,190,200,160,160,160,0,870
36822,230,180,120,240,320,320,1410
36823,210,180,160,240,320,0,1110
36824,220,120,120,0,0,0,460
36825,190,80,80,0,0,0,350
36826,190,60,40,80,0,0,370
36827,230,120,160,160,0,0,670
36828,210,140,120,0,0,0,470
36829,190,180,120,80,160,0,730
36830,190,140,120,160,320,320,1250
36831,200,100,160,0,0,0,460
36832,190,120,40,80,0,0,430
36833,170,120,160,80,0,0,530
36834,170,140,120,80,160,0,670
36835,170,100,80,80,0,0,430
36836,220,120,80,80,0,0,500
36837,200,120,80,80,160,0,640
36838,120,100,80,160,160,0,620
36839,190,220,200,160,160,0,930
36840,200,200,240,160,0,0,800
36841,180,100,120,80,160,0,640
36842,220,140,120,160,160,0,800
36843,190,140,40,0,0,0,370
36844,190,160,160,160,160,0,830
36845,190,140,120,80,160,0,690
36846,180,140,120,160,0,0,600
36847,200,80,0,0,0,0,280
36848,200,100,80,160,0,0,540
36849,210,100,120,80,160,0,670
36850,180,140,160,160,160,320,1120
36851,190,140,80,80,0,0,490
36852,180,120,40,80,160,320,900
36853,170,80,80,160,320,320,1130
36854,190,100,40,80,160,0,570
36855,240,120,80,160,160,0,760
36856,190,160,120,160,160,0,790
36857,190,160,120,160,320,0,950
36858,190,180,80,0,0,0,450
36859,200,120,40,80,160,0,600
36860,200,120,80,80,160,0,640
36861,210,120,40,80,0,0,450
36862,210,140,80,0,0,0,430
36863,190,160,160,160,160,0,830
36864,210,120,200,80,0,0,610
36865,190,100,120,160,320,0,890
36866,210,180,120,160,160,0,830
36867,210,160,120,80,160,0,730
36868,170,120,80,160,320,320,1170
36869,160,100,40,80,160,0,540
36870,180,80,0,0,0,0,260
36871,190,100,120,0,0,0,410
36872,220,80,120,0,0,0,420
36873,200,100,40,80,160,0,580
36874,190,120,120,80,0,0,510
36875,160,120,80,160,160,0,680
36876,210,40,80,160,160,0,650
36877,190,80,80,80,160,0,590
36878,230,140,80,0,0,0,450
36879,220,120,80,80,160,320,980
36880,220,160,80,80,160,0,700
36881,240,120,40,0,0,0,400
36882,240,160,120,160,320,0,1000
36883,220,100,80,80,0,0,480
36884,220,120,40,0,0,0,380
36885,200,160,160,160,320,0,1000
36886,180,160,120,160,160,0,780
36887,160,100,160,240,320,320,1300
36888,210,140,120,160,160,0,790
36889,220,120,80,80,160,0,660
36890,150,80,40,80,160,0,510
36891,220,160,40,0,0,0,420
36892,180,120,120,240,160,320,1140
36893,220,160,200,80,160,0,820
36894,180,140,120,160,160,0,760
36895,210,140,80,160,0,0,590
36896,170,100,120,80,160,0,630
36897,190,120,80,80,0,0,470
36898,200,200,160,80,160,320,1120
36899,190,60,0,0,0,0,250
36900,210,140,40,0,0,0,390
36901,170,80,80,80,0,0,410
36902,210,120,0,0,0,0,330
36903,170,140,80,0,0,0,390
36904,220,160,200,160,160,0,900
36905,190,80,40,80,160,0,550
36906,220,120,80,0,0,0,420
36907,200,100,120,160,160,320,1060
36908,190,60,40,80,0,0,370
36909,220,120,40,80,0,0,460
36910,230,120,80,0,0,0,430
36911,240,140,120,240,0,0,740
36912,200,80,80,80,160,0,600
36913,170,140,160,160,320,0,950
36914,200,80,120,160,320,0,880
36915,190,160,160,160,160,0,830
36916,200,140,120,80,160,0,700
36917,210,140,160,240,320,0,1070
36918,230,220,200,80,160,0,890
36919,220,160,160,80,160,0,780
36920,200,100,80,80,0,0,460
36921,180,100,160,240,320,0,1000
36922,190,120,80,0,0,0,390
36923,190,80,80,0,0,0,350
36924,160,100,80,80,0,0,420
36925,180,100,120,80,160,320,960
36926,200,140,120,80,160,320,1020
36927,180,180,80,80,160,320,1000
36928,210,140,120,0,0,0,470
36929,220,140,120,80,160,0,720
36930,180,140,120,80,0,0,520
36931,210,140,120,240,160,0,870
36932,190,60,80,0,0,0,330
36933,200,120,80,160,0,0,560
36934,180,140,80,160,0,0,560
36935,140,80,40,80,160,320,820
36936,190,180,120,160,0,0,650
36937,200,160,80,80,160,320,1000
36938,180,180,160,0,0,0,520
36939,200,180,80,0,0,0,460
36940,200,100,120,80,160,0,660
36941,170,120,200,80,0,0,570
36942,210,140,80,80,0,0,510
36943,210,120,120,160,160,0,770
36944,220,120,120,80,160,320,1020
36945,210,160,160,240,320,0,1090
36946,180,100,40,80,160,0,560
36947,240,120,40,0,0,0,400
36948,210,140,200,160,320,320,1350
36949,210,160,160,80,0,0,610
36950,210,80,80,80,160,0,610
36951,160,140,160,80,0,0,540
36952,190,80,0,0,0,0,270
36953,220,100,120,80,0,0,520
36954,200,120,160,240,320,0,1040
36955,160,80,80,80,0,0,400
36956,150,100,160,80,0,0,490
36957,210,160,120,0,0,0,490
36958,200,140,120,80,0,0,540
36959,180,140,120,160,320,320,1240
36960,200,80,0,0,0,0,280
36961,240,220,120,0,0,0,580
36962,200,60,120,80,0,0,460
36963,200,120,160,160,160,320,1120
36964,170,80,160,240,320,0,970
36965,180,160,120,160,160,0,780
36966,240,120,120,80,0,0,560
36967,190,180,160,160,320,0,1010
36968,170,100,80,0,0,0,350
36969,200,120,80,80,160,320,960
36970,240,180,120,160,160,0,860
36971,170,100,120,80,160,0,630
36972,210,40,0,0,0,0,250
36973,150,120,80,80,160,0,590
36974,180,80,40,80,160,0,540
36975,210,120,80,160,160,0,730
36976,180,140,80,0,0,0,400
36977,190,140,160,160,160,0,810
36978,220,160,80,80,160,0,700
36979,220,100,120,80,160,0,680
36980,170,120,160,160,160,320,1090
36981,240,180,120,80,0,0,620
36982,190,100,40,80,0,0,410
36983,220,100,80,80,0,0,480
36984,190,100,80,80,0,0,450
36985,250,120,160,0,0,0,530
36986,170,100,160,240,160,0,830
36987,200,100,120,160,160,0,740
36988,170,60,80,80,160,320,870
36989,230,80,80,0,0,0,390
36990,150,100,80,80,0,0,410
36991,200,120,80,80,160,0,640
36992,210,140,120,0,0,0,470
36993,120,100,40,0,0,0,260
36994,190,120,120,160,320,320,1230
36995,160,120,120,80,0,0,480
36996,190,200,200,160,0,0,750
36997,170,120,120,160,160,320,1050
36998,200,100,80,80,160,0,620
36999,220,80,80,80,0,0,460
37000,200,180,120,160,160,0,820
37001,210,80,80,80,160,0,610
37002,190,100,80,80,160,0,610
37003,160,120,160,160,160,320,1080
37004,170,80,80,80,160,0,570
37005,160,120,120,80,160,0,640
37006,160,80,160,240,320,0,960
37007,220,160,80,80,160,0,700
37008,230,140,80,0,0,0,450
37009,210,80,0,0,0,0,290
37010,210,100,120,160,160,0,750
37011,170,180,80,160,160,320,1070
37012,220,140,80,80,0,0,520
37013,240,180,80,0,0,0,500
37014,190,80,80,80,160,320,910
37015,190,100,120,160,320,0,890
37016,210,140,40,80,0,0,470
37017,210,140,40,0,0,0,390
37018,200,140,160,0,0,0,500
37019,210,120,120,80,160,320,1010
37020,230,160,200,80,160,0,830
37021,190,100,160,240,160,0,850
37022,200,80,80,80,0,0,440
37023,210,160,120,160,320,0,970
37024,210,180,80,80,0,0,550
37025,250,120,40,0,0,0,410
37026,190,100,80,80,0,0,450
37027,200,160,200,240,320,320,1440
37028,220,120,80,0,0,0,420
37029,210,100,120,160,320,0,910
37030,180,160,40,0,0,0,380
37031,180,140,120,240,160,0,840
37032,210,140,80,80,160,320,990
37033,180,120,120,80,0,0,500
37034,250,180,160,0,0,0,590
37035,170,140,160,80,0,0,550
37036,220,100,80,80,160,320,960
37037,140,80,120,160,160,0,660
37038,180,120,80,0,0,0,380
37039,170,80,40,0,0,0,290
37040,200,140,80,80,160,0,660
37041,180,160,120,160,0,0,620
37042,180,80,40,0,0,0,300
37043,170,120,120,80,160,320,970
37044,210,140,40,80,160,0,630
37045,210,140,120,160,160,320,1110
37046,220,100,120,0,0,0,440
37047,140,100,120,0,0,0,360
37048,250,140,120,80,160,320,1070
37049,180,100,120,80,160,0,640
37050,200,80,120,80,160,0,640
37051,190,100,120,160,160,320,1050
37052,230,140,80,80,160,0,690
37053,200,140,160,240,160,320,1220
37054,190,120,160,240,320,0,1030
37055,200,100,80,160,160,320,1020
37056,190,160,160,160,320,0,990
37057,210,100,160,160,160,320,1110
37058,170,100,80,160,320,320,1150
37059,220,120,120,80,160,0,700
37060,200,100,120,80,160,0,660
37061,150,120,80,80,0,0,430
37062,170,120,120,240,160,0,810
37063,230,160,160,160,0,0,710
37064,200,180,120,160,0,0,660
37065,190,140,160,240,320,0,1050
37066,200,100,80,0,0,0,380
37067,190,120,80,0,0,0,390
37068,200,80,80,80,160,0,600
37069,170,100,160,160,320,320,1230
37070,230,100,80,0,0,0,410
37071,210,120,120,80,0,0,530
37072,160,80,0,0,0,0,240
37073,200,160,200,80,160,0,800
37074,160,120,160,240,160,0,840
37075,230,60,80,0,0,0,370
37076,180,140,120,160,160,0,760
37077,240,180,120,160,160,0,860
37078,160,80,80,80,160,0,560
37079,170,120,120,160,160,0,730
37080,190,100,120,160,0,0,570
37081,190,120,120,80,160,0,670
37082,230,180,160,240,160,320,1290
37083,200,100,80,80,0,0,460
37084,210,140,200,160,160,0,870
37085,210,120,80,80,160,320,970
37086,160,140,120,160,320,320,1220
37087,230,160,80,160,0,0,630
37088,190,140,120,160,0,0,610
37089,200,100,40,80,0,0,420
37090,200,140,120,160,160,0,780
37091,190,140,160,80,0,0,570
37092,180,140,80,160,160,0,720
37093,170,100,40,80,160,0,550
37094,180,140,80,80,0,0,480
37095,170,140,200,80,160,320,1070
37096,160,100,80,0,0,0,340
37097,190,140,160,80,0,0,570
37098,230,100,200,160,320,0,1010
37099,170,140,40,80,160,0,590
37100,190,100,80,80,160,0,610
37101,210,140,120,0,0,0,470
37102,250,160,160,80,160,0,810
37103,180,140,160,160,160,0,800
37104,190,120,120,80,160,0,670
37105,160,100,120,80,160,320,940
37106,190,140,80,80,160,320,970
37107,160,160,40,0,0,0,360
37108,210,100,120,0,0,0,430
37109,180,100,80,80,160,0,600
37110,190,140,120,240,160,320,1170
37111,190,120,40,0,0,0,350
37112,230,140,120,240,320,320,1370
37113,200,100,80,160,160,0,700
37114,230,60,0,0,0,0,290
37115,210,100,80,80,160,0,630
37116,220,180,160,160,320,0,1040
37117,190,120,40,0,0,0,350
37118,190,140,120,160,320,320,1250
37119,200,80,120,80,0,0,480
37120,190,120,160,240,160,320,1190
37121,230,120,200,160,160,0,870
37122,200,160,120,80,0,0,560
37123,230,140,120,160,160,320,1130
37124,180,80,80,0,0,0,340
37125,190,140,40,80,160,0,610
37126,230,140,80,160,320,320,1250
37127,210,180,120,80,0,0,590
37128,220,100,40,0,0,0,360
37129,210,120,80,80,0,0,490
37130,250,160,160,160,160,0,890
37131,210,160,120,160,160,0,810
37132,190,140,80,0,0,0,410
37133,230,140,120,80,160,0,730
37134,190,100,80,80,0,0,450
37135,180,80,80,160,0,0,500
37136,170,120,120,160,320,0,890
37137,170,160,40,80,160,320,930
37138,190,100,160,80,160,320,1010
37139,170,120,160,160,160,0,770
37140,200,80,80,80,0,0,440
37141,190,60,80,80,160,320,890
37142,170,60,80,80,160,0,550
37143,240,140,80,0,0,0,460
37144,220,80,40,80,0,0,420
37145,170,60,80,160,160,320,950
37146,220,100,40,80,0,0,440
37147,200,120,80,0,0,0,400
37148,220,100,120,80,0,0,520
37149,220,100,80,80,160,0,640
37150,220,160,120,160,0,0,660
37151,210,120,120,80,0,0,530
37152,220,140,160,240,160,0,920
37153,210,100,80,0,0,0,390
37154,250,120,120,80,160,0,730
37155,230,140,120,160,160,0,810
37156,190,140,160,240,320,320,1370
37157,200,180,80,80,160,0,700
37158,220,120,80,160,160,0,740
37159,150,120,120,160,320,0,870
37160,190,120,80,0,0,0,390
37161,240,180,160,240,160,0,980
37162,210,140,120,80,0,0,550
37163,180,100,160,160,160,0,760
37164,200,80,80,160,320,320,1160
37165,170,120,80,0,0,0,370
37166,200,120,80,0,0,0,400
37167,170,100,160,80,160,0,670
37168,180,120,120,0,0,0,420
37169,190,80,80,80,160,0,590
37170,210,160,160,160,160,0,850
37171,210,140,40,80,0,0,470
37172,180,120,40,0,0,0,340
37173,190,100,160,240,0,0,690
37174,190,140,160,80,0,0,570
37175,150,100,40,80,160,0,530
37176,220,180,160,160,160,0,880
37177,190,160,120,160,160,0,790
37178,190,100,40,0,0,0,330
37179,160,80,80,80,160,0,560
37180,210,120,120,160,0,0,610
37181,200,120,40,80,0,0,440
37182,200,200,200,80,160,0,840
37183,200,120,160,160,0,0,640
37184,200,120,120,160,160,0,760
37185,170,100,120,160,320,320,1190
37186,220,120,120,80,160,0,700
37187,120,80,120,160,160,320,960
37188,180,140,120,160,0,0,600
37189,200,120,40,0,0,0,360
37190,230,80,120,80,0,0,510
37191,190,120,160,160,160,320,1110
37192,160,100,80,0,0,0,340
37193,230,160,120,160,0,0,670
37194,250,100,120,160,320,0,950
37195,210,100,120,0,0,0,430
37196,200,140,80,80,160,0,660
37197,210,100,160,160,160,0,790
37198,170,120,80,80,0,0,450
37199,200,120,120,80,0,0,520
37200,210,120,120,80,0,0,530
37201,210,100,80,0,0,0,390
37202,190,180,160,80,0,0,610
37203,150,100,80,80,160,0,570
37204,220,140,160,160,0,0,680
37205,210,180,80,0,0,0,470
37206,250,160,120,80,160,0,770
37207,180,100,80,80,0,0,440
37208,220,100,80,80,0,0,480
37209,180,100,160,240,0,0,680
37210,210,140,200,80,0,0,630
37211,180,180,120,0,0,0,480
37212,190,100,40,80,0,0,410
37213,180,120,160,80,160,0,700
37214,150,100,120,80,160,0,610
37215,240,160,120,80,0,0,600
37216,200,160,160,160,160,0,840
37217,190,140,160,0,0,0,490
37218,200,80,40,80,160,0,560
37219,190,120,80,80,160,0,630
37220,190,160,80,80,160,0,670
37221,150,80,40,0,0,0,270
37222,170,100,120,80,160,0,630
37223,210,40,80,80,160,0,570
37224,220,160,200,240,320,0,1140
37225,180,140,80,80,0,0,480
37226,220,140,80,0,0,0,440
37227,240,160,160,80,160,0,800
37228,200,140,160,0,0,0,500
37229,210,100,80,80,160,320,950
37230,180,160,120,80,0,0,540
37231,210,120,80,160,160,0,730
37232,210,140,160,80,160,0,750
37233,190,80,80,160,320,0,830
37234,220,120,80,160,160,320,1060
37235,190,100,80,160,160,320,1010
37236,200,80,120,80,0,0,480
37237,170,120,120,0,0,0,410
37238,210,100,80,160,160,0,710
37239,190,140,120,240,320,0,1010
37240,240,180,120,0,0,0,540
37241,210,140,160,80,160,320,1070
37242,170,100,40,80,0,0,390
37243,190,180,120,80,160,0,730
37244,220,160,120,80,160,0,740
37245,200,120,40,0,0,0,360
37246,220,120,120,80,160,0,700
37247,180,120,200,160,0,0,660
37248,180,100,160,240,160,0,840
37249,220,120,160,160,160,0,820
37250,240,160,120,0,0,0,520
37251,230,140,200,80,160,0,810
37252,190,140,120,160,320,0,930
37253,180,120,80,0,0,0,380
37254,190,100,160,160,160,0,770
37255,170,120,120,80,160,0,650
37256,200,140,120,160,320,0,940
37257,150,80,120,160,160,0,670
37258,210,100,120,80,160,0,670
37259,180,60,80,80,160,320,880
37260,230,160,40,0,0,0,430
37261,220,120,200,0,0,0,540
37262,180,100,200,160,320,0,960
37263,180,100,80,0,0,0,360
37264,170,220,280,240,320,320,1550
37265,220,120,80,160,320,0,900
37266,220,160,120,80,0,0,580
37267,200,120,80,160,160,320,1040
37268,200,100,120,160,160,0,740
37269,270,160,160,160,160,0,910
37270,190,100,80,0,0,0,370
37271,230,200,200,160,160,320,1270
37272,210,100,40,80,0,0,430
37273,190,160,160,80,160,0,750
37274,190,100,80,160,160,0,690
37275,190,120,160,160,0,0,630
37276,190,120,40,0,0,0,350
37277,190,100,80,80,0,0,450
37278,190,100,40,0,0,0,330
37279,220,160,200,160,160,0,900
37280,190,120,40,0,0,0,350
37281,190,80,120,160,320,0,870
37282,190,200,200,240,320,0,1150
37283,160,60,40,0,0,0,260
37284,190,160,80,160,160,320,1070
37285,210,100,40,80,160,0,590
37286,210,100,160,80,160,0,710
37287,190,100,120,0,0,0,410
37288,180,80,80,80,160,0,580
37289,190,40,40,80,0,0,350
37290,220,160,160,240,320,0,1100
37291,170,180,120,80,160,0,710
37292,240,140,120,80,160,0,740
37293,190,80,40,80,0,0,390
37294,210,120,80,0,0,0,410
37295,230,120,160,240,160,0,910
37296,230,160,120,160,160,0,830
37297,200,80,80,80,160,0,600
37298,170,80,120,80,160,0,610
37299,200,140,160,0,0,0,500
37300,180,140,120,80,160,0,680
37301,210,140,160,80,160,0,750
37302,150,140,120,160,160,0,730
37303,200,160,120,160,160,0,800
37304,180,100,120,160,160,320,1040
37305,210,140,120,80,160,0,710
37306,190,100,160,160,160,0,770
37307,160,80,40,80,160,0,520
37308,170,100,160,240,160,0,830
37309,220,160,120,80,0,0,580
37310,180,160,160,160,160,0,820
37311,210,180,120,160,320,0,990
37312,190,80,80,80,160,320,910
37313,220,120,120,160,160,0,780
37314,220,120,40,80,160,0,620
37315,220,100,120,240,320,0,1000
37316,200,160,40,80,160,0,640
37317,210,160,120,80,0,0,570
37318,200,140,200,160,320,320,1340
37319,180,140,120,160,160,0,760
37320,230,160,80,160,160,0,790
37321,160,80,120,80,160,0,600
37322,230,160,80,80,160,0,710
37323,150,80,40,80,0,0,350
37324,230,60,80,80,160,0,610
37325,240,180,120,80,160,0,780
37326,200,100,80,160,0,0,540
37327,200,160,200,80,160,0,800
37328,190,120,40,80,160,0,590
37329,180,140,120,80,160,0,680
37330,210,120,40,0,0,0,370
37331,220,80,40,0,0,0,340
37332,200,140,120,0,0,0,460
37333,180,80,80,0,0,0,340
37334,200,80,80,80,160,0,600
37335,220,100,120,160,0,0,600
37336,220,60,80,80,0,0,440
37337,170,100,120,80,160,0,630
37338,210,140,200,160,160,320,1190
37339,210,160,80,160,0,0,610
37340,170,120,160,80,160,0,690
37341,190,140,120,160,160,0,770
37342,200,180,160,240,160,0,940
37343,160,120,120,0,0,0,400
37344,230,160,200,240,160,0,990
37345,200,120,160,240,0,0,720
37346,220,120,160,240,320,0,1060
37347,180,40,80,160,160,0,620
37348,200,120,120,160,0,0,600
37349,210,180,120,160,160,0,830
37350,190,140,120,160,160,0,770
37351,220,120,80,80,160,0,660
37352,180,120,40,0,0,0,340
37353,210,140,160,0,0,0,510
37354,210,160,160,160,160,0,850
37355,180,140,80,0,0,0,400
37356,140,60,80,0,0,0,280
37357,200,140,160,240,0,0,740
37358,210,160,120,160,0,0,650
37359,160,60,40,80,160,320,820
37360,200,120,40,0,0,0,360
37361,180,80,80,80,160,0,580
37362,200,120,160,240,320,0,1040
37363,210,140,160,160,0,0,670
37364,180,120,40,80,160,320,900
37365,160,120,80,160,320,0,840
37366,180,140,80,80,160,0,640
37367,210,120,120,80,0,0,530
37368,210,120,120,80,0,0,530
37369,220,160,160,160,0,0,700
37370,180,60,0,0,0,0,240
37371,150,100,160,160,160,0,730
37372,180,80,0,0,0,0,260
37373,180,140,120,80,160,0,680
37374,230,140,120,0,0,0,490
37375,250,140,120,160,160,0,830
37376,230,180,160,80,0,0,650
37377,170,80,120,240,320,0,930
37378,220,200,200,240,160,320,1340
37379,210,200,200,80,160,0,850
37380,190,120,160,160,0,0,630
37381,210,160,80,160,0,0,610
37382,180,100,120,160,160,0,720
37383,200,140,120,80,0,0,540
37384,180,100,120,80,160,0,640
37385,200,100,160,80,160,0,700
37386,190,100,120,80,160,0,650
37387,230,120,160,80,0,0,590
37388,180,80,120,160,320,0,860
37389,180,100,80,80,160,0,600
37390,200,180,120,80,0,0,580
37391,210,80,40,80,160,0,570
37392,160,100,120,160,0,0,540
37393,190,140,160,160,160,0,810
37394,170,100,80,80,160,0,590
37395,160,140,120,80,0,0,500
37396,190,140,200,80,0,0,610
37397,200,120,200,0,0,0,520
37398,180,140,80,80,160,320,960
37399,210,100,120,160,320,320,1230
37400,150,80,80,80,0,0,390
37401,210,140,80,80,160,0,670
37402,200,120,120,0,0,0,440
37403,210,140,120,160,160,0,790
37404,210,120,120,80,160,320,1010
37405,200,160,160,80,0,0,600
37406,240,140,160,240,320,0,1100
37407,210,100,120,160,160,0,750
37408,210,120,160,160,160,0,810
37409,170,120,80,80,160,0,610
37410,170,100,160,240,320,0,990
37411,200,120,120,80,0,0,520
37412,210,140,160,80,160,0,750
37413,170,140,160,160,160,0,790
37414,230,160,120,80,0,0,590
37415,190,120,80,80,160,0,630
37416,190,80,40,80,0,0,390
37417,220,180,120,0,0,0,520
37418,210,160,120,80,160,0,730
37419,150,140,120,0,0,0,410
37420,220,140,40,80,160,0,640
37421,200,140,120,160,160,0,780
37422,230,120,160,80,160,0,750
37423,250,140,200,160,0,0,750
37424,210,120,40,80,160,0,610
37425,200,120,120,160,160,0,760
37426,230,140,120,160,320,0,970
37427,190,60,80,160,320,0,810
37428,230,200,200,160,160,320,1270
37429,190,140,200,160,160,320,1170
37430,210,160,80,160,320,0,930
37431,200,120,80,0,0,0,400
37432,200,100,160,240,0,0,700
37433,200,40,80,160,160,320,960
37434,180,100,120,240,320,320,1280
37435,220,120,160,160,160,0,820
37436,170,140,120,160,160,0,750
37437,170,160,160,80,160,0,730
37438,190,140,80,80,0,0,490
37439,210,180,160,80,160,0,790
37440,160,140,120,160,160,0,740
37441,200,120,120,160,320,0,920
37442,210,80,80,80,160,0,610
37443,180,160,160,240,320,0,1060
37444,240,100,120,160,160,0,780
37445,200,100,80,80,160,0,620
37446,180,120,160,160,160,0,780
37447,210,120,120,160,320,0,930
37448,180,120,120,80,0,0,500
37449,210,140,160,80,0,0,590
37450,190,140,160,160,160,0,810
37451,170,160,40,80,160,320,930
37452,190,100,120,80,0,0,490
37453,150,80,80,0,0,0,310
37454,200,120,40,0,0,0,360
37455,190,120,40,80,160,0,590
37456,200,100,120,0,0,0,420
37457,170,120,120,160,0,0,570
37458,220,140,40,80,0,0,480
37459,200,120,80,0,0,0,400
37460,220,180,120,240,160,0,920
37461,210,140,160,240,160,0,910
37462,200,160,120,80,160,320,1040
37463,190,140,120,160,320,0,930
37464,190,140,160,80,160,0,730
37465,200,100,40,0,0,0,340
37466,190,180,120,160,0,0,650
37467,180,100,120,80,0,0,480
37468,160,140,80,80,160,0,620
37469,200,140,160,80,0,0,580
37470,210,120,80,80,160,320,970
37471,190,100,120,80,0,0,490
37472,180,140,40,80,0,0,440
37473,170,120,120,240,160,0,810
37474,180,120,120,160,0,0,580
37475,150,100,0,0,0,0,250
37476,220,80,80,160,160,0,700
37477,180,120,80,160,320,0,860
37478,240,120,80,0,0,0,440
37479,160,100,120,160,160,0,700
37480,210,180,160,80,0,0,630
37481,200,120,80,80,0,0,480
37482,220,180,120,0,0,0,520
37483,230,140,40,0,0,0,410
37484,190,160,80,80,160,320,990
37485,200,60,40,80,0,0,380
37486,240,120,120,80,160,0,720
37487,170,100,80,80,0,0,430
37488,170,160,120,240,320,0,1010
37489,190,120,160,240,160,320,1190
37490,230,120,160,160,160,0,830
37491,210,140,120,0,0,0,470
37492,200,20,40,0,0,0,260
37493,200,140,120,160,320,320,1260
37494,170,100,120,160,160,0,710
37495,200,100,160,80,160,0,700
37496,190,120,120,80,0,0,510
37497,190,100,160,0,0,0,450
37498,180,80,120,160,160,0,700
37499,200,140,160,240,320,0,1060
37500,220,140,160,80,160,0,760
37501,200,140,200,160,160,0,860
37502,170,120,80,80,160,0,610
37503,180,120,80,80,160,0,620
37504,190,100,80,160,0,0,530
37505,250,180,80,80,160,0,750
37506,200,120,80,0,0,0,400
37507,200,140,120,0,0,0,460
37508,160,140,80,80,0,0,460
37509,210,120,120,80,0,0,530
37510,180,120,40,0,0,0,340
37511,210,140,160,160,160,320,1150
37512,240,140,120,80,160,0,740
37513,200,100,80,80,0,0,460
37514,170,140,200,160,160,0,830
37515,230,160,200,80,160,0,830
37516,210,120,80,160,160,320,1050
37517,180,120,160,160,160,0,780
37518,240,120,160,80,0,0,600
37519,220,140,120,160,320,0,960
37520,160,80,80,0,0,0,320
37521,170,120,40,0,0,0,330
37522,210,160,120,80,160,0,730
37523,180,80,120,160,0,0,540
37524,190,160,160,160,320,0,990
37525,180,60,40,0,0,0,280
37526,220,120,40,80,160,0,620
37527,220,120,80,0,0,0,420
37528,220,140,120,160,320,320,1280
37529,210,160,120,80,160,0,730
37530,170,80,80,160,160,320,970
37531,170,100,120,0,0,0,390
37532,200,100,40,80,160,0,580
37533,170,100,120,80,0,0,470
37534,170,80,80,80,160,0,570
37535,240,100,80,80,0,0,500
37536,180,160,160,160,0,0,660
37537,240,100,80,80,160,0,660
37538,180,100,80,160,160,0,680
37539,180,120,120,160,160,320,1060
37540,170,100,80,80,160,0,590
37541,210,160,80,0,0,0,450
37542,180,100,0,0,0,0,280
37543,210,120,80,0,0,0,410
37544,210,180,160,80,0,0,630
37545,210,160,120,160,320,0,970
37546,170,100,80,160,160,320,990
37547,230,100,80,160,160,0,730
37548,240,180,80,80,160,0,740
37549,190,60,0,0,0,0,250
37550,200,140,160,0,0,0,500
37551,210,100,160,160,160,0,790
37552,200,120,160,160,0,0,640
37553,180,80,80,0,0,0,340
37554,200,160,120,80,0,0,560
37555,210,140,160,0,0,0,510
37556,150,100,120,80,160,0,610
37557,200,140,200,160,0,0,700
37558,200,120,120,80,160,0,680
37559,170,80,80,0,0,0,330
37560,250,160,120,160,160,0,850
37561,180,80,80,80,160,0,580
37562,160,100,120,160,320,0,860
37563,210,200,160,240,160,0,970
37564,170,80,120,0,0,0,370
37565,240,180,120,80,160,0,780
37566,190,100,80,0,0,0,370
37567,210,120,120,160,0,0,610
37568,220,40,80,80,160,0,580
37569,190,140,120,80,160,0,690
37570,190,80,0,0,0,0,270
37571,220,120,80,160,0,0,580
37572,190,120,40,80,0,0,430
37573,220,180,240,240,320,320,1520
37574,220,120,200,160,160,0,860
37575,190,140,160,160,320,0,970
37576,190,80,120,240,160,0,790
37577,190,100,40,80,0,0,410
37578,130,100,120,80,160,320,910
37579,210,140,120,240,160,320,1190
37580,180,160,120,160,160,320,1100
37581,170,60,80,80,0,0,390
37582,200,160,120,0,0,0,480
37583,200,120,120,80,160,0,680
37584,190,120,120,80,160,0,670
37585,210,100,80,80,0,0,470
37586,180,80,120,240,320,0,940
37587,170,140,80,0,0,0,390
37588,200,160,160,160,160,0,840
37589,180,120,80,80,0,0,460
37590,190,120,120,160,160,0,750
37591,230,220,200,240,320,0,1210
37592,180,60,80,80,160,0,560
37593,170,100,120,160,320,320,1190
37594,170,120,200,160,0,0,650
37595,180,140,200,160,160,0,840
37596,170,140,120,80,0,0,510
37597,160,120,80,160,160,0,680
37598,180,80,0,0,0,0,260
37599,170,100,120,80,160,0,630
37600,190,140,120,80,160,0,690
37601,180,60,80,80,160,0,560
37602,160,100,80,160,160,0,660
37603,180,100,80,80,0,0,440
37604,180,120,120,80,160,0,660
37605,210,140,80,0,0,0,430
37606,180,80,80,80,0,0,420
37607,130,60,40,80,160,0,470
37608,190,180,120,80,160,320,1050
37609,190,120,200,160,160,0,830
37610,190,120,80,80,0,0,470
37611,200,140,120,80,160,0,700
37612,190,100,40,0,0,0,330
37613,260,160,120,160,320,0,1020
37614,190,80,120,160,0,0,550
37615,250,140,120,80,160,0,750
37616,260,100,40,80,0,0,480
37617,160,120,120,240,320,0,960
37618,230,120,80,80,0,0,510
37619,200,80,120,160,160,0,720
37620,210,100,120,80,0,0,510
37621,210,100,80,80,0,0,470
37622,190,180,240,240,320,0,1170
37623,230,140,120,80,160,0,730
37624,190,140,120,160,160,320,1090
37625,190,140,40,0,0,0,370
37626,180,80,120,160,160,0,700
37627,190,100,80,0,0,0,370
37628,190,160,80,80,160,0,670
37629,160,100,120,160,160,0,700
37630,150,120,160,160,160,0,750
37631,160,80,80,80,0,0,400
37632,180,100,80,160,320,0,840
37633,210,120,80,0,0,0,410
37634,160,80,120,80,160,0,600
37635,190,140,80,0,0,0,410
37636,210,120,200,160,160,0,850
37637,200,140,160,160,0,0,660
37638,230,180,80,0,0,0,490
37639,170,60,80,80,0,0,390
37640,180,80,40,0,0,0,300
37641,190,120,120,240,160,0,830
37642,180,140,120,160,0,0,600
37643,200,100,80,160,0,0,540
37644,210,120,80,0,0,0,410
37645,160,80,40,80,160,0,520
37646,190,140,120,80,0,0,530
37647,230,100,40,0,0,0,370
37648,200,120,120,80,160,320,1000
37649,180,80,80,160,160,0,660
37650,210,80,120,240,320,0,970
37651,170,140,160,160,320,0,950
37652,200,140,120,160,160,0,780
37653,200,60,80,80,0,0,420
37654,210,100,40,80,160,0,590
37655,210,140,120,160,160,0,790
37656,210,120,80,160,0,0,570
37657,230,140,200,160,0,0,730
37658,220,100,80,80,0,0,480
37659,150,80,120,80,160,0,590
37660,170,160,40,80,160,0,610
37661,220,160,240,80,0,0,700
37662,210,160,120,80,0,0,570
37663,210,100,80,0,0,0,390
37664,190,100,120,80,160,320,970
37665,150,100,120,80,160,0,610
37666,160,60,80,0,0,0,300
37667,210,140,80,80,0,0,510
37668,190,120,120,80,0,0,510
37669,230,140,80,80,160,0,690
37670,200,120,120,80,160,320,1000
37671,200,120,120,160,160,0,760
37672,170,120,80,0,0,0,370
37673,190,140,40,80,160,0,610
37674,240,160,160,160,160,0,880
37675,200,140,120,80,160,0,700
37676,190,120,160,160,0,0,630
37677,190,140,160,80,160,0,730
37678,210,180,160,160,320,0,1030
37679,180,100,120,0,0,0,400
37680,190,100,160,160,320,0,930
37681,180,140,120,80,0,0,520
37682,170,140,40,80,160,320,910
37683,200,160,120,80,0,0,560
37684,220,120,80,80,0,0,500
37685,220,100,40,0,0,0,360
37686,200,80,40,0,0,0,320
37687,210,100,80,80,0,0,470
37688,220,180,160,80,160,320,1120
37689,180,100,40,80,0,0,400
37690,210,100,40,0,0,0,350
37691,210,80,120,80,0,0,490
37692,200,120,120,80,160,320,1000
37693,180,160,120,160,160,0,780
37694,190,200,160,80,160,0,790
37695,200,160,80,80,160,320,1000
37696,190,120,80,80,160,320,950
37697,210,140,120,80,160,0,710
37698,230,160,40,0,0,0,430
37699,180,60,40,0,0,0,280
37700,150,80,120,160,160,0,670
37701,190,180,160,80,0,0,610
37702,220,140,200,240,160,0,960
37703,190,140,80,160,160,0,730
37704,200,160,200,160,160,320,1200
37705,190,140,160,80,0,0,570
37706,180,100,40,80,160,0,560
37707,170,140,200,80,0,0,590
37708,240,140,120,80,160,0,740
37709,190,100,120,80,160,0,650
37710,200,140,160,0,0,0,500
37711,220,140,160,160,320,0,1000
37712,190,140,200,160,0,0,690
37713,180,60,40,80,0,0,360
37714,220,100,120,160,0,0,600
37715,170,100,80,0,0,0,350
37716,200,100,160,160,160,0,780
37717,180,120,40,80,160,0,580
37718,170,120,120,80,160,0,650
37719,190,140,120,80,160,0,690
37720,200,140,160,160,160,320,1140
37721,170,60,80,80,160,0,550
37722,200,120,80,160,320,0,880
37723,200,80,80,160,160,0,680
37724,210,140,200,160,320,0,1030
37725,210,120,80,80,0,0,490
37726,160,80,80,0,0,0,320
37727,180,100,40,80,160,0,560
37728,200,100,120,160,160,0,740
37729,200,100,40,0,0,0,340
37730,220,100,120,160,320,0,920
37731,200,100,80,80,160,0,620
37732,210,100,80,80,0,0,470
37733,210,180,240,160,160,0,950
37734,210,160,160,240,0,0,770
37735,210,80,160,160,160,0,770
37736,190,180,160,240,320,320,1410
37737,190,140,160,80,0,0,570
37738,200,100,120,80,160,0,660
37739,190,120,120,80,160,0,670
37740,220,140,160,160,160,0,840
37741,140,100,120,80,160,0,600
37742,150,100,160,160,160,320,1050
37743,210,140,120,0,0,0,470
37744,210,180,120,160,0,0,670
37745,190,100,120,160,320,0,890
37746,130,40,40,80,160,0,450
37747,180,180,120,80,0,0,560
37748,180,100,80,160,0,0,520
37749,220,140,120,160,320,320,1280
37750,210,80,80,160,320,320,1170
37751,150,140,80,80,0,0,450
37752,160,100,40,0,0,0,300
37753,230,140,40,80,160,0,650
37754,160,100,120,80,0,0,460
37755,190,120,120,160,0,0,590
37756,210,180,120,0,0,0,510
37757,190,100,120,80,160,320,970
37758,180,140,80,80,160,0,640
37759,220,120,120,160,320,0,940
37760,240,140,120,80,160,0,740
37761,200,120,160,160,160,0,800
37762,170,140,120,240,160,0,830
37763,210,100,120,160,160,0,750
37764,220,120,40,80,160,0,620
37765,200,120,120,0,0,0,440
37766,230,140,160,0,0,0,530
37767,190,160,40,80,160,0,630
37768,180,120,80,80,0,0,460
37769,180,160,120,80,0,0,540
37770,170,160,120,0,0,0,450
37771,160,100,120,160,320,0,860
37772,180,100,120,80,0,0,480
37773,150,100,80,0,0,0,330
37774,200,120,120,80,0,0,520
37775,210,140,160,80,0,0,590
37776,210,160,160,160,0,0,690
37777,220,80,40,0,0,0,340
37778,210,140,200,80,0,0,630
37779,200,100,120,80,0,0,500
37780,170,120,120,0,0,0,410
37781,240,100,40,0,0,0,380
37782,180,160,160,0,0,0,500
37783,220,80,0,0,0,0,300
37784,230,140,120,160,160,0,810
37785,200,100,80,80,160,0,620
37786,230,180,120,80,0,0,610
37787,200,160,160,80,160,0,760
37788,150,140,120,160,320,0,890
37789,180,140,200,80,160,0,760
37790,160,60,80,80,160,0,540
37791,200,140,200,160,160,0,860
37792,200,160,120,80,160,0,720
37793,200,100,80,0,0,0,380
37794,200,140,120,160,160,320,1100
37795,180,120,160,240,320,320,1340
37796,170,60,40,80,0,0,350
37797,210,120,80,80,160,0,650
37798,230,140,160,160,160,0,850
37799,220,120,160,80,0,0,580
37800,190,120,80,80,160,0,630
37801,190,100,80,80,0,0,450
37802,190,180,160,160,0,0,690
37803,200,140,160,240,320,0,1060
37804,190,120,120,160,160,0,750
37805,230,100,80,80,160,0,650
37806,200,100,80,160,160,0,700
37807,210,100,120,0,0,0,430
37808,180,100,80,80,160,0,600
37809,150,80,80,160,320,0,790
37810,190,140,80,0,0,0,410
37811,210,180,120,80,160,0,750
37812,180,100,80,80,0,0,440
37813,190,120,200,160,320,0,990
37814,240,160,160,80,0,0,640
37815,200,140,160,160,320,0,980
37816,170,80,40,80,160,320,850
37817,170,140,80,160,160,320,1030
37818,230,180,200,160,160,0,930
37819,150,160,160,160,320,0,950
37820,160,80,120,160,160,0,680
37821,210,180,160,80,160,0,790
37822,180,60,40,0,0,0,280
37823,220,120,120,160,0,0,620
37824,190,200,160,160,160,0,870
37825,180,80,80,80,160,0,580
37826,230,200,120,80,160,320,1110
37827,140,140,120,80,0,0,480
37828,180,100,80,160,160,320,1000
37829,230,140,120,160,0,0,650
37830,220,120,120,160,320,0,940
37831,190,160,200,80,0,0,630
37832,210,80,80,0,0,0,370
37833,220,200,200,160,160,0,940
37834,210,160,80,80,0,0,530
37835,200,160,240,80,160,0,840
37836,190,120,120,240,160,320,1150
37837,220,120,160,160,160,320,1140
37838,190,60,80,160,320,0,810
37839,190,140,80,0,0,0,410
37840,170,60,80,160,320,0,790
37841,160,100,80,0,0,0,340
37842,130,100,40,0,0,0,270
37843,190,140,120,160,320,0,930
37844,230,120,40,80,160,320,950
37845,180,100,80,80,0,0,440
37846,200,120,80,80,0,0,480
37847,150,120,80,0,0,0,350
37848,170,80,80,80,160,0,570
37849,220,140,40,80,160,320,960
37850,190,120,40,0,0,0,350
37851,170,140,120,80,0,0,510
37852,170,80,120,80,0,0,450
37853,220,200,80,0,0,0,500
37854,190,80,80,80,160,0,590
37855,200,140,120,160,320,0,940
37856,200,80,40,80,0,0,400
37857,190,100,80,160,0,0,530
37858,200,200,80,0,0,0,480
37859,230,120,80,160,320,320,1230
37860,220,100,120,80,160,0,680
37861,230,180,80,80,0,0,570
37862,190,160,160,80,160,0,750
37863,210,100,80,80,160,0,630
37864,200,80,80,0,0,0,360
37865,200,120,0,0,0,0,320
37866,190,60,40,0,0,0,290
37867,230,160,160,80,160,0,790
37868,220,160,120,80,160,0,740
37869,230,100,120,80,160,0,690
37870,180,80,0,0,0,0,260
37871,190,80,80,80,160,0,590
37872,170,100,40,0,0,0,310
37873,180,100,160,240,160,0,840
37874,180,60,40,0,0,0,280
37875,260,100,80,80,0,0,520
37876,220,120,120,0,0,0,460
37877,190,160,160,80,160,0,750
37878,160,160,200,160,320,0,1000
37879,190,100,40,80,0,0,410
37880,130,80,80,0,0,0,290
37881,210,120,40,0,0,0,370
37882,200,80,80,0,0,0,360
37883,220,140,160,240,160,0,920
37884,200,120,200,80,160,0,760
37885,190,140,120,240,320,0,1010
37886,210,160,120,0,0,0,490
37887,250,140,160,160,160,0,870
37888,210,140,160,160,320,0,990
37889,220,120,120,0,0,0,460
37890,220,180,200,160,320,0,1080
37891,160,100,120,240,160,0,780
37892,120,100,160,160,320,320,1180
37893,190,120,120,240,160,0,830
37894,220,140,160,80,0,0,600
37895,210,160,120,160,0,0,650
37896,190,100,40,0,0,0,330
37897,200,120,120,80,160,0,680
37898,240,80,80,80,160,0,640
37899,230,80,80,80,160,0,630
37900,230,120,120,160,320,0,950
37901,240,120,80,160,320,0,920
37902,190,160,160,160,160,0,830
37903,170,200,160,160,0,0,690
37904,180,120,120,160,160,320,1060
37905,230,140,120,80,160,0,730
37906,200,140,160,240,320,0,1060
37907,170,120,160,240,320,0,1010
37908,230,120,80,0,0,0,430
37909,200,100,80,80,160,0,620
37910,220,100,40,0,0,0,360
37911,250,120,0,0,0,0,370
37912,200,160,120,80,0,0,560
37913,180,140,120,160,320,0,920
37914,180,120,80,0,0,0,380
37915,190,120,80,160,0,0,550
37916,190,120,120,160,320,320,1230
37917,200,100,80,160,160,0,700
37918,200,120,120,160,160,0,760
37919,200,120,120,160,0,0,600
37920,180,100,40,0,0,0,320
37921,180,160,120,160,160,0,780
37922,190,140,120,160,320,0,930
37923,210,100,40,80,160,0,590
37924,210,100,80,80,160,320,950
37925,150,100,120,160,160,0,690
37926,190,120,200,240,320,320,1390
37927,220,140,120,80,160,0,720
37928,210,140,120,0,0,0,470
37929,190,140,120,80,160,0,690
37930,180,60,40,0,0,0,280
37931,210,80,80,0,0,0,370
37932,210,120,160,160,160,320,1130
37933,210,160,120,0,0,0,490
37934,150,180,200,160,160,0,850
37935,220,140,160,240,320,320,1400
37936,170,140,120,80,0,0,510
37937,230,100,120,160,0,0,610
37938,180,120,120,240,160,0,820
37939,170,60,40,80,160,0,510
37940,230,60,40,80,160,320,890
37941,190,140,120,160,160,320,1090
37942,210,80,40,0,0,0,330
37943,180,140,120,160,320,320,1240
37944,200,100,160,160,160,0,780
37945,210,140,120,0,0,0,470
37946,180,140,160,240,320,320,1360
37947,220,60,80,0,0,0,360
37948,210,140,120,160,320,0,950
37949,210,100,120,80,0,0,510
37950,220,120,120,160,160,320,1100
37951,190,100,120,160,0,0,570
37952,210,120,80,80,0,0,490
37953,170,120,80,160,160,0,690
37954,190,160,120,240,320,320,1350
37955,160,80,80,160,320,0,800
37956,200,100,120,80,0,0,500
37957,220,160,200,160,160,0,900
37958,160,100,40,80,160,0,540
37959,180,120,80,80,160,0,620
37960,210,120,80,160,160,320,1050
37961,200,120,80,0,0,0,400
37962,230,140,160,160,0,0,690
37963,180,120,120,0,0,0,420
37964,190,80,80,80,160,0,590
37965,200,100,120,160,160,0,740
37966,170,140,120,80,0,0,510
37967,180,100,120,160,160,0,720
37968,230,100,120,80,0,0,530
37969,170,120,80,80,0,0,450
37970,160,100,120,160,0,0,540
37971,200,140,120,80,160,320,1020
37972,170,120,80,80,0,0,450
37973,210,140,160,160,320,0,990
37974,180,120,120,160,0,0,580
37975,200,140,160,240,160,0,900
37976,210,120,120,160,320,0,930
37977,220,120,120,80,160,0,700
37978,180,120,120,160,0,0,580
37979,180,100,120,240,320,0,960
37980,170,100,80,160,320,320,1150
37981,190,100,120,80,160,0,650
37982,230,100,40,0,0,0,370
37983,130,40,80,80,160,0,490
37984,150,100,120,80,160,0,610
37985,220,120,40,0,0,0,380
37986,180,120,120,160,320,0,900
37987,180,80,120,160,160,0,700
37988,180,120,120,160,320,320,1220
37989,200,160,40,80,160,0,640
37990,210,80,120,160,0,0,570
37991,190,140,120,160,320,320,1250
37992,160,160,200,160,320,0,1000
37993,160,120,160,160,0,0,600
37994,200,100,80,0,0,0,380
37995,240,160,160,240,320,0,1120
37996,160,100,120,0,0,0,380
37997,210,100,160,0,0,0,470
37998,210,140,160,160,160,0,830
37999,220,140,160,80,0,0,600
38000,180,60,40,0,0,0,280
38001,200,140,80,80,160,320,980
38002,170,80,40,0,0,0,290
38003,150,60,40,80,160,0,490
38004,190,120,80,160,160,0,710
38005,170,80,80,80,160,0,570
38006,230,220,200,160,160,0,970
38007,200,120,120,160,160,0,760
38008,170,100,160,80,0,0,510
38009,200,160,120,80,0,0,560
38010,220,140,120,0,0,0,480
38011,210,120,80,0,0,0,410
38012,210,120,80,80,160,0,650
38013,180,160,120,80,160,0,700
38014,220,120,40,80,160,320,940
38015,230,40,0,0,0,0,270
38016,180,100,120,240,160,0,800
38017,200,160,120,80,0,0,560
38018,230,120,120,160,320,0,950
38019,200,120,120,80,0,0,520
38020,220,160,120,80,160,0,740
38021,230,140,80,80,160,0,690
38022,150,120,160,80,0,0,510
38023,150,140,160,240,160,320,1170
38024,200,120,160,160,0,0,640
38025,180,120,80,80,160,0,620
38026,180,100,120,240,160,0,800
38027,160,160,120,160,160,320,1080
38028,200,120,80,160,160,0,720
38029,190,140,160,160,0,0,650
38030,220,140,120,80,0,0,560
38031,190,80,80,0,0,0,350
38032,150,100,80,0,0,0,330
38033,180,120,120,160,160,320,1060
38034,210,200,200,80,160,0,850
38035,190,80,120,80,0,0,470
38036,170,80,80,0,0,0,330
38037,200,120,120,160,0,0,600
38038,220,160,120,160,0,0,660
38039,150,140,120,160,0,0,570
38040,240,140,40,0,0,0,420
38041,210,120,80,160,0,0,570
38042,220,120,80,0,0,0,420
38043,150,140,40,80,0,0,410
38044,210,180,80,160,160,0,790
38045,180,180,200,160,160,0,880
38046,190,100,120,160,320,320,1210
38047,200,80,80,160,320,0,840
38048,190,100,120,80,160,0,650
38049,160,180,200,160,0,0,700
38050,170,80,80,80,160,0,570
38051,180,160,160,240,160,0,900
38052,190,160,160,80,0,0,590
38053,190,100,120,160,0,0,570
38054,200,100,120,160,320,0,900
38055,160,100,80,160,320,320,1140
38056,180,140,120,0,0,0,440
38057,190,140,160,80,0,0,570
38058,210,140,200,160,160,0,870
38059,190,120,80,80,160,320,950
38060,210,80,80,80,160,320,930
38061,180,180,160,80,160,320,1080
38062,210,80,80,80,160,320,930
38063,190,120,160,80,160,0,710
38064,180,80,80,80,160,0,580
38065,200,100,120,240,320,0,980
38066,200,140,160,160,160,0,820
38067,200,80,80,160,160,0,680
38068,230,120,40,0,0,0,390
38069,210,140,160,240,320,0,1070
38070,180,140,120,80,160,0,680
38071,230,180,40,0,0,0,450
38072,190,140,80,80,0,0,490
38073,160,100,120,80,0,0,460
38074,210,100,120,160,160,0,750
38075,200,40,40,0,0,0,280
38076,190,60,120,0,0,0,370
38077,190,100,80,0,0,0,370
38078,180,160,120,80,160,320,1020
38079,150,160,0,0,0,0,310
38080,150,100,80,80,160,0,570
38081,180,140,120,160,160,0,760
38082,190,80,40,80,160,320,870
38083,220,120,160,240,320,320,1380
38084,200,100,120,240,160,0,820
38085,210,160,160,160,160,320,1170
38086,240,140,120,0,0,0,500
38087,220,100,80,80,160,0,640
38088,220,140,120,80,160,0,720
38089,200,120,120,80,0,0,520
38090,220,100,120,240,320,0,1000
38091,200,100,40,80,160,320,900
38092,190,120,80,80,160,0,630
38093,140,80,40,80,160,0,500
38094,220,80,80,80,160,0,620
38095,190,120,160,160,160,0,790
38096,210,120,80,160,160,320,1050
38097,180,100,120,160,160,0,720
38098,160,120,120,160,0,0,560
38099,220,160,120,80,160,320,1060
38100,200,160,80,160,160,0,760
38101,220,140,120,80,0,0,560
38102,210,120,120,80,160,0,690
38103,150,80,120,80,0,0,430
38104,180,200,160,160,320,0,1020
38105,240,80,80,160,320,0,880
38106,190,140,120,80,160,0,690
38107,160,40,40,80,160,320,800
38108,230,120,80,80,0,0,510
38109,210,200,160,0,0,0,570
38110,180,140,160,160,320,0,960
38111,180,80,120,160,160,320,1020
38112,150,100,80,80,160,0,570
38113,230,160,160,160,320,320,1350
38114,220,100,80,80,160,0,640
38115,150,60,80,160,320,320,1090
38116,210,100,80,160,0,0,550
38117,250,100,160,0,0,0,510
38118,170,80,80,0,0,0,330
38119,220,140,160,80,160,0,760
38120,250,140,80,80,160,0,710
38121,170,120,120,0,0,0,410
38122,190,100,120,160,320,0,890
38123,200,120,120,80,160,0,680
38124,170,100,160,160,160,0,750
38125,240,140,80,80,160,0,700
38126,160,100,80,80,0,0,420
38127,190,80,80,80,160,0,590
38128,190,100,120,0,0,0,410
38129,190,140,80,80,0,0,490
38130,160,140,200,240,320,320,1380
38131,230,80,80,0,0,0,390
38132,170,100,120,160,320,320,1190
38133,220,140,160,240,160,320,1240
38134,210,140,120,0,0,0,470
38135,210,160,200,160,320,320,1370
38136,190,160,80,80,0,0,510
38137,200,180,120,80,0,0,580
38138,220,80,40,80,0,0,420
38139,170,100,120,0,0,0,390
38140,160,80,80,80,0,0,400
38141,200,100,120,160,0,0,580
38142,230,160,200,80,160,320,1150
38143,190,180,80,80,160,0,690
38144,200,100,120,0,0,0,420
38145,150,100,120,0,0,0,370
38146,190,120,80,160,0,0,550
38147,150,160,80,160,320,0,870
38148,210,120,160,80,0,0,570
38149,190,120,160,240,160,0,870
38150,190,180,160,80,0,0,610
38151,170,40,80,80,160,0,530
38152,210,100,80,0,0,0,390
38153,230,140,160,160,160,0,850
38154,180,140,120,240,160,0,840
38155,210,120,0,0,0,0,330
38156,160,80,40,80,160,320,840
38157,200,120,80,0,0,0,400
38158,160,160,160,240,0,0,720
38159,200,200,160,80,160,0,800
38160,210,140,120,80,160,0,710
38161,180,100,120,160,160,0,720
38162,170,120,200,240,160,0,890
38163,170,100,80,80,160,0,590
38164,150,100,80,160,160,0,650
38165,250,120,80,0,0,0,450
38166,200,80,80,80,160,0,600
38167,220,140,120,240,320,0,1040
38168,230,160,80,0,0,0,470
38169,190,100,40,80,160,320,890
38170,180,40,80,0,0,0,300
38171,220,140,80,80,0,0,520
38172,170,140,80,0,0,0,390
38173,210,160,120,0,0,0,490
38174,190,140,80,160,160,0,730
38175,150,40,80,80,160,0,510
38176,200,100,80,80,0,0,460
38177,200,100,80,160,160,0,700
38178,180,20,40,0,0,0,240
38179,160,120,40,80,160,0,560
38180,190,80,40,0,0,0,310
38181,170,60,80,0,0,0,310
38182,250,100,80,160,160,320,1070
38183,170,100,40,0,0,0,310
38184,150,80,80,160,320,0,790
38185,200,100,80,80,160,320,940
38186,240,180,120,160,160,0,860
38187,230,100,40,0,0,0,370
38188,170,120,120,80,160,0,650
38189,210,120,200,240,160,0,930
38190,180,60,80,80,160,320,880
38191,150,120,120,160,160,0,710
38192,200,120,160,160,160,0,800
38193,210,60,0,0,0,0,270
38194,170,100,120,80,160,0,630
38195,230,120,80,80,160,0,670
38196,220,140,0,0,0,0,360
38197,180,160,160,80,0,0,580
38198,230,160,160,0,0,0,550
38199,220,120,160,80,0,0,580
38200,210,120,120,80,0,0,530
38201,150,120,120,80,0,0,470
38202,220,160,120,80,160,0,740
38203,160,120,80,80,160,0,600
38204,140,120,120,80,160,0,620
38205,200,40,80,80,0,0,400
38206,220,140,120,80,160,0,720
38207,190,120,160,240,160,0,870
38208,180,140,120,160,320,0,920
38209,180,80,80,80,0,0,420
38210,230,120,160,160,320,0,990
38211,190,160,160,80,160,0,750
38212,230,140,80,80,160,0,690
38213,220,220,160,160,160,0,920
38214,250,140,160,240,160,320,1270
38215,210,160,160,80,160,320,1090
38216,190,140,160,160,320,320,1290
38217,130,100,80,80,0,0,390
38218,200,160,160,160,0,0,680
38219,190,100,80,80,160,0,610
38220,180,140,160,160,0,0,640
38221,220,140,40,0,0,0,400
38222,180,100,160,80,160,0,680
38223,160,100,40,80,160,0,540
38224,230,200,160,240,160,0,990
38225,190,120,40,0,0,0,350
38226,210,160,160,160,0,0,690
38227,200,120,80,80,160,320,960
38228,200,140,80,80,0,0,500
38229,220,140,120,0,0,0,480
38230,180,120,120,80,160,0,660
38231,230,160,80,160,160,0,790
38232,180,120,40,80,0,0,420
38233,210,140,160,160,0,0,670
38234,210,120,80,160,160,0,730
38235,190,120,120,160,160,0,750
38236,180,100,80,0,0,0,360
38237,170,120,120,160,320,0,890
38238,200,120,40,0,0,0,360
38239,190,120,120,80,0,0,510
38240,180,140,80,80,0,0,480
38241,230,180,80,80,160,0,730
38242,160,140,160,160,0,0,620
38243,200,120,120,160,160,0,760
38244,170,120,120,80,160,320,970
38245,220,100,120,160,160,0,760
38246,190,160,80,0,0,0,430
38247,150,80,0,0,0,0,230
38248,190,140,80,160,0,0,570
38249,220,180,160,240,0,0,800
38250,220,160,160,80,160,320,1100
38251,180,140,40,0,0,0,360
38252,210,120,40,0,0,0,370
38253,180,160,120,160,0,0,620
38254,210,80,160,160,0,0,610
38255,180,120,0,0,0,0,300
38256,220,140,200,160,160,0,880
38257,190,80,120,80,0,0,470
38258,170,160,80,80,0,0,490
38259,220,140,120,80,0,0,560
38260,210,120,160,160,160,0,810
38261,210,120,120,0,0,0,450
38262,190,100,80,80,160,0,610
38263,210,140,120,80,0,0,550
38264,180,160,160,160,160,0,820
38265,170,100,120,80,0,0,470
38266,200,100,40,80,160,320,900
38267,170,180,120,80,0,0,550
38268,240,140,80,160,0,0,620
38269,220,120,80,0,0,0,420
38270,160,100,40,80,160,0,540
38271,170,120,120,160,0,0,570
38272,250,200,160,80,160,320,1170
38273,180,100,80,80,160,0,600
38274,150,100,160,160,160,320,1050
38275,200,100,120,80,0,0,500
38276,180,80,40,0,0,0,300
38277,190,80,40,80,160,0,550
38278,190,120,160,240,320,0,1030
38279,160,100,80,0,0,0,340
38280,200,160,80,80,0,0,520
38281,220,140,80,80,160,0,680
38282,170,100,80,80,160,0,590
38283,200,100,80,80,160,0,620
38284,220,160,120,160,320,320,1300
38285,160,100,120,160,160,320,1020
38286,190,140,40,80,160,320,930
38287,190,60,80,0,0,0,330
38288,200,180,160,240,320,320,1420
38289,200,100,120,0,0,0,420
38290,200,140,80,80,0,0,500
38291,220,120,80,80,160,0,660
38292,180,160,120,80,0,0,540
38293,230,100,120,80,160,320,1010
38294,220,160,160,160,0,0,700
38295,220,180,120,160,320,0,1000
38296,190,100,120,0,0,0,410
38297,220,120,160,0,0,0,500
38298,200,140,40,0,0,0,380
38299,190,140,200,160,160,0,850
38300,190,120,160,80,0,0,550
38301,240,140,120,80,0,0,580
38302,230,160,40,80,0,0,510
38303,210,80,40,80,160,320,890
38304,180,100,160,240,160,0,840
38305,180,80,80,80,160,0,580
38306,200,160,160,80,0,0,600
38307,160,120,120,0,0,0,400
38308,210,60,80,0,0,0,350
38309,210,200,200,80,160,0,850
38310,170,80,0,0,0,0,250
38311,140,100,40,0,0,0,280
38312,190,120,120,80,160,0,670
38313,190,100,40,0,0,0,330
38314,190,100,120,160,320,320,1210
38315,190,140,80,160,0,0,570
38316,200,120,120,240,320,320,1320
38317,230,180,120,80,0,0,610
38318,140,140,80,80,160,0,600
38319,200,120,120,80,0,0,520
38320,250,140,80,80,160,0,710
38321,210,160,160,160,0,0,690
38322,210,160,80,0,0,0,450
38323,180,160,40,0,0,0,380
38324,180,80,80,160,160,0,660
38325,190,100,80,80,160,0,610
38326,200,120,80,80,160,0,640
38327,190,140,80,160,320,0,890
38328,190,80,40,0,0,0,310
38329,220,60,0,0,0,0,280
38330,170,180,80,160,320,320,1230
38331,210,120,80,80,160,320,970
38332,190,80,120,160,320,320,1190
38333,170,160,160,80,0,0,570
38334,160,140,160,80,0,0,540
38335,250,100,80,160,160,0,750
38336,220,140,160,240,0,0,760
38337,220,140,160,0,0,0,520
38338,210,100,80,80,160,0,630
38339,150,180,120,80,160,320,1010
38340,250,180,80,0,0,0,510
38341,160,100,120,80,0,0,460
38342,200,120,120,160,320,0,920
38343,230,200,160,160,160,0,910
38344,200,100,160,240,320,0,1020
38345,210,80,80,0,0,0,370
38346,200,140,160,80,0,0,580
38347,230,120,120,160,160,0,790
38348,160,140,160,80,160,0,700
38349,190,120,120,80,0,0,510
38350,200,120,160,240,320,0,1040
38351,200,100,160,160,0,0,620
38352,220,140,80,160,160,0,760
38353,190,120,120,160,0,0,590
38354,160,80,40,80,160,0,520
38355,210,100,120,0,0,0,430
38356,220,200,120,240,160,0,940
38357,170,160,200,80,160,320,1090
38358,170,100,80,80,160,0,590
38359,180,100,40,0,0,0,320
38360,150,160,200,80,160,0,750
38361,170,140,120,160,0,0,590
38362,170,100,120,160,320,0,870
38363,220,120,80,160,160,320,1060
38364,190,180,200,0,0,0,570
38365,220,180,160,160,160,320,1200
38366,210,180,120,160,160,0,830
38367,200,140,120,160,160,0,780
38368,180,80,0,0,0,0,260
38369,180,120,120,80,160,0,660
38370,160,60,40,80,0,0,340
38371,220,140,160,80,160,0,760
38372,170,100,40,80,0,0,390
38373,240,100,40,80,160,0,620
38374,200,120,120,80,160,0,680
38375,170,160,160,80,0,0,570
38376,150,140,200,240,160,0,890
38377,200,100,80,160,0,0,540
38378,160,120,160,80,0,0,520
38379,160,100,120,160,320,0,860
38380,210,120,160,160,0,0,650
38381,210,100,160,80,160,0,710
38382,160,120,80,80,160,320,920
38383,160,140,160,80,160,320,1020
38384,220,100,80,80,0,0,480
38385,210,80,80,0,0,0,370
38386,200,120,80,80,160,0,640
38387,180,80,80,0,0,0,340
38388,170,80,0,0,0,0,250
38389,240,100,120,240,160,0,860
38390,180,120,80,160,0,0,540
38391,210,120,120,0,0,0,450
38392,150,140,120,0,0,0,410
38393,210,160,120,160,0,0,650
38394,220,160,160,80,160,0,780
38395,190,160,200,80,160,0,790
38396,210,120,40,0,0,0,370
38397,200,160,160,80,0,0,600
38398,170,100,40,80,160,0,550
38399,210,180,160,160,160,0,870
38400,170,100,120,0,0,0,390
38401,230,80,80,80,160,0,630
38402,200,180,120,240,160,0,900
38403,190,140,160,80,0,0,570
38404,210,140,200,80,160,0,790
38405,210,80,120,160,320,0,890
38406,250,140,200,240,320,0,1150
38407,210,120,120,240,160,0,850
38408,150,100,120,80,160,0,610
38409,210,160,120,240,160,320,1210
38410,160,80,80,0,0,0,320
38411,170,120,160,240,160,0,850
38412,220,160,120,80,160,320,1060
38413,200,80,120,80,0,0,480
38414,230,180,200,240,160,0,1010
38415,200,80,80,80,160,320,920
38416,240,160,120,80,160,320,1080
38417,240,160,120,160,160,0,840
38418,200,140,80,80,160,0,660
38419,170,160,160,80,160,0,730
38420,220,120,80,80,0,0,500
38421,180,120,40,0,0,0,340
38422,200,140,120,160,0,0,620
38423,200,100,120,80,160,0,660
38424,160,80,40,80,160,0,520
38425,200,160,200,80,160,0,800
38426,230,120,120,80,160,0,710
38427,180,100,120,80,160,0,640
38428,190,80,80,80,0,0,430
38429,180,80,80,80,0,0,420
38430,200,120,160,80,160,0,720
38431,190,140,120,80,0,0,530
38432,210,120,80,160,160,0,730
38433,140,100,120,80,160,0,600
38434,180,140,120,160,320,320,1240
38435,200,140,80,80,160,0,660
38436,220,120,160,160,0,0,660
38437,190,200,160,160,160,0,870
38438,230,180,120,160,160,0,850
38439,210,160,120,0,0,0,490
38440,250,100,120,80,160,0,710
38441,220,100,80,80,0,0,480
38442,240,140,120,0,0,0,500
38443,180,80,120,80,160,0,620
38444,150,100,40,80,160,0,530
38445,210,200,240,160,160,0,970
38446,220,120,40,80,160,0,620
38447,160,100,40,0,0,0,300
38448,200,100,120,80,0,0,500
38449,200,140,120,240,160,0,860
38450,200,140,120,80,160,0,700
38451,180,180,120,80,160,0,720
38452,220,120,80,80,0,0,500
38453,250,100,120,160,320,320,1270
38454,160,100,120,80,160,0,620
38455,160,80,40,0,0,0,280
38456,220,160,160,80,0,0,620
38457,190,100,40,0,0,0,330
38458,170,120,120,80,0,0,490
38459,220,160,160,240,320,320,1420
38460,230,140,120,160,160,0,810
38461,200,120,160,160,160,0,800
38462,160,100,120,160,0,0,540
38463,160,100,120,160,160,0,700
38464,230,80,80,160,160,0,710
38465,190,100,120,80,160,0,650
38466,180,80,80,80,0,0,420
38467,220,160,160,160,160,320,1180
38468,160,120,160,80,0,0,520
38469,160,100,160,240,320,0,980
38470,180,40,80,80,160,0,540
38471,210,140,160,0,0,0,510
38472,190,80,80,80,160,0,590
38473,190,100,80,80,0,0,450
38474,200,120,160,240,320,320,1360
38475,250,140,120,160,160,0,830
38476,180,100,120,80,160,0,640
38477,180,160,160,160,160,320,1140
38478,250,160,40,0,0,0,450
38479,160,120,0,0,0,0,280
38480,170,100,120,0,0,0,390
38481,150,100,80,0,0,0,330
38482,200,160,40,80,160,0,640
38483,190,100,80,160,320,0,850
38484,230,120,120,80,160,0,710
38485,180,120,80,80,0,0,460
38486,270,140,120,80,160,0,770
38487,200,80,120,160,320,320,1200
38488,180,80,80,80,0,0,420
38489,150,120,40,80,160,0,550
38490,220,140,200,240,160,0,960
38491,210,180,40,80,0,0,510
38492,230,120,120,0,0,0,470
38493,210,140,160,80,160,0,750
38494,190,100,80,80,160,320,930
38495,170,120,80,0,0,0,370
38496,190,180,120,80,160,0,730
38497,200,120,80,160,160,0,720
38498,240,100,80,160,320,320,1220
38499,170,100,80,80,0,0,430
38500,200,120,80,160,160,0,720
38501,180,80,120,160,160,0,700
38502,140,120,120,80,160,0,620
38503,200,120,80,0,0,0,400
38504,210,140,160,240,160,0,910
38505,220,120,80,0,0,0,420
38506,220,80,80,80,160,0,620
38507,160,100,40,0,0,0,300
38508,200,120,120,80,0,0,520
38509,180,160,80,0,0,0,420
38510,220,100,80,0,0,0,400
38511,190,100,80,80,0,0,450
38512,240,100,120,0,0,0,460
38513,210,200,160,160,0,0,730
38514,210,120,80,80,0,0,490
38515,190,140,160,240,320,0,1050
38516,220,100,120,80,160,0,680
38517,230,120,80,80,0,0,510
38518,230,160,80,160,160,0,790
38519,170,100,0,0,0,0,270
38520,200,160,120,80,0,0,560
38521,210,120,40,80,0,0,450
38522,190,120,120,160,160,0,750
38523,190,120,80,80,0,0,470
38524,200,160,120,80,0,0,560
38525,140,120,40,0,0,0,300
38526,190,140,120,80,160,0,690
38527,190,100,80,0,0,0,370
38528,180,80,40,0,0,0,300
38529,190,80,80,0,0,0,350
38530,200,80,120,160,0,0,560
38531,190,60,40,80,0,0,370
38532,180,80,80,80,160,0,580
38533,220,160,120,80,0,0,580
38534,220,80,80,80,160,0,620
38535,180,180,200,240,160,0,960
38536,190,140,160,80,0,0,570
38537,230,100,0,0,0,0,330
38538,180,80,80,80,160,0,580
38539,180,140,120,80,0,0,520
38540,190,140,160,80,160,0,730
38541,190,120,80,80,160,0,630
38542,260,140,40,80,0,0,520
38543,210,60,40,80,0,0,390
38544,180,100,0,0,0,0,280
38545,200,120,80,0,0,0,400
38546,240,160,120,80,160,0,760
38547,160,80,40,80,160,0,520
38548,150,120,120,80,160,0,630
38549,170,140,120,80,0,0,510
38550,220,140,80,160,320,0,920
38551,180,140,120,160,320,320,1240
38552,190,120,120,0,0,0,430
38553,160,100,80,80,0,0,420
38554,200,120,120,80,160,0,680
38555,200,140,80,80,160,320,980
38556,210,60,0,0,0,0,270
38557,190,140,120,80,0,0,530
38558,160,100,160,160,320,320,1220
38559,230,120,80,160,160,320,1070
38560,210,180,200,240,0,0,830
38561,220,160,160,160,160,0,860
38562,170,120,40,0,0,0,330
38563,170,100,160,240,320,0,990
38564,230,80,120,160,160,320,1070
38565,180,120,200,240,160,0,900
38566,230,140,40,0,0,0,410
38567,220,160,80,80,0,0,540
38568,220,100,80,160,160,320,1040
38569,190,80,80,160,320,320,1150
38570,190,120,80,160,160,0,710
38571,180,100,160,160,320,320,1240
38572,170,100,80,80,160,0,590
38573,200,140,160,80,160,0,740
38574,170,100,0,0,0,0,270
38575,190,100,120,240,320,0,970
38576,200,160,200,160,160,0,880
38577,160,120,120,80,160,0,640
38578,180,200,80,80,160,320,1020
38579,210,160,120,160,0,0,650
38580,160,120,160,160,160,320,1080
38581,210,80,80,80,160,320,930
38582,200,140,80,160,0,0,580
38583,180,80,0,0,0,0,260
38584,220,120,80,80,160,320,980
38585,190,100,80,80,160,0,610
38586,160,80,40,80,160,0,520
38587,190,80,40,0,0,0,310
38588,170,100,40,0,0,0,310
38589,200,80,80,80,160,0,600
38590,180,120,40,0,0,0,340
38591,190,120,120,80,0,0,510
38592,190,40,0,0,0,0,230
38593,240,160,40,0,0,0,440
38594,180,120,0,0,0,0,300
38595,220,120,40,0,0,0,380
38596,210,140,160,160,160,0,830
38597,180,120,120,160,160,0,740
38598,190,100,120,160,160,320,1050
38599,170,140,120,160,320,320,1230
38600,170,80,120,0,0,0,370
38601,210,100,80,160,160,0,710
38602,200,200,160,160,0,0,720
38603,210,100,120,160,320,320,1230
38604,220,120,120,80,160,0,700
38605,250,120,160,240,320,0,1090
38606,180,100,80,0,0,0,360
38607,200,100,80,0,0,0,380
38608,190,160,120,80,160,0,710
38609,180,160,120,80,160,0,700
38610,190,140,160,80,160,0,730
38611,220,120,40,80,160,0,620
38612,160,160,160,160,160,0,800
38613,220,100,80,80,160,320,960
38614,220,120,80,80,160,0,660
38615,230,140,40,80,0,0,490
38616,200,140,120,160,160,320,1100
38617,190,100,0,0,0,0,290
38618,200,120,80,80,160,0,640
38619,210,140,160,0,0,0,510
38620,200,120,120,160,160,0,760
38621,200,140,40,80,160,320,940
38622,170,160,80,80,0,0,490
38623,160,160,160,80,160,0,720
38624,230,160,160,160,320,320,1350
38625,170,120,160,80,0,0,530
38626,220,140,40,80,160,0,640
38627,200,160,80,160,0,0,600
38628,180,100,80,0,0,0,360
38629,250,100,40,0,0,0,390
38630,190,120,120,160,0,0,590
38631,210,140,80,160,160,0,750
38632,240,140,120,80,160,0,740
38633,220,120,160,80,0,0,580
38634,220,160,120,80,160,0,740
38635,200,100,80,160,0,0,540
38636,180,140,80,80,160,0,640
38637,230,100,200,80,0,0,610
38638,210,120,40,0,0,0,370
38639,210,160,120,160,0,0,650
38640,220,100,160,240,160,0,880
38641,160,80,80,80,160,320,880
38642,210,160,120,0,0,0,490
38643,170,120,160,160,160,0,770
38644,190,140,200,160,160,0,850
38645,200,200,80,160,160,0,800
38646,220,60,40,0,0,0,320
38647,240,140,160,80,0,0,620
38648,230,120,160,160,160,0,830
38649,160,100,80,160,320,0,820
38650,200,120,80,80,0,0,480
38651,190,140,160,160,0,0,650
38652,220,120,80,80,160,0,660
38653,180,80,0,0,0,0,260
38654,210,120,120,240,320,320,1330
38655,190,120,80,80,160,320,950
38656,220,140,120,80,0,0,560
38657,170,140,160,160,0,0,630
38658,200,140,200,160,0,0,700
38659,140,100,80,0,0,0,320
38660,200,100,80,80,160,0,620
38661,200,120,120,80,160,0,680
38662,200,140,200,160,0,0,700
38663,200,60,120,0,0,0,380
38664,230,140,80,80,160,0,690
38665,240,140,120,80,0,0,580
38666,190,120,160,160,0,0,630
38667,190,80,120,160,320,0,870
38668,270,160,120,240,320,0,1110
38669,170,120,80,80,0,0,450
38670,230,200,40,80,160,0,710
38671,160,140,120,160,320,320,1220
38672,140,100,120,160,0,0,520
38673,150,60,40,80,160,0,490
38674,210,120,80,0,0,0,410
38675,200,100,120,80,0,0,500
38676,190,100,120,240,160,0,810
38677,210,140,120,80,160,0,710
38678,190,140,120,80,160,0,690
38679,250,100,80,80,160,0,670
38680,200,140,120,80,160,0,700
38681,220,160,120,80,160,0,740
38682,160,120,80,80,0,0,440
38683,200,80,80,80,0,0,440
38684,190,140,120,160,0,0,610
38685,200,140,80,80,160,0,660
38686,180,100,160,80,0,0,520
38687,180,160,80,160,320,0,900
38688,190,140,160,80,160,0,730
38689,200,80,0,0,0,0,280
38690,190,160,160,80,0,0,590
38691,200,180,160,80,0,0,620
38692,190,140,160,160,0,0,650
38693,200,160,120,160,0,0,640
38694,190,100,120,160,320,320,1210
38695,200,140,120,160,160,0,780
38696,180,40,80,80,0,0,380
38697,210,140,160,0,0,0,510
38698,260,140,160,160,320,0,1040
38699,200,120,120,160,160,0,760
38700,200,140,120,80,160,320,1020
38701,190,120,120,80,160,0,670
38702,170,100,0,0,0,0,270
38703,240,140,80,80,0,0,540
38704,220,160,120,80,160,0,740
38705,230,120,120,160,0,0,630
38706,230,140,120,160,160,0,810
38707,190,100,80,80,160,0,610
38708,210,120,80,80,0,0,490
38709,200,120,120,160,160,0,760
38710,210,60,80,160,320,0,830
38711,220,140,80,0,0,0,440
38712,190,80,120,80,160,0,630
38713,190,100,80,0,0,0,370
38714,190,140,160,80,0,0,570
38715,200,180,160,160,0,0,700
38716,190,160,80,160,0,0,590
38717,200,140,120,80,0,0,540
38718,230,80,80,0,0,0,390
38719,210,100,40,80,0,0,430
38720,210,120,80,80,160,320,970
38721,180,140,80,80,160,0,640
38722,210,160,80,160,0,0,610
38723,180,120,80,80,0,0,460
38724,190,100,40,80,160,0,570
38725,200,160,40,80,160,0,640
38726,210,160,160,240,320,0,1090
38727,200,80,80,0,0,0,360
38728,150,140,160,240,320,320,1330
38729,200,160,160,240,320,0,1080
38730,200,100,120,160,160,0,740
38731,200,140,80,80,0,0,500
38732,220,160,120,240,160,0,900
38733,180,120,160,80,0,0,540
38734,200,100,120,80,160,0,660
38735,200,160,160,160,160,320,1160
38736,170,140,160,240,320,0,1030
38737,200,120,160,80,160,0,720
38738,200,100,120,160,160,0,740
38739,230,60,120,80,160,320,970
38740,200,120,200,160,0,0,680
38741,160,100,120,160,160,0,700
38742,230,180,160,80,0,0,650
38743,170,100,80,80,160,320,910
38744,150,120,120,160,160,0,710
38745,170,160,120,80,160,0,690
38746,180,120,200,160,160,0,820
38747,200,120,120,240,160,0,840
38748,210,140,40,0,0,0,390
38749,220,20,40,80,160,0,520
38750,180,100,120,240,320,0,960
38751,190,120,80,80,160,0,630
38752,140,120,40,80,0,0,380
38753,230,160,120,160,320,320,1310
38754,190,100,120,80,0,0,490
38755,170,80,80,80,160,0,570
38756,210,160,120,160,0,0,650
38757,230,140,40,0,0,0,410
38758,160,120,40,80,0,0,400
38759,200,120,160,0,0,0,480
38760,180,160,120,160,320,0,940
38761,180,100,80,160,320,0,840
38762,170,120,160,160,160,0,770
38763,220,120,80,160,160,0,740
38764,190,100,80,80,160,0,610
38765,210,120,120,80,0,0,530
38766,210,120,80,160,320,320,1210
38767,210,160,40,80,160,0,650
38768,180,120,120,80,0,0,500
38769,170,80,80,160,320,320,1130
38770,210,120,80,0,0,0,410
38771,220,160,120,0,0,0,500
38772,180,120,120,0,0,0,420
38773,190,160,200,240,320,320,1430
38774,160,140,80,160,160,0,700
38775,230,120,160,160,160,0,830
38776,200,120,40,0,0,0,360
38777,200,160,160,80,160,0,760
38778,210,100,80,0,0,0,390
38779,140,160,120,160,160,0,740
38780,230,140,80,160,160,0,770
38781,190,60,40,80,160,0,530
38782,250,100,80,80,160,0,670
38783,190,120,80,160,320,0,870
38784,180,120,120,80,160,0,660
38785,190,100,120,160,160,0,730
38786,190,60,120,240,160,0,770
38787,220,180,120,160,320,0,1000
38788,220,120,120,80,160,0,700
38789,170,100,40,80,0,0,390
38790,170,160,200,160,320,320,1330
38791,180,140,160,240,160,0,880
38792,190,120,80,80,160,0,630
38793,220,140,80,160,160,0,760
38794,180,180,120,80,0,0,560
38795,200,180,160,160,160,0,860
38796,220,120,120,160,160,0,780
38797,180,180,240,160,320,0,1080
38798,230,100,40,80,0,0,450
38799,190,120,160,160,160,320,1110
38800,150,100,120,80,160,0,610
38801,190,120,80,80,160,320,950
38802,210,100,120,80,160,0,670
38803,220,180,200,80,0,0,680
38804,210,160,160,160,320,0,1010
38805,220,100,120,160,0,0,600
38806,190,160,200,160,160,0,870
38807,180,80,40,0,0,0,300
38808,180,100,40,80,160,0,560
38809,190,100,120,160,320,320,1210
38810,180,120,120,80,160,0,660
38811,210,100,80,160,160,0,710
38812,180,220,240,240,160,0,1040
38813,200,100,120,80,160,0,660
38814,200,180,160,80,0,0,620
38815,190,120,80,80,0,0,470
38816,230,160,120,160,160,0,830
38817,210,120,120,160,160,0,770
38818,210,160,160,0,0,0,530
38819,220,180,200,80,160,0,840
38820,200,160,160,160,320,0,1000
38821,200,160,120,0,0,0,480
38822,210,100,120,160,320,320,1230
38823,180,60,120,80,160,0,600
38824,230,140,120,160,160,320,1130
38825,180,160,120,80,160,320,1020
38826,210,120,80,80,0,0,490
38827,160,120,40,80,0,0,400
38828,220,140,160,80,160,0,760
38829,220,100,80,160,160,0,720
38830,200,120,120,240,160,0,840
38831,200,120,120,240,160,0,840
38832,150,60,40,80,160,0,490
38833,210,100,40,0,0,0,350
38834,200,80,120,160,320,0,880
38835,190,120,120,160,160,0,750
38836,200,100,120,80,160,0,660
38837,200,80,80,160,320,320,1160
38838,180,160,120,80,160,0,700
38839,200,100,120,160,320,0,900
38840,180,80,120,160,160,0,700
38841,210,100,120,160,160,0,750
38842,180,140,160,160,0,0,640
38843,180,80,80,0,0,0,340
38844,220,140,120,80,0,0,560
38845,190,100,160,160,0,0,610
38846,220,140,160,80,0,0,600
38847,230,140,80,0,0,0,450
38848,220,160,120,0,0,0,500
38849,200,140,120,160,160,0,780
38850,190,120,80,160,320,320,1190
38851,240,140,120,80,0,0,580
38852,180,140,0,0,0,0,320
38853,190,180,80,80,160,0,690
38854,180,100,80,0,0,0,360
38855,200,100,80,80,0,0,460
38856,170,100,160,160,160,0,750
38857,140,80,40,0,0,0,260
38858,190,120,80,80,160,0,630
38859,190,120,80,80,160,0,630
38860,230,160,160,0,0,0,550
38861,220,120,80,80,160,0,660
38862,210,100,80,160,160,0,710
38863,190,140,40,0,0,0,370
38864,220,120,40,0,0,0,380
38865,250,140,80,80,160,0,710
38866,210,140,120,80,160,0,710
38867,190,80,40,0,0,0,310
38868,190,120,160,160,160,0,790
38869,200,180,120,80,160,0,740
38870,230,100,120,80,160,0,690
38871,190,120,160,80,0,0,550
38872,200,200,160,80,160,0,800
38873,200,120,120,160,0,0,600
38874,200,100,80,80,160,0,620
38875,180,40,40,0,0,0,260
38876,170,160,160,80,160,0,730
38877,210,100,40,0,0,0,350
38878,210,160,160,80,160,320,1090
38879,160,60,80,0,0,0,300
38880,190,160,120,160,160,0,790
38881,170,120,80,80,0,0,450
38882,180,80,80,0,0,0,340
38883,230,80,80,160,160,320,1030
38884,230,140,160,80,160,320,1090
38885,200,200,120,160,160,0,840
38886,260,180,200,80,0,0,720
38887,200,120,120,160,0,0,600
38888,190,80,40,0,0,0,310
38889,150,80,120,80,0,0,430
38890,190,120,120,80,0,0,510
38891,190,120,80,0,0,0,390
38892,190,100,120,80,160,0,650
38893,220,160,200,80,160,0,820
38894,160,160,200,240,160,0,920
38895,210,140,120,80,160,0,710
38896,200,140,80,80,0,0,500
38897,220,160,160,80,160,0,780
38898,200,120,80,80,160,0,640
38899,200,120,120,160,160,0,760
38900,180,100,40,0,0,0,320
38901,190,120,120,80,0,0,510
38902,190,140,200,160,320,320,1330
38903,170,140,120,80,0,0,510
38904,200,120,40,80,0,0,440
38905,170,120,80,80,0,0,450
38906,240,100,80,160,160,0,740
38907,190,120,120,160,320,320,1230
38908,160,140,40,0,0,0,340
38909,190,80,40,0,0,0,310
38910,190,120,120,80,160,0,670
38911,170,120,40,0,0,0,330
38912,190,120,160,160,160,0,790
38913,170,100,80,0,0,0,350
38914,250,180,200,240,160,0,1030
38915,210,100,120,0,0,0,430
38916,190,140,80,160,0,0,570
38917,210,80,160,80,0,0,530
38918,210,80,40,0,0,0,330
38919,240,140,160,80,0,0,620
38920,190,140,160,160,160,0,810
38921,230,140,160,240,0,0,770
38922,150,120,160,80,0,0,510
38923,220,140,160,0,0,0,520
38924,200,160,80,80,160,320,1000
38925,190,100,120,0,0,0,410
38926,210,140,160,80,160,0,750
38927,160,120,160,80,160,320,1000
38928,210,120,120,160,160,0,770
38929,190,120,160,160,160,0,790
38930,220,140,40,0,0,0,400
38931,180,120,40,80,0,0,420
38932,170,120,80,0,0,0,370
38933,220,140,120,80,0,0,560
38934,230,220,120,0,0,0,570
38935,220,120,120,160,160,0,780
38936,210,100,40,80,160,0,590
38937,240,140,200,240,320,0,1140
38938,170,100,80,80,160,320,910
38939,180,120,120,160,160,0,740
38940,240,120,120,160,320,0,960
38941,180,100,80,80,160,0,600
38942,270,140,120,160,160,0,850
38943,190,100,80,80,0,0,450
38944,190,100,80,80,160,0,610
38945,200,140,80,80,0,0,500
38946,210,120,80,80,0,0,490
38947,190,120,80,80,160,0,630
38948,190,140,200,160,0,0,690
38949,220,160,120,80,0,0,580
38950,190,120,80,80,160,0,630
38951,180,60,80,0,0,0,320
38952,190,160,80,160,0,0,590
38953,180,140,80,0,0,0,400
38954,190,80,80,160,160,0,670
38955,210,80,80,0,0,0,370
38956,220,80,40,0,0,0,340
38957,220,160,200,80,0,0,660
38958,220,140,160,160,320,0,1000
38959,230,120,160,80,0,0,590
38960,190,140,160,160,0,0,650
38961,210,180,80,160,320,0,950
38962,190,60,40,0,0,0,290
38963,210,180,160,80,160,320,1110
38964,210,140,40,0,0,0,390
38965,180,160,160,80,160,0,740
38966,200,100,160,240,320,0,1020
38967,230,120,40,0,0,0,390
38968,220,140,120,160,0,0,640
38969,230,140,200,160,0,0,730
38970,240,160,120,160,160,0,840
38971,170,160,120,160,320,0,930
38972,180,120,120,160,160,320,1060
38973,170,140,120,160,0,0,590
38974,220,100,40,80,0,0,440
38975,200,140,160,240,320,0,1060
38976,230,100,40,0,0,0,370
38977,180,140,120,80,160,0,680
38978,170,120,120,80,160,0,650
38979,180,120,120,240,160,0,820
38980,230,100,80,0,0,0,410
38981,160,120,160,80,160,320,1000
38982,230,160,120,240,320,0,1070
38983,180,100,120,80,0,0,480
38984,210,120,80,0,0,0,410
38985,200,100,80,160,0,0,540
38986,190,140,160,160,160,0,810
38987,200,100,120,160,320,320,1220
38988,200,180,80,160,160,320,1100
38989,200,160,120,240,320,0,1040
38990,170,100,80,0,0,0,350
38991,190,140,120,80,0,0,530
38992,200,120,120,0,0,0,440
38993,190,100,120,80,0,0,490
38994,200,180,120,160,320,0,980
38995,200,180,160,80,0,0,620
38996,180,140,120,160,160,0,760
38997,190,140,120,80,160,0,690
38998,220,100,80,80,160,320,960
38999,230,80,120,160,160,0,750
39000,210,120,80,80,160,320,970
39001,210,120,120,160,320,0,930
39002,180,140,240,240,160,0,960
39003,220,100,120,160,160,0,760
39004,170,160,120,0,0,0,450
39005,220,120,80,80,160,0,660
39006,220,160,120,0,0,0,500
39007,160,200,80,80,0,0,520
39008,190,120,120,80,160,0,670
39009,200,140,120,160,320,0,940
39010,200,120,160,0,0,0,480
39011,180,140,200,160,160,320,1160
39012,190,80,40,0,0,0,310
39013,170,100,80,160,0,0,510
39014,190,100,80,0,0,0,370
39015,200,100,80,160,160,0,700
39016,170,140,80,80,160,0,630
39017,210,120,120,160,160,0,770
39018,180,160,120,240,320,0,1020
39019,200,120,200,240,320,320,1400
39020,200,140,120,80,160,0,700
39021,180,160,160,160,320,0,980
39022,170,160,80,80,160,0,650
39023,200,100,120,80,160,0,660
39024,220,120,120,160,160,0,780
39025,190,140,80,0,0,0,410
39026,210,80,80,80,160,320,930
39027,210,160,120,0,0,0,490
39028,180,120,120,80,160,320,980
39029,180,120,80,80,160,0,620
39030,220,120,80,80,0,0,500
39031,220,160,80,0,0,0,460
39032,210,120,80,160,160,0,730
39033,220,120,120,80,0,0,540
39034,200,120,120,80,160,320,1000
39035,190,200,160,160,160,0,870
39036,220,80,80,80,160,0,620
39037,210,140,160,160,160,0,830
39038,190,80,40,80,0,0,390
39039,200,120,80,80,160,0,640
39040,210,80,80,80,0,0,450
39041,200,100,80,80,160,0,620
39042,150,120,120,160,160,0,710
39043,180,80,120,80,0,0,460
39044,210,60,40,80,160,0,550
39045,200,120,80,80,160,320,960
39046,170,80,80,0,0,0,330
39047,220,140,160,80,160,320,1080
39048,180,160,80,80,160,0,660
39049,220,120,80,80,160,320,980
39050,190,80,80,160,160,320,990
39051,220,180,120,80,160,0,760
39052,210,100,40,0,0,0,350
39053,210,100,80,80,0,0,470
39054,200,120,160,160,320,0,960
39055,170,80,120,160,160,0,690
39056,180,140,120,160,320,0,920
39057,170,120,80,160,160,0,690
39058,170,80,80,80,0,0,410
39059,240,140,160,160,160,0,860
39060,200,80,40,0,0,0,320
39061,210,140,160,160,0,0,670
39062,190,120,40,0,0,0,350
39063,160,80,40,80,160,320,840
39064,220,80,40,80,0,0,420
39065,210,200,80,160,160,0,810
39066,180,140,80,0,0,0,400
39067,160,100,80,80,160,0,580
39068,230,160,120,80,160,0,750
39069,220,140,160,160,160,320,1160
39070,190,200,160,80,160,0,790
39071,180,80,80,80,0,0,420
39072,220,160,160,0,0,0,540
39073,180,60,80,160,160,320,960
39074,190,100,80,0,0,0,370
39075,200,100,40,80,160,0,580
39076,130,100,120,160,160,0,670
39077,200,80,120,0,0,0,400
39078,190,120,80,80,160,0,630
39079,210,100,120,240,320,320,1310
39080,220,140,80,0,0,0,440
39081,240,220,120,80,0,0,660
39082,200,140,80,0,0,0,420
39083,190,40,40,0,0,0,270
39084,180,120,120,0,0,0,420
39085,250,140,160,240,320,320,1430
39086,210,100,80,80,0,0,470
39087,240,120,120,80,160,0,720
39088,170,140,80,80,0,0,470
39089,250,140,120,80,0,0,590
39090,200,120,80,80,160,0,640
39091,250,100,40,80,0,0,470
39092,150,120,120,160,0,0,550
39093,210,160,120,80,160,0,730
39094,230,100,80,80,160,0,650
39095,200,100,80,0,0,0,380
39096,220,100,80,80,160,0,640
39097,220,40,40,0,0,0,300
39098,200,80,80,80,160,0,600
39099,210,140,80,80,160,0,670
39100,220,160,80,80,0,0,540
39101,210,80,120,80,0,0,490
39102,190,60,40,80,160,0,530
39103,190,120,120,0,0,0,430
39104,180,100,120,80,160,0,640
39105,190,100,40,80,160,0,570
39106,200,100,120,80,0,0,500
39107,210,120,120,160,160,0,770
39108,160,140,120,80,160,320,980
39109,180,160,80,80,160,320,980
39110,180,140,80,80,160,0,640
39111,220,160,120,160,160,0,820
39112,190,60,80,160,320,0,810
39113,210,100,80,0,0,0,390
39114,190,160,120,160,160,0,790
39115,180,120,40,0,0,0,340
39116,170,40,40,80,160,0,490
39117,200,160,80,80,160,0,680
39118,200,120,80,0,0,0,400
39119,180,120,80,80,160,0,620
39120,180,100,120,80,0,0,480
39121,210,100,40,80,0,0,430
39122,160,80,80,160,320,0,800
39123,170,140,80,80,160,0,630
39124,230,160,120,80,160,320,1070
39125,210,80,80,80,0,0,450
39126,230,120,40,80,160,320,950
39127,190,140,200,240,160,0,930
39128,210,140,160,0,0,0,510
39129,190,120,80,160,160,0,710
39130,190,140,200,240,0,0,770
39131,190,120,40,0,0,0,350
39132,200,120,40,0,0,0,360
39133,160,100,160,160,0,0,580
39134,190,80,80,80,160,0,590
39135,220,180,160,80,0,0,640
39136,230,100,120,160,160,0,770
39137,170,120,120,80,160,0,650
39138,170,100,120,80,160,0,630
39139,210,120,80,0,0,0,410
39140,130,100,40,80,160,0,510
39141,200,100,120,160,160,0,740
39142,200,40,80,80,0,0,400
39143,250,200,240,160,160,0,1010
39144,190,80,80,80,160,0,590
39145,210,100,80,0,0,0,390
39146,210,100,120,160,160,0,750
39147,170,80,40,80,0,0,370
39148,160,60,80,160,160,0,620
39149,200,120,80,80,160,0,640
39150,200,160,120,160,160,0,800
39151,180,140,80,160,0,0,560
39152,220,120,80,0,0,0,420
39153,220,180,160,160,160,0,880
39154,200,160,200,80,0,0,640
39155,220,140,40,80,0,0,480
39156,220,160,40,0,0,0,420
39157,190,120,80,160,320,320,1190
39158,100,60,80,80,160,0,480
39159,240,160,80,80,0,0,560
39160,200,160,160,80,0,0,600
39161,180,120,80,80,0,0,460
39162,200,180,160,80,0,0,620
39163,200,120,160,240,320,320,1360
39164,200,100,120,0,0,0,420
39165,200,120,120,160,160,0,760
39166,160,80,40,0,0,0,280
39167,150,60,80,0,0,0,290
39168,180,180,240,160,160,0,920
39169,210,120,200,240,160,320,1250
39170,180,80,40,80,160,0,540
39171,220,100,80,80,160,0,640
39172,190,120,80,0,0,0,390
39173,230,160,160,240,320,0,1110
39174,180,160,160,160,160,0,820
39175,230,140,40,80,160,0,650
39176,180,120,120,80,160,320,980
39177,160,120,160,160,0,0,600
39178,190,100,160,160,0,0,610
39179,210,140,120,80,160,0,710
39180,170,100,80,160,160,0,670
39181,160,180,80,0,0,0,420
39182,190,140,120,160,320,0,930
39183,180,120,120,80,160,0,660
39184,150,120,160,240,160,0,830
39185,170,120,160,160,320,0,930
39186,190,100,40,0,0,0,330
39187,180,100,80,160,160,0,680
39188,180,160,120,80,160,0,700
39189,160,120,80,80,0,0,440
39190,180,180,120,160,160,0,800
39191,200,140,40,0,0,0,380
39192,230,100,120,80,160,0,690
39193,250,120,120,160,160,320,1130
39194,220,140,160,160,160,0,840
39195,210,120,120,160,160,0,770
39196,200,120,120,80,160,320,1000
39197,200,140,120,80,160,0,700
39198,230,140,120,160,320,320,1290
39199,190,140,40,0,0,0,370
39200,190,80,80,80,160,320,910
39201,170,140,40,0,0,0,350
39202,220,80,0,0,0,0,300
39203,190,80,80,80,0,0,430
39204,210,120,80,0,0,0,410
39205,170,100,160,240,320,320,1310
39206,220,120,160,0,0,0,500
39207,190,120,160,160,160,0,790
39208,190,120,120,0,0,0,430
39209,190,140,120,0,0,0,450
39210,200,160,200,80,160,0,800
39211,190,180,160,80,160,320,1090
39212,170,180,0,0,0,0,350
39213,210,60,120,80,160,0,630
39214,220,140,160,80,0,0,600
39215,190,160,80,0,0,0,430
39216,240,180,160,80,160,320,1140
39217,200,180,200,160,160,0,900
39218,190,120,80,80,0,0,470
39219,220,80,40,80,160,0,580
39220,190,100,120,80,160,320,970
39221,180,60,80,0,0,0,320
39222,220,120,120,0,0,0,460
39223,190,120,240,240,160,0,950
39224,180,160,160,160,160,0,820
39225,180,120,120,0,0,0,420
39226,230,180,80,160,0,0,650
39227,180,100,160,80,160,320,1000
39228,200,100,200,160,160,0,820
39229,210,140,120,160,160,0,790
39230,220,120,120,80,160,0,700
39231,160,100,80,80,0,0,420
39232,210,100,40,0,0,0,350
39233,210,160,200,240,160,0,970
39234,180,120,80,80,0,0,460
39235,230,160,80,160,320,320,1270
39236,160,140,80,80,0,0,460
39237,180,80,120,160,160,0,700
39238,220,140,80,80,0,0,520
39239,190,100,120,160,160,0,730
39240,190,140,80,80,160,0,650
39241,200,120,80,80,160,0,640
39242,190,100,80,80,160,0,610
39243,190,120,40,80,160,0,590
39244,250,140,80,80,160,0,710
39245,190,160,160,0,0,0,510
39246,170,100,80,0,0,0,350
39247,190,180,160,80,0,0,610
39248,210,180,160,80,160,0,790
39249,230,200,120,0,0,0,550
39250,220,120,80,0,0,0,420
39251,170,140,120,160,160,0,750
39252,180,60,80,160,160,0,640
39253,150,160,120,0,0,0,430
39254,190,80,80,160,160,0,670
39255,180,120,80,160,160,0,700
39256,160,160,120,160,320,0,920
39257,210,160,80,80,160,0,690
39258,190,140,160,160,160,0,810
39259,220,100,120,80,0,0,520
39260,150,80,160,80,160,0,630
39261,220,160,120,240,160,0,900
39262,180,80,40,80,160,0,540
39263,190,100,40,80,0,0,410
39264,210,140,80,0,0,0,430
39265,180,100,160,160,320,320,1240
39266,160,80,80,80,0,0,400
39267,190,160,120,0,0,0,470
39268,220,100,40,0,0,0,360
39269,160,140,160,160,160,320,1100
39270,170,80,40,0,0,0,290
39271,190,100,120,160,320,320,1210
39272,200,100,120,160,160,0,740
39273,200,160,40,80,160,320,960
39274,190,120,80,80,0,0,470
39275,220,120,120,80,0,0,540
39276,200,100,80,80,160,0,620
39277,220,140,160,160,160,0,840
39278,160,160,120,160,320,0,920
39279,220,180,120,80,160,0,760
39280,200,140,160,160,160,320,1140
39281,190,140,240,80,0,0,650
39282,240,160,80,160,160,0,800
39283,200,160,200,160,160,0,880
39284,140,80,80,80,0,0,380
39285,220,160,200,160,160,0,900
39286,210,180,160,240,0,0,790
39287,200,100,120,240,0,0,660
39288,220,80,120,160,160,0,740
39289,240,160,160,160,320,0,1040
39290,220,140,160,80,0,0,600
39291,230,180,80,160,160,320,1130
39292,230,120,80,0,0,0,430
39293,250,140,160,80,0,0,630
39294,160,160,160,80,160,0,720
39295,160,80,0,0,0,0,240
39296,200,120,80,80,160,0,640
39297,230,100,120,0,0,0,450
39298,210,140,80,80,0,0,510
39299,180,140,160,160,320,0,960
39300,200,80,40,80,160,320,880
39301,200,140,120,80,160,0,700
39302,170,140,160,80,0,0,550
39303,200,100,80,0,0,0,380
39304,180,80,160,80,160,0,660
39305,240,160,120,160,160,0,840
39306,200,120,80,0,0,0,400
39307,200,60,40,0,0,0,300
39308,200,100,120,80,0,0,500
39309,200,200,160,160,0,0,720
39310,190,120,80,160,160,320,1030
39311,210,180,80,0,0,0,470
39312,210,140,160,80,160,0,750
39313,180,120,80,0,0,0,380
39314,210,100,40,0,0,0,350
39315,150,140,80,160,160,0,690
39316,210,120,80,160,0,0,570
39317,240,120,80,80,160,0,680
39318,180,120,160,160,160,0,780
39319,190,100,80,160,160,0,690
39320,200,120,120,160,0,0,600
39321,250,160,80,80,160,0,730
39322,160,160,80,80,160,0,640
39323,210,80,0,0,0,0,290
39324,190,120,80,80,160,0,630
39325,220,180,120,0,0,0,520
39326,170,120,160,0,0,0,450
39327,170,100,80,160,160,0,670
39328,180,120,120,80,0,0,500
39329,190,120,160,80,160,0,710
39330,220,160,120,160,320,320,1300
39331,200,180,80,80,0,0,540
39332,180,100,80,80,160,0,600
39333,150,100,40,80,160,0,530
39334,190,120,120,160,320,320,1230
39335,250,120,80,80,0,0,530
39336,190,160,160,160,320,0,990
39337,240,140,80,160,160,320,1100
39338,170,120,200,240,160,0,890
39339,220,80,40,80,160,0,580
39340,190,120,40,0,0,0,350
39341,170,80,40,80,160,0,530
39342,190,160,160,80,160,0,750
39343,210,120,160,80,160,0,730
39344,220,180,160,80,160,0,800
39345,210,140,160,80,0,0,590
39346,210,160,80,80,160,0,690
39347,160,80,80,80,160,0,560
39348,220,160,120,80,160,0,740
39349,130,120,120,0,0,0,370
39350,180,140,120,160,160,320,1080
39351,230,120,80,80,0,0,510
39352,220,160,80,0,0,0,460
39353,220,100,40,80,160,0,600
39354,170,100,40,80,0,0,390
39355,180,100,80,160,160,0,680
39356,200,140,80,80,0,0,500
39357,190,120,80,80,160,0,630
39358,210,200,120,80,0,0,610
39359,200,60,80,160,160,0,660
39360,160,120,120,160,0,0,560
39361,190,100,40,0,0,0,330
39362,170,160,120,80,160,0,690
39363,190,220,160,160,160,320,1210
39364,190,120,120,80,160,0,670
39365,190,100,120,160,160,0,730
39366,220,140,80,0,0,0,440
39367,180,100,40,80,0,0,400
39368,210,140,120,160,320,0,950
39369,170,60,80,0,0,0,310
39370,190,120,160,160,160,320,1110
39371,220,120,80,80,0,0,500
39372,200,100,80,160,160,0,700
39373,210,140,120,160,160,320,1110
39374,220,120,80,80,160,0,660
39375,190,100,80,80,160,0,610
39376,180,120,160,160,320,0,940
39377,220,120,80,160,320,0,900
39378,200,160,160,160,0,0,680
39379,210,140,120,160,160,320,1110
39380,190,100,40,0,0,0,330
39381,180,120,120,160,160,0,740
39382,210,120,120,80,160,0,690
39383,180,100,160,160,160,0,760
39384,160,120,160,80,0,0,520
39385,180,140,160,160,0,0,640
39386,190,140,160,80,160,0,730
39387,180,120,80,80,0,0,460
39388,210,160,120,80,160,0,730
39389,210,100,80,160,160,0,710
39390,220,120,120,160,0,0,620
39391,240,140,40,80,0,0,500
39392,200,80,80,160,160,320,1000
39393,170,80,80,80,160,0,570
39394,180,40,80,80,160,0,540
39395,180,160,80,0,0,0,420
39396,230,140,160,160,160,0,850
39397,170,100,80,80,0,0,430
39398,120,80,120,160,160,0,640
39399,170,120,80,160,160,0,690
39400,210,180,160,160,160,0,870
39401,160,80,120,0,0,0,360
39402,160,120,80,80,160,0,600
39403,190,120,40,0,0,0,350
39404,220,160,160,0,0,0,540
39405,170,100,80,0,0,0,350
39406,220,120,120,160,160,0,780
39407,200,100,120,160,160,0,740
39408,200,100,160,160,0,0,620
39409,180,140,160,160,160,0,800
39410,160,80,120,160,0,0,520
39411,200,40,80,80,160,320,880
39412,200,140,120,160,160,320,1100
39413,150,160,160,80,160,0,710
39414,200,80,40,0,0,0,320
39415,220,180,160,80,0,0,640
39416,210,100,80,160,320,0,870
39417,190,140,120,0,0,0,450
39418,190,140,80,160,320,0,890
39419,160,160,40,0,0,0,360
39420,220,140,80,80,160,0,680
39421,190,100,40,0,0,0,330
39422,180,140,160,240,160,0,880
39423,160,100,40,80,0,0,380
39424,200,180,120,80,160,320,1060
39425,190,120,120,160,320,0,910
39426,220,160,120,160,160,0,820
39427,190,160,80,0,0,0,430
39428,200,80,120,80,160,0,640
39429,190,140,160,160,160,0,810
39430,150,180,200,80,0,0,610
39431,200,120,40,80,160,0,600
39432,210,80,40,0,0,0,330
39433,250,180,160,160,320,0,1070
39434,160,80,120,80,160,0,600
39435,230,100,80,0,0,0,410
39436,200,120,200,160,160,0,840
39437,200,120,40,80,0,0,440
39438,190,160,80,0,0,0,430
39439,190,140,160,0,0,0,490
39440,230,120,120,160,160,0,790
39441,210,100,120,160,320,0,910
39442,170,100,120,0,0,0,390
39443,200,120,240,80,0,0,640
39444,220,100,120,80,160,0,680
39445,210,120,120,0,0,0,450
39446,190,80,80,0,0,0,350
39447,220,160,160,160,160,0,860
39448,170,140,120,80,0,0,510
39449,200,80,40,80,160,0,560
39450,210,180,120,80,0,0,590
39451,170,140,40,80,0,0,430
39452,240,120,80,0,0,0,440
39453,180,60,40,80,0,0,360
39454,200,100,80,80,160,0,620
39455,200,160,120,80,160,320,1040
39456,240,180,120,160,160,0,860
39457,200,120,80,0,0,0,400
39458,210,140,120,160,160,0,790
39459,130,100,120,80,0,0,430
39460,210,140,120,80,0,0,550
39461,150,160,200,240,320,0,1070
39462,170,120,80,0,0,0,370
39463,150,60,80,80,0,0,370
39464,190,180,160,160,160,320,1170
39465,210,120,40,80,160,0,610
39466,200,120,120,80,0,0,520
39467,190,160,160,80,0,0,590
39468,190,140,80,80,160,320,970
39469,190,120,120,160,160,320,1070
39470,230,140,120,160,0,0,650
39471,150,100,80,0,0,0,330
39472,190,120,0,0,0,0,310
39473,200,120,120,0,0,0,440
39474,170,100,120,80,160,0,630
39475,210,120,80,160,160,0,730
39476,230,160,200,160,160,320,1230
39477,170,100,120,160,160,0,710
39478,200,120,160,80,0,0,560
39479,220,200,160,240,160,0,980
39480,170,120,160,160,160,0,770
39481,120,120,120,80,160,0,600
39482,180,80,80,80,0,0,420
39483,190,60,40,80,0,0,370
39484,190,140,80,80,160,320,970
39485,210,140,80,80,160,0,670
39486,200,140,160,0,0,0,500
39487,180,180,120,80,160,0,720
39488,170,140,80,80,160,0,630
39489,190,160,120,80,160,0,710
39490,170,100,80,80,160,0,590
39491,190,140,120,80,160,320,1010
39492,190,120,120,240,0,0,670
39493,190,140,200,240,0,0,770
39494,190,120,80,160,320,0,870
39495,220,80,120,160,160,0,740
39496,210,180,160,80,0,0,630
39497,170,160,120,160,320,320,1250
39498,220,120,80,80,0,0,500
39499,200,120,120,160,160,320,1080
39500,200,140,160,160,0,0,660
39501,180,160,120,160,0,0,620
39502,190,180,280,160,0,0,810
39503,220,140,120,80,160,0,720
39504,150,100,40,0,0,0,290
39505,170,120,160,160,160,0,770
39506,160,80,80,160,320,0,800
39507,140,40,40,80,160,0,460
39508,200,180,80,80,0,0,540
39509,190,100,80,160,0,0,530
39510,180,140,80,80,0,0,480
39511,220,140,120,80,160,0,720
39512,190,100,80,80,160,0,610
39513,240,120,120,240,320,0,1040
39514,190,120,80,80,160,0,630
39515,220,140,200,80,160,0,800
39516,220,140,200,0,0,0,560
39517,160,100,80,80,160,0,580
39518,240,100,40,80,160,0,620
39519,180,120,120,0,0,0,420
39520,230,140,120,160,160,0,810
39521,180,80,120,80,160,0,620
39522,160,120,120,80,0,0,480
39523,170,80,80,80,160,0,570
39524,180,60,80,80,160,0,560
39525,190,80,40,0,0,0,310
39526,180,140,80,160,320,0,880
39527,210,160,80,160,160,0,770
39528,190,80,40,80,160,0,550
39529,190,160,160,240,160,0,910
39530,190,80,80,160,160,0,670
39531,200,60,120,160,0,0,540
39532,160,60,80,80,0,0,380
39533,230,120,160,0,0,0,510
39534,220,80,120,80,160,0,660
39535,180,160,80,80,160,320,980
39536,200,100,40,0,0,0,340
39537,220,180,120,160,320,0,1000
39538,160,100,120,0,0,0,380
39539,220,120,80,80,160,0,660
39540,150,100,120,160,160,320,1010
39541,240,180,160,160,160,320,1220
39542,220,140,80,160,320,0,920
39543,200,100,40,80,160,0,580
39544,170,120,120,0,0,0,410
39545,160,120,80,160,320,0,840
39546,240,180,200,80,160,320,1180
39547,200,100,120,80,160,0,660
39548,200,120,120,160,320,320,1240
39549,190,140,160,160,160,0,810
39550,200,100,80,0,0,0,380
39551,160,100,120,160,0,0,540
39552,170,160,120,160,0,0,610
39553,250,160,160,240,160,320,1290
39554,210,100,160,240,160,0,870
39555,240,140,160,240,160,0,940
39556,160,120,120,80,160,0,640
39557,170,140,80,0,0,0,390
39558,190,120,120,80,160,0,670
39559,190,100,120,160,320,320,1210
39560,190,80,40,0,0,0,310
39561,190,120,40,80,160,0,590
39562,200,160,120,160,0,0,640
39563,160,120,80,80,0,0,440
39564,200,120,80,80,160,0,640
39565,180,80,80,80,160,0,580
39566,200,120,120,80,0,0,520
39567,190,120,240,240,160,320,1270
39568,190,120,80,80,160,320,950
39569,170,100,80,160,160,0,670
39570,190,100,80,0,0,0,370
39571,160,120,120,240,320,0,960
39572,170,60,120,80,160,0,590
39573,190,120,40,0,0,0,350
39574,180,80,80,80,160,0,580
39575,170,80,40,0,0,0,290
39576,210,140,120,160,320,0,950
39577,170,140,160,160,0,0,630
39578,190,80,80,0,0,0,350
39579,190,120,80,160,160,0,710
39580,220,140,40,80,160,0,640
39581,190,140,80,80,0,0,490
39582,180,120,160,160,160,0,780
39583,180,120,80,80,0,0,460
39584,160,120,40,80,0,0,400
39585,200,140,160,160,160,320,1140
39586,170,60,0,0,0,0,230
39587,200,100,80,80,0,0,460
39588,170,120,80,80,160,0,610
39589,150,120,120,80,160,0,630
39590,210,120,160,160,320,320,1290
39591,170,140,160,160,320,320,1270
39592,220,100,80,0,0,0,400
39593,130,100,80,80,160,320,870
39594,200,100,120,80,0,0,500
39595,230,160,200,240,320,320,1470
39596,210,160,160,80,160,320,1090
39597,200,180,120,0,0,0,500
39598,200,140,160,80,0,0,580
39599,150,120,200,240,320,320,1350
39600,190,160,120,160,160,320,1110
39601,210,0,0,0,0,0,210
39602,190,120,120,240,160,0,830
39603,200,140,120,80,160,0,700
39604,220,120,80,80,160,0,660
39605,180,120,80,80,160,0,620
39606,220,140,120,80,160,0,720
39607,220,60,40,0,0,0,320
39608,210,100,120,0,0,0,430
39609,190,100,120,160,320,0,890
39610,220,140,120,80,160,0,720
39611,200,140,80,0,0,0,420
39612,210,200,120,80,0,0,610
39613,190,120,120,80,0,0,510
39614,240,100,40,0,0,0,380
39615,210,140,80,160,160,0,750
39616,190,140,120,160,320,0,930
39617,200,120,160,160,0,0,640
39618,160,120,40,0,0,0,320
39619,160,120,40,80,0,0,400
39620,160,60,80,160,160,0,620
39621,200,140,200,160,160,320,1180
39622,160,80,40,80,0,0,360
39623,180,120,120,80,0,0,500
39624,200,140,160,80,160,0,740
39625,150,100,80,0,0,0,330
39626,210,160,120,80,0,0,570
39627,230,160,120,80,0,0,590
39628,220,120,120,240,160,0,860
39629,210,140,80,80,160,0,670
39630,180,80,120,80,0,0,460
39631,170,100,160,240,320,0,990
39632,210,120,80,0,0,0,410
39633,230,60,40,0,0,0,330
39634,180,120,80,160,160,0,700
39635,170,140,80,80,160,0,630
39636,180,80,80,0,0,0,340
39637,160,100,80,80,0,0,420
39638,210,140,200,240,320,0,1110
39639,200,120,120,160,160,0,760
39640,180,140,80,80,160,320,960
39641,220,80,80,80,0,0,460
39642,200,140,120,80,160,0,700
39643,260,160,160,80,0,0,660
39644,200,160,120,80,0,0,560
39645,190,100,80,80,160,0,610
39646,210,100,120,80,160,0,670
39647,180,60,40,0,0,0,280
39648,210,100,120,80,160,320,990
39649,180,160,200,160,160,0,860
39650,210,80,40,80,0,0,410
39651,170,140,120,160,320,0,910
39652,180,80,80,0,0,0,340
39653,140,80,80,80,160,0,540
39654,220,160,160,240,160,0,940
39655,200,120,80,0,0,0,400
39656,230,160,120,80,0,0,590
39657,200,140,40,0,0,0,380
39658,190,100,80,0,0,0,370
39659,190,160,120,0,0,0,470
39660,170,100,120,80,160,0,630
39661,180,100,120,160,0,0,560
39662,220,140,120,80,160,0,720
39663,210,140,120,0,0,0,470
39664,150,60,40,80,0,0,330
39665,200,140,120,80,160,0,700
39666,210,140,120,160,160,0,790
39667,220,140,80,80,160,0,680
39668,190,120,120,160,160,320,1070
39669,160,120,160,80,160,0,680
39670,190,80,120,160,160,0,710
39671,150,140,120,80,160,0,650
39672,190,120,80,80,160,0,630
39673,220,120,120,80,160,0,700
39674,210,140,80,0,0,0,430
39675,230,160,80,80,0,0,550
39676,180,140,40,0,0,0,360
39677,180,140,80,0,0,0,400
39678,210,120,120,80,0,0,530
39679,220,160,40,80,0,0,500
39680,180,60,40,80,0,0,360
39681,200,160,120,80,0,0,560
39682,200,100,80,80,160,0,620
39683,190,120,120,80,0,0,510
39684,190,100,80,80,160,0,610
39685,160,60,0,0,0,0,220
39686,190,140,200,160,160,320,1170
39687,210,200,120,160,160,0,850
39688,140,80,0,0,0,0,220
39689,210,60,80,80,160,320,910
39690,150,80,120,160,320,0,830
39691,250,120,80,160,160,0,770
39692,190,60,80,80,160,0,570
39693,180,100,120,160,320,0,880
39694,210,60,0,0,0,0,270
39695,170,140,120,80,160,320,990
39696,210,200,200,160,160,0,930
39697,240,80,120,160,320,320,1240
39698,220,160,120,160,160,320,1140
39699,230,100,160,240,320,320,1370
39700,170,140,160,160,0,0,630
39701,220,140,160,80,160,0,760
39702,230,160,160,160,160,320,1190
39703,200,160,160,160,320,320,1320
39704,160,100,80,160,160,320,980
39705,230,100,80,80,160,0,650
39706,200,120,80,80,160,0,640
39707,180,80,80,0,0,0,340
39708,200,140,120,160,160,0,780
39709,170,80,40,80,160,320,850
39710,210,120,120,240,320,0,1010
39711,190,160,80,0,0,0,430
39712,200,80,160,160,0,0,600
39713,200,100,40,80,160,320,900
39714,220,80,40,80,160,0,580
39715,210,120,200,160,160,0,850
39716,190,120,160,160,0,0,630
39717,220,180,240,240,0,0,880
39718,180,100,160,160,320,320,1240
39719,220,140,120,0,0,0,480
39720,220,160,120,80,160,0,740
39721,190,100,120,0,0,0,410
39722,200,180,80,80,160,0,700
39723,250,60,40,0,0,0,350
39724,180,120,40,80,0,0,420
39725,170,140,160,80,160,320,1030
39726,190,100,120,80,160,0,650
39727,190,80,40,0,0,0,310
39728,200,60,80,80,160,0,580
39729,200,160,120,240,160,0,880
39730,240,160,120,160,320,320,1320
39731,210,140,160,160,0,0,670
39732,190,80,160,160,160,0,750
39733,170,100,120,160,320,320,1190
39734,200,140,160,80,160,0,740
39735,180,120,120,160,160,0,740
39736,210,120,80,80,0,0,490
39737,180,100,160,240,320,0,1000
39738,230,100,40,80,0,0,450
39739,160,140,200,160,0,0,660
39740,170,60,80,0,0,0,310
39741,210,80,120,80,160,0,650
39742,190,200,200,160,160,0,910
39743,180,120,80,0,0,0,380
39744,270,100,120,80,160,320,1050
39745,230,100,80,80,0,0,490
39746,190,120,80,80,160,0,630
39747,220,160,240,240,320,0,1180
39748,210,140,160,160,160,0,830
39749,210,120,160,240,320,0,1050
39750,170,60,0,0,0,0,230
39751,180,100,40,80,0,0,400
39752,220,100,160,160,160,0,800
39753,180,120,120,80,0,0,500
39754,220,80,80,160,0,0,540
39755,130,60,80,0,0,0,270
39756,230,40,0,0,0,0,270
39757,200,100,120,80,0,0,500
39758,230,100,120,0,0,0,450
39759,240,140,80,0,0,0,460
39760,210,140,160,80,160,0,750
39761,230,180,80,0,0,0,490
39762,200,120,160,240,160,320,1200
39763,150,120,120,80,160,0,630
39764,170,100,120,0,0,0,390
39765,230,140,40,80,160,320,970
39766,180,100,160,160,160,0,760
39767,200,160,160,240,320,0,1080
39768,220,140,80,160,160,0,760
39769,190,100,160,80,0,0,530
39770,150,100,120,80,160,0,610
39771,210,100,40,80,0,0,430
39772,170,100,40,0,0,0,310
39773,200,140,160,160,0,0,660
39774,210,140,80,160,320,0,910
39775,150,120,120,80,160,320,950
39776,140,60,40,80,160,0,480
39777,160,120,200,160,160,0,800
39778,200,160,120,0,0,0,480
39779,190,160,120,240,160,0,870
39780,170,140,160,80,160,0,710
39781,210,80,80,80,160,320,930
39782,180,160,200,80,0,0,620
39783,220,120,120,0,0,0,460
39784,170,160,80,80,0,0,490
39785,210,160,80,160,160,0,770
39786,230,120,80,0,0,0,430
39787,200,140,120,80,160,0,700
39788,210,120,120,0,0,0,450
39789,210,120,80,0,0,0,410
39790,190,140,160,80,0,0,570
39791,220,100,120,0,0,0,440
39792,160,100,40,80,160,0,540
39793,150,120,120,80,160,0,630
39794,230,140,120,160,160,0,810
39795,220,120,80,80,160,0,660
39796,220,160,160,160,320,0,1020
39797,190,160,160,160,160,0,830
39798,180,100,120,160,160,0,720
39799,190,100,120,240,320,0,970
39800,230,120,80,80,160,0,670
39801,210,60,80,0,0,0,350
39802,200,140,40,0,0,0,380
39803,180,80,40,80,160,320,860
39804,160,120,120,80,0,0,480
39805,220,140,40,80,160,0,640
39806,190,40,0,0,0,0,230
39807,180,100,80,160,160,0,680
39808,190,140,80,0,0,0,410
39809,210,60,120,80,0,0,470
39810,200,80,40,80,0,0,400
39811,180,60,40,0,0,0,280
39812,210,140,80,80,0,0,510
39813,140,60,40,80,0,0,320
39814,230,100,120,0,0,0,450
39815,140,100,80,0,0,0,320
39816,190,120,120,160,320,320,1230
39817,180,160,80,0,0,0,420
39818,170,80,120,0,0,0,370
39819,220,120,120,80,0,0,540
39820,150,140,120,80,0,0,490
39821,170,80,80,160,0,0,490
39822,170,160,120,0,0,0,450
39823,180,120,120,160,160,0,740
39824,180,60,40,0,0,0,280
39825,190,100,120,80,160,0,650
39826,210,140,120,80,0,0,550
39827,180,100,80,80,160,0,600
39828,210,140,80,80,160,0,670
39829,220,120,40,0,0,0,380
39830,160,100,80,80,0,0,420
39831,210,140,40,80,160,0,630
39832,180,160,120,80,160,320,1020
39833,250,140,40,0,0,0,430
39834,200,160,160,80,0,0,600
39835,180,80,40,0,0,0,300
39836,190,80,120,80,0,0,470
39837,200,120,160,0,0,0,480
39838,230,120,80,80,160,0,670
39839,180,100,40,0,0,0,320
39840,140,40,40,0,0,0,220
39841,200,80,40,0,0,0,320
39842,220,120,160,160,160,0,820
39843,180,160,80,0,0,0,420
39844,190,100,160,80,0,0,530
39845,160,140,80,0,0,0,380
39846,170,120,120,240,320,320,1290
39847,180,160,120,80,0,0,540
39848,190,100,120,160,160,0,730
39849,190,120,120,0,0,0,430
39850,190,140,40,0,0,0,370
39851,190,120,120,160,160,0,750
39852,200,100,120,160,160,0,740
39853,200,160,120,80,160,320,1040
39854,210,100,160,160,160,320,1110
39855,230,140,160,80,0,0,610
39856,210,80,120,80,0,0,490
39857,190,140,80,80,160,0,650
39858,220,180,80,80,160,0,720
39859,190,180,160,160,160,0,850
39860,190,60,40,80,0,0,370
39861,170,120,160,160,160,0,770
39862,200,160,120,160,320,0,960
39863,190,60,0,0,0,0,250
39864,210,160,200,80,0,0,650
39865,240,120,120,80,160,0,720
39866,170,160,160,80,160,0,730
39867,170,60,40,0,0,0,270
39868,180,60,80,80,160,0,560
39869,180,120,200,80,160,0,740
39870,220,120,80,80,160,0,660
39871,200,160,160,80,160,0,760
39872,200,100,40,80,0,0,420
39873,180,140,120,80,0,0,520
39874,200,100,80,160,160,0,700
39875,210,120,80,80,0,0,490
39876,150,120,40,80,0,0,390
39877,210,160,160,80,160,0,770
39878,220,100,160,240,320,0,1040
39879,200,80,0,0,0,0,280
39880,200,80,40,80,160,320,880
39881,210,120,120,80,0,0,530
39882,210,100,120,160,160,0,750
39883,210,120,120,80,0,0,530
39884,180,140,120,80,0,0,520
39885,240,80,120,80,0,0,520
39886,190,80,120,80,160,0,630
39887,170,100,80,80,160,0,590
39888,140,60,80,80,160,0,520
39889,220,120,120,160,160,0,780
39890,190,200,160,80,0,0,630
39891,190,100,160,160,320,0,930
39892,210,140,80,80,160,0,670
39893,190,80,80,80,160,0,590
39894,210,140,120,80,160,320,1030
39895,170,160,120,80,0,0,530
39896,220,140,80,0,0,0,440
39897,180,80,80,160,160,320,980
39898,190,80,40,0,0,0,310
39899,200,100,80,0,0,0,380
39900,230,140,160,160,160,0,850
39901,180,60,40,80,160,0,520
39902,230,140,120,0,0,0,490
39903,220,120,80,80,160,0,660
39904,200,120,120,160,160,0,760
39905,190,80,120,80,160,0,630
39906,220,180,80,0,0,0,480
39907,200,140,120,80,160,0,700
39908,230,140,120,0,0,0,490
39909,160,100,120,80,0,0,460
39910,180,160,200,160,160,0,860
39911,220,140,120,80,0,0,560
39912,200,220,160,160,160,0,900
39913,180,140,120,80,160,0,680
39914,180,160,80,80,0,0,500
39915,200,180,160,240,160,320,1260
39916,210,120,160,160,160,320,1130
39917,220,80,120,80,0,0,500
39918,220,100,40,0,0,0,360
39919,180,60,80,160,160,0,640
39920,190,140,120,0,0,0,450
39921,210,80,120,160,0,0,570
39922,170,120,120,160,160,0,730
39923,170,120,160,80,0,0,530
39924,180,180,40,80,160,0,640
39925,170,100,80,80,160,0,590
39926,180,140,120,80,0,0,520
39927,250,120,160,160,320,0,1010
39928,170,80,120,0,0,0,370
39929,210,180,160,240,320,320,1430
39930,170,100,40,0,0,0,310
39931,210,140,160,160,160,0,830
39932,200,140,80,160,320,0,900
39933,150,100,40,0,0,0,290
39934,220,120,120,160,160,0,780
39935,200,120,160,160,0,0,640
39936,200,120,120,80,0,0,520
39937,220,180,160,80,160,0,800
39938,200,120,120,160,0,0,600
39939,180,120,80,160,160,0,700
39940,170,100,40,0,0,0,310
39941,160,120,80,80,0,0,440
39942,210,80,40,80,160,0,570
39943,190,100,40,80,160,0,570
39944,190,120,80,80,160,0,630
39945,170,100,120,240,0,0,630
39946,210,160,200,240,320,320,1450
39947,210,160,160,160,160,0,850
39948,210,120,160,160,160,0,810
39949,220,120,200,80,160,0,780
39950,180,120,40,80,160,0,580
39951,190,120,120,80,160,0,670
39952,210,160,120,80,0,0,570
39953,170,140,120,0,0,0,430
39954,220,120,40,0,0,0,380
39955,200,80,80,80,160,0,600
39956,120,100,120,80,0,0,420
39957,210,120,120,80,160,320,1010
39958,240,120,40,0,0,0,400
39959,190,120,120,80,0,0,510
39960,190,120,40,80,160,0,590
39961,190,140,200,320,320,320,1490
39962,180,120,80,80,160,0,620
39963,160,60,80,80,0,0,380
39964,200,140,120,160,320,0,940
39965,200,120,80,160,320,320,1200
39966,170,140,200,160,320,0,990
39967,190,80,80,80,0,0,430
39968,180,120,80,80,160,0,620
39969,190,140,120,240,320,0,1010
39970,240,120,200,160,320,0,1040
39971,170,160,160,240,160,0,890
39972,200,120,40,80,0,0,440
39973,220,140,120,80,160,0,720
39974,200,140,80,80,160,0,660
39975,200,140,0,0,0,0,340
39976,230,140,160,160,160,320,1170
39977,160,200,120,160,320,0,960
39978,170,60,40,80,160,0,510
39979,190,140,40,0,0,0,370
39980,210,140,120,160,160,0,790
39981,200,100,80,0,0,0,380
39982,180,100,80,80,0,0,440
39983,150,100,80,0,0,0,330
39984,190,120,40,80,0,0,430
39985,220,120,80,80,160,0,660
39986,190,120,200,240,320,320,1390
39987,200,100,0,0,0,0,300
39988,200,100,160,0,0,0,460
39989,160,120,80,80,160,0,600
39990,170,120,160,0,0,0,450
39991,230,80,120,160,320,0,910
39992,210,80,80,160,160,320,1010
39993,230,120,120,0,0,0,470
39994,200,140,160,160,160,0,820
39995,170,80,40,80,0,0,370
39996,210,120,80,80,0,0,490
39997,210,140,80,0,0,0,430
39998,190,120,160,160,160,320,1110
39999,190,80,40,0,0,0,310
40000,240,140,160,160,160,0,860
40001,210,160,160,80,0,0,610
40002,210,140,80,160,160,0,750
40003,200,140,120,160,320,0,940
40004,220,160,120,0,0,0,500
40005,180,80,40,0,0,0,300
40006,190,120,80,80,0,0,470
40007,220,120,80,80,0,0,500
40008,140,100,120,160,160,0,680
40009,200,120,120,80,160,0,680
40010,230,140,160,160,160,0,850
40011,190,100,160,80,0,0,530
40012,160,120,120,160,160,0,720
40013,190,140,120,0,0,0,450
40014,190,160,120,160,320,0,950
40015,210,120,40,0,0,0,370
40016,190,120,160,160,0,0,630
40017,220,140,120,160,320,320,1280
40018,180,140,200,160,160,0,840
40019,190,160,200,80,0,0,630
40020,190,120,120,80,160,0,670
40021,190,120,160,80,0,0,550
40022,230,80,40,0,0,0,350
40023,220,100,80,0,0,0,400
40024,170,100,80,80,160,0,590
40025,210,100,40,80,160,0,590
40026,230,160,120,80,0,0,590
40027,210,140,120,160,160,0,790
40028,170,140,160,160,0,0,630
40029,170,180,160,160,320,0,990
40030,210,100,80,0,0,0,390
40031,190,100,80,80,160,320,930
40032,210,140,160,160,0,0,670
40033,230,100,120,80,160,0,690
40034,220,100,80,160,0,0,560
40035,170,120,120,80,0,0,490
40036,180,120,120,160,320,320,1220
40037,160,180,120,0,0,0,460
40038,190,80,80,80,0,0,430
40039,220,100,120,160,160,0,760
40040,210,140,160,160,160,0,830
40041,250,160,80,80,160,0,730
40042,220,100,40,80,160,0,600
40043,130,120,120,160,320,0,850
40044,230,80,80,80,160,0,630
40045,160,160,160,160,160,0,800
40046,190,120,120,0,0,0,430
40047,200,160,160,160,320,320,1320
40048,200,120,120,160,160,0,760
40049,210,180,120,240,320,0,1070
40050,190,120,120,0,0,0,430
40051,200,140,120,80,0,0,540
40052,190,180,120,160,160,0,810
40053,220,140,80,160,160,0,760
40054,220,100,80,80,160,0,640
40055,180,100,120,80,160,320,960
40056,190,180,160,80,160,320,1090
40057,190,120,80,0,0,0,390
40058,210,120,120,80,0,0,530
40059,220,140,160,160,160,0,840
40060,260,100,120,0,0,0,480
40061,170,180,160,80,160,0,750
40062,200,120,120,80,160,0,680
40063,220,180,120,80,0,0,600
40064,190,140,160,160,160,0,810
40065,190,160,120,80,0,0,550
40066,210,80,0,0,0,0,290
40067,210,120,120,80,160,0,690
40068,150,60,40,80,160,0,490
40069,210,80,80,80,0,0,450
40070,170,120,80,80,160,0,610
40071,240,180,160,160,0,0,740
40072,210,120,0,0,0,0,330
40073,190,180,200,80,0,0,650
40074,170,100,120,160,320,320,1190
40075,200,100,0,0,0,0,300
40076,180,120,80,80,160,0,620
40077,160,100,80,160,320,0,820
40078,170,140,160,240,160,320,1190
40079,210,140,120,0,0,0,470
40080,180,140,40,0,0,0,360
40081,230,100,160,80,160,320,1050
40082,170,100,120,80,0,0,470
40083,170,100,80,80,160,0,590
40084,210,100,120,160,0,0,590
40085,180,80,80,160,0,0,500
40086,260,140,160,240,320,320,1440
40087,200,80,120,80,0,0,480
40088,230,180,160,80,160,0,810
40089,190,140,80,160,160,0,730
40090,180,120,160,240,320,0,1020
40091,210,120,160,80,160,0,730
40092,220,160,120,0,0,0,500
40093,190,140,120,80,0,0,530
40094,200,160,200,160,160,320,1200
40095,170,80,80,80,160,0,570
40096,180,80,40,0,0,0,300
40097,180,120,80,80,0,0,460
40098,220,120,80,0,0,0,420
40099,190,100,80,80,160,0,610
40100,210,80,40,80,160,320,890
40101,200,160,160,160,160,320,1160
40102,210,120,80,80,0,0,490
40103,180,140,80,160,320,320,1200
40104,170,160,80,80,160,0,650
40105,140,100,80,80,160,0,560
40106,200,160,160,80,160,0,760
40107,180,100,80,80,160,0,600
40108,230,120,40,80,160,320,950
40109,230,140,80,160,160,0,770
40110,220,140,160,80,0,0,600
40111,190,120,80,80,160,0,630
40112,170,140,160,160,0,0,630
40113,160,80,120,80,160,0,600
40114,180,120,160,160,160,320,1100
40115,220,140,160,160,0,0,680
40116,200,80,80,80,0,0,440
40117,190,100,160,160,160,0,770
40118,170,80,120,80,0,0,450
40119,180,100,0,0,0,0,280
40120,190,80,40,80,0,0,390
40121,210,140,120,160,0,0,630
40122,180,140,160,240,160,320,1200
40123,210,160,200,160,160,0,890
40124,210,100,40,0,0,0,350
40125,180,60,80,160,160,0,640
40126,210,120,0,0,0,0,330
40127,180,60,80,80,160,320,880
40128,190,120,120,160,160,0,750
40129,220,80,40,80,160,0,580
40130,190,100,120,0,0,0,410
40131,230,120,120,80,160,0,710
40132,200,120,120,160,0,0,600
40133,190,120,40,0,0,0,350
40134,200,80,120,80,160,0,640
40135,170,80,80,80,0,0,410
40136,210,140,80,80,160,0,670
40137,210,80,80,80,160,0,610
40138,200,120,80,160,320,0,880
40139,210,60,40,0,0,0,310
40140,160,100,160,80,160,320,980
40141,140,80,40,0,0,0,260
40142,190,100,80,80,0,0,450
40143,180,120,80,160,0,0,540
40144,200,60,120,160,320,320,1180
40145,210,40,80,160,160,0,650
40146,190,100,80,80,160,0,610
40147,240,120,40,0,0,0,400
40148,180,140,200,240,160,0,920
40149,180,80,160,240,160,0,820
40150,190,80,40,0,0,0,310
40151,210,180,160,240,320,0,1110
40152,200,140,80,160,160,0,740
40153,220,140,120,160,320,320,1280
40154,190,80,120,160,320,320,1190
40155,180,140,120,160,160,320,1080
40156,220,120,120,80,0,0,540
40157,230,160,160,160,160,0,870
40158,200,60,120,80,0,0,460
40159,190,120,120,160,160,320,1070
40160,200,140,40,0,0,0,380
40161,200,100,120,160,320,0,900
40162,180,120,120,240,160,0,820
40163,200,160,120,160,160,0,800
40164,210,120,80,80,0,0,490
40165,200,100,80,80,160,0,620
40166,220,100,120,160,160,0,760
40167,220,80,80,80,160,0,620
40168,170,80,80,80,160,0,570
40169,180,140,160,160,320,0,960
40170,180,100,80,0,0,0,360
40171,190,160,200,160,320,320,1350
40172,210,180,120,160,160,0,830
40173,160,140,120,240,160,0,820
40174,190,180,160,80,160,0,770
40175,200,180,160,160,320,0,1020
40176,180,160,200,240,160,0,940
40177,190,180,120,160,320,0,970
40178,190,160,80,80,0,0,510
40179,190,80,80,160,160,0,670
40180,250,160,240,160,0,0,810
40181,200,100,40,80,0,0,420
40182,180,60,80,80,160,0,560
40183,210,100,120,80,0,0,510
40184,240,140,120,160,160,320,1140
40185,210,160,160,80,160,0,770
40186,250,120,120,0,0,0,490
40187,220,160,160,160,160,0,860
40188,200,100,80,160,320,0,860
40189,200,160,160,80,160,0,760
40190,210,160,200,160,320,320,1370
40191,190,120,80,0,0,0,390
40192,200,140,120,160,160,0,780
40193,180,140,120,80,160,0,680
40194,200,100,80,160,160,320,1020
40195,190,80,0,0,0,0,270
40196,200,120,40,80,0,0,440
40197,210,160,120,80,160,0,730
40198,190,140,80,80,160,320,970
40199,230,200,200,240,320,320,1510
40200,180,160,120,80,0,0,540
40201,190,120,80,160,320,0,870
40202,170,60,40,80,160,0,510
40203,180,80,40,0,0,0,300
40204,220,100,40,0,0,0,360
40205,190,200,200,160,160,0,910
40206,220,180,200,160,160,0,920
40207,180,120,120,160,160,0,740
40208,150,120,120,160,320,320,1190
40209,180,60,40,80,160,0,520
40210,230,200,200,160,0,0,790
40211,190,120,120,240,320,0,990
40212,220,140,120,80,0,0,560
40213,180,100,120,240,0,0,640
40214,230,100,80,80,160,0,650
40215,140,80,40,0,0,0,260
40216,180,180,80,80,0,0,520
40217,210,120,80,80,0,0,490
40218,210,100,40,0,0,0,350
40219,240,140,120,240,320,0,1060
40220,190,120,80,160,320,0,870
40221,190,160,120,80,0,0,550
40222,180,140,80,80,0,0,480
40223,150,60,40,0,0,0,250
40224,180,160,160,80,160,0,740
40225,210,80,40,80,160,0,570
40226,220,140,120,160,160,320,1120
40227,180,120,120,160,320,0,900
40228,170,120,0,0,0,0,290
40229,180,120,160,240,320,0,1020
40230,220,140,120,160,160,0,800
40231,160,80,120,80,0,0,440
40232,170,160,160,80,160,0,730
40233,180,100,120,80,160,0,640
40234,210,220,120,160,160,0,870
40235,190,140,160,160,320,0,970
40236,190,140,80,160,160,0,730
40237,190,100,0,0,0,0,290
40238,210,100,120,80,0,0,510
40239,170,120,40,80,0,0,410
40240,210,160,200,240,160,0,970
40241,190,160,120,80,0,0,550
40242,180,100,80,160,160,0,680
40243,210,140,40,0,0,0,390
40244,240,140,120,160,160,0,820
40245,160,100,120,80,160,0,620
40246,180,120,120,80,160,0,660
40247,210,160,120,240,0,0,730
40248,200,120,80,80,0,0,480
40249,180,100,120,160,160,0,720
40250,160,80,120,160,0,0,520
40251,160,100,80,0,0,0,340
40252,210,120,120,160,320,0,930
40253,210,160,120,240,320,0,1050
40254,190,100,40,80,160,0,570
40255,210,100,80,80,160,0,630
40256,170,80,80,160,320,320,1130
40257,220,120,40,80,160,320,940
40258,210,100,80,160,320,0,870
40259,170,100,80,160,0,0,510
40260,210,200,160,80,160,0,810
40261,240,100,40,0,0,0,380
40262,170,80,120,80,160,0,610
40263,220,160,120,160,160,0,820
40264,180,180,120,160,160,0,800
40265,170,140,200,160,160,0,830
40266,200,160,160,240,320,320,1400
40267,170,120,120,80,160,320,970
40268,200,100,120,80,160,0,660
40269,230,140,120,80,0,0,570
40270,210,80,80,160,160,0,690
40271,170,80,40,0,0,0,290
40272,190,160,160,160,160,0,830
40273,200,160,160,80,0,0,600
40274,240,100,120,80,0,0,540
40275,170,60,0,0,0,0,230
40276,230,100,40,80,0,0,450
40277,190,120,80,80,160,0,630
40278,170,120,80,0,0,0,370
40279,170,140,80,0,0,0,390
40280,150,100,40,0,0,0,290
40281,200,60,40,0,0,0,300
40282,210,140,120,80,0,0,550
40283,200,120,80,80,160,0,640
40284,200,120,40,0,0,0,360
40285,240,200,120,160,160,0,880
40286,230,140,120,80,160,0,730
40287,200,120,160,160,160,320,1120
40288,200,100,120,80,160,0,660
40289,220,160,120,80,0,0,580
40290,250,140,160,160,0,0,710
40291,190,40,40,80,0,0,350
40292,180,160,80,0,0,0,420
40293,200,80,120,160,160,0,720
40294,200,80,0,0,0,0,280
40295,190,100,80,80,160,0,610
40296,190,140,80,0,0,0,410
40297,190,80,160,240,0,0,670
40298,190,160,160,80,0,0,590
40299,230,160,120,80,0,0,590
40300,180,140,80,80,160,0,640
40301,160,140,120,80,0,0,500
40302,200,100,40,80,160,0,580
40303,190,100,120,160,160,0,730
40304,210,140,120,160,320,320,1270
40305,140,100,80,0,0,0,320
40306,240,160,120,80,160,0,760
40307,190,120,120,0,0,0,430
40308,180,140,120,160,160,0,760
40309,220,140,120,160,0,0,640
40310,180,140,120,160,160,0,760
40311,240,100,80,0,0,0,420
40312,170,80,40,0,0,0,290
40313,210,100,80,80,160,0,630
40314,180,180,160,160,160,0,840
40315,140,100,80,80,160,0,560
40316,190,100,120,80,160,0,650
40317,200,160,120,80,160,0,720
40318,220,160,160,240,320,0,1100
40319,190,80,120,240,320,320,1270
40320,200,120,80,80,0,0,480
40321,180,100,120,0,0,0,400
40322,190,160,160,80,160,0,750
40323,220,80,40,0,0,0,340
40324,200,80,80,80,160,0,600
40325,170,140,120,80,160,320,990
40326,190,120,120,80,160,0,670
40327,230,120,80,160,0,0,590
40328,190,100,80,80,160,0,610
40329,190,160,160,0,0,0,510
40330,190,120,160,80,0,0,550
40331,190,160,120,80,160,0,710
40332,170,160,120,0,0,0,450
40333,220,120,120,80,160,0,700
40334,200,120,120,80,160,0,680
40335,200,160,80,80,160,0,680
40336,170,120,120,160,320,0,890
40337,210,120,120,0,0,0,450
40338,220,140,80,0,0,0,440
40339,170,100,120,80,0,0,470
40340,220,100,80,80,0,0,480
40341,200,120,0,0,0,0,320
40342,210,140,120,80,0,0,550
40343,200,100,40,0,0,0,340
40344,190,120,120,160,160,0,750
40345,190,120,80,160,160,0,710
40346,240,120,120,240,320,0,1040
40347,220,180,80,80,0,0,560
40348,200,120,160,160,320,320,1280
40349,180,80,120,160,160,0,700
40350,190,140,120,80,0,0,530
40351,210,160,40,0,0,0,410
40352,180,100,120,80,0,0,480
40353,170,140,40,80,0,0,430
40354,180,100,120,80,160,0,640
40355,230,120,160,240,320,0,1070
40356,200,40,0,0,0,0,240
40357,190,120,120,160,320,0,910
40358,190,120,120,80,160,0,670
40359,230,160,160,80,160,0,790
40360,230,100,80,80,160,0,650
40361,180,120,40,0,0,0,340
40362,200,120,120,0,0,0,440
40363,240,140,80,80,160,0,700
40364,170,120,120,80,0,0,490
40365,180,100,80,80,160,0,600
40366,150,60,80,160,160,0,610
40367,200,100,120,160,0,0,580
40368,230,180,160,160,160,0,890
40369,190,140,160,240,160,320,1210
40370,220,160,80,80,160,320,1020
40371,180,160,200,160,320,0,1020
40372,210,180,80,0,0,0,470
40373,210,140,120,80,160,0,710
40374,240,100,80,0,0,0,420
40375,170,80,80,160,320,0,810
40376,200,140,160,80,0,0,580
40377,190,120,120,80,160,0,670
40378,170,100,0,0,0,0,270
40379,220,100,40,80,0,0,440
40380,210,160,120,160,320,320,1290
40381,210,100,120,0,0,0,430
40382,200,140,80,160,160,320,1060
40383,210,180,160,160,160,0,870
40384,170,120,120,160,160,320,1050
40385,180,140,40,0,0,0,360
40386,180,140,160,80,160,0,720
40387,170,120,40,80,160,0,570
40388,200,120,160,80,160,0,720
40389,190,120,120,80,160,0,670
40390,240,140,80,80,160,0,700
40391,230,40,40,0,0,0,310
40392,160,120,160,80,160,0,680
40393,200,100,120,160,160,0,740
40394,190,120,160,80,160,0,710
40395,240,200,200,160,160,0,960
40396,210,100,40,80,160,0,590
40397,130,100,160,160,160,0,710
40398,180,200,120,80,160,0,740
40399,170,120,120,80,0,0,490
40400,180,100,120,80,160,0,640
40401,190,120,120,160,160,0,750
40402,170,120,80,0,0,0,370
40403,220,120,80,160,160,320,1060
40404,200,140,80,80,0,0,500
40405,170,120,200,80,160,0,730
40406,170,180,120,160,0,0,630
40407,210,80,40,0,0,0,330
40408,180,160,120,80,0,0,540
40409,190,160,40,0,0,0,390
40410,230,120,160,240,320,320,1390
40411,160,80,80,160,160,0,640
40412,210,140,120,80,0,0,550
40413,190,120,120,80,0,0,510
40414,200,160,120,80,160,0,720
40415,220,160,120,80,0,0,580
40416,180,120,80,80,0,0,460
40417,170,120,120,160,160,0,730
40418,210,120,160,80,0,0,570
40419,220,100,0,0,0,0,320
40420,200,160,160,80,160,0,760
40421,230,140,160,80,160,0,770
40422,200,140,160,80,0,0,580
40423,250,100,120,160,0,0,630
40424,150,120,120,80,160,0,630
40425,210,120,80,80,160,0,650
40426,200,160,160,160,160,0,840
40427,210,140,80,80,160,0,670
40428,220,120,80,160,160,320,1060
40429,130,100,80,80,0,0,390
40430,240,80,80,80,0,0,480
40431,190,120,160,160,320,0,950
40432,210,100,80,80,160,0,630
40433,200,140,40,80,0,0,460
40434,190,120,80,0,0,0,390
40435,230,160,80,80,0,0,550
40436,200,120,160,80,160,0,720
40437,200,80,80,160,160,0,680
40438,240,160,160,80,160,0,800
40439,240,160,120,160,320,0,1000
40440,220,140,80,80,160,0,680
40441,230,100,160,80,0,0,570
40442,180,80,80,80,160,0,580
40443,190,180,120,80,160,0,730
40444,200,100,80,80,160,0,620
40445,160,100,80,0,0,0,340
40446,240,100,120,80,160,0,700
40447,210,140,120,80,0,0,550
40448,170,100,120,80,160,0,630
40449,220,140,120,160,160,0,800
40450,210,160,200,80,0,0,650
40451,220,140,80,80,160,320,1000
40452,210,140,120,0,0,0,470
40453,190,80,40,80,160,0,550
40454,160,120,80,0,0,0,360
40455,180,100,80,80,0,0,440
40456,150,160,120,160,320,320,1230
40457,180,120,160,160,160,0,780
40458,190,100,80,160,160,0,690
40459,170,80,80,0,0,0,330
40460,210,60,120,80,0,0,470
40461,170,100,80,160,0,0,510
40462,190,120,200,80,0,0,590
40463,190,140,120,80,160,320,1010
40464,210,160,160,160,160,0,850
40465,140,120,160,240,320,0,980
40466,190,140,200,160,160,0,850
40467,220,140,200,160,160,0,880
40468,200,100,80,160,160,0,700
40469,150,60,40,80,0,0,330
40470,190,120,80,0,0,0,390
40471,170,100,80,160,160,0,670
40472,190,80,80,80,160,0,590
40473,160,100,80,80,0,0,420
40474,170,100,40,0,0,0,310
40475,160,200,120,0,0,0,480
40476,140,60,80,80,160,0,520
40477,180,120,120,160,160,320,1060
40478,200,120,80,0,0,0,400
40479,180,140,120,80,0,0,520
40480,220,160,120,160,320,0,980
40481,190,60,40,0,0,0,290
40482,210,120,120,160,160,0,770
40483,180,160,120,160,160,0,780
40484,140,100,120,80,0,0,440
40485,220,180,160,160,160,0,880
40486,200,180,80,0,0,0,460
40487,200,140,120,160,160,0,780
40488,210,200,240,160,160,0,970
40489,170,120,120,80,0,0,490
40490,170,140,80,80,160,0,630
40491,220,140,120,160,320,0,960
40492,180,100,40,80,160,0,560
40493,190,120,80,80,160,320,950
40494,210,140,160,160,0,0,670
40495,230,140,120,160,160,0,810
40496,190,120,120,160,0,0,590
40497,200,120,160,160,320,0,960
40498,200,120,120,160,160,0,760
40499,180,80,80,160,160,0,660
40500,240,120,120,80,160,0,720
40501,220,120,120,80,160,0,700
40502,180,80,120,160,160,0,700
40503,210,140,120,80,160,0,710
40504,240,140,120,0,0,0,500
40505,200,160,120,160,160,0,800
40506,190,140,120,80,160,0,690
40507,220,120,40,80,160,0,620
40508,180,140,160,160,0,0,640
40509,200,160,160,0,0,0,520
40510,240,160,200,240,160,0,1000
40511,200,80,80,80,160,0,600
40512,210,200,160,80,160,0,810
40513,240,140,160,160,160,0,860
40514,200,140,40,0,0,0,380
40515,260,140,80,80,160,0,720
40516,220,140,160,80,160,0,760
40517,210,140,80,0,0,0,430
40518,230,100,120,80,160,0,690
40519,180,100,160,160,320,0,920
40520,170,120,200,80,160,0,730
40521,200,120,160,80,0,0,560
40522,190,140,160,80,0,0,570
40523,190,100,40,0,0,0,330
40524,160,140,120,80,160,0,660
40525,190,160,80,80,160,0,670
40526,170,100,160,80,160,0,670
40527,170,80,80,160,160,320,970
40528,210,140,160,160,160,320,1150
40529,180,80,0,0,0,0,260
40530,230,160,120,160,160,0,830
40531,210,160,80,80,160,0,690
40532,190,140,160,80,160,0,730
40533,200,80,80,80,160,320,920
40534,200,140,40,0,0,0,380
40535,170,100,80,80,160,0,590
40536,160,100,40,0,0,0,300
40537,160,80,120,0,0,0,360
40538,220,160,80,80,0,0,540
40539,170,100,160,160,160,0,750
40540,200,140,80,0,0,0,420
40541,260,140,200,160,0,0,760
40542,210,160,120,80,160,0,730
40543,200,120,80,160,320,0,880
40544,210,140,160,160,160,0,830
40545,170,140,120,160,160,320,1070
40546,120,80,120,80,0,0,400
40547,200,180,160,160,160,0,860
40548,180,120,40,80,160,0,580
40549,230,160,80,80,160,0,710
40550,170,140,80,80,160,0,630
40551,220,80,80,80,0,0,460
40552,160,120,40,80,0,0,400
40553,190,160,120,80,160,0,710
40554,160,100,80,80,160,320,900
40555,220,200,200,80,160,0,860
40556,220,100,80,80,0,0,480
40557,200,120,80,0,0,0,400
40558,200,140,120,160,160,0,780
40559,190,140,80,80,160,0,650
40560,170,140,160,0,0,0,470
40561,200,60,0,0,0,0,260
40562,170,140,200,160,160,0,830
40563,190,100,120,160,160,320,1050
40564,200,120,80,80,160,0,640
40565,180,60,80,80,160,0,560
40566,200,160,80,0,0,0,440
40567,210,120,80,80,160,320,970
40568,140,140,120,160,160,0,720
40569,180,140,120,160,320,0,920
40570,190,100,120,160,160,0,730
40571,230,100,40,0,0,0,370
40572,210,140,120,80,160,0,710
40573,200,140,120,80,160,0,700
40574,230,160,240,240,320,320,1510
40575,190,140,40,80,160,320,930
40576,190,80,40,80,160,0,550
40577,210,80,80,80,160,0,610
40578,230,100,40,0,0,0,370
40579,200,160,40,0,0,0,400
40580,160,120,120,80,0,0,480
40581,180,120,120,0,0,0,420
40582,220,80,80,0,0,0,380
40583,230,120,120,80,160,0,710
40584,230,140,160,240,0,0,770
40585,230,140,160,0,0,0,530
40586,200,140,200,160,160,0,860
40587,230,140,120,80,0,0,570
40588,180,140,120,160,160,0,760
40589,210,140,80,0,0,0,430
40590,230,180,80,160,160,0,810
40591,210,120,80,80,160,320,970
40592,220,160,80,160,160,0,780
40593,230,60,0,0,0,0,290
40594,200,160,120,80,0,0,560
40595,180,120,160,160,160,0,780
40596,210,160,80,0,0,0,450
40597,230,160,200,160,0,0,750
40598,180,80,80,160,160,320,980
40599,190,160,200,160,320,0,1030
40600,200,80,120,160,160,0,720
40601,180,100,80,0,0,0,360
40602,220,100,40,80,160,0,600
40603,140,100,120,160,160,320,1000
40604,200,100,40,0,0,0,340
40605,180,120,80,80,160,0,620
40606,180,100,40,80,0,0,400
40607,200,180,120,80,0,0,580
40608,250,120,40,0,0,0,410
40609,190,140,120,80,160,320,1010
40610,230,120,120,160,160,0,790
40611,180,80,80,80,160,320,900
40612,200,80,80,0,0,0,360
40613,190,120,80,160,0,0,550
40614,190,140,160,160,320,0,970
40615,220,180,160,160,320,0,1040
40616,200,60,40,80,160,0,540
40617,210,140,40,80,160,0,630
40618,250,120,80,0,0,0,450
40619,170,80,80,80,0,0,410
40620,200,180,80,160,0,0,620
40621,180,140,160,160,320,320,1280
40622,130,80,120,80,160,0,570
40623,190,140,120,160,160,0,770
40624,210,160,80,0,0,0,450
40625,190,100,80,80,0,0,450
40626,200,140,120,160,0,0,620
40627,180,60,40,80,160,0,520
40628,190,180,200,80,160,320,1130
40629,180,160,160,0,0,0,500
40630,170,80,80,80,0,0,410
40631,210,160,120,240,320,320,1370
40632,190,120,120,80,0,0,510
40633,250,160,120,80,0,0,610
40634,210,140,120,80,160,320,1030
40635,210,100,80,0,0,0,390
40636,190,160,160,160,0,0,670
40637,230,160,120,160,160,320,1150
40638,190,120,120,160,320,0,910
40639,210,80,80,0,0,0,370
40640,200,160,160,80,160,0,760
40641,210,140,160,160,320,0,990
40642,230,200,200,160,0,0,790
40643,210,140,120,160,320,0,950
40644,200,120,0,0,0,0,320
40645,160,100,80,0,0,0,340
40646,180,60,120,160,160,0,680
40647,220,120,120,80,160,0,700
40648,170,60,80,80,160,0,550
40649,210,120,120,80,160,0,690
40650,180,120,120,160,160,0,740
40651,190,140,120,160,320,320,1250
40652,210,140,160,160,160,0,830
40653,180,100,120,80,160,320,960
40654,180,140,80,0,0,0,400
40655,200,100,80,80,0,0,460
40656,190,140,160,80,0,0,570
40657,180,80,80,160,160,0,660
40658,220,160,40,80,0,0,500
40659,220,180,200,160,160,0,920
40660,200,140,240,160,0,0,740
40661,160,120,40,0,0,0,320
40662,220,160,200,80,0,0,660
40663,190,120,120,80,0,0,510
40664,210,120,120,0,0,0,450
40665,180,100,160,80,160,0,680
40666,190,120,40,0,0,0,350
40667,160,80,120,0,0,0,360
40668,160,100,40,80,0,0,380
40669,180,120,80,0,0,0,380
40670,180,120,160,240,160,0,860
40671,240,100,160,80,160,320,1060
40672,200,180,160,160,0,0,700
40673,220,180,160,160,0,0,720
40674,240,100,120,160,160,0,780
40675,180,120,120,80,160,0,660
40676,180,120,80,160,160,320,1020
40677,170,140,160,240,160,0,870
40678,200,140,160,160,0,0,660
40679,160,140,160,160,0,0,620
40680,170,80,160,160,160,320,1050
40681,190,120,80,0,0,0,390
40682,190,100,80,80,160,320,930
40683,190,140,120,80,0,0,530
40684,230,160,40,80,160,0,670
40685,220,100,80,80,160,0,640
40686,190,160,200,160,160,0,870
40687,200,80,80,80,0,0,440
40688,230,140,80,160,320,0,930
40689,190,120,80,80,0,0,470
40690,230,80,40,80,160,0,590
40691,210,100,80,0,0,0,390
40692,210,100,120,160,160,0,750
40693,160,140,120,0,0,0,420
40694,220,40,40,80,160,0,540
40695,170,80,120,80,160,0,610
40696,210,140,80,160,160,0,750
40697,190,40,40,80,160,0,510
40698,150,120,120,160,320,0,870
40699,180,160,160,160,320,320,1300
40700,160,120,120,80,0,0,480
40701,190,120,80,0,0,0,390
40702,200,100,80,160,160,0,700
40703,220,160,160,160,160,320,1180
40704,190,120,80,160,160,0,710
40705,190,180,120,80,0,0,570
40706,190,80,40,80,160,0,550
40707,190,120,80,80,160,0,630
40708,210,140,120,0,0,0,470
40709,160,60,80,160,160,320,940
40710,200,80,80,80,0,0,440
40711,220,120,160,80,160,0,740
40712,210,140,160,160,0,0,670
40713,230,80,40,0,0,0,350
40714,160,120,160,160,320,0,920
40715,200,140,40,80,160,0,620
40716,200,120,200,160,160,0,840
40717,190,80,80,80,160,0,590
40718,170,80,80,160,160,320,970
40719,210,140,160,80,0,0,590
40720,210,120,120,80,160,320,1010
40721,200,100,80,80,160,0,620
40722,180,140,40,80,160,0,600
40723,200,180,120,80,160,320,1060
40724,210,80,40,80,160,0,570
40725,190,120,120,160,320,0,910
40726,210,160,120,80,0,0,570
40727,210,120,120,80,0,0,530
40728,200,100,160,160,320,0,940
40729,170,140,160,80,160,0,710
40730,220,100,40,80,160,320,920
40731,170,100,160,80,0,0,510
40732,160,80,80,80,160,0,560
40733,180,100,0,0,0,0,280
40734,190,100,120,160,160,0,730
40735,210,100,80,80,0,0,470
40736,210,160,160,80,0,0,610
40737,160,60,80,80,0,0,380
40738,200,80,120,160,320,320,1200
40739,170,100,120,160,160,0,710
40740,220,60,80,160,160,0,680
40741,190,140,120,80,160,0,690
40742,210,140,80,80,160,0,670
40743,200,80,80,80,0,0,440
40744,200,140,160,160,160,0,820
40745,190,140,200,0,0,0,530
40746,190,80,80,80,0,0,430
40747,210,160,200,240,320,0,1130
40748,200,100,80,160,160,0,700
40749,150,100,80,160,160,320,970
40750,140,100,40,0,0,0,280
40751,200,120,80,80,160,0,640
40752,210,140,160,80,160,0,750
40753,220,160,80,80,0,0,540
40754,220,180,200,160,0,0,760
40755,200,80,160,160,160,320,1080
40756,240,120,40,80,160,320,960
40757,230,180,120,160,0,0,690
40758,190,120,80,80,160,0,630
40759,200,140,40,80,0,0,460
40760,160,120,120,160,160,320,1040
40761,190,160,160,160,160,0,830
40762,120,120,80,80,160,0,560
40763,220,60,80,160,0,0,520
40764,160,60,40,80,160,0,500
40765,220,140,120,80,160,0,720
40766,190,120,120,80,0,0,510
40767,200,160,120,80,160,0,720
40768,150,80,120,80,160,0,590
40769,180,120,120,80,0,0,500
40770,200,120,120,80,160,0,680
40771,190,140,80,80,160,0,650
40772,190,160,40,80,0,0,470
40773,170,120,120,160,320,320,1210
40774,220,120,80,80,0,0,500
40775,150,80,40,80,160,0,510
40776,170,160,160,160,160,0,810
40777,230,140,200,80,0,0,650
40778,180,120,0,0,0,0,300
40779,210,100,40,0,0,0,350
40780,170,140,160,160,160,0,790
40781,190,120,40,80,160,0,590
40782,190,160,80,0,0,0,430
40783,190,80,40,80,0,0,390
40784,220,140,160,160,320,320,1320
40785,160,120,40,0,0,0,320
40786,210,100,120,80,160,0,670
40787,190,40,80,160,160,0,630
40788,190,120,80,80,160,0,630
40789,210,100,200,160,0,0,670
40790,210,160,200,160,160,320,1210
40791,180,140,160,160,160,0,800
40792,210,140,160,80,160,0,750
40793,190,120,40,0,0,0,350
40794,200,140,160,80,160,0,740
40795,210,80,80,80,0,0,450
40796,130,120,120,0,0,0,370
40797,230,160,120,80,0,0,590
40798,200,120,120,160,0,0,600
40799,220,180,40,0,0,0,440
40800,190,120,120,80,160,0,670
40801,210,180,120,240,320,320,1390
40802,180,140,80,80,160,320,960
40803,200,80,120,160,0,0,560
40804,220,80,80,80,160,0,620
40805,200,60,80,80,0,0,420
40806,190,60,80,80,160,0,570
40807,250,120,120,80,0,0,570
40808,210,140,160,80,160,0,750
40809,220,180,120,240,160,0,920
40810,180,180,200,240,160,0,960
40811,220,120,80,160,160,320,1060
40812,220,140,40,80,160,0,640
40813,210,120,80,0,0,0,410
40814,190,160,120,0,0,0,470
40815,200,60,80,160,0,0,500
40816,220,120,120,160,0,0,620
40817,200,120,80,0,0,0,400
40818,230,180,120,80,160,0,770
40819,200,80,120,80,0,0,480
40820,170,100,80,160,160,320,990
40821,200,100,40,80,160,0,580
40822,200,120,80,160,160,320,1040
40823,200,160,160,240,320,0,1080
40824,160,100,80,80,0,0,420
40825,230,140,120,80,160,0,730
40826,190,180,200,160,0,0,730
40827,160,120,80,80,0,0,440
40828,190,140,80,80,0,0,490
40829,200,80,80,80,160,0,600
40830,210,160,120,160,160,0,810
40831,170,180,160,80,160,0,750
40832,210,120,40,80,0,0,450
40833,200,140,80,80,160,320,980
40834,190,100,120,80,160,0,650
40835,220,120,160,80,0,0,580
40836,190,160,160,160,160,0,830
40837,150,80,120,160,0,0,510
40838,190,140,160,160,0,0,650
40839,160,60,80,160,160,0,620
40840,200,140,160,240,160,0,900
40841,180,160,80,80,160,0,660
40842,200,200,160,160,160,0,880
40843,210,120,80,80,160,0,650
40844,210,120,160,80,160,0,730
40845,200,140,80,0,0,0,420
40846,160,120,80,160,320,0,840
40847,190,100,80,0,0,0,370
40848,200,100,80,80,160,0,620
40849,180,80,80,80,160,320,900
40850,190,100,120,80,160,0,650
40851,190,120,120,0,0,0,430
40852,210,160,160,0,0,0,530
40853,210,140,120,0,0,0,470
40854,190,140,80,80,160,0,650
40855,170,100,200,240,320,0,1030
40856,220,120,80,0,0,0,420
40857,200,120,120,160,320,0,920
40858,210,140,80,80,0,0,510
40859,180,120,120,160,0,0,580
40860,220,180,160,80,0,0,640
40861,180,120,40,0,0,0,340
40862,210,80,120,80,0,0,490
40863,220,180,80,80,0,0,560
40864,200,80,120,160,320,320,1200
40865,190,160,160,80,160,0,750
40866,180,100,80,0,0,0,360
40867,240,120,120,80,0,0,560
40868,180,120,80,0,0,0,380
40869,200,100,40,80,0,0,420
40870,190,120,160,80,0,0,550
40871,220,120,80,80,0,0,500
40872,170,80,120,160,320,0,850
40873,230,180,160,160,320,0,1050
40874,190,120,120,160,160,0,750
40875,190,80,40,80,160,0,550
40876,220,160,200,160,160,0,900
40877,200,160,80,80,0,0,520
40878,180,140,120,80,160,0,680
40879,220,200,120,80,0,0,620
40880,220,140,200,160,320,320,1360
40881,170,120,80,0,0,0,370
40882,170,140,200,80,160,0,750
40883,170,100,120,80,0,0,470
40884,240,100,40,80,160,0,620
40885,160,100,80,160,160,0,660
40886,180,180,120,80,160,0,720
40887,200,160,160,80,0,0,600
40888,200,80,40,80,160,0,560
40889,190,160,160,160,160,0,830
40890,170,140,120,80,0,0,510
40891,210,100,40,0,0,0,350
40892,190,160,120,160,0,0,630
40893,230,160,80,160,160,0,790
40894,210,140,160,240,160,0,910
40895,160,100,120,160,160,0,700
40896,220,160,160,160,160,0,860
40897,170,60,0,0,0,0,230
40898,180,100,80,160,160,0,680
40899,220,100,80,0,0,0,400
40900,240,140,200,80,0,0,660
40901,230,160,120,160,0,0,670
40902,220,100,80,160,320,0,880
40903,200,160,160,80,160,320,1080
40904,160,100,120,160,160,0,700
40905,160,140,40,80,160,0,580
40906,190,120,160,160,160,0,790
40907,220,160,80,160,0,0,620
40908,200,140,80,160,160,320,1060
40909,200,180,200,160,160,0,900
40910,220,120,120,160,0,0,620
40911,180,140,120,80,160,0,680
40912,220,180,240,160,320,320,1440
40913,190,140,160,80,0,0,570
40914,200,140,120,160,160,0,780
40915,180,80,80,80,160,0,580
40916,220,180,160,80,0,0,640
40917,150,180,160,160,160,0,810
40918,220,140,80,0,0,0,440
40919,210,100,80,0,0,0,390
40920,220,100,80,80,160,0,640
40921,190,120,160,80,0,0,550
40922,210,140,80,80,0,0,510
40923,190,80,80,80,160,0,590
40924,220,160,120,0,0,0,500
40925,230,160,200,160,0,0,750
40926,230,100,80,160,320,0,890
40927,170,60,0,0,0,0,230
40928,190,80,80,80,160,0,590
40929,220,160,120,0,0,0,500
40930,200,160,200,80,160,0,800
40931,220,140,120,160,160,0,800
40932,200,120,80,80,0,0,480
40933,200,80,80,0,0,0,360
40934,200,120,80,80,160,320,960
40935,220,120,120,160,320,0,940
40936,210,100,80,160,0,0,550
40937,220,140,160,240,320,0,1080
40938,220,220,160,160,320,0,1080
40939,190,140,120,80,0,0,530
40940,190,60,40,0,0,0,290
40941,150,40,80,160,160,0,590
40942,180,100,160,80,160,0,680
40943,200,160,160,160,320,0,1000
40944,170,140,120,160,160,0,750
40945,200,180,120,160,160,320,1140
40946,190,120,160,160,320,0,950
40947,190,180,120,160,160,0,810
40948,190,200,80,80,160,0,710
40949,180,140,200,160,160,0,840
40950,180,140,120,160,160,320,1080
40951,140,100,80,0,0,0,320
40952,210,140,120,80,160,0,710
40953,160,120,80,80,160,0,600
40954,160,120,120,160,320,0,880
40955,150,140,120,160,320,0,890
40956,160,80,80,160,160,0,640
40957,180,160,160,80,0,0,580
40958,210,140,120,160,160,320,1110
40959,190,120,120,80,0,0,510
40960,180,120,120,160,160,0,740
40961,190,120,120,160,160,0,750
40962,160,120,80,80,160,320,920
40963,240,120,120,80,160,0,720
40964,200,160,160,160,320,0,1000
40965,190,160,120,160,160,320,1110
40966,210,140,120,80,0,0,550
40967,160,100,80,80,0,0,420
40968,210,180,80,80,160,0,710
40969,190,100,120,160,0,0,570
40970,180,80,40,0,0,0,300
40971,190,140,80,160,160,320,1050
40972,190,120,80,80,160,0,630
40973,210,140,120,160,320,0,950
40974,220,180,160,240,320,0,1120
40975,190,120,120,80,160,0,670
40976,210,100,80,80,0,0,470
40977,190,100,0,0,0,0,290
40978,220,160,120,80,160,0,740
40979,210,80,40,80,160,0,570
40980,210,100,80,80,160,0,630
40981,200,100,120,160,160,320,1060
40982,220,80,80,160,0,0,540
40983,200,100,40,80,0,0,420
40984,180,140,80,0,0,0,400
40985,240,140,80,0,0,0,460
40986,250,220,160,160,160,0,950
40987,190,160,160,80,0,0,590
40988,210,140,40,0,0,0,390
40989,200,80,40,80,0,0,400
40990,210,120,120,80,160,320,1010
40991,170,140,120,240,160,0,830
40992,230,160,120,80,160,0,750
40993,170,120,80,80,160,0,610
40994,180,140,120,160,160,0,760
40995,210,160,120,0,0,0,490
40996,160,100,120,160,160,0,700
40997,170,100,80,160,0,0,510
40998,170,80,80,160,160,0,650
40999,220,120,80,0,0,0,420
41000,210,100,80,0,0,0,390
41001,230,140,120,240,0,0,730
41002,220,160,120,160,320,320,1300
41003,170,80,80,80,160,0,570
41004,170,140,80,80,0,0,470
41005,210,120,40,80,160,0,610
41006,170,120,120,160,320,320,1210
41007,220,120,160,80,160,0,740
41008,220,100,120,0,0,0,440
41009,190,100,80,80,160,0,610
41010,200,120,40,80,160,0,600
41011,180,100,0,0,0,0,280
41012,200,140,80,0,0,0,420
41013,190,140,240,80,0,0,650
41014,210,160,160,80,160,0,770
41015,180,60,40,0,0,0,280
41016,210,100,120,160,160,0,750
41017,230,140,160,240,320,0,1090
41018,220,140,200,160,160,0,880
41019,190,140,120,80,0,0,530
41020,160,120,160,160,160,0,760
41021,190,120,80,160,160,0,710
41022,200,60,120,160,320,0,860
41023,190,160,80,160,160,0,750
41024,210,100,80,0,0,0,390
41025,180,140,120,160,0,0,600
41026,210,120,80,160,160,0,730
41027,230,100,80,160,160,0,730
41028,170,80,40,80,160,0,530
41029,240,220,200,80,160,0,900
41030,210,120,40,80,0,0,450
41031,190,160,200,160,160,0,870
41032,160,120,120,160,160,0,720
41033,220,100,80,80,0,0,480
41034,180,160,120,80,160,0,700
41035,240,140,200,160,160,0,900
41036,240,180,160,240,320,0,1140
41037,210,140,120,0,0,0,470
41038,190,120,80,0,0,0,390
41039,210,120,40,0,0,0,370
41040,180,160,120,80,0,0,540
41041,190,180,200,80,0,0,650
41042,190,60,40,80,160,0,530
41043,210,120,160,240,160,0,890
41044,220,100,40,80,0,0,440
41045,210,80,40,80,160,0,570
41046,190,160,160,160,0,0,670
41047,220,120,160,240,320,0,1060
41048,200,180,160,160,160,320,1180
41049,190,160,80,160,160,320,1070
41050,240,160,160,160,160,0,880
41051,190,100,120,160,320,320,1210
41052,200,100,160,160,160,320,1100
41053,190,140,80,80,160,0,650
41054,200,100,40,0,0,0,340
41055,190,180,200,160,160,320,1210
41056,170,80,0,0,0,0,250
41057,210,180,120,80,0,0,590
41058,190,140,120,240,160,0,850
41059,200,120,80,80,160,0,640
41060,140,80,120,240,320,0,900
41061,190,120,160,240,160,320,1190
41062,220,100,80,80,160,0,640
41063,180,140,80,160,160,0,720
41064,170,160,120,160,160,0,770
41065,210,140,80,160,160,320,1070
41066,190,120,120,80,160,0,670
41067,210,180,200,80,160,320,1150
41068,170,140,160,80,160,0,710
41069,190,60,0,0,0,0,250
41070,180,60,120,160,160,0,680
41071,180,100,120,240,160,0,800
41072,160,100,80,80,160,0,580
41073,220,100,120,80,0,0,520
41074,210,120,120,0,0,0,450
41075,210,140,120,80,160,0,710
41076,190,120,120,80,160,0,670
41077,210,100,80,80,160,0,630
41078,180,140,120,80,160,0,680
41079,220,140,40,0,0,0,400
41080,210,200,160,160,320,0,1050
41081,180,120,120,80,0,0,500
41082,230,140,120,80,0,0,570
41083,190,140,80,80,0,0,490
41084,180,120,120,160,160,0,740
41085,200,120,160,240,320,0,1040
41086,230,100,120,160,320,0,930
41087,220,160,120,160,160,320,1140
41088,210,120,160,160,320,320,1290
41089,180,120,120,160,160,0,740
41090,200,100,120,80,0,0,500
41091,160,80,80,0,0,0,320
41092,200,80,80,80,160,0,600
41093,200,160,160,160,160,0,840
41094,180,80,80,0,0,0,340
41095,180,100,120,160,160,0,720
41096,210,100,80,80,160,0,630
41097,200,140,40,0,0,0,380
41098,220,100,120,80,160,0,680
41099,160,100,80,80,0,0,420
41100,210,60,80,80,160,0,590
41101,160,60,80,0,0,0,300
41102,210,140,200,160,160,320,1190
41103,200,180,160,160,320,0,1020
41104,140,140,200,80,160,0,720
41105,170,140,120,80,160,0,670
41106,200,140,80,0,0,0,420
41107,170,100,120,160,160,0,710
41108,200,160,160,160,320,320,1320
41109,200,160,80,80,0,0,520
41110,190,120,120,80,160,0,670
41111,190,60,80,80,160,0,570
41112,180,140,120,80,160,320,1000
41113,180,120,120,160,160,320,1060
41114,180,100,120,80,160,0,640
41115,190,80,80,0,0,0,350
41116,170,140,120,80,0,0,510
41117,170,80,40,80,0,0,370
41118,190,100,40,80,0,0,410
41119,160,100,200,240,320,320,1340
41120,160,60,40,80,0,0,340
41121,220,100,120,80,160,0,680
41122,210,140,40,80,160,320,950
41123,190,80,0,0,0,0,270
41124,210,60,40,80,160,0,550
41125,210,140,80,80,160,0,670
41126,200,120,80,80,160,0,640
41127,180,80,80,0,0,0,340
41128,190,140,160,240,0,0,730
41129,170,100,120,160,160,0,710
41130,180,140,120,160,320,320,1240
41131,180,100,80,80,160,0,600
41132,230,100,40,80,160,0,610
41133,210,160,200,160,160,0,890
41134,250,160,80,0,0,0,490
41135,210,140,160,0,0,0,510
41136,240,160,80,160,160,0,800
41137,210,100,80,0,0,0,390
41138,260,120,120,80,160,0,740
41139,180,100,80,80,160,0,600
41140,190,100,80,80,0,0,450
41141,220,120,120,80,0,0,540
41142,210,200,200,80,0,0,690
41143,210,120,80,80,160,0,650
41144,190,140,80,0,0,0,410
41145,160,140,120,160,320,0,900
41146,220,140,160,80,0,0,600
41147,190,160,200,240,320,0,1110
41148,220,160,120,160,160,0,820
41149,230,140,160,0,0,0,530
41150,210,120,80,160,160,0,730
41151,180,120,120,80,160,320,980
41152,170,120,80,160,160,0,690
41153,150,140,80,0,0,0,370
41154,230,80,120,160,320,320,1230
41155,190,60,40,0,0,0,290
41156,210,160,200,80,0,0,650
41157,210,200,120,80,0,0,610
41158,180,60,40,0,0,0,280
41159,180,100,120,160,160,0,720
41160,210,140,80,160,0,0,590
41161,180,80,80,80,160,0,580
41162,160,100,160,160,0,0,580
41163,210,100,120,240,160,0,830
41164,170,100,80,160,320,0,830
41165,220,120,160,160,160,0,820
41166,200,120,120,160,320,0,920
41167,220,180,120,160,160,320,1160
41168,170,140,80,160,160,0,710
41169,210,140,120,80,160,320,1030
41170,240,100,80,80,160,0,660
41171,200,120,160,160,320,0,960
41172,220,120,120,80,0,0,540
41173,190,140,160,0,0,0,490
41174,210,140,120,80,0,0,550
41175,220,140,160,160,160,0,840
41176,190,120,120,240,320,320,1310
41177,190,120,80,80,0,0,470
41178,190,80,120,80,160,0,630
41179,250,140,80,80,160,0,710
41180,210,180,120,80,0,0,590
41181,210,120,40,80,160,0,610
41182,220,100,120,160,0,0,600
41183,200,120,40,0,0,0,360
41184,210,120,80,160,160,320,1050
41185,210,140,120,160,160,0,790
41186,180,120,40,80,0,0,420
41187,160,100,0,0,0,0,260
41188,210,80,80,0,0,0,370
41189,160,140,80,0,0,0,380
41190,230,180,160,240,160,320,1290
41191,160,80,80,80,160,0,560
41192,200,100,80,160,160,0,700
41193,180,140,160,160,320,0,960
41194,180,120,40,0,0,0,340
41195,230,60,40,80,0,0,410
41196,180,180,40,80,160,0,640
41197,180,140,200,80,160,0,760
41198,180,60,120,240,160,0,760
41199,210,120,120,0,0,0,450
41200,210,100,120,240,320,0,990
41201,190,100,160,80,160,320,1010
41202,230,140,40,80,160,0,650
41203,200,140,160,80,160,0,740
41204,210,140,160,80,160,320,1070
41205,190,140,160,80,0,0,570
41206,180,140,80,0,0,0,400
41207,230,120,160,160,320,0,990
41208,210,100,40,80,160,320,910
41209,180,100,120,80,160,320,960
41210,200,100,120,0,0,0,420
41211,220,60,80,160,160,0,680
41212,180,120,120,0,0,0,420
41213,220,120,120,160,160,0,780
41214,210,80,80,80,0,0,450
41215,210,80,80,160,160,320,1010
41216,220,140,80,0,0,0,440
41217,200,160,160,80,0,0,600
41218,200,160,240,240,320,320,1480
41219,220,160,120,80,0,0,580
41220,210,140,80,80,160,0,670
41221,170,140,160,160,320,0,950
41222,210,140,200,240,160,0,950
41223,200,160,120,160,320,320,1280
41224,190,160,240,80,0,0,670
41225,180,100,80,80,0,0,440
41226,210,100,120,80,160,320,990
41227,220,80,120,240,160,0,820
41228,220,160,200,240,320,0,1140
41229,190,160,80,80,0,0,510
41230,200,140,80,80,0,0,500
41231,150,120,80,0,0,0,350
41232,180,60,80,160,0,0,480
41233,160,80,120,160,320,0,840
41234,190,40,40,0,0,0,270
41235,180,120,80,80,0,0,460
41236,200,120,80,160,160,0,720
41237,210,120,120,80,160,320,1010
41238,210,140,160,80,0,0,590
41239,190,120,120,80,160,0,670
41240,180,100,120,160,160,0,720
41241,170,120,120,80,0,0,490
41242,180,140,160,160,0,0,640
41243,220,180,80,80,160,0,720
41244,220,100,120,80,160,0,680
41245,240,100,80,160,160,0,740
41246,180,80,120,160,160,0,700
41247,190,80,80,80,160,320,910
41248,210,100,120,0,0,0,430
41249,200,120,160,160,0,0,640
41250,220,100,120,240,320,0,1000
41251,190,140,160,160,0,0,650
41252,190,140,120,0,0,0,450
41253,200,100,80,80,0,0,460
41254,180,140,160,240,320,320,1360
41255,220,120,120,80,160,0,700
41256,180,100,120,160,160,0,720
41257,180,100,40,0,0,0,320
41258,200,120,80,0,0,0,400
41259,180,140,120,160,320,0,920
41260,220,180,120,80,160,0,760
41261,150,120,120,160,160,320,1030
41262,240,60,40,80,160,320,900
41263,200,180,160,80,0,0,620
41264,190,140,120,80,160,0,690
41265,210,160,120,80,160,0,730
41266,210,160,160,160,320,0,1010
41267,200,140,160,80,160,0,740
41268,180,120,120,160,160,320,1060
41269,180,100,120,0,0,0,400
41270,200,160,160,240,320,0,1080
41271,220,160,160,80,160,0,780
41272,200,140,160,160,320,320,1300
41273,190,140,160,80,0,0,570
41274,170,120,120,80,160,0,650
41275,190,140,160,0,0,0,490
41276,210,140,40,80,160,0,630
41277,210,120,120,80,0,0,530
41278,170,140,80,80,0,0,470
41279,190,140,160,240,320,320,1370
41280,240,80,40,0,0,0,360
41281,200,120,120,80,160,0,680
41282,170,140,160,240,320,320,1350
41283,210,60,40,0,0,0,310
41284,190,100,120,80,0,0,490
41285,230,120,120,80,160,0,710
41286,150,160,80,80,160,320,950
41287,170,120,80,0,0,0,370
41288,190,160,160,0,0,0,510
41289,210,80,80,80,0,0,450
41290,140,80,80,80,160,0,540
41291,180,140,80,0,0,0,400
41292,150,80,120,160,160,0,670
41293,170,120,40,0,0,0,330
41294,150,80,80,80,160,0,550
41295,230,180,120,80,160,0,770
41296,200,100,160,160,160,0,780
41297,250,140,80,80,0,0,550
41298,210,100,160,80,0,0,550
41299,250,200,200,80,160,320,1210
41300,200,100,120,0,0,0,420
41301,140,60,40,80,0,0,320
41302,210,80,120,80,0,0,490
41303,200,160,120,160,160,320,1120
41304,160,120,160,80,160,320,1000
41305,210,60,40,80,160,0,550
41306,210,100,40,0,0,0,350
41307,220,80,120,160,320,0,900
41308,170,140,160,0,0,0,470
41309,160,120,200,240,320,320,1360
41310,170,120,40,0,0,0,330
41311,170,80,80,80,0,0,410
41312,210,100,120,80,0,0,510
41313,220,120,40,80,160,0,620
41314,180,100,80,80,160,0,600
41315,200,120,120,240,0,0,680
41316,180,80,40,80,160,0,540
41317,210,140,80,160,160,0,750
41318,210,200,120,80,0,0,610
41319,170,100,80,80,160,0,590
41320,190,120,120,160,320,320,1230
41321,210,120,120,160,160,320,1090
41322,180,120,40,0,0,0,340
41323,200,100,120,160,160,0,740
41324,160,120,80,80,0,0,440
41325,160,100,120,80,0,0,460
41326,220,160,80,80,160,0,700
41327,160,160,160,80,160,0,720
41328,190,80,80,80,0,0,430
41329,160,80,120,80,160,0,600
41330,190,120,120,80,160,0,670
41331,210,120,120,240,320,0,1010
41332,220,140,200,80,160,0,800
41333,210,200,160,160,0,0,730
41334,230,100,120,80,160,0,690
41335,210,160,200,160,0,0,730
41336,220,160,80,0,0,0,460
41337,200,100,120,160,160,0,740
41338,170,100,120,80,160,0,630
41339,180,100,160,80,160,0,680
41340,180,100,80,80,0,0,440
41341,150,60,80,80,0,0,370
41342,240,120,200,240,160,0,960
41343,210,100,40,80,160,0,590
41344,190,120,80,80,160,0,630
41345,170,140,200,240,320,320,1390
41346,220,180,120,160,0,0,680
41347,210,60,0,0,0,0,270
41348,200,40,40,80,0,0,360
41349,190,60,80,80,160,0,570
41350,220,140,40,80,0,0,480
41351,200,100,120,0,0,0,420
41352,180,100,80,0,0,0,360
41353,150,120,80,80,160,320,910
41354,200,100,0,0,0,0,300
41355,230,60,80,0,0,0,370
41356,220,120,120,160,320,0,940
41357,200,80,80,0,0,0,360
41358,190,100,40,80,0,0,410
41359,200,100,160,160,160,320,1100
41360,150,120,160,160,160,320,1070
41361,180,100,120,240,320,320,1280
41362,210,200,200,160,0,0,770
41363,210,140,120,80,0,0,550
41364,210,140,120,80,160,0,710
41365,180,100,120,80,0,0,480
41366,200,180,160,80,160,0,780
41367,180,80,120,80,0,0,460
41368,230,120,80,160,160,0,750
41369,160,40,40,0,0,0,240
41370,230,120,200,80,160,0,790
41371,210,120,80,80,0,0,490
41372,210,120,80,80,160,320,970
41373,240,120,40,80,160,0,640
41374,220,180,200,240,160,0,1000
41375,220,120,120,80,0,0,540
41376,170,120,200,80,160,0,730
41377,220,120,40,0,0,0,380
41378,220,100,80,80,0,0,480
41379,180,120,160,80,160,0,700
41380,210,140,80,80,160,0,670
41381,160,140,200,80,160,0,740
41382,250,160,80,80,160,0,730
41383,200,100,120,160,320,0,900
41384,190,100,120,80,0,0,490
41385,170,60,0,0,0,0,230
41386,180,60,80,80,160,0,560
41387,190,100,80,80,160,0,610
41388,150,80,0,0,0,0,230
41389,190,140,160,80,0,0,570
41390,170,120,80,80,160,0,610
41391,190,100,80,80,0,0,450
41392,170,180,80,80,160,0,670
41393,210,140,160,160,320,320,1310
41394,200,120,160,160,320,0,960
41395,230,160,120,160,320,0,990
41396,190,180,160,80,160,0,770
41397,180,140,160,80,0,0,560
41398,200,100,80,80,0,0,460
41399,190,80,120,80,160,0,630
41400,190,140,160,0,0,0,490
41401,220,120,120,160,160,0,780
41402,210,120,120,160,160,320,1090
41403,180,120,120,80,160,0,660
41404,230,100,40,80,0,0,450
41405,210,120,120,240,0,0,690
41406,220,160,80,80,0,0,540
41407,160,100,120,160,160,0,700
41408,210,100,120,80,0,0,510
41409,160,160,160,160,320,0,960
41410,210,140,120,160,320,320,1270
41411,210,120,40,80,0,0,450
41412,180,140,40,80,160,0,600
41413,160,100,40,0,0,0,300
41414,190,140,120,0,0,0,450
41415,170,120,120,160,0,0,570
41416,200,120,80,0,0,0,400
41417,170,100,80,0,0,0,350
41418,210,120,40,0,0,0,370
41419,220,80,40,0,0,0,340
41420,180,120,40,0,0,0,340
41421,210,140,80,80,160,0,670
41422,180,120,120,160,320,0,900
41423,240,120,80,160,320,0,920
41424,230,160,120,160,160,0,830
41425,190,100,120,80,160,320,970
41426,180,100,120,0,0,0,400
41427,210,140,80,0,0,0,430
41428,210,120,40,0,0,0,370
41429,170,160,120,160,320,0,930
41430,190,160,120,160,160,0,790
41431,200,60,120,80,0,0,460
41432,170,80,120,80,160,0,610
41433,200,100,200,160,160,0,820
41434,180,60,0,0,0,0,240
41435,210,160,200,240,160,0,970
41436,190,80,40,80,160,0,550
41437,180,140,120,80,0,0,520
41438,180,140,200,160,320,320,1320
41439,190,180,200,80,0,0,650
41440,240,140,80,80,160,0,700
41441,200,120,200,160,0,0,680
41442,170,80,80,0,0,0,330
41443,200,60,80,0,0,0,340
41444,220,200,160,160,0,0,740
41445,220,120,80,80,160,0,660
41446,170,100,80,80,0,0,430
41447,210,120,120,160,160,0,770
41448,170,120,120,80,160,0,650
41449,230,200,200,160,160,320,1270
41450,220,160,120,80,160,0,740
41451,200,120,120,240,160,0,840
41452,180,100,160,80,160,0,680
41453,190,120,120,80,160,0,670
41454,180,80,0,0,0,0,260
41455,200,180,160,80,0,0,620
41456,210,100,80,80,160,0,630
41457,160,120,80,0,0,0,360
41458,240,180,120,0,0,0,540
41459,180,40,0,0,0,0,220
41460,180,80,80,160,0,0,500
41461,220,120,40,80,0,0,460
41462,220,140,80,0,0,0,440
41463,210,120,80,80,160,0,650
41464,180,100,80,80,160,0,600
41465,170,120,40,0,0,0,330
41466,180,100,80,160,160,0,680
41467,190,100,120,80,0,0,490
41468,180,140,120,80,0,0,520
41469,210,140,160,240,160,0,910
41470,150,100,120,160,160,0,690
41471,190,120,80,80,0,0,470
41472,180,160,80,80,160,0,660
41473,200,80,120,160,160,0,720
41474,190,80,120,240,320,320,1270
41475,170,100,80,80,160,0,590
41476,190,140,40,80,160,0,610
41477,200,180,160,80,160,0,780
41478,230,140,120,160,320,0,970
41479,190,120,80,0,0,0,390
41480,200,160,80,0,0,0,440
41481,200,80,80,160,160,0,680
41482,170,100,120,0,0,0,390
41483,200,120,200,240,160,0,920
41484,180,140,40,0,0,0,360
41485,180,120,120,80,0,0,500
41486,210,160,80,80,160,0,690
41487,140,140,120,160,160,0,720
41488,230,140,160,80,160,0,770
41489,200,120,80,160,160,320,1040
41490,190,60,40,80,0,0,370
41491,230,140,160,160,160,0,850
41492,210,120,80,0,0,0,410
41493,220,120,40,0,0,0,380
41494,160,80,80,80,160,0,560
41495,210,140,120,80,160,0,710
41496,240,180,80,160,160,0,820
41497,210,160,80,80,0,0,530
41498,200,100,80,80,0,0,460
41499,200,140,160,240,160,0,900
41500,190,120,160,160,160,0,790
41501,190,140,200,240,160,0,930
41502,180,80,40,0,0,0,300
41503,170,60,0,0,0,0,230
41504,210,100,40,80,160,0,590
41505,220,120,160,160,320,0,980
41506,190,80,80,80,0,0,430
41507,180,160,160,160,160,320,1140
41508,240,80,80,80,0,0,480
41509,200,100,0,0,0,0,300
41510,210,140,120,160,320,0,950
41511,230,140,40,80,160,320,970
41512,200,40,40,80,0,0,360
41513,200,100,120,160,160,0,740
41514,220,180,80,160,160,0,800
41515,180,60,80,80,160,0,560
41516,200,180,160,160,320,320,1340
41517,160,120,40,80,0,0,400
41518,190,80,80,160,320,320,1150
41519,220,120,80,80,0,0,500
41520,150,100,160,80,0,0,490
41521,180,60,80,80,160,0,560
41522,140,100,40,80,160,0,520
41523,230,140,120,160,160,0,810
41524,220,120,80,80,0,0,500
41525,200,120,160,160,160,0,800
41526,170,60,120,80,160,0,590
41527,200,120,160,80,160,0,720
41528,180,80,40,80,160,0,540
41529,160,140,120,80,0,0,500
41530,220,180,240,240,0,0,880
41531,220,140,40,0,0,0,400
41532,130,80,120,160,160,0,650
41533,210,140,80,80,0,0,510
41534,180,60,40,80,160,0,520
41535,190,40,40,80,160,320,830
41536,150,100,120,80,0,0,450
41537,180,140,160,80,160,320,1040
41538,220,60,40,80,0,0,400
41539,210,140,120,160,160,320,1110
41540,170,120,40,80,160,0,570
41541,210,160,120,80,0,0,570
41542,240,140,160,240,320,0,1100
41543,210,140,80,160,0,0,590
41544,190,40,40,80,160,0,510
41545,220,180,0,0,0,0,400
41546,210,140,200,80,160,0,790
41547,200,140,80,80,0,0,500
41548,190,100,120,0,0,0,410
41549,210,180,80,80,0,0,550
41550,190,100,80,80,0,0,450
41551,190,140,120,80,160,0,690
41552,190,100,80,80,160,0,610
41553,190,140,160,80,0,0,570
41554,200,100,80,160,320,0,860
41555,180,160,160,80,160,0,740
41556,180,100,80,80,160,0,600
41557,210,200,120,80,160,0,770
41558,220,60,0,0,0,0,280
41559,220,200,80,80,0,0,580
41560,200,140,160,160,160,0,820
41561,200,140,120,240,320,320,1340
41562,200,80,120,240,160,0,800
41563,220,200,200,160,0,0,780
41564,160,140,120,80,160,0,660
41565,200,60,40,80,0,0,380
41566,210,100,120,80,160,0,670
41567,160,140,120,80,0,0,500
41568,210,100,40,0,0,0,350
41569,180,120,80,80,160,0,620
41570,220,180,160,160,160,0,880
41571,180,160,120,0,0,0,460
41572,210,140,160,80,0,0,590
41573,230,140,80,80,0,0,530
41574,200,120,80,80,0,0,480
41575,240,100,80,160,320,0,900
41576,170,140,80,0,0,0,390
41577,190,180,200,240,160,0,970
41578,220,80,40,0,0,0,340
41579,180,60,80,80,0,0,400
41580,210,120,80,80,160,0,650
41581,230,80,80,80,160,320,950
41582,190,180,80,80,0,0,530
41583,190,100,120,80,0,0,490
41584,150,80,120,0,0,0,350
41585,170,120,120,80,160,320,970
41586,220,120,40,80,160,0,620
41587,180,140,120,160,160,0,760
41588,180,100,120,160,0,0,560
41589,170,80,80,0,0,0,330
41590,210,80,80,80,0,0,450
41591,190,80,120,80,0,0,470
41592,230,120,80,80,160,0,670
41593,180,120,120,80,0,0,500
41594,240,120,80,80,160,320,1000
41595,190,100,0,0,0,0,290
41596,240,180,160,160,160,0,900
41597,240,120,160,80,160,0,760
41598,180,120,80,160,320,0,860
41599,170,40,40,80,160,0,490
41600,210,60,80,80,160,0,590
41601,200,140,0,0,0,0,340
41602,240,140,160,160,320,320,1340
41603,210,140,160,160,160,0,830
41604,190,120,160,80,160,320,1030
41605,190,140,0,0,0,0,330
41606,200,180,200,160,160,0,900
41607,190,80,80,80,160,0,590
41608,190,100,200,240,320,320,1370
41609,210,180,200,160,320,0,1070
41610,170,100,120,160,0,0,550
41611,220,80,0,0,0,0,300
41612,190,100,120,80,0,0,490
41613,180,120,120,80,0,0,500
41614,220,120,120,160,160,0,780
41615,190,100,160,160,160,0,770
41616,180,100,120,80,0,0,480
41617,170,180,120,80,0,0,550
41618,220,120,160,160,160,0,820
41619,180,120,160,160,160,0,780
41620,220,140,240,160,0,0,760
41621,210,160,200,240,160,0,970
41622,230,140,80,80,160,320,1010
41623,210,120,80,160,160,320,1050
41624,220,160,200,160,160,0,900
41625,210,120,120,160,320,320,1250
41626,180,180,120,160,160,0,800
41627,200,140,160,160,160,320,1140
41628,170,120,160,160,160,0,770
41629,190,140,240,240,160,0,970
41630,210,80,80,0,0,0,370
41631,190,160,160,160,160,0,830
41632,170,100,40,80,160,0,550
41633,200,120,120,80,160,0,680
41634,160,100,120,80,0,0,460
41635,180,120,120,160,0,0,580
41636,240,140,40,0,0,0,420
41637,230,100,120,80,160,0,690
41638,200,140,160,160,160,0,820
41639,200,100,80,80,160,0,620
41640,200,120,80,80,160,0,640
41641,190,100,80,80,0,0,450
41642,250,160,120,80,0,0,610
41643,190,140,160,240,320,0,1050
41644,240,120,120,160,320,320,1280
41645,190,120,80,80,0,0,470
41646,210,100,80,80,160,0,630
41647,190,80,80,0,0,0,350
41648,190,140,80,80,0,0,490
41649,170,80,80,80,160,320,890
41650,200,120,120,160,160,0,760
41651,180,120,80,80,0,0,460
41652,160,100,80,80,160,0,580
41653,190,140,120,80,160,0,690
41654,190,140,120,160,160,0,770
41655,210,60,40,80,160,0,550
41656,200,140,160,240,320,0,1060
41657,200,140,40,0,0,0,380
41658,190,100,120,160,320,320,1210
41659,200,40,40,0,0,0,280
41660,250,180,120,160,160,320,1190
41661,200,100,40,80,160,0,580
41662,240,140,160,160,160,0,860
41663,230,140,120,0,0,0,490
41664,160,120,120,160,320,320,1200
41665,230,80,80,80,160,0,630
41666,190,160,160,80,160,0,750
41667,230,160,80,80,160,0,710
41668,190,120,120,160,160,320,1070
41669,230,180,160,160,160,0,890
41670,250,120,40,0,0,0,410
41671,240,160,160,160,320,320,1360
41672,200,200,160,160,160,0,880
41673,250,160,120,80,160,0,770
41674,220,120,120,80,160,0,700
41675,220,100,80,80,160,0,640
41676,190,100,80,0,0,0,370
41677,180,100,120,160,160,0,720
41678,230,160,160,240,320,320,1430
41679,190,140,120,80,160,0,690
41680,210,160,120,80,0,0,570
41681,220,120,80,160,0,0,580
41682,220,120,80,160,0,0,580
41683,170,100,120,80,160,0,630
41684,210,120,160,160,160,320,1130
41685,230,140,160,160,320,0,1010
41686,200,140,120,160,160,0,780
41687,250,160,120,80,0,0,610
41688,160,120,160,160,0,0,600
41689,180,100,40,80,160,0,560
41690,240,120,120,80,160,0,720
41691,210,100,80,160,0,0,550
41692,190,140,160,160,320,0,970
41693,170,120,120,160,160,320,1050
41694,190,120,120,80,0,0,510
41695,210,80,80,80,160,0,610
41696,220,140,40,0,0,0,400
41697,240,120,40,0,0,0,400
41698,190,140,200,0,0,0,530
41699,160,140,120,80,160,0,660
41700,190,140,120,160,320,0,930
41701,180,100,120,160,160,0,720
41702,190,80,80,160,160,0,670
41703,200,100,40,80,0,0,420
41704,180,100,80,80,160,0,600
41705,190,100,80,80,0,0,450
41706,160,100,80,0,0,0,340
41707,240,160,120,0,0,0,520
41708,200,140,40,80,160,320,940
41709,220,140,120,80,160,0,720
41710,200,120,40,80,0,0,440
41711,220,140,80,160,160,320,1080
41712,200,180,80,0,0,0,460
41713,180,140,120,240,160,0,840
41714,190,120,80,80,160,320,950
41715,200,100,120,80,160,0,660
41716,200,100,160,160,160,320,1100
41717,220,120,160,160,160,0,820
41718,210,140,40,80,0,0,470
41719,190,100,120,160,0,0,570
41720,200,80,120,80,160,320,960
41721,160,120,40,80,160,320,880
41722,260,120,120,160,160,0,820
41723,180,140,160,80,0,0,560
41724,190,120,120,240,160,0,830
41725,210,120,80,80,0,0,490
41726,190,100,80,80,0,0,450
41727,170,120,80,160,320,0,850
41728,170,60,120,0,0,0,350
41729,170,80,80,80,160,0,570
41730,170,80,80,160,160,0,650
41731,200,160,120,0,0,0,480
41732,220,160,120,80,160,320,1060
41733,180,140,80,80,0,0,480
41734,170,180,200,160,160,0,870
41735,200,80,0,0,0,0,280
41736,190,140,120,160,160,320,1090
41737,170,160,160,0,0,0,490
41738,210,200,160,0,0,0,570
41739,210,100,40,80,160,0,590
41740,180,140,120,160,0,0,600
41741,210,120,120,80,0,0,530
41742,190,120,120,80,160,0,670
41743,200,140,80,80,160,0,660
41744,200,100,80,80,160,0,620
41745,190,60,120,80,160,0,610
41746,230,140,120,160,320,0,970
41747,200,100,160,80,0,0,540
41748,210,200,80,80,0,0,570
41749,240,140,80,80,160,0,700
41750,160,140,80,80,0,0,460
41751,240,180,200,160,160,0,940
41752,190,140,80,80,160,320,970
41753,150,100,80,80,0,0,410
41754,190,60,40,0,0,0,290
41755,180,100,120,240,320,0,960
41756,210,100,120,240,320,0,990
41757,230,180,120,80,0,0,610
41758,220,120,120,80,0,0,540
41759,220,140,120,240,160,0,880
41760,200,120,200,160,160,0,840
41761,160,100,120,240,0,0,620
41762,230,100,40,80,160,0,610
41763,180,100,120,80,0,0,480
41764,210,120,120,80,160,0,690
41765,210,120,120,240,320,0,1010
41766,170,80,120,80,0,0,450
41767,170,140,160,160,160,320,1110
41768,180,100,80,80,0,0,440
41769,190,80,120,80,160,0,630
41770,180,40,0,0,0,0,220
41771,220,160,120,160,160,0,820
41772,170,140,80,160,0,0,550
41773,210,120,120,80,160,320,1010
41774,190,100,80,80,160,0,610
41775,180,100,120,80,160,0,640
41776,210,100,160,160,160,320,1110
41777,210,120,80,80,160,0,650
41778,190,80,40,80,160,320,870
41779,180,100,40,80,160,0,560
41780,170,160,40,80,160,0,610
41781,190,160,240,80,160,0,830
41782,170,140,80,0,0,0,390
41783,170,100,80,160,0,0,510
41784,240,120,80,160,0,0,600
41785,200,140,200,160,160,0,860
41786,190,140,120,80,160,0,690
41787,190,60,80,160,160,0,650
41788,220,100,120,240,160,320,1160
41789,200,120,120,160,160,0,760
41790,160,140,200,160,160,0,820
41791,190,100,120,80,160,320,970
41792,190,160,40,0,0,0,390
41793,230,140,80,0,0,0,450
41794,210,120,120,80,0,0,530
41795,210,120,80,80,0,0,490
41796,220,160,120,80,160,0,740
41797,190,80,80,80,160,0,590
41798,180,100,80,80,0,0,440
41799,180,140,200,240,320,0,1080
41800,220,160,200,240,0,0,820
41801,230,140,160,80,160,0,770
41802,180,80,0,0,0,0,260
41803,180,80,80,0,0,0,340
41804,210,140,160,160,160,320,1150
41805,230,160,80,80,160,0,710
41806,180,120,120,80,160,320,980
41807,210,80,80,80,160,320,930
41808,190,140,80,160,160,0,730
41809,210,160,160,80,160,320,1090
41810,200,100,120,160,160,0,740
41811,210,120,80,80,160,0,650
41812,200,160,120,160,160,0,800
41813,220,120,120,0,0,0,460
41814,160,100,40,80,0,0,380
41815,190,80,80,80,160,0,590
41816,220,160,160,240,320,320,1420
41817,220,80,40,0,0,0,340
41818,220,160,40,0,0,0,420
41819,220,80,40,0,0,0,340
41820,200,140,120,80,160,0,700
41821,220,140,160,80,160,320,1080
41822,170,100,120,0,0,0,390
41823,160,120,120,160,160,0,720
41824,240,120,160,0,0,0,520
41825,220,120,120,160,0,0,620
41826,180,80,80,80,0,0,420
41827,200,100,120,160,160,0,740
41828,190,100,120,80,160,0,650
41829,190,120,80,80,0,0,470
41830,160,60,40,80,160,0,500
41831,240,160,160,160,160,0,880
41832,170,140,80,80,0,0,470
41833,190,120,120,160,160,0,750
41834,180,120,40,80,0,0,420
41835,190,140,120,0,0,0,450
41836,220,60,80,0,0,0,360
41837,220,120,40,0,0,0,380
41838,190,140,80,160,160,0,730
41839,190,60,40,0,0,0,290
41840,170,100,80,160,160,0,670
41841,210,120,160,80,0,0,570
41842,210,140,120,80,160,0,710
41843,220,100,160,160,320,0,960
41844,200,120,80,80,160,0,640
41845,180,120,120,160,320,0,900
41846,180,120,160,80,0,0,540
41847,180,180,160,160,160,320,1160
41848,170,80,80,160,160,0,650
41849,200,80,80,80,160,0,600
41850,190,80,80,80,0,0,430
41851,190,120,160,160,160,0,790
41852,210,120,40,0,0,0,370
41853,210,120,80,0,0,0,410
41854,200,80,40,0,0,0,320
41855,200,100,40,0,0,0,340
41856,160,100,40,80,160,0,540
41857,150,20,0,0,0,0,170
41858,180,120,120,80,0,0,500
41859,180,120,120,0,0,0,420
41860,180,120,160,160,0,0,620
41861,220,80,40,0,0,0,340
41862,190,80,80,80,160,0,590
41863,220,80,40,0,0,0,340
41864,210,100,160,0,0,0,470
41865,240,160,80,0,0,0,480
41866,160,100,80,80,160,0,580
41867,210,140,120,160,160,0,790
41868,180,140,160,80,160,0,720
41869,200,60,40,0,0,0,300
41870,180,20,0,0,0,0,200
41871,200,60,80,0,0,0,340
41872,210,100,80,80,160,320,950
41873,200,80,120,160,0,0,560
41874,200,120,120,160,160,320,1080
41875,210,100,120,0,0,0,430
41876,180,100,80,0,0,0,360
41877,210,140,120,80,160,0,710
41878,210,100,40,80,160,0,590
41879,160,100,80,0,0,0,340
41880,230,200,120,160,160,0,870
41881,190,140,120,80,160,320,1010
41882,180,140,80,80,160,0,640
41883,190,100,80,160,160,0,690
41884,200,160,120,80,160,0,720
41885,230,140,120,0,0,0,490
41886,230,120,80,80,160,0,670
41887,170,100,120,160,160,0,710
41888,180,120,120,80,0,0,500
41889,240,100,40,80,0,0,460
41890,170,60,40,80,160,0,510
41891,180,140,120,240,320,0,1000
41892,200,160,120,80,160,0,720
41893,210,40,40,0,0,0,290
41894,230,160,240,160,160,0,950
41895,240,160,40,0,0,0,440
41896,180,160,120,240,0,0,700
41897,190,80,80,160,160,0,670
41898,160,60,80,0,0,0,300
41899,160,60,40,0,0,0,260
41900,200,160,40,80,0,0,480
41901,160,100,120,160,160,320,1020
41902,200,100,120,0,0,0,420
41903,250,120,40,80,0,0,490
41904,210,100,40,80,0,0,430
41905,220,120,160,160,160,320,1140
41906,210,140,80,160,160,0,750
41907,160,160,200,240,320,320,1400
41908,210,60,40,80,160,320,870
41909,210,160,120,160,0,0,650
41910,140,80,80,80,160,0,540
41911,220,180,160,80,160,320,1120
41912,240,120,120,80,0,0,560
41913,170,100,80,80,0,0,430
41914,220,120,80,0,0,0,420
41915,190,120,80,80,160,0,630
41916,220,60,40,80,0,0,400
41917,210,140,120,240,320,0,1030
41918,220,160,240,80,0,0,700
41919,150,140,40,0,0,0,330
41920,230,140,120,0,0,0,490
41921,160,120,80,160,0,0,520
41922,250,160,0,0,0,0,410
41923,190,180,120,240,320,320,1370
41924,210,140,120,160,320,0,950
41925,200,160,80,160,160,0,760
41926,240,120,120,160,0,0,640
41927,180,100,120,80,0,0,480
41928,240,120,160,80,0,0,600
41929,220,80,80,80,0,0,460
41930,190,160,80,0,0,0,430
41931,200,120,160,160,0,0,640
41932,250,140,80,160,160,0,790
41933,210,160,80,80,160,0,690
41934,150,100,160,240,0,0,650
41935,180,120,40,80,0,0,420
41936,180,180,120,160,0,0,640
41937,200,140,120,80,160,0,700
41938,190,140,40,80,0,0,450
41939,160,100,120,80,160,320,940
41940,210,100,40,0,0,0,350
41941,200,100,80,80,0,0,460
41942,190,60,120,160,320,320,1170
41943,210,100,120,0,0,0,430
41944,170,120,120,80,160,320,970
41945,190,80,40,80,160,0,550
41946,190,60,80,160,160,320,970
41947,190,80,120,160,320,0,870
41948,180,120,80,80,160,0,620
41949,220,100,120,80,0,0,520
41950,190,140,40,80,0,0,450
41951,190,140,40,80,160,320,930
41952,230,180,120,80,160,0,770
41953,210,160,80,80,160,0,690
41954,240,220,160,80,0,0,700
41955,210,100,40,80,0,0,430
41956,210,100,120,80,160,0,670
41957,190,140,160,80,160,0,730
41958,180,120,200,240,320,0,1060
41959,220,160,200,160,0,0,740
41960,200,120,40,0,0,0,360
41961,170,160,120,0,0,0,450
41962,240,100,80,80,160,320,980
41963,170,100,80,80,0,0,430
41964,200,140,200,160,320,320,1340
41965,190,160,80,80,0,0,510
41966,200,160,80,160,160,0,760
41967,210,80,0,0,0,0,290
41968,150,80,80,80,160,0,550
41969,180,100,80,80,160,0,600
41970,200,180,80,80,160,0,700
41971,230,40,40,80,0,0,390
41972,170,140,240,240,0,0,790
41973,220,120,120,160,320,320,1260
41974,220,100,80,80,0,0,480
41975,240,160,80,80,160,0,720
41976,180,160,160,240,160,0,900
41977,180,100,120,80,160,0,640
41978,220,140,120,240,320,0,1040
41979,200,100,120,80,160,0,660
41980,190,120,40,80,160,0,590
41981,170,100,80,0,0,0,350
41982,200,120,160,160,0,0,640
41983,160,120,160,240,160,0,840
41984,220,100,120,160,160,0,760
41985,170,100,80,0,0,0,350
41986,190,160,160,80,160,320,1070
41987,230,100,40,0,0,0,370
41988,230,160,160,240,160,0,950
41989,200,160,240,240,320,0,1160
41990,190,100,160,160,0,0,610
41991,250,140,120,0,0,0,510
41992,220,160,120,0,0,0,500
41993,190,60,120,80,0,0,450
41994,180,120,120,160,320,320,1220
41995,210,100,120,160,160,320,1070
41996,170,140,120,160,160,0,750
41997,190,140,80,160,0,0,570
41998,200,140,160,80,160,0,740
41999,210,120,40,80,160,0,610
42000,150,120,80,80,0,0,430
42001,220,140,120,0,0,0,480
42002,180,160,120,80,0,0,540
42003,200,80,80,80,0,0,440
42004,210,80,80,160,0,0,530
42005,230,100,80,80,160,320,970
42006,210,140,120,80,0,0,550
42007,150,140,160,80,0,0,530
42008,170,140,160,80,160,320,1030
42009,180,80,40,0,0,0,300
42010,210,140,120,80,160,0,710
42011,230,180,120,160,160,0,850
42012,180,100,120,80,160,0,640
42013,190,140,120,160,160,0,770
42014,140,160,120,80,160,0,660
42015,220,160,120,160,320,0,980
42016,180,120,80,0,0,0,380
42017,210,80,120,160,320,0,890
42018,210,120,160,160,160,320,1130
42019,250,100,80,80,0,0,510
42020,160,120,120,160,160,0,720
42021,180,160,120,80,0,0,540
42022,200,180,120,160,160,0,820
42023,170,100,120,0,0,0,390
42024,200,120,120,160,160,0,760
42025,220,120,40,80,0,0,460
42026,190,120,80,0,0,0,390
42027,200,100,80,160,320,320,1180
42028,230,200,160,80,0,0,670
42029,190,160,160,160,160,0,830
42030,200,180,160,240,160,0,940
42031,200,100,120,160,320,0,900
42032,190,120,80,80,160,0,630
42033,190,140,120,80,0,0,530
42034,200,140,120,160,320,0,940
42035,220,100,40,80,160,0,600
42036,220,120,40,80,0,0,460
42037,160,120,80,80,0,0,440
42038,220,160,80,80,0,0,540
42039,200,180,160,240,320,0,1100
42040,230,120,80,80,160,0,670
42041,190,140,80,160,160,0,730
42042,170,100,160,160,320,0,910
42043,230,180,40,80,160,0,690
42044,200,100,160,160,160,0,780
42045,190,160,80,0,0,0,430
42046,170,140,120,160,0,0,590
42047,170,120,80,0,0,0,370
42048,160,60,120,160,320,0,820
42049,210,140,160,80,0,0,590
42050,210,140,160,160,320,0,990
42051,210,140,40,0,0,0,390
42052,140,100,80,160,320,0,800
42053,190,80,160,160,160,0,750
42054,210,80,80,80,160,0,610
42055,160,120,120,160,160,0,720
42056,200,160,160,160,160,0,840
42057,200,80,80,80,160,320,920
42058,200,100,160,80,160,0,700
42059,190,120,80,160,320,0,870
42060,220,100,80,80,0,0,480
42061,200,120,160,160,0,0,640
42062,170,160,80,80,0,0,490
42063,220,100,80,80,160,320,960
42064,190,140,120,160,0,0,610
42065,190,100,120,160,160,0,730
42066,180,160,120,160,160,0,780
42067,220,140,80,160,160,0,760
42068,190,140,160,0,0,0,490
42069,190,120,240,160,0,0,710
42070,190,140,120,0,0,0,450
42071,220,60,120,160,0,0,560
42072,200,80,80,0,0,0,360
42073,190,120,80,80,160,320,950
42074,210,140,120,80,160,0,710
42075,190,140,80,0,0,0,410
42076,240,100,160,80,0,0,580
42077,170,100,80,80,0,0,430
42078,170,100,80,0,0,0,350
42079,190,120,80,0,0,0,390
42080,160,80,120,160,0,0,520
42081,200,80,40,80,0,0,400
42082,170,120,160,80,160,0,690
42083,210,180,160,160,0,0,710
42084,210,120,120,240,160,0,850
42085,170,120,40,0,0,0,330
42086,220,160,40,80,160,320,980
42087,240,180,160,160,320,0,1060
42088,240,140,120,160,160,0,820
42089,180,140,120,0,0,0,440
42090,150,100,40,80,0,0,370
42091,190,140,240,160,160,0,890
42092,210,120,160,80,0,0,570
42093,140,140,80,80,0,0,440
42094,180,100,40,0,0,0,320
42095,180,100,80,80,160,0,600
42096,210,120,120,0,0,0,450
42097,220,140,120,160,160,0,800
42098,220,120,160,160,160,0,820
42099,200,140,120,240,320,320,1340
42100,200,140,120,80,160,0,700
42101,220,100,40,0,0,0,360
42102,190,120,120,80,160,0,670
42103,180,120,80,80,160,0,620
42104,210,120,80,80,160,320,970
42105,210,120,120,160,160,320,1090
42106,210,100,80,80,160,320,950
42107,200,160,200,240,320,320,1440
42108,130,60,80,0,0,0,270
42109,200,100,80,80,160,0,620
42110,170,60,80,80,0,0,390
42111,230,120,40,80,160,0,630
42112,160,120,120,160,160,320,1040
42113,150,140,200,160,160,0,810
42114,190,120,120,160,160,0,750
42115,220,120,120,160,160,0,780
42116,230,180,120,80,160,0,770
42117,190,120,160,80,0,0,550
42118,180,120,120,160,160,0,740
42119,200,60,40,80,0,0,380
42120,170,80,120,240,320,320,1250
42121,160,160,160,160,320,0,960
42122,220,160,120,80,160,0,740
42123,200,80,80,160,0,0,520
42124,210,160,120,160,320,0,970
42125,190,100,80,0,0,0,370
42126,190,80,40,0,0,0,310
42127,180,140,120,160,160,0,760
42128,160,140,160,160,0,0,620
42129,180,100,80,80,160,0,600
42130,200,60,80,80,0,0,420
42131,210,100,80,80,160,0,630
42132,220,140,120,160,160,320,1120
42133,170,60,80,160,0,0,470
42134,180,160,80,80,0,0,500
42135,200,160,80,80,160,0,680
42136,200,100,40,80,0,0,420
42137,180,120,160,240,160,0,860
42138,210,200,160,80,160,0,810
42139,140,120,120,160,160,0,700
42140,250,120,80,0,0,0,450
42141,190,120,160,160,160,320,1110
42142,210,140,160,80,160,0,750
42143,200,120,0,0,0,0,320
42144,190,80,120,80,160,0,630
42145,200,160,120,160,320,0,960
42146,180,120,120,160,160,0,740
42147,180,80,40,0,0,0,300
42148,170,100,80,80,160,320,910
42149,210,80,80,80,160,320,930
42150,200,180,160,240,160,0,940
42151,190,140,80,80,160,0,650
42152,230,160,80,80,160,0,710
42153,150,80,120,80,0,0,430
42154,230,140,40,0,0,0,410
42155,200,160,160,160,160,320,1160
42156,190,140,80,0,0,0,410
42157,170,160,120,240,160,0,850
42158,190,140,80,80,0,0,490
42159,140,120,120,160,160,320,1020
42160,140,80,40,0,0,0,260
42161,190,80,80,80,160,320,910
42162,210,100,80,80,160,0,630
42163,200,200,160,160,160,0,880
42164,200,180,160,160,160,0,860
42165,210,140,160,160,0,0,670
42166,200,100,80,160,160,0,700
42167,160,100,40,0,0,0,300
42168,240,200,160,0,0,0,600
42169,250,100,40,80,0,0,470
42170,200,100,80,160,160,0,700
42171,190,120,80,0,0,0,390
42172,200,160,160,160,160,0,840
42173,170,140,120,80,160,0,670
42174,190,160,160,80,0,0,590
42175,150,140,160,240,160,0,850
42176,160,100,120,160,0,0,540
42177,180,160,160,0,0,0,500
42178,210,140,80,80,0,0,510
42179,180,180,80,80,0,0,520
42180,190,120,160,160,160,0,790
42181,180,120,120,80,160,0,660
42182,160,60,40,80,160,0,500
42183,220,60,80,160,320,0,840
42184,150,140,160,160,160,0,770
42185,180,100,40,0,0,0,320
42186,160,80,40,0,0,0,280
42187,190,180,160,160,320,0,1010
42188,140,100,120,160,160,0,680
42189,170,60,120,80,0,0,430
42190,200,140,80,80,160,0,660
42191,180,120,120,160,160,320,1060
42192,230,120,80,80,160,0,670
42193,230,120,160,160,0,0,670
42194,210,160,160,80,0,0,610
42195,190,140,160,160,160,0,810
42196,190,140,160,80,0,0,570
42197,190,100,40,80,0,0,410
42198,220,120,120,160,0,0,620
42199,240,140,120,0,0,0,500
42200,160,60,40,80,160,0,500
42201,170,80,120,160,160,0,690
42202,160,140,80,80,160,0,620
42203,180,160,80,80,0,0,500
42204,200,100,80,160,320,0,860
42205,170,80,120,160,320,320,1170
42206,230,120,120,160,160,0,790
42207,210,160,160,80,0,0,610
42208,200,160,200,160,320,0,1040
42209,180,100,40,0,0,0,320
42210,200,100,120,80,160,0,660
42211,200,160,160,240,160,0,920
42212,170,60,80,80,0,0,390
42213,210,180,80,80,160,0,710
42214,140,120,120,160,320,320,1180
42215,200,120,120,80,160,320,1000
42216,180,120,160,80,160,0,700
42217,190,100,80,80,160,320,930
42218,180,160,120,160,320,320,1260
42219,210,180,120,80,0,0,590
42220,200,80,40,80,0,0,400
42221,180,80,80,80,160,0,580
42222,180,140,120,80,0,0,520
42223,190,80,80,80,0,0,430
42224,180,160,120,80,160,0,700
42225,270,160,120,240,160,0,950
42226,240,80,80,80,160,0,640
42227,210,120,80,80,160,0,650
42228,190,160,160,240,320,320,1390
42229,180,140,120,80,160,0,680
42230,170,80,120,160,0,0,530
42231,190,80,80,160,0,0,510
42232,220,80,120,0,0,0,420
42233,160,60,40,80,160,0,500
42234,200,80,120,160,160,0,720
42235,180,100,40,0,0,0,320
42236,160,140,160,160,320,0,940
42237,170,140,160,240,0,0,710
42238,210,120,40,80,0,0,450
42239,180,120,120,80,160,0,660
42240,200,120,160,80,160,0,720
42241,200,140,80,80,0,0,500
42242,140,140,120,160,160,0,720
42243,210,140,120,80,160,0,710
42244,230,140,160,240,320,320,1410
42245,180,120,120,0,0,0,420
42246,190,120,80,0,0,0,390
42247,210,120,80,80,0,0,490
42248,150,140,80,80,160,320,930
42249,160,160,120,80,160,0,680
42250,200,160,120,80,0,0,560
42251,200,160,120,80,160,0,720
42252,190,100,80,80,0,0,450
42253,170,120,160,240,160,0,850
42254,160,120,80,80,0,0,440
42255,210,120,40,0,0,0,370
42256,220,160,120,160,320,0,980
42257,240,220,200,160,320,0,1140
42258,160,40,80,80,160,0,520
42259,210,100,80,160,160,0,710
42260,220,140,120,0,0,0,480
42261,220,140,120,80,160,0,720
42262,150,160,200,240,160,320,1230
42263,210,120,120,160,320,320,1250
42264,240,160,160,80,160,0,800
42265,210,100,80,0,0,0,390
42266,160,80,160,80,160,0,640
42267,260,200,240,160,0,0,860
42268,200,140,160,160,160,0,820
42269,220,140,40,0,0,0,400
42270,160,160,160,240,160,0,880
42271,200,140,40,0,0,0,380
42272,190,140,80,0,0,0,410
42273,190,100,80,80,160,0,610
42274,150,80,80,80,160,320,870
42275,190,140,120,80,0,0,530
42276,200,160,80,80,0,0,520
42277,230,160,200,160,160,320,1230
42278,230,100,80,80,0,0,490
42279,190,140,160,160,0,0,650
42280,170,100,80,80,0,0,430
42281,160,120,160,240,160,0,840
42282,230,120,80,160,160,0,750
42283,200,120,120,160,160,0,760
42284,240,140,120,160,160,0,820
42285,240,180,120,80,160,0,780
42286,180,80,80,0,0,0,340
42287,170,80,80,0,0,0,330
42288,180,120,120,0,0,0,420
42289,180,40,80,160,320,320,1100
42290,220,160,120,160,320,0,980
42291,150,80,80,80,160,0,550
42292,190,180,160,160,0,0,690
42293,220,180,120,160,0,0,680
42294,170,120,80,0,0,0,370
42295,190,120,80,160,160,0,710
42296,170,120,40,80,160,0,570
42297,190,100,40,80,160,0,570
42298,190,140,80,0,0,0,410
42299,170,120,120,160,160,0,730
42300,250,180,120,160,320,0,1030
42301,190,140,160,160,0,0,650
42302,180,200,160,0,0,0,540
42303,160,140,120,80,160,0,660
42304,180,120,160,240,160,320,1180
42305,210,140,120,160,0,0,630
42306,220,120,120,80,160,0,700
42307,220,100,120,160,160,0,760
42308,160,100,120,80,160,320,940
42309,220,120,120,160,320,0,940
42310,220,140,80,0,0,0,440
42311,250,160,40,80,160,0,690
42312,210,160,160,160,320,0,1010
42313,230,120,80,80,160,320,990
42314,210,100,80,160,0,0,550
42315,200,80,0,0,0,0,280
42316,190,140,40,80,160,0,610
42317,150,60,40,80,160,0,490
42318,180,120,120,160,320,320,1220
42319,190,160,200,80,0,0,630
42320,150,120,160,160,160,320,1070
42321,190,140,160,80,160,0,730
42322,190,80,0,0,0,0,270
42323,170,100,80,80,0,0,430
42324,190,140,120,80,160,0,690
42325,230,100,120,80,0,0,530
42326,190,160,120,240,0,0,710
42327,180,140,200,240,320,320,1400
42328,190,140,80,160,0,0,570
42329,180,80,80,80,160,0,580
42330,210,140,80,160,320,0,910
42331,170,80,40,0,0,0,290
42332,190,100,120,80,0,0,490
42333,220,160,120,160,320,320,1300
42334,200,100,80,80,160,0,620
42335,200,80,80,80,0,0,440
42336,230,100,80,80,0,0,490
42337,190,100,120,0,0,0,410
42338,230,160,160,160,0,0,710
42339,210,120,80,80,0,0,490
42340,220,160,40,80,0,0,500
42341,210,140,160,160,160,0,830
42342,200,100,80,80,160,0,620
42343,200,120,120,240,160,0,840
42344,200,140,120,80,0,0,540
42345,220,120,160,240,160,0,900
42346,180,120,40,0,0,0,340
42347,210,140,160,160,160,0,830
42348,160,120,120,80,160,0,640
42349,210,160,160,160,0,0,690
42350,220,100,80,160,160,0,720
42351,190,100,120,80,160,0,650
42352,190,120,80,0,0,0,390
42353,200,120,40,80,160,0,600
42354,210,120,80,80,160,0,650
42355,140,60,120,160,160,320,960
42356,180,120,80,80,0,0,460
42357,180,140,80,80,0,0,480
42358,200,140,80,80,0,0,500
42359,180,100,40,80,160,0,560
42360,190,100,80,160,320,0,850
42361,190,140,80,80,160,0,650
42362,170,100,80,80,160,320,910
42363,200,160,120,160,320,320,1280
42364,210,120,80,80,160,320,970
42365,190,140,40,80,0,0,450
42366,180,140,80,160,320,320,1200
42367,230,160,160,0,0,0,550
42368,190,80,80,160,160,0,670
42369,200,120,80,160,160,0,720
42370,200,140,160,0,0,0,500
42371,180,100,80,80,0,0,440
42372,190,80,120,80,160,0,630
42373,190,160,120,160,160,0,790
42374,220,160,80,160,320,0,940
42375,180,160,120,160,320,0,940
42376,210,160,80,160,160,0,770
42377,150,80,120,240,320,0,910
42378,190,120,80,0,0,0,390
42379,170,120,80,0,0,0,370
42380,170,60,80,80,0,0,390
42381,200,80,80,160,160,320,1000
42382,200,100,200,240,160,0,900
42383,190,80,80,80,160,0,590
42384,190,180,40,0,0,0,410
42385,200,140,120,80,160,0,700
42386,190,100,80,80,0,0,450
42387,200,100,120,80,160,320,980
42388,200,140,80,160,160,0,740
42389,220,140,120,160,160,0,800
42390,170,60,0,0,0,0,230
42391,180,120,160,80,160,0,700
42392,210,160,160,160,160,0,850
42393,200,140,80,160,160,320,1060
42394,200,160,120,160,0,0,640
42395,210,40,0,0,0,0,250
42396,200,80,80,160,160,0,680
42397,220,140,160,80,160,0,760
42398,170,120,160,0,0,0,450
42399,200,120,80,80,0,0,480
42400,190,140,200,160,0,0,690
42401,200,100,80,0,0,0,380
42402,160,120,120,160,0,0,560
42403,180,160,240,160,320,0,1060
42404,190,120,80,0,0,0,390
42405,170,60,40,0,0,0,270
42406,180,160,120,160,320,0,940
42407,210,100,80,80,0,0,470
42408,200,140,160,160,160,0,820
42409,220,120,120,240,320,0,1020
42410,220,140,120,80,0,0,560
42411,200,120,120,80,160,0,680
42412,250,180,200,80,160,0,870
42413,180,120,120,160,160,320,1060
42414,180,160,120,160,0,0,620
42415,210,120,40,0,0,0,370
42416,190,40,40,0,0,0,270
42417,190,120,120,160,320,0,910
42418,190,100,120,160,160,0,730
42419,180,120,120,80,0,0,500
42420,210,160,80,80,0,0,530
42421,200,140,80,160,160,0,740
42422,200,40,0,0,0,0,240
42423,230,160,200,160,160,0,910
42424,210,220,160,160,0,0,750
42425,190,120,120,0,0,0,430
42426,200,80,80,80,0,0,440
42427,190,120,120,160,320,0,910
42428,190,140,80,160,160,0,730
42429,210,100,80,80,0,0,470
42430,180,180,80,80,160,320,1000
42431,220,140,40,0,0,0,400
42432,210,120,80,160,160,0,730
42433,200,120,120,160,160,0,760
42434,190,100,80,0,0,0,370
42435,210,160,160,80,0,0,610
42436,220,160,200,240,320,0,1140
42437,210,140,120,160,0,0,630
42438,200,100,80,160,160,0,700
42439,190,120,120,80,160,0,670
42440,200,140,160,80,160,320,1060
42441,160,120,120,160,160,0,720
42442,220,100,80,160,160,0,720
42443,220,160,120,80,160,0,740
42444,200,160,120,80,0,0,560
42445,200,160,120,80,160,0,720
42446,180,140,120,80,160,0,680
42447,190,180,120,80,160,0,730
42448,190,100,160,0,0,0,450
42449,180,160,120,160,160,320,1100
42450,250,140,120,160,160,320,1150
42451,230,80,120,160,160,0,750
42452,160,60,80,80,160,320,860
42453,200,120,120,160,160,0,760
42454,240,100,80,80,160,0,660
42455,170,80,80,0,0,0,330
42456,170,160,80,80,160,0,650
42457,220,100,40,0,0,0,360
42458,230,120,80,160,160,0,750
42459,210,160,200,160,320,0,1050
42460,210,180,200,80,160,0,830
42461,180,100,160,160,160,320,1080
42462,240,140,80,80,160,0,700
42463,220,160,120,80,0,0,580
42464,220,180,120,160,160,0,840
42465,220,80,40,0,0,0,340
42466,180,140,120,0,0,0,440
42467,190,120,120,160,0,0,590
42468,190,100,120,80,160,0,650
42469,240,160,200,80,160,0,840
42470,200,100,80,80,160,0,620
42471,180,80,40,80,160,320,860
42472,220,120,120,0,0,0,460
42473,180,100,40,80,0,0,400
42474,180,120,80,80,160,320,940
42475,190,100,40,0,0,0,330
42476,160,120,120,160,160,320,1040
42477,220,140,160,160,0,0,680
42478,240,120,160,160,160,0,840
42479,200,140,160,80,0,0,580
42480,190,140,120,160,160,0,770
42481,200,100,80,160,160,0,700
42482,200,140,200,160,0,0,700
42483,190,120,80,0,0,0,390
42484,200,140,160,160,160,0,820
42485,230,180,80,80,0,0,570
42486,180,120,120,160,320,0,900
42487,130,100,120,160,0,0,510
42488,190,220,160,160,160,0,890
42489,210,100,80,160,160,0,710
42490,200,140,120,80,160,0,700
42491,210,120,80,80,160,0,650
42492,220,160,200,160,160,0,900
42493,210,140,120,80,0,0,550
42494,190,140,200,80,160,0,770
42495,200,140,160,240,160,320,1220
42496,170,140,200,80,0,0,590
42497,210,100,80,80,0,0,470
42498,200,180,120,160,160,0,820
42499,200,120,120,160,320,0,920
42500,200,140,160,160,160,0,820
42501,220,60,120,160,160,0,720
42502,150,140,160,160,0,0,610
42503,190,80,80,80,0,0,430
42504,190,100,120,160,160,0,730
42505,210,120,40,80,0,0,450
42506,210,140,160,80,160,0,750
42507,180,140,80,160,160,320,1040
42508,190,100,120,160,160,0,730
42509,210,140,120,80,0,0,550
42510,200,80,80,160,160,0,680
42511,200,100,120,160,0,0,580
42512,190,80,160,160,320,0,910
42513,200,80,80,80,160,0,600
42514,170,100,80,80,0,0,430
42515,200,100,80,0,0,0,380
42516,200,140,120,80,160,0,700
42517,200,80,80,0,0,0,360
42518,160,140,80,80,160,0,620
42519,190,140,80,80,0,0,490
42520,200,140,120,160,160,320,1100
42521,180,100,80,80,0,0,440
42522,190,140,160,80,0,0,570
42523,190,80,0,0,0,0,270
42524,210,160,120,240,320,0,1050
42525,200,160,160,160,160,0,840
42526,220,140,120,0,0,0,480
42527,150,160,160,240,320,0,1030
42528,200,100,120,160,320,0,900
42529,160,100,0,0,0,0,260
42530,200,120,120,80,0,0,520
42531,180,100,120,160,160,0,720
42532,170,120,120,80,160,0,650
42533,230,140,120,160,160,0,810
42534,210,140,120,80,0,0,550
42535,170,100,80,160,160,320,990
42536,220,100,160,80,160,0,720
42537,200,60,40,80,160,320,860
42538,180,40,40,0,0,0,260
42539,160,120,80,80,0,0,440
42540,160,80,80,0,0,0,320
42541,190,80,40,80,160,0,550
42542,180,120,120,160,160,320,1060
42543,210,120,200,240,160,320,1250
42544,220,200,160,160,160,0,900
42545,230,200,80,80,160,0,750
42546,190,160,200,240,320,0,1110
42547,190,120,80,0,0,0,390
42548,180,140,80,0,0,0,400
42549,180,80,160,80,0,0,500
42550,190,160,160,160,160,320,1150
42551,220,100,80,160,160,0,720
42552,190,100,80,160,320,0,850
42553,190,60,0,0,0,0,250
42554,160,100,0,0,0,0,260
42555,170,140,200,160,160,0,830
42556,190,160,120,240,320,320,1350
42557,200,140,160,80,160,0,740
42558,180,80,80,80,160,0,580
42559,210,140,120,160,160,320,1110
42560,180,160,160,240,160,0,900
42561,170,120,120,160,320,320,1210
42562,220,120,120,80,160,0,700
42563,190,180,120,240,320,0,1050
42564,200,160,120,80,160,320,1040
42565,190,120,80,80,160,0,630
42566,220,180,120,80,160,0,760
42567,160,100,160,80,160,0,660
42568,140,80,80,0,0,0,300
42569,140,120,120,160,320,0,860
42570,210,160,80,0,0,0,450
42571,220,160,120,160,320,0,980
42572,190,100,80,80,160,0,610
42573,190,80,120,0,0,0,390
42574,180,60,120,160,320,320,1160
42575,200,140,160,240,320,0,1060
42576,150,60,80,0,0,0,290
42577,190,140,160,240,320,0,1050
42578,180,60,120,80,160,320,920
42579,150,80,120,80,160,0,590
42580,190,120,120,80,160,0,670
42581,210,120,80,80,160,0,650
42582,200,100,0,0,0,0,300
42583,170,100,120,80,160,0,630
42584,200,120,80,0,0,0,400
42585,230,160,160,160,0,0,710
42586,170,120,80,160,160,0,690
42587,230,120,120,80,160,0,710
42588,210,120,80,0,0,0,410
42589,190,80,40,80,160,0,550
42590,200,120,160,160,160,0,800
42591,200,160,120,240,160,320,1200
42592,210,100,40,0,0,0,350
42593,210,200,200,160,0,0,770
42594,190,140,120,80,160,0,690
42595,180,80,120,160,320,320,1180
42596,170,140,120,160,160,0,750
42597,200,100,80,0,0,0,380
42598,200,100,80,0,0,0,380
42599,180,140,120,0,0,0,440
42600,180,100,80,80,160,0,600
42601,190,120,40,0,0,0,350
42602,190,160,200,80,160,0,790
42603,220,100,40,80,160,0,600
42604,240,120,40,80,160,0,640
42605,240,120,0,0,0,0,360
42606,200,80,80,80,160,320,920
42607,200,160,80,80,0,0,520
42608,180,160,80,80,0,0,500
42609,190,100,40,0,0,0,330
42610,170,100,80,80,160,0,590
42611,170,80,80,80,0,0,410
42612,210,120,80,0,0,0,410
42613,190,80,80,80,0,0,430
42614,230,140,40,80,160,0,650
42615,210,60,80,80,0,0,430
42616,160,100,160,0,0,0,420
42617,210,140,120,160,160,0,790
42618,180,140,120,160,320,0,920
42619,200,100,120,160,160,0,740
42620,240,80,80,160,320,0,880
42621,170,100,80,80,0,0,430
42622,200,120,120,80,160,0,680
42623,190,160,160,160,160,0,830
42624,220,80,80,160,320,0,860
42625,210,140,120,80,0,0,550
42626,190,160,80,80,0,0,510
42627,200,120,80,80,160,0,640
42628,200,120,120,80,160,0,680
42629,170,140,120,80,160,0,670
42630,240,180,120,160,160,0,860
42631,170,120,120,80,160,320,970
42632,210,140,80,160,160,320,1070
42633,180,100,120,160,160,0,720
42634,220,120,40,80,0,0,460
42635,190,120,80,80,160,0,630
42636,260,100,80,80,160,320,1000
42637,190,120,120,160,160,0,750
42638,220,80,80,160,320,0,860
42639,230,120,120,80,160,0,710
42640,210,100,80,80,160,320,950
42641,180,100,40,0,0,0,320
42642,180,120,80,80,0,0,460
42643,200,100,120,160,0,0,580
42644,190,140,120,0,0,0,450
42645,220,140,120,160,320,0,960
42646,190,140,120,80,0,0,530
42647,180,100,80,80,160,0,600
42648,200,120,80,160,0,0,560
42649,200,60,120,160,160,0,700
42650,180,140,120,80,0,0,520
42651,200,120,40,0,0,0,360
42652,140,100,120,80,160,0,600
42653,230,160,80,80,160,0,710
42654,180,120,80,80,160,0,620
42655,180,160,160,80,160,0,740
42656,230,180,120,80,160,0,770
42657,200,140,80,160,0,0,580
42658,230,160,40,80,0,0,510
42659,200,160,160,160,160,0,840
42660,210,120,80,80,0,0,490
42661,190,140,160,80,160,0,730
42662,220,120,120,80,160,0,700
42663,220,80,40,80,0,0,420
42664,220,100,80,160,160,320,1040
42665,210,100,40,80,0,0,430
42666,200,160,80,80,0,0,520
42667,220,120,120,160,160,0,780
42668,210,180,160,80,160,0,790
42669,210,140,80,160,320,0,910
42670,240,120,80,160,0,0,600
42671,210,100,40,0,0,0,350
42672,160,120,120,240,160,0,800
42673,170,120,80,80,160,0,610
42674,220,160,160,80,0,0,620
42675,170,100,120,80,160,320,950
42676,210,80,0,0,0,0,290
42677,230,140,120,80,160,0,730
42678,200,140,120,80,160,0,700
42679,230,140,120,80,160,0,730
42680,180,80,40,0,0,0,300
42681,190,140,120,0,0,0,450
42682,240,160,160,80,0,0,640
42683,210,140,160,80,160,0,750
42684,230,140,160,160,160,0,850
42685,210,160,160,160,320,0,1010
42686,190,140,40,80,160,0,610
42687,180,140,200,80,0,0,600
42688,180,140,120,80,160,0,680
42689,190,140,120,240,160,0,850
42690,210,140,120,160,160,0,790
42691,200,160,200,80,0,0,640
42692,200,140,120,80,0,0,540
42693,220,100,120,80,0,0,520
42694,230,140,40,0,0,0,410
42695,200,140,120,80,160,0,700
42696,200,80,80,80,0,0,440
42697,180,160,40,80,160,0,620
42698,180,120,160,160,160,0,780
42699,200,100,80,80,0,0,460
42700,200,80,40,80,160,320,880
42701,210,160,120,160,160,0,810
42702,210,80,80,80,160,0,610
42703,250,240,120,80,160,0,850
42704,190,80,80,80,160,320,910
42705,180,120,120,0,0,0,420
42706,210,120,80,80,160,0,650
42707,210,100,40,0,0,0,350
42708,240,120,120,0,0,0,480
42709,180,100,160,80,0,0,520
42710,210,100,80,80,160,0,630
42711,180,80,40,0,0,0,300
42712,240,100,120,160,160,0,780
42713,180,100,40,80,160,0,560
42714,200,100,80,160,320,320,1180
42715,220,140,40,0,0,0,400
42716,170,140,40,0,0,0,350
42717,220,100,40,80,160,320,920
42718,190,140,120,240,320,320,1330
42719,210,100,80,160,320,320,1190
42720,190,140,120,80,160,0,690
42721,190,120,80,0,0,0,390
42722,190,80,80,0,0,0,350
42723,180,100,120,160,0,0,560
42724,220,120,40,0,0,0,380
42725,200,120,160,160,0,0,640
42726,190,100,80,0,0,0,370
42727,220,140,160,240,320,320,1400
42728,190,120,80,80,0,0,470
42729,230,160,160,160,160,320,1190
42730,160,140,80,0,0,0,380
42731,190,140,120,240,320,0,1010
42732,190,120,80,160,320,320,1190
42733,170,180,80,160,160,0,750
42734,250,160,160,80,0,0,650
42735,190,160,160,160,160,0,830
42736,170,80,80,0,0,0,330
42737,220,160,160,0,0,0,540
42738,180,180,80,80,160,0,680
42739,190,160,80,80,160,0,670
42740,170,100,120,240,160,320,1110
42741,260,60,40,80,160,320,920
42742,210,140,120,160,0,0,630
42743,190,100,120,160,160,320,1050
42744,200,100,120,80,160,0,660
42745,210,200,200,160,160,0,930
42746,170,120,120,160,160,320,1050
42747,210,120,120,160,160,320,1090
42748,160,100,80,0,0,0,340
42749,150,100,40,80,0,0,370
42750,220,100,160,160,160,0,800
42751,210,140,80,160,160,0,750
42752,180,120,80,80,0,0,460
42753,160,100,40,0,0,0,300
42754,210,100,80,80,0,0,470
42755,180,80,80,0,0,0,340
42756,200,60,0,0,0,0,260
42757,220,140,160,160,320,0,1000
42758,180,220,160,160,0,0,720
42759,210,100,80,160,320,0,870
42760,210,180,160,160,160,320,1190
42761,170,120,160,240,160,0,850
42762,180,180,80,0,0,0,440
42763,240,100,80,80,160,0,660
42764,220,100,80,160,160,0,720
42765,220,80,80,0,0,0,380
42766,210,100,80,80,0,0,470
42767,170,100,160,240,320,0,990
42768,200,100,80,80,0,0,460
42769,240,160,160,240,160,0,960
42770,170,60,80,80,0,0,390
42771,160,60,80,160,160,0,620
42772,210,140,80,80,0,0,510
42773,180,120,80,160,320,0,860
42774,180,120,120,160,0,0,580
42775,180,120,120,80,160,0,660
42776,240,120,40,80,160,0,640
42777,200,80,120,160,0,0,560
42778,200,80,120,80,160,0,640
42779,210,120,120,160,160,320,1090
42780,220,160,160,80,160,320,1100
42781,210,180,160,160,160,320,1190
42782,240,120,120,80,0,0,560
42783,180,120,120,160,320,0,900
42784,180,160,120,0,0,0,460
42785,190,180,80,80,160,0,690
42786,210,100,80,0,0,0,390
42787,240,160,120,80,160,0,760
42788,220,140,80,80,160,320,1000
42789,220,100,120,80,160,0,680
42790,190,100,80,160,160,0,690
42791,190,120,120,80,0,0,510
42792,160,80,120,80,160,0,600
42793,170,160,160,80,0,0,570
42794,210,140,120,80,0,0,550
42795,210,140,40,80,0,0,470
42796,210,180,160,160,0,0,710
42797,200,120,160,240,160,0,880
42798,170,100,80,0,0,0,350
42799,200,100,120,0,0,0,420
42800,220,140,120,0,0,0,480
42801,180,80,80,80,160,0,580
42802,230,140,200,160,0,0,730
42803,180,160,80,80,0,0,500
42804,170,160,160,0,0,0,490
42805,200,140,160,240,320,320,1380
42806,210,160,200,160,320,320,1370
42807,160,80,80,80,0,0,400
42808,210,120,80,80,160,0,650
42809,130,160,200,160,320,0,970
42810,180,160,200,240,160,0,940
42811,210,160,160,160,160,0,850
42812,170,160,120,0,0,0,450
42813,200,160,80,0,0,0,440
42814,200,100,120,0,0,0,420
42815,190,120,80,160,160,0,710
42816,230,60,40,0,0,0,330
42817,160,100,120,80,160,0,620
42818,180,120,40,80,160,0,580
42819,210,60,40,80,0,0,390
42820,240,160,80,80,160,320,1040
42821,210,140,120,80,0,0,550
42822,190,80,120,80,160,320,950
42823,230,120,120,160,160,0,790
42824,210,100,80,160,160,0,710
42825,190,140,80,160,160,0,730
42826,220,140,80,160,160,320,1080
42827,210,120,160,80,160,0,730
42828,210,180,80,160,0,0,630
42829,210,120,80,80,160,0,650
42830,200,100,40,0,0,0,340
42831,170,120,120,160,160,0,730
42832,210,160,120,80,0,0,570
42833,240,140,80,160,160,0,780
42834,200,120,80,80,0,0,480
42835,190,120,80,160,320,320,1190
42836,210,200,240,160,160,0,970
42837,220,140,120,240,160,0,880
42838,220,120,0,0,0,0,340
42839,190,120,80,80,0,0,470
42840,220,160,80,160,160,320,1100
42841,150,120,120,80,0,0,470
42842,230,140,120,160,320,320,1290
42843,190,160,120,80,160,320,1030
42844,210,80,120,80,0,0,490
42845,180,140,120,160,160,0,760
42846,180,120,160,80,160,0,700
42847,200,120,120,80,160,0,680
42848,190,140,120,80,0,0,530
42849,240,160,80,80,160,0,720
42850,150,100,80,160,0,0,490
42851,190,140,120,160,160,0,770
42852,190,160,200,160,160,320,1190
42853,200,100,40,80,0,0,420
42854,170,120,80,0,0,0,370
42855,200,120,160,160,320,0,960
42856,210,100,120,80,160,0,670
42857,180,100,80,80,160,0,600
42858,220,160,80,160,160,0,780
42859,220,160,160,160,320,0,1020
42860,170,80,80,80,160,0,570
42861,190,120,40,80,160,0,590
42862,230,140,120,80,160,0,730
42863,180,60,80,160,160,0,640
42864,180,100,80,80,160,0,600
42865,200,100,80,160,0,0,540
42866,210,120,120,80,0,0,530
42867,180,80,80,0,0,0,340
42868,170,100,80,80,160,320,910
42869,190,160,160,80,160,320,1070
42870,220,100,160,160,320,0,960
42871,190,120,40,80,0,0,430
42872,140,100,80,80,160,0,560
42873,180,120,80,80,0,0,460
42874,210,100,120,80,0,0,510
42875,190,120,120,160,160,320,1070
42876,200,100,120,0,0,0,420
42877,210,60,40,0,0,0,310
42878,170,100,120,80,160,0,630
42879,190,100,160,240,160,0,850
42880,190,80,80,160,160,320,990
42881,190,100,120,160,160,0,730
42882,220,100,120,80,160,0,680
42883,200,180,160,160,320,0,1020
42884,210,100,120,80,160,0,670
42885,130,60,0,0,0,0,190
42886,210,80,80,0,0,0,370
42887,210,60,40,0,0,0,310
42888,170,60,80,0,0,0,310
42889,180,80,40,80,0,0,380
42890,170,140,120,80,160,0,670
42891,200,140,120,80,0,0,540
42892,220,160,240,240,0,0,860
42893,210,100,120,80,160,0,670
42894,200,80,40,80,160,320,880
42895,200,120,80,0,0,0,400
42896,170,80,80,0,0,0,330
42897,210,140,160,160,160,320,1150
42898,210,120,40,80,160,0,610
42899,220,100,160,160,0,0,640
42900,170,140,40,80,160,0,590
42901,230,120,200,160,160,0,870
42902,210,140,120,0,0,0,470
42903,190,120,80,0,0,0,390
42904,230,140,120,80,160,0,730
42905,230,140,120,80,160,0,730
42906,170,120,160,80,0,0,530
42907,220,180,120,80,160,0,760
42908,230,160,40,80,0,0,510
42909,190,80,40,0,0,0,310
42910,200,120,120,80,0,0,520
42911,200,140,80,80,160,0,660
42912,200,140,80,80,0,0,500
42913,190,120,120,0,0,0,430
42914,170,140,120,80,160,320,990
42915,170,100,120,80,160,0,630
42916,190,140,120,160,320,0,930
42917,190,120,80,0,0,0,390
42918,160,100,120,0,0,0,380
42919,200,160,200,80,160,0,800
42920,250,160,160,160,320,320,1370
42921,160,100,80,160,320,0,820
42922,190,100,160,80,160,0,690
42923,180,180,40,0,0,0,400
42924,200,120,80,80,160,0,640
42925,190,80,40,0,0,0,310
42926,210,100,80,80,160,320,950
42927,200,100,120,160,160,0,740
42928,200,160,160,80,160,0,760
42929,220,200,120,80,0,0,620
42930,220,140,120,160,160,0,800
42931,200,120,120,80,0,0,520
42932,200,160,160,240,320,320,1400
42933,190,120,160,160,160,0,790
42934,180,60,120,160,0,0,520
42935,140,160,80,80,160,0,620
42936,200,140,120,80,160,0,700
42937,200,160,160,80,0,0,600
42938,140,120,160,160,0,0,580
42939,220,100,80,80,0,0,480
42940,180,140,200,80,0,0,600
42941,160,100,120,160,160,0,700
42942,260,60,80,0,0,0,400
42943,230,100,120,80,0,0,530
42944,200,140,160,80,0,0,580
42945,210,140,120,80,160,0,710
42946,150,60,40,80,160,320,810
42947,160,60,120,240,160,320,1060
42948,170,140,200,160,160,0,830
42949,240,120,160,160,160,0,840
42950,220,140,80,80,160,0,680
42951,200,100,120,240,320,0,980
42952,220,140,160,160,320,0,1000
42953,250,160,120,80,160,0,770
42954,180,100,40,0,0,0,320
42955,170,160,160,240,160,0,890
42956,210,120,160,80,160,0,730
42957,200,100,0,0,0,0,300
42958,190,200,80,160,320,320,1270
42959,190,160,120,160,320,0,950
42960,180,100,160,160,160,0,760
42961,170,80,40,80,160,0,530
42962,150,60,120,160,0,0,490
42963,180,120,160,80,160,0,700
42964,210,100,200,160,160,320,1150
42965,170,120,120,240,160,0,810
42966,160,100,80,80,160,0,580
42967,250,160,80,80,160,0,730
42968,200,80,40,0,0,0,320
42969,230,180,160,240,160,0,970
42970,190,160,160,160,320,320,1310
42971,190,140,120,80,160,320,1010
42972,220,140,120,160,320,320,1280
42973,180,140,160,80,160,0,720
42974,220,180,160,160,160,320,1200
42975,200,120,160,80,0,0,560
42976,190,120,120,80,160,0,670
42977,200,120,160,160,160,0,800
42978,180,140,40,80,160,0,600
42979,130,120,80,80,0,0,410
42980,150,120,120,80,0,0,470
42981,170,100,40,0,0,0,310
42982,190,100,120,80,0,0,490
42983,190,120,80,80,160,0,630
42984,160,100,120,80,0,0,460
42985,150,80,80,80,160,0,550
42986,200,100,80,0,0,0,380
42987,170,120,80,80,160,0,610
42988,180,120,80,0,0,0,380
42989,180,120,120,160,160,0,740
42990,220,140,160,160,0,0,680
42991,200,120,160,0,0,0,480
42992,180,120,160,80,160,320,1020
42993,180,100,80,80,160,0,600
42994,180,60,0,0,0,0,240
42995,180,160,160,240,160,0,900
42996,200,160,120,160,320,0,960
42997,200,60,40,0,0,0,300
42998,270,140,160,160,160,0,890
42999,190,120,120,160,160,0,750
43000,200,100,120,80,160,320,980
43001,240,180,80,0,0,0,500
43002,170,100,120,80,160,320,950
43003,180,140,160,240,320,0,1040
43004,220,180,160,160,160,0,880
43005,160,120,160,160,160,0,760
43006,240,120,120,160,160,0,800
43007,200,140,120,0,0,0,460
43008,190,120,160,160,160,0,790
43009,190,160,80,80,0,0,510
43010,240,40,80,80,160,0,600
43011,160,100,80,80,0,0,420
43012,160,100,80,160,160,0,660
43013,250,120,200,160,160,0,890
43014,180,120,80,80,160,320,940
43015,210,120,160,0,0,0,490
43016,210,120,120,80,160,0,690
43017,210,160,80,80,160,320,1010
43018,210,100,40,80,160,0,590
43019,200,100,80,160,0,0,540
43020,220,160,120,80,0,0,580
43021,210,120,80,80,0,0,490
43022,150,140,120,160,320,320,1210
43023,200,100,80,80,160,0,620
43024,210,60,0,0,0,0,270
43025,160,80,80,80,0,0,400
43026,180,120,80,80,0,0,460
43027,230,100,80,160,160,0,730
43028,170,160,120,160,320,320,1250
43029,220,180,120,160,0,0,680
43030,180,120,80,80,160,320,940
43031,200,120,120,80,0,0,520
43032,220,160,200,160,160,0,900
43033,230,100,80,0,0,0,410
43034,200,120,160,160,160,0,800
43035,190,140,160,240,320,0,1050
43036,180,140,160,80,160,320,1040
43037,240,100,80,160,160,0,740
43038,200,120,120,160,160,0,760
43039,200,120,120,80,0,0,520
43040,200,140,160,160,160,320,1140
43041,150,100,160,160,320,0,890
43042,220,140,160,160,160,0,840
43043,220,160,80,0,0,0,460
43044,210,80,40,0,0,0,330
43045,190,60,80,160,160,0,650
43046,210,120,160,160,320,0,970
43047,180,60,40,80,160,0,520
43048,200,100,40,80,160,0,580
43049,220,120,80,80,160,0,660
43050,200,140,160,80,0,0,580
43051,170,100,160,240,0,0,670
43052,160,100,0,0,0,0,260
43053,180,80,80,160,160,0,660
43054,180,140,120,80,0,0,520
43055,200,100,80,160,160,0,700
43056,190,100,80,0,0,0,370
43057,230,180,200,160,160,0,930
43058,220,140,40,0,0,0,400
43059,250,140,80,160,160,320,1110
43060,220,140,120,80,0,0,560
43061,180,140,200,160,0,0,680
43062,200,160,120,240,320,320,1360
43063,260,200,160,80,160,0,860
43064,180,140,80,80,0,0,480
43065,210,180,160,160,160,0,870
43066,240,160,160,160,320,0,1040
43067,190,140,120,80,160,0,690
43068,230,80,80,160,320,0,870
43069,170,140,160,80,0,0,550
43070,220,120,120,0,0,0,460
43071,180,100,120,160,160,320,1040
43072,190,100,160,80,160,320,1010
43073,220,140,160,80,0,0,600
43074,210,60,80,80,160,320,910
43075,220,100,80,80,160,0,640
43076,200,140,120,160,160,0,780
43077,190,120,80,0,0,0,390
43078,240,80,40,80,160,0,600
43079,230,140,80,0,0,0,450
43080,190,120,40,0,0,0,350
43081,190,80,80,160,160,0,670
43082,230,140,120,160,160,0,810
43083,180,120,120,80,0,0,500
43084,190,200,120,80,160,0,750
43085,200,160,160,0,0,0,520
43086,180,100,120,160,160,0,720
43087,200,120,80,160,160,0,720
43088,210,200,80,0,0,0,490
43089,180,140,40,80,0,0,440
43090,180,120,120,160,320,0,900
43091,180,140,200,160,160,0,840
43092,190,180,120,160,160,320,1130
43093,240,160,240,240,320,0,1200
43094,180,160,120,160,160,0,780
43095,230,120,80,80,160,0,670
43096,160,100,160,240,160,320,1140
43097,210,140,200,240,320,0,1110
43098,200,140,160,240,0,0,740
43099,180,60,80,160,160,0,640
43100,190,120,80,160,160,0,710
43101,190,100,120,80,0,0,490
43102,180,160,120,80,160,0,700
43103,210,100,160,0,0,0,470
43104,180,120,80,80,160,320,940
43105,130,120,160,0,0,0,410
43106,220,140,120,80,160,320,1040
43107,170,80,120,80,160,0,610
43108,220,200,120,160,160,0,860
43109,230,120,200,160,0,0,710
43110,190,120,80,80,160,0,630
43111,150,100,120,80,160,0,610
43112,170,80,40,0,0,0,290
43113,190,60,120,160,160,0,690
43114,200,120,120,160,160,0,760
43115,220,100,120,240,320,0,1000
43116,210,140,120,80,0,0,550
43117,180,140,160,240,320,320,1360
43118,180,80,80,80,0,0,420
43119,210,160,120,80,160,320,1050
43120,200,200,240,80,0,0,720
43121,220,120,120,160,160,0,780
43122,190,160,120,80,160,0,710
43123,180,120,40,0,0,0,340
43124,210,120,160,80,0,0,570
43125,220,120,0,0,0,0,340
43126,190,120,80,80,160,0,630
43127,170,100,120,80,0,0,470
43128,170,140,160,240,320,0,1030
43129,210,120,80,160,0,0,570
43130,140,120,200,160,320,0,940
43131,180,120,120,160,160,0,740
43132,230,140,160,160,160,0,850
43133,200,120,120,80,0,0,520
43134,180,160,120,0,0,0,460
43135,170,100,120,80,160,0,630
43136,210,140,80,80,0,0,510
43137,200,160,200,240,160,0,960
43138,160,80,120,160,0,0,520
43139,250,160,200,240,320,0,1170
43140,190,100,80,80,160,0,610
43141,220,80,120,160,160,0,740
43142,200,120,160,80,0,0,560
43143,220,120,120,80,0,0,540
43144,210,140,200,240,320,320,1430
43145,160,60,40,0,0,0,260
43146,220,140,120,80,160,0,720
43147,190,160,200,80,0,0,630
43148,200,100,40,80,160,0,580
43149,190,120,80,80,0,0,470
43150,200,160,200,240,160,0,960
43151,190,80,80,80,160,320,910
43152,180,120,200,240,160,0,900
43153,170,140,120,0,0,0,430
43154,160,80,80,80,160,0,560
43155,200,180,80,80,0,0,540
43156,210,40,40,80,160,0,530
43157,190,100,120,80,160,320,970
43158,210,180,160,80,160,0,790
43159,220,200,200,80,0,0,700
43160,160,80,80,80,0,0,400
43161,210,100,40,0,0,0,350
43162,170,160,40,80,0,0,450
43163,200,180,160,160,0,0,700
43164,210,180,80,160,320,0,950
43165,190,60,40,80,0,0,370
43166,220,140,120,80,0,0,560
43167,200,100,120,160,160,0,740
43168,230,140,120,160,160,0,810
43169,200,160,0,0,0,0,360
43170,190,140,120,160,160,0,770
43171,230,60,80,80,160,0,610
43172,210,100,80,0,0,0,390
43173,200,100,80,80,0,0,460
43174,200,180,80,80,160,0,700
43175,210,140,80,160,160,0,750
43176,200,140,120,160,160,0,780
43177,200,160,120,0,0,0,480
43178,220,140,120,160,160,320,1120
43179,180,140,160,240,160,0,880
43180,190,140,40,80,0,0,450
43181,220,140,120,160,160,0,800
43182,200,140,200,160,160,320,1180
43183,210,120,200,160,320,0,1010
43184,190,120,80,80,0,0,470
43185,200,140,160,160,320,0,980
43186,200,120,120,160,160,0,760
43187,190,80,40,0,0,0,310
43188,220,120,160,0,0,0,500
43189,200,160,80,80,160,0,680
43190,190,160,160,160,160,0,830
43191,220,80,40,80,0,0,420
43192,230,60,40,80,160,320,890
43193,200,140,160,80,0,0,580
43194,190,180,40,0,0,0,410
43195,220,100,80,0,0,0,400
43196,210,140,200,240,0,0,790
43197,190,160,160,160,0,0,670
43198,240,60,40,80,160,0,580
43199,160,40,80,160,160,0,600
43200,220,160,120,160,0,0,660
43201,200,140,80,80,0,0,500
43202,190,100,80,80,0,0,450
43203,240,140,80,0,0,0,460
43204,190,160,80,80,0,0,510
43205,210,100,120,160,320,0,910
43206,210,140,120,240,160,0,870
43207,210,200,120,160,320,0,1010
43208,160,160,160,240,320,0,1040
43209,200,100,120,160,320,320,1220
43210,200,60,80,80,0,0,420
43211,220,140,120,160,160,320,1120
43212,190,80,80,80,160,0,590
43213,220,140,160,160,160,0,840
43214,210,140,120,80,160,0,710
43215,190,140,120,80,160,0,690
43216,180,100,80,0,0,0,360
43217,190,140,120,80,0,0,530
43218,180,120,80,0,0,0,380
43219,160,120,160,80,160,320,1000
43220,210,140,120,80,160,0,710
43221,220,140,160,240,160,0,920
43222,230,120,80,160,160,0,750
43223,200,120,40,0,0,0,360
43224,170,120,80,80,0,0,450
43225,200,140,120,0,0,0,460
43226,200,140,160,160,160,0,820
43227,180,120,120,160,160,0,740
43228,190,140,120,160,320,0,930
43229,190,100,120,160,160,0,730
43230,200,20,0,0,0,0,220
43231,260,140,40,80,160,0,680
43232,230,160,160,160,0,0,710
43233,210,140,160,80,160,0,750
43234,210,140,160,240,320,0,1070
43235,170,100,80,80,160,320,910
43236,200,60,40,80,0,0,380
43237,220,140,160,160,160,0,840
43238,220,100,120,80,0,0,520
43239,190,80,40,80,0,0,390
43240,220,120,80,80,0,0,500
43241,240,160,80,80,0,0,560
43242,180,140,200,160,0,0,680
43243,220,100,80,160,320,0,880
43244,210,80,120,80,160,0,650
43245,180,140,120,160,320,320,1240
43246,160,100,120,160,160,0,700
43247,180,80,120,160,320,0,860
43248,230,220,120,80,160,320,1130
43249,220,140,120,160,160,0,800
43250,160,80,120,80,160,0,600
43251,210,160,160,80,160,0,770
43252,200,140,120,160,160,320,1100
43253,220,120,120,160,160,0,780
43254,190,80,40,80,160,0,550
43255,160,140,160,160,320,320,1260
43256,230,180,240,160,0,0,810
43257,180,140,120,160,0,0,600
43258,170,100,120,160,320,0,870
43259,160,120,80,0,0,0,360
43260,170,120,40,0,0,0,330
43261,230,120,80,80,160,0,670
43262,180,100,80,80,160,0,600
43263,220,100,80,160,0,0,560
43264,190,160,80,80,160,0,670
43265,190,100,40,80,160,0,570
43266,170,100,40,80,160,0,550
43267,160,120,160,160,160,320,1080
43268,220,120,200,80,160,0,780
43269,190,120,80,160,160,0,710
43270,200,140,160,160,160,0,820
43271,240,180,160,160,0,0,740
43272,240,140,40,0,0,0,420
43273,170,120,40,80,160,0,570
43274,190,60,40,80,0,0,370
43275,190,140,160,160,160,320,1130
43276,180,140,80,80,160,0,640
43277,170,100,120,80,0,0,470
43278,200,140,80,80,0,0,500
43279,170,180,120,80,160,0,710
43280,220,160,120,80,160,0,740
43281,220,140,40,80,160,0,640
43282,210,120,80,80,0,0,490
43283,210,120,80,80,160,0,650
43284,160,80,80,80,0,0,400
43285,200,140,80,0,0,0,420
43286,160,100,0,0,0,0,260
43287,180,120,40,0,0,0,340
43288,230,80,80,160,160,0,710
43289,220,160,160,160,0,0,700
43290,190,80,40,80,0,0,390
43291,160,140,80,0,0,0,380
43292,200,160,160,240,160,0,920
43293,170,120,120,80,160,0,650
43294,190,100,80,160,160,0,690
43295,180,100,120,80,160,0,640
43296,200,120,120,160,160,0,760
43297,210,160,80,80,160,0,690
43298,210,80,80,0,0,0,370
43299,170,140,80,80,160,0,630
43300,210,120,80,80,160,320,970
43301,240,180,120,80,160,0,780
43302,180,140,120,80,160,0,680
43303,210,200,120,80,160,0,770
43304,160,100,160,160,160,0,740
43305,200,160,120,0,0,0,480
43306,180,120,40,0,0,0,340
43307,240,140,160,240,0,0,780
43308,240,180,120,160,160,0,860
43309,210,120,80,0,0,0,410
43310,170,100,80,160,160,0,670
43311,190,140,160,80,160,0,730
43312,210,120,120,80,160,0,690
43313,210,160,160,160,0,0,690
43314,180,80,40,80,0,0,380
43315,200,100,120,80,160,0,660
43316,200,80,40,0,0,0,320
43317,190,140,160,160,320,0,970
43318,240,120,160,160,0,0,680
43319,190,80,40,0,0,0,310
43320,180,120,40,80,160,320,900
43321,170,140,120,160,160,0,750
43322,210,160,120,160,320,0,970
43323,250,160,120,160,0,0,690
43324,180,80,120,160,320,0,860
43325,260,140,80,0,0,0,480
43326,220,160,80,0,0,0,460
43327,220,100,160,160,160,0,800
43328,180,120,80,80,160,0,620
43329,190,180,160,160,320,320,1330
43330,180,80,40,80,160,0,540
43331,190,100,80,160,160,0,690
43332,220,120,80,80,0,0,500
43333,190,120,120,160,320,0,910
43334,200,100,80,80,0,0,460
43335,180,100,80,0,0,0,360
43336,200,120,120,80,160,0,680
43337,210,120,120,80,0,0,530
43338,180,80,80,80,0,0,420
43339,190,180,40,80,160,320,970
43340,240,120,40,80,160,0,640
43341,240,140,160,160,160,0,860
43342,170,140,80,0,0,0,390
43343,230,120,120,80,0,0,550
43344,220,140,120,160,160,0,800
43345,230,100,160,160,0,0,650
43346,210,140,120,80,160,320,1030
43347,230,120,120,160,160,0,790
43348,200,180,120,160,320,320,1300
43349,190,140,120,80,160,0,690
43350,220,200,80,80,0,0,580
43351,180,120,80,0,0,0,380
43352,210,120,120,160,160,0,770
43353,230,120,120,0,0,0,470
43354,230,160,80,160,160,0,790
43355,190,80,40,0,0,0,310
43356,220,80,120,240,320,320,1300
43357,240,100,160,240,320,0,1060
43358,200,80,80,0,0,0,360
43359,220,100,120,80,0,0,520
43360,190,120,40,80,160,0,590
43361,180,80,80,80,0,0,420
43362,160,120,120,160,320,0,880
43363,200,100,80,0,0,0,380
43364,210,100,80,80,160,0,630
43365,190,120,80,80,0,0,470
43366,160,160,80,0,0,0,400
43367,190,100,80,80,0,0,450
43368,250,140,120,80,160,0,750
43369,190,100,120,0,0,0,410
43370,180,100,80,0,0,0,360
43371,220,100,120,160,320,320,1240
43372,210,120,160,240,320,0,1050
43373,170,120,120,160,160,320,1050
43374,180,100,80,160,160,0,680
43375,140,100,200,160,160,0,760
43376,210,140,160,80,0,0,590
43377,170,140,120,80,160,0,670
43378,180,120,200,160,160,0,820
43379,170,100,120,0,0,0,390
43380,180,80,40,0,0,0,300
43381,180,120,80,0,0,0,380
43382,180,160,120,80,160,0,700
43383,190,140,120,160,160,0,770
43384,200,100,120,160,0,0,580
43385,210,160,240,160,320,0,1090
43386,170,80,120,240,160,0,770
43387,190,140,120,160,160,0,770
43388,180,120,120,160,320,0,900
43389,220,120,40,80,160,0,620
43390,180,140,40,0,0,0,360
43391,180,100,120,160,160,0,720
43392,210,80,40,0,0,0,330
43393,210,140,120,160,160,320,1110
43394,220,160,120,80,160,320,1060
43395,170,80,80,0,0,0,330
43396,230,120,40,0,0,0,390
43397,200,140,80,80,160,0,660
43398,150,80,120,80,160,320,910
43399,190,140,120,80,0,0,530
43400,210,140,80,0,0,0,430
43401,230,140,120,160,160,320,1130
43402,210,160,80,80,160,0,690
43403,200,140,80,80,160,0,660
43404,200,140,200,240,160,320,1260
43405,210,140,120,80,160,0,710
43406,200,160,120,160,160,320,1120
43407,200,120,80,80,160,0,640
43408,230,140,120,80,160,0,730
43409,260,140,120,160,160,0,840
43410,200,100,80,160,160,0,700
43411,210,80,80,80,160,0,610
43412,170,160,120,0,0,0,450
43413,240,120,80,80,160,0,680
43414,180,100,40,0,0,0,320
43415,220,160,120,80,160,0,740
43416,150,20,40,80,160,0,450
43417,190,100,40,0,0,0,330
43418,230,160,120,80,160,0,750
43419,160,60,80,80,0,0,380
43420,150,140,120,240,320,320,1290
43421,160,120,40,0,0,0,320
43422,190,180,160,160,160,0,850
43423,170,120,120,80,160,320,970
43424,220,120,120,80,0,0,540
43425,170,100,80,0,0,0,350
43426,170,120,80,80,160,320,930
43427,220,120,200,240,160,0,940
43428,190,100,80,0,0,0,370
43429,200,80,80,160,160,0,680
43430,190,40,40,80,0,0,350
43431,180,140,40,0,0,0,360
43432,190,100,120,160,160,0,730
43433,230,80,120,0,0,0,430
43434,200,120,40,80,160,320,920
43435,210,120,80,80,0,0,490
43436,180,140,80,80,0,0,480
43437,130,80,80,80,160,0,530
43438,200,80,120,160,160,0,720
43439,200,120,120,80,160,0,680
43440,220,160,120,80,160,0,740
43441,190,80,160,160,160,0,750
43442,180,140,120,80,160,0,680
43443,180,140,120,160,160,0,760
43444,190,100,120,80,160,0,650
43445,210,80,80,160,320,0,850
43446,160,120,160,80,160,0,680
43447,170,140,120,80,160,0,670
43448,230,120,0,0,0,0,350
43449,210,80,80,80,160,0,610
43450,170,80,80,80,160,320,890
43451,210,120,80,80,0,0,490
43452,260,120,120,160,160,0,820
43453,160,80,120,160,160,0,680
43454,190,140,40,0,0,0,370
43455,190,160,200,240,160,0,950
43456,210,160,120,80,160,0,730
43457,180,200,120,80,0,0,580
43458,180,100,40,80,160,320,880
43459,200,100,40,0,0,0,340
43460,180,140,160,80,160,0,720
43461,190,80,80,0,0,0,350
43462,220,140,120,160,160,0,800
43463,220,120,80,160,160,320,1060
43464,210,120,40,0,0,0,370
43465,180,120,0,0,0,0,300
43466,200,120,80,0,0,0,400
43467,190,100,160,160,160,0,770
43468,190,120,80,0,0,0,390
43469,220,120,120,0,0,0,460
43470,250,100,120,0,0,0,470
43471,190,80,80,80,0,0,430
43472,170,100,40,80,160,0,550
43473,230,160,80,80,0,0,550
43474,240,200,160,240,160,0,1000
43475,160,80,40,0,0,0,280
43476,170,120,160,80,0,0,530
43477,200,160,40,80,160,0,640
43478,170,60,80,0,0,0,310
43479,200,140,120,160,0,0,620
43480,200,120,80,160,320,320,1200
43481,200,140,160,160,160,320,1140
43482,180,80,120,80,160,320,940
43483,170,100,40,80,160,0,550
43484,190,120,120,80,160,0,670
43485,180,100,80,80,0,0,440
43486,180,140,160,0,0,0,480
43487,230,120,80,80,160,0,670
43488,210,100,40,0,0,0,350
43489,240,140,80,80,160,0,700
43490,130,60,40,80,160,0,470
43491,210,160,120,80,0,0,570
43492,130,120,80,160,160,0,650
43493,230,160,200,160,0,0,750
43494,220,120,80,0,0,0,420
43495,190,140,80,0,0,0,410
43496,230,100,80,80,160,0,650
43497,230,160,120,0,0,0,510
43498,180,140,120,80,0,0,520
43499,210,160,160,160,320,0,1010
43500,210,100,80,80,160,0,630
43501,210,100,80,80,0,0,470
43502,220,140,120,240,320,0,1040
43503,140,100,80,160,320,0,800
43504,220,140,120,80,0,0,560
43505,190,160,120,80,0,0,550
43506,190,140,80,80,160,0,650
43507,250,120,120,160,0,0,650
43508,200,100,80,80,160,0,620
43509,220,100,40,80,160,0,600
43510,160,120,160,160,160,0,760
43511,180,80,120,80,160,0,620
43512,200,140,40,0,0,0,380
43513,200,120,120,160,160,0,760
43514,190,100,40,0,0,0,330
43515,170,120,120,0,0,0,410
43516,190,120,80,160,160,320,1030
43517,160,80,120,80,0,0,440
43518,190,80,80,0,0,0,350
43519,190,140,80,80,160,0,650
43520,220,120,120,80,0,0,540
43521,170,80,120,160,320,320,1170
43522,200,160,200,240,160,0,960
43523,190,160,120,80,0,0,550
43524,180,140,80,160,320,320,1200
43525,180,160,120,160,160,0,780
43526,190,200,160,80,160,0,790
43527,200,100,80,160,160,0,700
43528,230,140,120,80,0,0,570
43529,210,140,120,80,0,0,550
43530,180,100,80,0,0,0,360
43531,200,140,0,0,0,0,340
43532,210,80,0,0,0,0,290
43533,230,140,120,0,0,0,490
43534,180,120,120,80,0,0,500
43535,190,60,40,0,0,0,290
43536,210,120,40,80,160,0,610
43537,190,60,40,80,160,320,850
43538,210,80,160,240,320,320,1330
43539,180,180,120,80,160,0,720
43540,170,80,80,0,0,0,330
43541,160,100,40,80,160,0,540
43542,190,140,120,160,160,0,770
43543,170,120,120,80,160,320,970
43544,210,160,200,80,160,0,810
43545,180,160,120,80,160,0,700
43546,180,120,160,160,320,0,940
43547,190,140,80,160,320,0,890
43548,200,120,120,160,160,0,760
43549,240,100,0,0,0,0,340
43550,200,140,120,160,160,0,780
43551,190,80,40,80,160,0,550
43552,230,140,160,0,0,0,530
43553,180,120,120,80,160,0,660
43554,220,160,80,80,160,0,700
43555,230,180,160,240,160,0,970
43556,130,60,80,0,0,0,270
43557,200,140,80,0,0,0,420
43558,150,80,80,160,0,0,470
43559,200,120,80,160,160,0,720
43560,200,120,80,0,0,0,400
43561,250,120,80,160,160,320,1090
43562,210,60,80,160,0,0,510
43563,210,120,120,0,0,0,450
43564,210,180,120,80,0,0,590
43565,180,140,160,160,320,320,1280
43566,200,60,80,80,0,0,420
43567,170,180,160,160,160,0,830
43568,190,100,80,0,0,0,370
43569,200,100,80,80,160,0,620
43570,200,200,160,160,320,320,1360
43571,200,80,80,80,160,320,920
43572,160,80,0,0,0,0,240
43573,210,160,120,240,320,0,1050
43574,200,160,160,80,0,0,600
43575,230,80,40,0,0,0,350
43576,200,120,160,80,0,0,560
43577,200,100,80,0,0,0,380
43578,180,100,120,80,0,0,480
43579,190,100,160,80,0,0,530
43580,200,100,120,160,0,0,580
43581,190,140,40,80,160,0,610
43582,230,180,160,80,160,0,810
43583,140,100,80,80,160,0,560
43584,190,80,80,80,0,0,430
43585,220,80,40,0,0,0,340
43586,200,100,120,80,160,0,660
43587,210,80,80,0,0,0,370
43588,120,100,80,80,160,0,540
43589,190,160,200,240,0,0,790
43590,190,60,80,80,160,0,570
43591,170,160,120,160,160,0,770
43592,220,120,160,160,0,0,660
43593,210,80,80,80,160,0,610
43594,220,80,80,80,160,0,620
43595,200,80,40,0,0,0,320
43596,210,80,120,160,320,0,890
43597,230,160,160,80,0,0,630
43598,160,100,40,80,160,0,540
43599,220,140,200,0,0,0,560
43600,200,140,160,240,0,0,740
43601,160,140,80,80,160,0,620
43602,210,120,120,80,160,320,1010
43603,180,80,40,80,160,0,540
43604,170,100,0,0,0,0,270
43605,190,120,120,160,320,0,910
43606,160,120,80,0,0,0,360
43607,210,140,120,80,160,0,710
43608,180,80,120,80,0,0,460
43609,220,140,200,240,160,0,960
43610,190,160,120,80,0,0,550
43611,170,100,80,80,160,0,590
43612,160,120,160,240,160,0,840
43613,190,100,120,0,0,0,410
43614,160,80,40,0,0,0,280
43615,180,100,120,160,320,0,880
43616,220,200,200,160,160,320,1260
43617,180,160,120,160,160,320,1100
43618,180,160,200,240,160,0,940
43619,210,160,120,160,160,0,810
43620,210,120,200,160,160,0,850
43621,210,80,40,80,0,0,410
43622,190,120,120,80,0,0,510
43623,210,120,40,0,0,0,370
43624,190,100,80,160,160,0,690
43625,200,160,120,80,160,0,720
43626,200,140,80,80,0,0,500
43627,200,120,160,240,160,0,880
43628,130,80,120,240,160,320,1050
43629,190,80,120,80,0,0,470
43630,230,80,80,80,160,0,630
43631,190,140,120,0,0,0,450
43632,200,200,80,160,160,0,800
43633,200,80,120,160,320,0,880
43634,250,120,80,0,0,0,450
43635,220,80,80,80,160,0,620
43636,200,80,40,80,0,0,400
43637,190,140,160,80,160,320,1050
43638,210,120,80,80,160,0,650
43639,160,80,80,80,0,0,400
43640,230,120,120,160,160,0,790
43641,200,120,40,80,0,0,440
43642,180,80,80,80,160,0,580
43643,250,160,80,160,160,0,810
43644,190,120,80,80,160,0,630
43645,190,80,80,80,0,0,430
43646,200,80,40,80,160,0,560
43647,190,140,80,160,160,0,730
43648,240,100,120,160,0,0,620
43649,180,100,120,80,160,0,640
43650,200,180,200,240,320,320,1460
43651,180,80,120,160,160,0,700
43652,200,80,120,80,160,0,640
43653,200,140,160,0,0,0,500
43654,180,120,80,80,160,0,620
43655,150,80,80,80,160,320,870
43656,170,140,80,80,0,0,470
43657,180,80,40,80,160,0,540
43658,240,100,120,80,160,0,700
43659,200,100,80,160,160,0,700
43660,220,180,160,80,160,0,800
43661,180,120,120,0,0,0,420
43662,190,80,80,80,0,0,430
43663,200,180,120,160,320,0,980
43664,170,100,80,0,0,0,350
43665,190,100,160,160,160,0,770
43666,150,120,160,160,160,320,1070
43667,230,140,160,240,320,0,1090
43668,220,140,200,160,160,0,880
43669,180,120,80,80,0,0,460
43670,190,100,80,80,160,0,610
43671,150,140,160,160,0,0,610
43672,210,180,80,80,160,0,710
43673,190,160,120,80,0,0,550
43674,180,60,120,80,0,0,440
43675,150,140,120,80,160,0,650
43676,160,120,80,160,320,0,840
43677,220,120,80,0,0,0,420
43678,180,120,120,80,0,0,500
43679,190,200,80,80,160,0,710
43680,190,120,80,80,0,0,470
43681,220,160,120,80,0,0,580
43682,200,100,160,160,160,0,780
43683,180,140,120,160,160,320,1080
43684,190,140,120,160,160,0,770
43685,210,180,160,160,160,320,1190
43686,190,120,80,80,0,0,470
43687,190,120,160,160,320,0,950
43688,190,100,80,0,0,0,370
43689,200,140,160,160,160,0,820
43690,210,100,80,80,0,0,470
43691,190,140,80,80,160,0,650
43692,170,160,120,160,320,320,1250
43693,170,120,160,0,0,0,450
43694,180,100,120,160,160,0,720
43695,200,160,200,80,160,0,800
43696,190,120,40,0,0,0,350
43697,200,100,160,240,320,0,1020
43698,180,120,160,80,160,0,700
43699,240,120,120,80,160,320,1040
43700,180,120,120,160,0,0,580
43701,180,160,160,80,0,0,580
43702,210,140,200,80,160,320,1110
43703,170,60,40,80,0,0,350
43704,170,80,0,0,0,0,250
43705,200,100,80,80,0,0,460
43706,180,80,40,0,0,0,300
43707,200,100,80,80,160,0,620
43708,190,120,120,80,160,0,670
43709,160,120,80,80,160,320,920
43710,190,120,80,80,160,320,950
43711,210,60,40,80,0,0,390
43712,200,160,80,80,0,0,520
43713,200,120,80,0,0,0,400
43714,190,120,160,80,160,0,710
43715,160,120,120,80,0,0,480
43716,200,60,80,80,160,320,900
43717,190,80,120,160,0,0,550
43718,170,160,160,0,0,0,490
43719,150,100,120,0,0,0,370
43720,170,120,80,160,160,0,690
43721,190,120,160,0,0,0,470
43722,200,80,80,0,0,0,360
43723,180,60,120,80,0,0,440
43724,200,120,40,80,160,0,600
43725,210,140,160,240,320,0,1070
43726,200,160,120,160,160,0,800
43727,210,140,120,80,0,0,550
43728,160,120,240,160,320,0,1000
43729,210,160,80,80,160,320,1010
43730,160,140,40,80,0,0,420
43731,210,120,120,80,160,0,690
43732,200,120,160,80,160,0,720
43733,180,120,80,80,160,0,620
43734,230,120,40,80,160,0,630
43735,190,100,80,160,160,320,1010
43736,260,120,80,0,0,0,460
43737,180,120,40,80,160,0,580
43738,190,140,80,80,160,0,650
43739,250,80,80,160,160,0,730
43740,230,100,80,160,160,0,730
43741,210,120,120,160,0,0,610
43742,200,100,120,80,160,0,660
43743,190,120,80,80,0,0,470
43744,230,160,120,160,320,0,990
43745,210,100,0,0,0,0,310
43746,200,100,40,80,0,0,420
43747,200,120,120,160,160,320,1080
43748,190,120,80,80,160,320,950
43749,180,120,40,80,160,0,580
43750,170,100,120,160,320,320,1190
43751,180,120,160,80,160,0,700
43752,200,100,160,160,0,0,620
43753,190,120,120,160,0,0,590
43754,180,100,40,80,0,0,400
43755,210,120,80,80,160,320,970
43756,220,80,40,80,160,0,580
43757,210,120,120,160,320,320,1250
43758,170,140,120,160,160,0,750
43759,180,100,120,160,160,320,1040
43760,170,80,80,80,0,0,410
43761,200,60,80,80,160,320,900
43762,190,120,40,80,160,320,910
43763,170,160,40,80,160,0,610
43764,170,80,120,80,0,0,450
43765,140,100,160,240,160,0,800
43766,190,120,160,160,160,320,1110
43767,130,120,80,160,160,320,970
43768,200,120,160,240,320,0,1040
43769,180,120,80,80,0,0,460
43770,180,120,160,0,0,0,460
43771,200,180,120,80,0,0,580
43772,200,180,80,80,0,0,540
43773,200,180,40,80,0,0,500
43774,160,120,80,160,0,0,520
43775,160,100,80,160,320,0,820
43776,180,140,80,80,160,0,640
43777,180,120,120,80,0,0,500
43778,200,120,160,80,160,0,720
43779,220,140,120,0,0,0,480
43780,170,160,280,160,320,0,1090
43781,190,100,120,80,160,320,970
43782,210,100,160,80,0,0,550
43783,200,100,40,0,0,0,340
43784,170,160,120,80,0,0,530
43785,180,140,40,80,160,0,600
43786,170,140,40,0,0,0,350
43787,210,60,80,0,0,0,350
43788,160,180,200,160,0,0,700
43789,190,160,120,80,160,0,710
43790,200,180,200,160,160,320,1220
43791,190,160,160,80,0,0,590
43792,210,140,200,240,160,0,950
43793,220,120,80,80,160,0,660
43794,180,180,160,80,160,0,760
43795,240,140,120,160,160,0,820
43796,170,80,80,80,160,0,570
43797,210,100,80,80,160,0,630
43798,210,80,80,160,160,0,690
43799,200,120,120,240,160,0,840
43800,240,160,160,160,160,0,880
43801,170,100,160,160,0,0,590
43802,220,100,40,0,0,0,360
43803,190,160,120,80,160,0,710
43804,180,120,200,160,160,0,820
43805,210,120,160,80,0,0,570
43806,200,180,0,0,0,0,380
43807,170,160,80,80,0,0,490
43808,190,120,80,160,0,0,550
43809,200,160,160,0,0,0,520
43810,210,100,120,160,160,320,1070
43811,220,100,80,160,0,0,560
43812,190,100,120,80,160,320,970
43813,190,180,160,80,160,0,770
43814,190,160,160,160,160,0,830
43815,220,160,200,160,160,0,900
43816,200,120,80,0,0,0,400
43817,200,120,120,80,160,0,680
43818,170,140,0,0,0,0,310
43819,180,140,120,160,0,0,600
43820,260,120,160,80,0,0,620
43821,180,80,120,80,160,0,620
43822,160,60,80,80,160,320,860
43823,140,100,80,80,160,0,560
43824,190,80,80,80,0,0,430
43825,150,100,160,160,160,0,730
43826,200,120,40,80,160,0,600
43827,220,120,160,160,160,0,820
43828,220,100,0,0,0,0,320
43829,200,120,40,80,160,0,600
43830,210,120,120,80,160,320,1010
43831,170,160,120,80,0,0,530
43832,200,140,40,0,0,0,380
43833,180,120,160,160,0,0,620
43834,170,100,40,80,0,0,390
43835,240,180,160,240,320,320,1460
43836,210,60,80,160,160,0,670
43837,190,100,120,160,320,0,890
43838,180,140,160,80,160,320,1040
43839,240,160,80,160,320,0,960
43840,160,100,160,240,320,0,980
43841,180,140,120,160,320,320,1240
43842,180,120,120,160,320,320,1220
43843,210,100,120,160,160,0,750
43844,220,160,80,80,160,0,700
43845,220,100,120,80,0,0,520
43846,220,140,80,80,160,0,680
43847,190,140,160,160,160,0,810
43848,180,120,120,80,0,0,500
43849,190,100,80,0,0,0,370
43850,210,140,120,160,0,0,630
43851,160,100,120,0,0,0,380
43852,170,140,80,80,0,0,470
43853,200,100,40,80,0,0,420
43854,230,140,120,80,160,0,730
43855,180,100,80,80,160,0,600
43856,190,140,120,160,160,0,770
43857,200,100,120,160,0,0,580
43858,190,160,200,160,160,320,1190
43859,200,140,80,80,160,0,660
43860,210,160,80,160,160,0,770
43861,190,140,120,240,160,320,1170
43862,190,120,120,240,160,0,830
43863,170,100,120,240,160,0,790
43864,200,120,120,80,160,320,1000
43865,170,160,80,0,0,0,410
43866,190,100,80,160,320,320,1170
43867,190,100,80,80,160,0,610
43868,190,120,40,0,0,0,350
43869,200,80,80,80,160,0,600
43870,180,140,160,240,160,0,880
43871,210,160,120,160,320,0,970
43872,150,140,160,160,160,320,1090
43873,220,120,80,80,160,0,660
43874,190,120,120,80,160,0,670
43875,180,100,120,80,160,0,640
43876,250,140,80,160,0,0,630
43877,240,160,120,80,160,0,760
43878,220,60,80,0,0,0,360
43879,210,120,80,0,0,0,410
43880,200,100,40,0,0,0,340
43881,200,140,160,240,160,0,900
43882,170,140,80,160,0,0,550
43883,220,120,80,160,160,320,1060
43884,170,180,120,160,0,0,630
43885,210,140,120,80,160,0,710
43886,170,140,160,80,160,320,1030
43887,210,120,80,160,0,0,570
43888,230,140,80,160,160,0,770
43889,190,80,80,80,0,0,430
43890,210,140,0,0,0,0,350
43891,200,100,120,160,160,320,1060
43892,190,120,40,0,0,0,350
43893,210,80,80,160,320,0,850
43894,180,100,80,80,0,0,440
43895,190,60,40,80,160,320,850
43896,170,120,80,160,160,0,690
43897,220,60,40,0,0,0,320
43898,220,140,80,80,0,0,520
43899,180,120,80,80,160,320,940
43900,200,120,160,80,160,0,720
43901,220,140,160,160,0,0,680
43902,200,120,120,160,320,0,920
43903,200,120,40,0,0,0,360
43904,200,140,120,160,160,0,780
43905,150,100,120,160,160,0,690
43906,190,160,160,240,160,0,910
43907,210,160,120,80,160,320,1050
43908,200,100,120,160,160,0,740
43909,210,80,80,160,160,320,1010
43910,200,160,120,80,160,0,720
43911,240,80,80,80,0,0,480
43912,200,140,160,160,0,0,660
43913,200,100,160,240,320,0,1020
43914,210,120,120,160,320,320,1250
43915,200,120,80,80,160,320,960
43916,190,140,120,80,160,0,690
43917,150,80,120,80,0,0,430
43918,210,100,80,80,0,0,470
43919,170,120,120,160,320,0,890
43920,220,120,40,0,0,0,380
43921,190,140,80,80,0,0,490
43922,200,160,160,80,160,0,760
43923,190,120,120,0,0,0,430
43924,200,140,120,80,0,0,540
43925,170,60,40,0,0,0,270
43926,230,120,120,80,160,320,1030
43927,190,140,80,80,160,320,970
43928,210,160,120,160,0,0,650
43929,210,180,120,80,0,0,590
43930,170,100,120,160,160,320,1030
43931,250,140,200,80,160,320,1150
43932,200,160,200,240,160,0,960
43933,180,120,120,80,0,0,500
43934,220,80,120,80,160,0,660
43935,170,100,40,0,0,0,310
43936,200,160,120,0,0,0,480
43937,210,40,80,160,320,320,1130
43938,130,60,80,0,0,0,270
43939,210,40,80,80,160,0,570
43940,230,180,80,160,0,0,650
43941,230,140,120,80,160,0,730
43942,180,140,160,160,160,0,800
43943,220,140,120,160,0,0,640
43944,210,120,80,0,0,0,410
43945,220,100,80,80,160,0,640
43946,190,100,80,160,0,0,530
43947,200,160,120,80,160,320,1040
43948,200,140,80,0,0,0,420
43949,240,180,160,160,160,0,900
43950,170,100,120,240,320,320,1270
43951,190,80,0,0,0,0,270
43952,200,80,80,80,0,0,440
43953,180,120,160,240,160,0,860
43954,170,100,120,160,160,0,710
43955,210,140,160,240,0,0,750
43956,190,160,120,240,0,0,710
43957,210,100,80,0,0,0,390
43958,250,140,120,160,160,0,830
43959,200,80,120,160,320,0,880
43960,150,140,80,80,160,0,610
43961,190,160,120,160,0,0,630
43962,190,200,160,0,0,0,550
43963,200,80,40,0,0,0,320
43964,200,60,80,160,320,0,820
43965,190,80,80,80,160,0,590
43966,180,120,120,80,160,0,660
43967,200,140,120,0,0,0,460
43968,200,140,160,80,0,0,580
43969,180,120,80,0,0,0,380
43970,190,120,80,80,0,0,470
43971,210,120,80,80,0,0,490
43972,210,100,40,80,160,0,590
43973,180,80,120,160,160,320,1020
43974,190,100,160,160,160,0,770
43975,190,120,80,80,160,320,950
43976,200,80,80,160,160,0,680
43977,180,140,120,80,0,0,520
43978,220,120,0,0,0,0,340
43979,200,60,40,80,160,0,540
43980,180,140,160,80,160,0,720
43981,220,160,200,80,0,0,660
43982,240,100,0,0,0,0,340
43983,160,120,160,80,0,0,520
43984,230,120,160,160,160,0,830
43985,200,80,80,80,0,0,440
43986,190,120,120,160,160,0,750
43987,200,120,120,80,160,0,680
43988,200,80,80,160,160,0,680
43989,160,100,120,80,160,0,620
43990,190,160,80,80,160,0,670
43991,200,160,200,160,0,0,720
43992,210,140,80,0,0,0,430
43993,220,140,120,80,0,0,560
43994,180,160,160,80,160,320,1060
43995,200,120,200,160,0,0,680
43996,220,180,80,80,0,0,560
43997,190,120,120,0,0,0,430
43998,200,160,160,240,160,0,920
43999,180,80,80,80,0,0,420
44000,190,120,80,80,160,0,630
44001,200,100,80,80,0,0,460
44002,190,100,40,80,0,0,410
44003,200,140,120,80,0,0,540
44004,200,100,40,0,0,0,340
44005,230,160,160,160,160,0,870
44006,220,120,120,80,160,0,700
44007,190,140,120,160,160,0,770
44008,200,140,120,80,160,0,700
44009,190,40,80,80,160,0,550
44010,210,160,160,80,0,0,610
44011,230,100,120,160,0,0,610
44012,210,140,120,160,320,0,950
44013,160,160,120,80,0,0,520
44014,200,80,80,80,0,0,440
44015,210,80,80,160,160,0,690
44016,150,40,40,80,160,0,470
44017,180,120,80,160,320,320,1180
44018,180,120,80,80,160,0,620
44019,200,100,120,80,0,0,500
44020,240,160,160,80,0,0,640
44021,200,120,80,80,160,0,640
44022,230,180,80,160,160,0,810
44023,220,120,160,80,0,0,580
44024,200,120,80,80,160,320,960
44025,190,120,120,160,320,0,910
44026,210,100,40,80,160,320,910
44027,260,180,160,160,160,0,920
44028,220,100,120,160,0,0,600
44029,200,80,40,80,0,0,400
44030,210,100,40,80,160,0,590
44031,150,140,160,240,160,320,1170
44032,190,60,120,0,0,0,370
44033,190,80,80,0,0,0,350
44034,200,80,0,0,0,0,280
44035,180,80,40,80,160,0,540
44036,200,180,160,160,160,0,860
44037,190,120,80,80,160,0,630
44038,180,80,80,0,0,0,340
44039,220,140,120,160,320,0,960
44040,210,140,200,160,160,320,1190
44041,200,100,80,0,0,0,380
44042,240,180,200,80,160,320,1180
44043,200,140,120,0,0,0,460
44044,200,80,80,80,0,0,440
44045,210,160,160,80,160,0,770
44046,180,100,80,80,160,0,600
44047,180,100,80,160,320,0,840
44048,240,100,120,160,0,0,620
44049,190,120,200,80,160,0,750
44050,210,120,120,160,0,0,610
44051,170,60,80,80,0,0,390
44052,160,100,160,160,320,0,900
44053,250,100,80,0,0,0,430
44054,170,160,160,80,160,0,730
44055,220,120,40,0,0,0,380
44056,160,120,160,160,160,0,760
44057,180,80,40,80,160,0,540
44058,150,120,120,160,320,0,870
44059,200,100,80,80,160,0,620
44060,160,80,80,160,160,0,640
44061,240,60,80,0,0,0,380
44062,200,120,160,240,160,0,880
44063,200,140,120,80,0,0,540
44064,170,100,160,80,160,0,670
44065,190,120,80,80,160,0,630
44066,210,80,40,80,0,0,410
44067,170,140,80,80,160,0,630
44068,200,160,160,160,160,0,840
44069,180,120,40,80,0,0,420
44070,180,120,160,80,160,0,700
44071,210,120,160,160,160,0,810
44072,170,120,160,80,160,0,690
44073,180,120,160,160,160,0,780
44074,180,80,80,80,160,320,900
44075,220,120,80,80,0,0,500
44076,230,140,120,160,160,0,810
44077,190,120,160,160,160,320,1110
44078,210,140,80,0,0,0,430
44079,250,100,160,80,0,0,590
44080,220,120,80,0,0,0,420
44081,230,160,120,160,160,0,830
44082,190,140,160,80,0,0,570
44083,220,140,80,160,160,320,1080
44084,220,120,80,0,0,0,420
44085,210,80,40,80,160,320,890
44086,230,140,40,80,0,0,490
44087,200,140,80,80,160,0,660
44088,260,200,40,0,0,0,500
44089,170,120,120,80,160,0,650
44090,160,100,80,80,160,0,580
44091,220,140,160,160,0,0,680
44092,180,100,80,80,0,0,440
44093,180,80,80,80,160,0,580
44094,160,120,160,240,160,0,840
44095,200,120,120,160,320,0,920
44096,220,100,40,80,160,0,600
44097,220,180,80,0,0,0,480
44098,190,120,80,80,0,0,470
44099,210,100,80,80,0,0,470
44100,200,120,120,160,320,0,920
44101,180,140,80,80,160,0,640
44102,180,140,80,80,0,0,480
44103,180,140,80,0,0,0,400
44104,210,100,80,80,0,0,470
44105,140,100,40,80,160,320,840
44106,210,120,80,80,0,0,490
44107,220,100,80,0,0,0,400
44108,220,120,80,80,160,0,660
44109,180,140,80,80,160,0,640
44110,180,120,40,80,0,0,420
44111,190,120,80,80,160,0,630
44112,210,100,80,80,0,0,470
44113,230,100,160,240,160,0,890
44114,190,120,0,0,0,0,310
44115,140,140,120,80,160,0,640
44116,200,120,80,80,160,0,640
44117,250,160,120,80,160,0,770
44118,220,140,120,80,160,0,720
44119,160,120,160,160,160,0,760
44120,200,120,80,80,160,0,640
44121,190,120,120,160,320,0,910
44122,160,100,80,80,160,0,580
44123,200,180,80,80,0,0,540
44124,200,120,120,80,0,0,520
44125,230,120,80,0,0,0,430
44126,190,160,200,160,160,320,1190
44127,190,100,80,160,160,0,690
44128,180,60,80,160,160,320,960
44129,180,60,80,80,160,0,560
44130,180,120,120,160,320,320,1220
44131,170,140,120,160,320,0,910
44132,200,160,160,240,0,0,760
44133,200,140,80,80,0,0,500
44134,180,100,40,0,0,0,320
44135,210,100,80,80,160,0,630
44136,190,120,160,160,160,320,1110
44137,170,60,80,80,0,0,390
44138,170,100,80,160,160,0,670
44139,170,80,40,0,0,0,290
44140,170,160,200,160,160,0,850
44141,200,80,0,0,0,0,280
44142,190,80,80,0,0,0,350
44143,220,120,80,80,0,0,500
44144,170,100,80,160,160,0,670
44145,190,160,240,160,160,0,910
44146,210,120,120,80,0,0,530
44147,210,200,160,0,0,0,570
44148,190,100,0,0,0,0,290
44149,190,120,0,0,0,0,310
44150,210,140,80,160,160,0,750
44151,190,140,160,0,0,0,490
44152,190,80,120,160,160,0,710
44153,220,120,160,80,0,0,580
44154,200,160,120,0,0,0,480
44155,180,80,120,160,160,320,1020
44156,170,100,120,80,0,0,470
44157,240,120,80,0,0,0,440
44158,240,160,80,80,160,0,720
44159,220,120,160,240,320,320,1380
44160,180,60,40,80,0,0,360
44161,250,180,120,80,160,320,1110
44162,160,120,80,160,0,0,520
44163,220,60,120,240,320,0,960
44164,220,120,160,160,160,320,1140
44165,190,60,120,160,0,0,530
44166,210,120,120,80,160,0,690
44167,200,120,80,80,160,0,640
44168,250,60,40,80,160,0,590
44169,170,120,120,160,160,320,1050
44170,170,120,160,80,160,0,690
44171,200,120,120,240,160,0,840
44172,240,120,120,160,320,320,1280
44173,240,100,120,160,0,0,620
44174,190,140,160,0,0,0,490
44175,220,80,40,0,0,0,340
44176,220,120,120,80,0,0,540
44177,230,160,200,160,160,320,1230
44178,210,120,80,80,160,0,650
44179,180,140,80,80,0,0,480
44180,230,140,120,160,160,0,810
44181,220,180,160,240,320,0,1120
44182,230,160,40,80,0,0,510
44183,180,120,160,160,160,0,780
44184,240,100,80,160,320,0,900
44185,190,100,120,80,0,0,490
44186,220,120,80,80,160,0,660
44187,210,140,120,80,160,320,1030
44188,190,140,120,80,160,0,690
44189,190,100,120,160,160,0,730
44190,220,140,40,0,0,0,400
44191,200,100,120,160,320,320,1220
44192,200,120,120,160,320,0,920
44193,200,100,80,80,160,0,620
44194,220,60,40,0,0,0,320
44195,210,160,160,160,160,0,850
44196,180,160,160,240,320,0,1060
44197,230,120,160,160,160,0,830
44198,230,120,80,160,320,0,910
44199,190,80,160,80,160,0,670
44200,240,160,200,240,320,0,1160
44201,200,160,120,160,320,0,960
44202,180,80,80,80,160,0,580
44203,190,60,40,0,0,0,290
44204,210,100,120,160,160,0,750
44205,210,120,120,80,160,0,690
44206,190,140,120,160,160,0,770
44207,190,140,200,80,0,0,610
44208,190,80,40,80,0,0,390
44209,200,140,160,240,320,0,1060
44210,210,120,80,160,160,0,730
44211,160,140,40,80,160,0,580
44212,180,120,40,0,0,0,340
44213,200,100,80,160,160,0,700
44214,190,60,80,80,160,0,570
44215,160,140,120,80,160,0,660
44216,240,160,120,80,0,0,600
44217,230,120,80,160,160,0,750
44218,220,180,160,80,0,0,640
44219,220,80,40,0,0,0,340
44220,230,120,80,160,160,0,750
44221,180,140,80,160,160,0,720
44222,190,60,80,80,0,0,410
44223,160,100,120,160,0,0,540
44224,210,160,120,240,160,0,890
44225,210,120,40,80,160,0,610
44226,230,140,120,160,0,0,650
44227,220,100,120,160,160,0,760
44228,190,100,120,160,160,320,1050
44229,210,120,80,160,160,0,730
44230,150,40,80,0,0,0,270
44231,220,140,120,80,160,0,720
44232,180,140,120,80,160,0,680
44233,180,100,80,160,320,320,1160
44234,180,80,80,80,160,320,900
44235,190,120,120,160,160,0,750
44236,170,100,80,0,0,0,350
44237,170,80,80,0,0,0,330
44238,210,140,120,240,320,0,1030
44239,230,140,80,80,160,0,690
44240,150,140,160,160,320,0,930
44241,240,160,120,160,160,0,840
44242,200,140,80,160,160,0,740
44243,180,200,160,80,0,0,620
44244,220,140,160,240,160,0,920
44245,220,180,120,160,0,0,680
44246,240,160,120,160,160,320,1160
44247,230,100,40,0,0,0,370
44248,180,60,80,0,0,0,320
44249,170,160,200,240,160,0,930
44250,190,140,80,80,0,0,490
44251,170,100,120,80,160,0,630
44252,210,100,40,0,0,0,350
44253,160,60,40,0,0,0,260
44254,180,120,80,80,0,0,460
44255,210,120,80,160,0,0,570
44256,170,100,120,240,160,0,790
44257,190,120,200,160,320,320,1310
44258,200,120,80,80,160,0,640
44259,200,120,80,80,0,0,480
44260,170,140,160,240,320,0,1030
44261,190,120,40,0,0,0,350
44262,170,80,40,0,0,0,290
44263,200,120,200,160,160,0,840
44264,210,120,40,0,0,0,370
44265,210,140,160,80,160,0,750
44266,230,120,160,80,160,0,750
44267,190,180,160,160,160,0,850
44268,190,180,160,240,160,0,930
44269,170,100,80,160,160,0,670
44270,210,120,80,160,160,0,730
44271,150,120,120,160,0,0,550
44272,190,140,120,160,0,0,610
44273,210,120,120,160,320,320,1250
44274,220,180,160,240,160,0,960
44275,200,160,80,0,0,0,440
44276,160,120,40,0,0,0,320
44277,220,200,160,80,160,320,1140
44278,180,80,160,160,160,0,740
44279,150,120,160,240,160,0,830
44280,210,80,120,0,0,0,410
44281,160,80,160,240,320,320,1280
44282,190,140,160,80,0,0,570
44283,140,80,80,160,0,0,460
44284,200,120,80,80,0,0,480
44285,210,120,40,0,0,0,370
44286,150,140,160,160,160,0,770
44287,210,120,160,80,160,0,730
44288,200,40,80,160,0,0,480
44289,230,100,120,160,320,0,930
44290,200,100,120,80,0,0,500
44291,190,160,80,160,320,320,1230
44292,210,120,80,80,160,0,650
44293,220,80,80,0,0,0,380
44294,170,160,200,160,160,0,850
44295,190,140,120,0,0,0,450
44296,210,120,80,0,0,0,410
44297,180,120,80,80,160,320,940
44298,140,100,120,160,320,320,1160
44299,170,80,40,0,0,0,290
44300,210,180,80,0,0,0,470
44301,200,100,80,80,0,0,460
44302,190,120,80,80,160,0,630
44303,160,120,160,320,320,0,1080
44304,180,160,160,160,320,0,980
44305,220,160,80,0,0,0,460
44306,170,80,40,80,160,0,530
44307,170,160,200,80,0,0,610
44308,160,120,80,80,160,0,600
44309,160,100,120,80,160,0,620
44310,140,120,80,80,160,320,900
44311,200,100,80,0,0,0,380
44312,200,100,120,80,160,320,980
44313,200,160,80,80,160,320,1000
44314,190,80,120,160,160,320,1030
44315,150,40,0,0,0,0,190
44316,210,140,160,240,320,320,1390
44317,200,160,40,0,0,0,400
44318,220,120,120,80,160,0,700
44319,200,140,200,240,160,320,1260
44320,170,100,80,80,160,0,590
44321,200,200,160,80,160,0,800
44322,200,120,120,80,0,0,520
44323,190,120,160,80,160,0,710
44324,180,140,80,80,0,0,480
44325,220,100,80,80,0,0,480
44326,180,100,120,240,320,0,960
44327,190,120,40,80,160,0,590
44328,190,140,120,80,0,0,530
44329,240,200,160,0,0,0,600
44330,160,120,200,240,160,0,880
44331,210,120,120,80,160,0,690
44332,210,140,120,80,160,320,1030
44333,190,100,80,80,160,0,610
44334,190,100,80,80,0,0,450
44335,220,120,120,0,0,0,460
44336,230,180,200,160,320,320,1410
44337,210,160,160,160,0,0,690
44338,210,160,120,160,160,0,810
44339,200,120,40,80,160,0,600
44340,200,80,80,80,160,0,600
44341,190,160,160,80,160,320,1070
44342,220,160,80,160,160,0,780
44343,230,120,120,80,160,0,710
44344,180,120,120,0,0,0,420
44345,170,100,40,80,160,0,550
44346,180,120,40,0,0,0,340
44347,170,140,40,0,0,0,350
44348,210,80,120,160,160,0,730
44349,170,60,40,80,0,0,350
44350,190,140,120,160,320,0,930
44351,190,100,40,80,160,0,570
44352,250,140,80,160,320,0,950
44353,200,120,40,80,160,0,600
44354,200,80,40,80,0,0,400
44355,230,160,120,240,320,320,1390
44356,220,120,120,160,320,320,1260
44357,190,120,120,160,0,0,590
44358,230,160,160,80,160,0,790
44359,160,140,160,160,160,0,780
44360,170,100,80,80,160,0,590
44361,220,100,120,80,160,0,680
44362,180,100,120,80,0,0,480
44363,190,100,40,0,0,0,330
44364,220,140,160,160,160,320,1160
44365,160,120,80,80,0,0,440
44366,210,100,80,160,0,0,550
44367,180,120,120,0,0,0,420
44368,210,120,160,0,0,0,490
44369,230,100,80,0,0,0,410
44370,200,120,120,160,160,0,760
44371,170,120,80,80,160,0,610
44372,180,120,80,160,160,0,700
44373,160,120,160,240,160,0,840
44374,190,160,160,240,320,0,1070
44375,230,60,120,80,160,0,650
44376,230,160,160,240,160,320,1270
44377,220,60,40,80,0,0,400
44378,160,80,120,240,320,0,920
44379,210,120,160,160,160,0,810
44380,210,100,80,80,0,0,470
44381,180,140,160,0,0,0,480
44382,250,120,80,80,0,0,530
44383,220,140,40,80,0,0,480
44384,190,100,160,240,320,320,1330
44385,200,120,80,80,0,0,480
44386,160,160,160,160,160,0,800
44387,230,120,160,0,0,0,510
44388,220,100,40,80,160,0,600
44389,210,140,120,240,320,0,1030
44390,170,120,160,80,0,0,530
44391,190,140,160,80,0,0,570
44392,190,100,40,0,0,0,330
44393,250,140,80,80,0,0,550
44394,210,100,80,80,0,0,470
44395,210,160,120,80,0,0,570
44396,200,120,80,0,0,0,400
44397,180,180,160,0,0,0,520
44398,180,140,120,160,320,0,920
44399,160,140,120,80,160,320,980
44400,170,160,160,80,160,0,730
44401,230,160,120,160,160,0,830
44402,240,160,160,0,0,0,560
44403,170,100,40,80,160,0,550
44404,200,160,120,80,0,0,560
44405,180,100,80,80,0,0,440
44406,180,140,80,80,0,0,480
44407,200,160,160,80,0,0,600
44408,170,140,80,0,0,0,390
44409,230,140,80,0,0,0,450
44410,210,120,120,80,160,0,690
44411,210,100,120,160,160,0,750
44412,200,160,120,160,160,0,800
44413,180,100,160,240,320,320,1320
44414,190,120,120,160,160,0,750
44415,200,100,80,160,160,0,700
44416,180,120,80,80,0,0,460
44417,240,160,80,0,0,0,480
44418,200,100,120,240,160,0,820
44419,200,160,160,240,160,0,920
44420,140,80,80,160,160,0,620
44421,200,180,80,0,0,0,460
44422,220,120,80,80,160,320,980
44423,190,120,80,0,0,0,390
44424,220,100,120,160,160,0,760
44425,190,120,80,80,160,320,950
44426,200,120,80,80,0,0,480
44427,200,160,120,80,0,0,560
44428,190,60,80,160,160,0,650
44429,160,120,160,160,160,0,760
44430,240,140,160,240,0,0,780
44431,190,80,80,80,0,0,430
44432,170,100,40,80,0,0,390
44433,220,120,120,80,0,0,540
44434,200,120,80,80,160,0,640
44435,210,140,160,160,160,320,1150
44436,180,140,80,0,0,0,400
44437,190,140,160,240,160,0,890
44438,190,100,80,80,160,0,610
44439,170,120,80,80,160,0,610
44440,200,180,160,80,160,0,780
44441,220,160,120,80,0,0,580
44442,170,80,40,0,0,0,290
44443,200,80,80,80,0,0,440
44444,210,140,40,0,0,0,390
44445,200,80,40,80,160,320,880
44446,240,120,0,0,0,0,360
44447,180,80,120,160,320,320,1180
44448,170,80,80,0,0,0,330
44449,170,120,80,80,160,0,610
44450,200,160,120,160,0,0,640
44451,150,160,200,160,160,0,830
44452,250,120,200,160,160,0,890
44453,190,160,160,160,320,0,990
44454,180,100,120,160,0,0,560
44455,210,120,160,240,160,0,890
44456,200,60,40,0,0,0,300
44457,160,80,120,0,0,0,360
44458,190,120,120,80,160,0,670
44459,220,180,120,160,160,320,1160
44460,160,60,80,0,0,0,300
44461,220,100,80,80,160,0,640
44462,190,100,80,80,160,0,610
44463,190,120,120,240,320,0,990
44464,200,100,80,80,0,0,460
44465,190,120,160,80,160,0,710
44466,190,160,160,240,320,0,1070
44467,190,140,240,80,160,0,810
44468,180,120,40,0,0,0,340
44469,220,120,40,80,0,0,460
44470,190,140,160,160,160,0,810
44471,230,180,160,160,0,0,730
44472,200,140,200,160,160,0,860
44473,200,140,200,160,160,320,1180
44474,190,160,120,80,0,0,550
44475,210,120,80,80,160,0,650
44476,160,120,80,0,0,0,360
44477,200,120,120,80,160,0,680
44478,200,140,40,0,0,0,380
44479,140,140,120,160,160,0,720
44480,150,120,200,0,0,0,470
44481,170,140,120,80,0,0,510
44482,200,40,40,80,0,0,360
44483,180,140,120,80,160,0,680
44484,180,100,120,80,160,0,640
44485,140,60,40,80,160,0,480
44486,210,80,40,80,160,0,570
44487,240,120,80,80,0,0,520
44488,210,120,120,80,0,0,530
44489,220,120,40,0,0,0,380
44490,210,220,200,240,320,0,1190
44491,180,100,80,0,0,0,360
44492,220,140,120,0,0,0,480
44493,210,240,120,0,0,0,570
44494,180,160,120,80,160,0,700
44495,190,140,0,0,0,0,330
44496,200,140,200,160,0,0,700
44497,160,100,120,240,320,0,940
44498,220,120,40,80,0,0,460
44499,200,140,120,160,160,0,780
44500,200,160,80,80,0,0,520
44501,160,80,40,80,0,0,360
44502,190,140,80,0,0,0,410
44503,230,120,0,0,0,0,350
44504,170,140,80,80,0,0,470
44505,170,120,80,160,160,0,690
44506,190,120,80,80,160,0,630
44507,210,180,120,160,160,0,830
44508,200,140,120,0,0,0,460
44509,210,100,80,160,160,320,1030
44510,160,120,120,80,0,0,480
44511,200,180,120,160,0,0,660
44512,210,140,200,240,0,0,790
44513,160,160,160,160,160,0,800
44514,200,140,80,160,320,0,900
44515,170,140,80,80,160,0,630
44516,160,160,120,160,160,0,760
44517,210,80,40,0,0,0,330
44518,190,140,120,0,0,0,450
44519,240,160,160,160,320,0,1040
44520,170,140,40,80,160,320,910
44521,190,100,40,0,0,0,330
44522,180,120,80,80,160,0,620
44523,230,100,80,0,0,0,410
44524,190,100,120,160,320,320,1210
44525,200,80,120,160,320,0,880
44526,220,100,120,80,0,0,520
44527,210,100,80,80,0,0,470
44528,190,140,120,80,0,0,530
44529,190,180,200,160,160,0,890
44530,190,140,40,80,160,0,610
44531,200,140,120,80,160,0,700
44532,240,120,120,240,320,0,1040
44533,200,100,80,80,160,0,620
44534,170,120,120,80,0,0,490
44535,170,60,40,80,0,0,350
44536,210,160,160,0,0,0,530
44537,180,120,120,80,160,320,980
44538,190,100,80,80,160,0,610
44539,160,60,40,80,0,0,340
44540,180,80,80,80,0,0,420
44541,180,220,160,80,0,0,640
44542,170,140,120,0,0,0,430
44543,220,200,160,240,160,0,980
44544,200,160,40,0,0,0,400
44545,200,180,160,160,0,0,700
44546,190,100,40,80,160,0,570
44547,200,120,80,80,0,0,480
44548,210,60,40,0,0,0,310
44549,220,140,80,160,160,0,760
44550,190,80,40,80,160,0,550
44551,210,120,120,160,160,0,770
44552,190,160,160,160,160,0,830
44553,170,160,120,80,160,0,690
44554,200,100,80,80,160,0,620
44555,190,180,240,80,0,0,690
44556,200,120,80,0,0,0,400
44557,170,140,160,160,320,0,950
44558,190,120,160,160,160,0,790
44559,200,40,0,0,0,0,240
44560,150,60,40,80,160,320,810
44561,200,100,40,80,0,0,420
44562,180,60,80,0,0,0,320
44563,170,120,80,0,0,0,370
44564,200,80,80,80,160,0,600
44565,210,160,40,80,160,0,650
44566,180,60,80,80,160,0,560
44567,190,120,0,0,0,0,310
44568,180,140,160,80,0,0,560
44569,180,80,80,80,160,0,580
44570,170,100,80,80,0,0,430
44571,190,100,40,80,0,0,410
44572,170,120,120,80,160,0,650
44573,170,160,120,160,160,0,770
44574,190,100,120,160,160,0,730
44575,210,120,120,80,160,0,690
44576,230,180,40,80,160,0,690
44577,200,140,120,240,160,0,860
44578,160,80,80,0,0,0,320
44579,180,140,120,160,160,0,760
44580,130,100,120,160,160,0,670
44581,200,100,120,80,160,0,660
44582,180,80,120,0,0,0,380
44583,200,100,160,160,0,0,620
44584,200,180,80,160,0,0,620
44585,190,140,80,80,160,320,970
44586,240,100,40,80,160,0,620
44587,210,160,80,160,0,0,610
44588,210,120,120,80,160,320,1010
44589,170,80,80,80,160,0,570
44590,210,140,160,80,0,0,590
44591,180,120,160,240,160,0,860
44592,210,160,160,160,320,0,1010
44593,190,120,160,240,320,0,1030
44594,240,200,160,240,160,0,1000
44595,190,120,120,80,0,0,510
44596,190,140,80,80,0,0,490
44597,190,120,120,160,320,0,910
44598,160,80,0,0,0,0,240
44599,140,100,80,80,0,0,400
44600,200,160,120,160,160,0,800
44601,200,120,200,80,160,0,760
44602,170,160,80,80,0,0,490
44603,140,120,120,80,0,0,460
44604,240,160,160,80,160,0,800
44605,240,120,120,240,160,0,880
44606,150,120,120,160,160,0,710
44607,140,80,120,80,0,0,420
44608,190,120,120,80,160,0,670
44609,240,160,80,80,160,320,1040
44610,180,140,120,80,160,0,680
44611,210,160,120,160,160,320,1130
44612,210,100,40,80,160,0,590
44613,200,120,80,80,160,320,960
44614,200,100,80,80,0,0,460
44615,200,140,80,0,0,0,420
44616,180,100,120,80,160,0,640
44617,220,100,40,0,0,0,360
44618,230,80,80,80,160,0,630
44619,170,120,40,0,0,0,330
44620,190,100,80,80,0,0,450
44621,180,100,120,160,320,0,880
44622,180,120,160,160,0,0,620
44623,190,140,200,240,0,0,770
44624,190,80,80,80,0,0,430
44625,130,120,120,160,160,0,690
44626,200,60,80,0,0,0,340
44627,200,120,160,160,160,0,800
44628,200,100,80,80,160,0,620
44629,190,100,120,160,160,0,730
44630,170,100,120,0,0,0,390
44631,210,160,120,160,160,0,810
44632,200,140,120,0,0,0,460
44633,200,200,200,80,160,0,840
44634,190,120,80,80,160,0,630
44635,210,140,160,160,160,0,830
44636,200,180,120,160,160,0,820
44637,160,100,80,160,160,0,660
44638,220,180,40,0,0,0,440
44639,240,100,80,80,0,0,500
44640,190,100,120,160,160,0,730
44641,200,100,160,80,0,0,540
44642,230,180,200,80,0,0,690
44643,210,160,160,80,160,320,1090
44644,180,120,40,0,0,0,340
44645,190,80,80,80,160,0,590
44646,190,140,160,160,0,0,650
44647,190,140,120,80,160,320,1010
44648,180,100,120,160,320,320,1200
44649,190,120,80,160,160,0,710
44650,180,80,80,80,0,0,420
44651,160,80,80,160,160,0,640
44652,200,100,160,240,160,0,860
44653,200,160,160,0,0,0,520
44654,210,140,80,80,160,0,670
44655,160,120,80,160,160,0,680
44656,150,100,160,160,0,0,570
44657,200,180,120,160,160,0,820
44658,200,100,120,160,160,320,1060
44659,180,140,160,80,160,0,720
44660,200,180,120,160,160,0,820
44661,160,120,80,80,160,320,920
44662,180,120,160,80,0,0,540
44663,170,120,120,160,160,0,730
44664,190,160,120,80,160,0,710
44665,190,160,80,160,320,0,910
44666,200,120,80,80,0,0,480
44667,210,180,160,160,160,320,1190
44668,220,120,120,160,320,320,1260
44669,170,160,120,80,160,0,690
44670,180,180,120,80,0,0,560
44671,210,100,120,80,160,0,670
44672,210,100,80,80,160,320,950
44673,200,80,40,80,160,0,560
44674,180,80,40,80,160,320,860
44675,220,100,80,80,0,0,480
44676,200,180,160,160,160,320,1180
44677,200,80,40,80,160,0,560
44678,200,120,120,80,0,0,520
44679,170,80,80,80,160,320,890
44680,220,120,120,160,320,0,940
44681,200,140,120,80,0,0,540
44682,210,120,40,80,160,320,930
44683,210,120,120,80,160,0,690
44684,220,140,120,160,160,320,1120
44685,200,160,80,80,160,0,680
44686,260,120,160,80,160,0,780
44687,160,100,200,240,160,0,860
44688,180,140,80,0,0,0,400
44689,210,100,80,0,0,0,390
44690,170,160,40,80,160,320,930
44691,220,80,80,80,160,0,620
44692,200,80,120,240,320,0,960
44693,150,100,160,80,160,0,650
44694,230,120,120,160,160,0,790
44695,180,120,120,160,160,0,740
44696,150,80,120,160,320,0,830
44697,210,140,160,160,160,0,830
44698,180,160,160,80,0,0,580
44699,200,160,200,160,320,320,1360
44700,210,140,80,80,160,0,670
44701,200,140,80,80,160,320,980
44702,200,80,120,160,160,320,1040
44703,200,80,40,0,0,0,320
44704,200,140,120,80,160,0,700
44705,240,180,160,240,0,0,820
44706,200,160,120,160,320,0,960
44707,180,120,120,160,320,0,900
44708,200,120,120,240,320,0,1000
44709,190,120,40,0,0,0,350
44710,240,160,80,80,160,0,720
44711,190,140,160,240,160,0,890
44712,210,80,120,160,160,0,730
44713,160,120,80,80,0,0,440
44714,210,200,160,160,0,0,730
44715,140,80,80,80,0,0,380
44716,180,140,120,160,0,0,600
44717,230,180,120,0,0,0,530
44718,170,100,120,80,160,0,630
44719,220,140,120,160,160,0,800
44720,230,120,120,160,160,0,790
44721,190,80,120,160,160,320,1030
44722,190,120,160,160,160,0,790
44723,190,100,80,160,320,0,850
44724,210,140,40,80,160,0,630
44725,210,140,160,80,0,0,590
44726,200,160,80,160,320,320,1240
44727,170,100,80,160,160,0,670
44728,170,120,120,160,320,0,890
44729,150,80,80,80,0,0,390
44730,160,100,120,240,0,0,620
44731,160,140,160,240,320,0,1020
44732,200,100,120,80,160,320,980
44733,180,100,80,0,0,0,360
44734,220,140,80,160,160,0,760
44735,170,120,80,0,0,0,370
44736,220,120,80,0,0,0,420
44737,200,80,80,160,160,0,680
44738,230,180,160,160,160,0,890
44739,230,100,40,80,0,0,450
44740,140,120,160,160,160,0,740
44741,190,100,40,0,0,0,330
44742,190,120,40,80,160,0,590
44743,190,140,160,160,0,0,650
44744,200,80,40,80,160,0,560
44745,190,160,120,80,0,0,550
44746,240,140,160,160,160,0,860
44747,200,140,160,160,160,320,1140
44748,200,60,80,80,160,0,580
44749,190,80,80,0,0,0,350
44750,160,100,120,80,160,0,620
44751,220,140,200,240,160,0,960
44752,240,160,0,0,0,0,400
44753,190,140,120,80,160,0,690
44754,190,100,80,80,0,0,450
44755,170,120,120,160,320,0,890
44756,200,140,120,80,160,0,700
44757,210,160,160,80,0,0,610
44758,210,160,120,80,0,0,570
44759,170,100,80,80,0,0,430
44760,190,120,80,160,160,0,710
44761,210,160,120,0,0,0,490
44762,200,80,40,80,0,0,400
44763,210,120,160,0,0,0,490
44764,180,80,120,0,0,0,380
44765,190,200,160,160,160,0,870
44766,190,100,200,240,320,0,1050
44767,230,120,80,160,0,0,590
44768,210,80,40,0,0,0,330
44769,200,140,200,80,0,0,620
44770,210,220,240,240,0,0,910
44771,160,120,120,80,160,0,640
44772,230,80,120,160,160,0,750
44773,170,120,160,240,320,0,1010
44774,190,100,120,80,0,0,490
44775,190,140,120,160,160,0,770
44776,240,160,80,80,160,0,720
44777,220,160,200,240,0,0,820
44778,200,80,80,80,0,0,440
44779,200,120,160,240,0,0,720
44780,170,120,120,160,160,0,730
44781,180,120,120,160,160,0,740
44782,190,100,120,160,320,0,890
44783,190,140,160,0,0,0,490
44784,170,60,40,80,0,0,350
44785,170,80,40,80,160,0,530
44786,200,240,200,160,160,0,960
44787,210,120,80,80,0,0,490
44788,210,80,120,160,160,320,1050
44789,160,60,80,80,160,320,860
44790,230,140,120,160,320,0,970
44791,170,60,0,0,0,0,230
44792,170,180,160,80,160,320,1070
44793,170,80,80,160,320,320,1130
44794,170,120,120,160,320,320,1210
44795,270,200,120,160,0,0,750
44796,220,120,80,160,320,0,900
44797,180,140,120,160,160,0,760
44798,190,100,40,0,0,0,330
44799,210,100,160,80,160,0,710
44800,200,120,160,160,160,0,800
44801,240,120,80,160,160,0,760
44802,190,160,160,0,0,0,510
44803,180,120,120,160,320,320,1220
44804,170,120,80,160,160,0,690
44805,180,20,40,0,0,0,240
44806,200,180,120,160,160,320,1140
44807,210,140,40,0,0,0,390
44808,160,180,160,160,160,0,820
44809,170,100,120,80,0,0,470
44810,250,160,120,160,160,0,850
44811,260,160,120,80,0,0,620
44812,180,40,40,80,0,0,340
44813,190,120,120,80,160,0,670
44814,180,100,160,240,320,0,1000
44815,200,160,120,80,160,0,720
44816,220,120,120,160,160,0,780
44817,140,120,120,80,160,0,620
44818,200,140,80,160,0,0,580
44819,210,100,80,80,0,0,470
44820,220,120,160,80,160,0,740
44821,200,100,160,80,0,0,540
44822,200,140,120,80,0,0,540
44823,160,120,120,80,160,320,960
44824,220,200,200,240,320,0,1180
44825,200,180,160,80,0,0,620
44826,200,140,120,160,160,0,780
44827,190,100,80,160,160,0,690
44828,230,80,80,0,0,0,390
44829,180,120,120,80,160,0,660
44830,210,120,80,0,0,0,410
44831,210,80,0,0,0,0,290
44832,170,120,80,80,160,0,610
44833,200,160,120,80,160,320,1040
44834,180,100,80,80,160,0,600
44835,170,100,160,80,160,0,670
44836,210,160,120,80,0,0,570
44837,200,120,120,160,160,0,760
44838,190,60,40,80,160,0,530
44839,160,60,120,80,0,0,420
44840,190,140,80,80,160,0,650
44841,220,180,160,80,160,320,1120
44842,190,100,120,240,0,0,650
44843,180,100,120,160,160,0,720
44844,200,120,160,160,320,0,960
44845,170,120,120,80,160,0,650
44846,200,80,80,160,160,0,680
44847,160,140,160,240,320,0,1020
44848,180,140,160,240,0,0,720
44849,230,100,80,160,0,0,570
44850,200,100,120,160,160,0,740
44851,190,180,160,160,160,0,850
44852,170,160,160,240,160,0,890
44853,200,80,0,0,0,0,280
44854,220,140,160,240,160,0,920
44855,180,120,120,240,160,0,820
44856,180,120,200,240,320,0,1060
44857,160,140,120,160,160,320,1060
44858,160,120,160,240,320,0,1000
44859,190,120,120,80,160,0,670
44860,170,60,40,0,0,0,270
44861,200,120,80,0,0,0,400
44862,220,120,120,0,0,0,460
44863,240,100,80,80,160,0,660
44864,180,140,120,80,160,320,1000
44865,190,100,80,80,0,0,450
44866,190,120,120,160,320,320,1230
44867,190,100,160,160,160,0,770
44868,200,100,80,80,0,0,460
44869,160,120,120,160,320,0,880
44870,170,60,40,80,0,0,350
44871,180,120,120,160,160,0,740
44872,190,120,120,160,160,0,750
44873,160,60,120,80,0,0,420
44874,150,160,80,80,0,0,470
44875,120,80,80,80,160,0,520
44876,180,100,120,0,0,0,400
44877,200,100,120,160,160,0,740
44878,200,180,160,160,320,0,1020
44879,190,60,80,160,320,0,810
44880,220,120,40,80,0,0,460
44881,160,120,80,0,0,0,360
44882,210,100,40,80,160,0,590
44883,210,100,80,80,160,0,630
44884,200,100,80,80,160,0,620
44885,200,160,40,80,160,0,640
44886,200,120,120,160,320,320,1240
44887,210,140,80,80,160,320,990
44888,200,160,120,80,0,0,560
44889,130,100,80,160,0,0,470
44890,140,80,40,80,160,0,500
44891,210,120,120,80,160,0,690
44892,190,140,120,160,160,320,1090
44893,170,120,80,0,0,0,370
44894,160,140,80,80,0,0,460
44895,220,160,120,0,0,0,500
44896,200,100,160,160,160,0,780
44897,200,120,120,80,0,0,520
44898,190,140,80,0,0,0,410
44899,160,80,40,0,0,0,280
44900,200,120,40,0,0,0,360
44901,200,120,80,80,0,0,480
44902,240,160,200,160,160,0,920
44903,180,100,80,160,320,0,840
44904,180,120,80,80,0,0,460
44905,190,80,80,160,160,0,670
44906,200,80,160,0,0,0,440
44907,190,120,160,80,160,0,710
44908,190,140,120,80,160,0,690
44909,160,100,120,0,0,0,380
44910,260,120,80,80,160,0,700
44911,200,140,120,80,160,320,1020
44912,160,60,40,80,160,0,500
44913,230,120,80,160,160,0,750
44914,170,140,160,80,160,320,1030
44915,240,140,160,160,160,0,860
44916,220,180,200,160,320,0,1080
44917,190,100,80,160,160,320,1010
44918,230,120,200,0,0,0,550
44919,210,180,120,80,0,0,590
44920,200,160,160,160,160,0,840
44921,220,80,80,160,160,0,700
44922,200,120,120,80,0,0,520
44923,200,100,160,80,0,0,540
44924,210,140,120,80,160,0,710
44925,130,120,120,160,160,0,690
44926,170,120,120,80,0,0,490
44927,190,80,120,160,160,320,1030
44928,160,80,120,160,320,0,840
44929,170,120,120,160,0,0,570
44930,220,60,80,80,160,0,600
44931,200,160,200,240,160,320,1280
44932,220,100,160,80,0,0,560
44933,190,120,120,160,160,320,1070
44934,200,140,160,160,0,0,660
44935,180,120,120,160,160,0,740
44936,170,100,80,80,160,0,590
44937,170,100,40,80,0,0,390
44938,230,140,120,80,0,0,570
44939,220,140,40,0,0,0,400
44940,220,100,40,80,0,0,440
44941,180,160,120,0,0,0,460
44942,200,100,80,160,160,0,700
44943,230,200,160,160,0,0,750
44944,170,80,80,160,160,0,650
44945,210,100,120,80,0,0,510
44946,220,180,120,80,160,320,1080
44947,190,120,120,160,320,320,1230
44948,200,120,80,0,0,0,400
44949,220,100,40,80,160,0,600
44950,170,100,160,240,160,0,830
44951,170,120,80,80,160,0,610
44952,190,100,80,80,0,0,450
44953,190,140,80,160,0,0,570
44954,220,120,120,160,160,320,1100
44955,180,120,160,160,320,320,1260
44956,200,180,200,160,160,0,900
44957,230,100,120,160,160,0,770
44958,260,160,200,160,160,0,940
44959,180,100,80,0,0,0,360
44960,190,100,120,80,160,0,650
44961,220,180,40,80,160,0,680
44962,230,160,120,160,0,0,670
44963,140,80,40,0,0,0,260
44964,180,100,160,80,160,0,680
44965,190,80,80,80,0,0,430
44966,190,120,160,80,0,0,550
44967,220,100,0,0,0,0,320
44968,220,140,120,80,0,0,560
44969,200,140,160,160,320,0,980
44970,190,120,80,80,160,320,950
44971,200,200,120,160,160,0,840
44972,210,160,80,0,0,0,450
44973,230,120,160,160,160,0,830
44974,190,100,160,160,0,0,610
44975,190,120,160,160,160,0,790
44976,180,140,160,0,0,0,480
44977,250,180,120,160,160,320,1190
44978,200,140,80,80,160,0,660
44979,200,80,160,160,160,0,760
44980,190,100,0,0,0,0,290
44981,190,120,80,0,0,0,390
44982,220,160,160,80,160,0,780
44983,180,140,120,80,0,0,520
44984,180,80,120,0,0,0,380
44985,200,120,160,80,0,0,560
44986,180,140,80,160,160,0,720
44987,240,120,120,80,0,0,560
44988,200,120,160,160,0,0,640
44989,190,120,40,0,0,0,350
44990,230,100,80,80,160,0,650
44991,210,180,160,80,160,0,790
44992,220,140,200,0,0,0,560
44993,200,140,120,80,0,0,540
44994,250,80,80,80,160,0,650
44995,190,60,80,0,0,0,330
44996,190,140,120,0,0,0,450
44997,210,160,240,80,0,0,690
44998,220,140,120,160,320,0,960
44999,170,120,120,80,160,320,970
45000,200,160,80,160,320,320,1240
45001,190,140,120,80,160,0,690
45002,190,160,40,0,0,0,390
45003,170,120,80,80,160,0,610
45004,180,60,80,80,160,320,880
45005,220,140,80,80,160,0,680
45006,190,120,120,160,0,0,590
45007,210,180,120,80,160,0,750
45008,160,140,120,160,160,0,740
45009,200,80,120,80,160,0,640
45010,190,140,80,160,0,0,570
45011,210,200,80,0,0,0,490
45012,200,120,120,160,320,320,1240
45013,200,120,80,160,160,320,1040
45014,180,120,120,80,160,0,660
45015,180,140,160,240,160,0,880
45016,220,120,160,240,160,0,900
45017,190,120,120,160,320,320,1230
45018,210,80,120,0,0,0,410
45019,170,120,120,160,160,320,1050
45020,180,140,80,160,0,0,560
45021,200,80,80,0,0,0,360
45022,200,140,120,80,160,0,700
45023,200,80,120,80,160,0,640
45024,220,180,80,80,160,0,720
45025,180,80,40,0,0,0,300
45026,160,100,40,0,0,0,300
45027,170,80,120,80,0,0,450
45028,180,100,80,0,0,0,360
45029,180,160,80,0,0,0,420
45030,200,180,120,160,320,0,980
45031,150,100,80,80,0,0,410
45032,220,140,80,0,0,0,440
45033,260,160,120,0,0,0,540
45034,170,120,80,80,0,0,450
45035,190,140,120,160,320,0,930
45036,190,160,200,160,320,0,1030
45037,210,120,120,80,160,320,1010
45038,240,120,160,160,0,0,680
45039,210,200,120,80,0,0,610
45040,200,140,40,80,160,0,620
45041,240,160,80,0,0,0,480
45042,170,120,80,80,160,0,610
45043,190,180,120,160,160,0,810
45044,230,120,80,160,160,0,750
45045,170,120,160,160,0,0,610
45046,210,120,120,160,160,0,770
45047,200,160,200,240,160,320,1280
45048,240,80,80,80,0,0,480
45049,170,120,120,160,160,0,730
45050,190,100,120,160,160,0,730
45051,210,180,80,80,160,0,710
45052,240,160,160,80,160,320,1120
45053,230,240,240,80,0,0,790
45054,210,140,40,80,160,0,630
45055,180,140,160,0,0,0,480
45056,150,140,160,160,0,0,610
45057,170,80,40,80,0,0,370
45058,220,120,120,80,0,0,540
45059,200,140,120,0,0,0,460
45060,200,160,80,80,0,0,520
45061,230,80,120,160,0,0,590
45062,200,160,120,160,320,0,960
45063,190,180,160,160,0,0,690
45064,220,140,40,80,0,0,480
45065,210,60,40,0,0,0,310
45066,150,120,160,80,160,0,670
45067,150,100,80,0,0,0,330
45068,170,80,80,80,160,320,890
45069,170,120,80,80,160,0,610
45070,190,60,40,80,0,0,370
45071,190,140,160,0,0,0,490
45072,180,100,40,0,0,0,320
45073,210,120,80,160,0,0,570
45074,190,120,80,80,160,0,630
45075,220,100,120,0,0,0,440
45076,190,100,80,80,160,320,930
45077,200,100,160,160,160,0,780
45078,220,180,40,0,0,0,440
45079,190,100,80,80,160,0,610
45080,200,120,160,80,160,0,720
45081,190,120,160,80,160,0,710
45082,220,180,200,160,0,0,760
45083,210,140,80,80,160,0,670
45084,180,140,80,160,320,0,880
45085,210,100,0,0,0,0,310
45086,210,140,80,160,160,0,750
45087,180,120,120,80,0,0,500
45088,180,160,120,160,0,0,620
45089,180,100,120,160,0,0,560
45090,190,160,120,80,160,0,710
45091,220,140,80,0,0,0,440
45092,190,180,120,80,0,0,570
45093,220,120,80,80,0,0,500
45094,200,160,160,240,320,320,1400
45095,220,140,80,80,160,0,680
45096,210,120,80,80,160,0,650
45097,260,160,120,80,160,0,780
45098,220,140,120,80,160,0,720
45099,190,120,80,80,160,0,630
45100,180,160,200,160,320,320,1340
45101,220,180,160,160,320,0,1040
45102,180,100,120,160,160,0,720
45103,250,140,120,160,320,0,990
45104,140,140,40,80,160,0,560
45105,200,100,80,80,160,0,620
45106,210,100,120,240,0,0,670
45107,220,180,200,240,0,0,840
45108,210,100,120,0,0,0,430
45109,180,120,80,80,0,0,460
45110,180,120,80,0,0,0,380
45111,160,100,160,80,160,320,980
45112,180,140,160,160,160,0,800
45113,190,140,120,80,0,0,530
45114,180,180,120,0,0,0,480
45115,210,100,160,0,0,0,470
45116,200,120,120,240,320,0,1000
45117,230,160,160,80,160,0,790
45118,170,100,40,0,0,0,310
45119,200,160,160,160,320,0,1000
45120,180,80,160,240,160,0,820
45121,190,140,120,80,160,320,1010
45122,210,140,160,160,0,0,670
45123,200,120,80,160,160,0,720
45124,240,140,160,160,0,0,700
45125,190,140,200,80,160,0,770
45126,170,160,160,80,160,0,730
45127,210,140,160,80,0,0,590
45128,190,160,120,160,160,0,790
45129,170,80,160,80,0,0,490
45130,210,80,120,240,160,0,810
45131,200,100,40,0,0,0,340
45132,230,180,120,80,160,320,1090
45133,240,100,80,80,160,0,660
45134,210,80,40,0,0,0,330
45135,230,120,120,0,0,0,470
45136,150,120,80,160,160,0,670
45137,210,120,120,160,160,0,770
45138,190,160,200,160,320,0,1030
45139,230,140,120,80,0,0,570
45140,180,120,80,160,160,320,1020
45141,180,60,40,0,0,0,280
45142,220,140,120,80,160,320,1040
45143,210,120,120,80,160,0,690
45144,190,140,80,80,0,0,490
45145,210,160,160,160,320,0,1010
45146,230,180,80,0,0,0,490
45147,200,140,80,80,160,0,660
45148,170,140,80,80,160,320,950
45149,210,80,80,80,160,0,610
45150,200,120,80,0,0,0,400
45151,150,60,120,0,0,0,330
45152,210,140,120,160,160,320,1110
45153,200,120,40,80,0,0,440
45154,200,140,160,160,160,0,820
45155,240,140,200,160,160,0,900
45156,190,120,120,80,160,0,670
45157,230,140,120,160,160,0,810
45158,220,180,80,80,0,0,560
45159,170,140,0,0,0,0,310
45160,210,120,80,160,160,320,1050
45161,190,120,80,160,160,0,710
45162,180,100,120,160,160,0,720
45163,190,120,160,80,160,0,710
45164,180,120,40,0,0,0,340
45165,210,180,160,240,160,0,950
45166,180,140,160,160,160,320,1120
45167,160,160,200,240,160,0,920
45168,230,120,120,160,160,0,790
45169,200,120,80,80,160,0,640
45170,220,160,80,160,160,0,780
45171,230,160,80,80,160,0,710
45172,190,140,120,80,160,0,690
45173,210,120,160,160,160,0,810
45174,200,100,80,80,160,0,620
45175,190,120,160,160,320,320,1270
45176,200,140,80,80,160,0,660
45177,200,140,40,80,160,0,620
45178,210,120,120,80,160,0,690
45179,230,140,160,160,0,0,690
45180,200,160,160,80,160,0,760
45181,220,160,80,80,160,320,1020
45182,200,160,160,80,160,320,1080
45183,160,100,40,0,0,0,300
45184,220,100,80,0,0,0,400
45185,180,40,40,80,160,0,500
45186,170,120,80,160,160,0,690
45187,240,180,160,240,320,0,1140
45188,170,80,40,0,0,0,290
45189,220,160,160,80,0,0,620
45190,190,140,120,80,0,0,530
45191,140,60,40,80,160,0,480
45192,150,120,120,80,160,0,630
45193,190,20,40,80,0,0,330
45194,220,180,200,240,160,0,1000
45195,260,140,120,80,160,0,760
45196,230,120,120,240,320,0,1030
45197,200,140,200,160,160,0,860
45198,150,100,160,160,0,0,570
45199,220,140,160,0,0,0,520
45200,200,140,120,0,0,0,460
45201,190,120,120,160,0,0,590
45202,140,100,0,0,0,0,240
45203,210,160,80,160,160,0,770
45204,210,120,120,160,160,0,770
45205,190,120,80,80,160,0,630
45206,170,120,80,80,160,320,930
45207,200,60,80,80,160,0,580
45208,230,120,120,160,0,0,630
45209,210,140,160,160,0,0,670
45210,200,100,80,80,160,0,620
45211,160,80,80,160,320,320,1120
45212,200,120,120,80,0,0,520
45213,220,160,80,160,160,0,780
45214,190,100,80,80,0,0,450
45215,200,120,120,160,0,0,600
45216,210,100,40,80,160,0,590
45217,220,100,80,80,0,0,480
45218,120,100,120,80,160,0,580
45219,200,120,120,80,0,0,520
45220,180,140,120,160,0,0,600
45221,220,140,160,80,0,0,600
45222,190,120,160,240,160,0,870
45223,180,100,120,160,0,0,560
45224,200,100,80,160,320,0,860
45225,200,80,80,80,160,0,600
45226,200,180,240,80,0,0,700
45227,160,100,40,0,0,0,300
45228,200,100,120,160,0,0,580
45229,150,140,40,0,0,0,330
45230,180,120,120,80,0,0,500
45231,210,140,80,0,0,0,430
45232,230,80,40,0,0,0,350
45233,170,120,40,0,0,0,330
45234,170,120,120,0,0,0,410
45235,160,100,160,80,160,320,980
45236,200,140,120,80,0,0,540
45237,200,140,120,80,0,0,540
45238,180,100,120,80,160,0,640
45239,190,100,80,160,160,0,690
45240,180,100,160,0,0,0,440
45241,190,120,80,160,320,0,870
45242,180,60,0,0,0,0,240
45243,190,80,120,80,160,0,630
45244,200,140,80,80,160,320,980
45245,200,160,160,80,0,0,600
45246,160,80,120,80,0,0,440
45247,220,140,80,160,320,0,920
45248,200,120,120,160,160,0,760
45249,170,100,80,160,320,0,830
45250,190,140,80,80,0,0,490
45251,190,120,80,160,320,0,870
45252,180,140,40,0,0,0,360
45253,220,100,80,80,0,0,480
45254,190,100,160,160,160,0,770
45255,210,120,120,160,160,0,770
45256,200,180,80,80,160,0,700
45257,220,80,80,80,0,0,460
45258,160,100,80,160,160,0,660
45259,210,180,80,0,0,0,470
45260,200,100,80,80,0,0,460
45261,180,120,160,160,320,320,1260
45262,210,80,40,80,160,0,570
45263,190,180,240,240,320,0,1170
45264,170,160,200,240,160,0,930
45265,160,100,120,80,160,0,620
45266,200,80,80,160,0,0,520
45267,210,120,40,80,160,0,610
45268,170,100,80,160,160,0,670
45269,210,80,80,80,160,0,610
45270,220,140,160,80,160,0,760
45271,220,140,40,0,0,0,400
45272,190,60,0,0,0,0,250
45273,140,140,120,160,160,0,720
45274,180,60,120,160,160,0,680
45275,210,180,80,80,160,0,710
45276,210,160,160,240,160,320,1250
45277,180,120,120,80,160,0,660
45278,220,120,80,80,0,0,500
45279,200,100,80,80,160,0,620
45280,210,120,160,80,160,320,1050
45281,180,120,40,0,0,0,340
45282,210,160,40,0,0,0,410
45283,200,160,80,80,160,0,680
45284,180,100,80,80,160,0,600
45285,180,80,40,0,0,0,300
45286,200,180,80,80,0,0,540
45287,180,120,120,80,0,0,500
45288,220,180,160,240,160,0,960
45289,230,120,0,0,0,0,350
45290,210,100,160,80,0,0,550
45291,190,120,120,80,160,0,670
45292,220,120,40,80,160,0,620
45293,200,80,120,80,160,0,640
45294,210,160,120,0,0,0,490
45295,180,80,160,160,160,0,740
45296,180,80,40,0,0,0,300
45297,200,120,120,160,320,0,920
45298,180,120,120,80,0,0,500
45299,200,120,80,160,160,0,720
45300,200,140,80,80,160,0,660
45301,210,120,120,80,160,0,690
45302,220,140,80,80,160,0,680
45303,180,100,80,0,0,0,360
45304,190,160,120,160,320,0,950
45305,210,160,120,240,320,320,1370
45306,140,80,80,0,0,0,300
45307,190,100,160,160,160,320,1090
45308,190,140,160,160,0,0,650
45309,200,100,120,240,160,0,820
45310,250,120,160,80,160,0,770
45311,220,140,160,160,320,320,1320
45312,200,180,200,160,160,0,900
45313,240,200,200,80,160,320,1200
45314,190,140,200,80,160,0,770
45315,200,120,80,160,160,320,1040
45316,210,120,200,80,160,0,770
45317,170,120,80,80,160,0,610
45318,230,140,80,80,0,0,530
45319,200,140,120,160,160,0,780
45320,190,100,160,80,160,0,690
45321,210,80,120,80,160,0,650
45322,200,140,160,160,0,0,660
45323,210,120,120,160,160,0,770
45324,230,160,200,80,0,0,670
45325,230,160,120,80,160,320,1070
45326,180,120,80,80,160,0,620
45327,210,160,40,80,160,0,650
45328,210,140,40,80,160,0,630
45329,220,80,120,160,320,0,900
45330,180,100,80,80,160,320,920
45331,160,180,240,80,0,0,660
45332,210,140,160,160,160,0,830
45333,190,100,120,80,160,0,650
45334,180,140,80,0,0,0,400
45335,180,100,120,160,160,0,720
45336,250,120,80,160,160,0,770
45337,160,140,120,0,0,0,420
45338,170,100,120,160,320,0,870
45339,160,100,40,0,0,0,300
45340,170,140,120,160,160,0,750
45341,140,80,80,80,160,0,540
45342,190,80,80,0,0,0,350
45343,160,120,120,160,160,0,720
45344,210,80,40,80,160,0,570
45345,210,140,80,160,320,320,1230
45346,220,180,80,0,0,0,480
45347,200,140,80,80,0,0,500
45348,210,100,40,80,0,0,430
45349,220,120,80,0,0,0,420
45350,180,40,40,80,160,0,500
45351,220,140,160,80,0,0,600
45352,230,140,80,0,0,0,450
45353,230,100,80,160,0,0,570
45354,170,100,120,80,0,0,470
45355,230,120,160,160,160,320,1150
45356,210,160,200,160,320,320,1370
45357,190,100,80,80,0,0,450
45358,210,120,120,160,160,320,1090
45359,210,120,120,80,160,0,690
45360,190,140,120,240,320,0,1010
45361,180,120,80,0,0,0,380
45362,190,140,80,80,0,0,490
45363,190,160,120,160,160,0,790
45364,210,140,120,160,160,0,790
45365,170,140,240,160,160,0,870
45366,210,140,120,160,0,0,630
45367,240,160,120,160,320,0,1000
45368,170,100,120,80,160,0,630
45369,170,160,120,80,160,0,690
45370,230,80,40,80,160,320,910
45371,210,60,80,80,160,320,910
45372,210,60,40,0,0,0,310
45373,190,160,80,0,0,0,430
45374,160,140,80,80,160,0,620
45375,230,140,160,240,320,320,1410
45376,190,140,80,0,0,0,410
45377,200,120,80,80,0,0,480
45378,210,160,200,240,320,0,1130
45379,180,100,120,160,160,320,1040
45380,260,200,120,80,0,0,660
45381,190,180,80,80,0,0,530
45382,220,120,80,80,160,320,980
45383,170,140,160,160,160,0,790
45384,180,40,40,80,0,0,340
45385,230,60,0,0,0,0,290
45386,220,120,40,80,0,0,460
45387,200,140,80,0,0,0,420
45388,190,140,160,160,160,0,810
45389,210,140,80,160,320,0,910
45390,210,140,160,160,160,0,830
45391,210,140,80,0,0,0,430
45392,200,100,40,80,0,0,420
45393,210,180,0,0,0,0,390
45394,200,120,120,80,0,0,520
45395,200,160,120,160,160,320,1120
45396,180,100,80,80,0,0,440
45397,220,140,40,0,0,0,400
45398,200,140,80,0,0,0,420
45399,190,120,40,80,160,0,590
45400,210,160,40,0,0,0,410
45401,230,160,80,160,320,0,950
45402,240,180,80,160,160,0,820
45403,170,60,40,80,160,0,510
45404,210,100,40,80,160,0,590
45405,230,120,160,80,0,0,590
45406,180,100,80,80,160,0,600
45407,200,120,80,80,160,320,960
45408,190,160,160,80,160,0,750
45409,200,120,120,160,160,0,760
45410,210,160,200,160,0,0,730
45411,190,80,40,80,0,0,390
45412,200,140,80,80,160,0,660
45413,170,100,120,0,0,0,390
45414,200,140,40,80,160,0,620
45415,210,100,160,80,160,0,710
45416,190,140,120,160,320,0,930
45417,210,60,40,0,0,0,310
45418,160,100,120,80,160,0,620
45419,200,160,120,160,160,320,1120
45420,200,60,80,160,160,0,660
45421,250,120,80,80,0,0,530
45422,220,60,0,0,0,0,280
45423,210,200,120,240,320,0,1090
45424,160,100,80,80,160,0,580
45425,160,80,80,80,0,0,400
45426,200,160,120,160,0,0,640
45427,220,160,120,80,160,0,740
45428,190,140,80,80,0,0,490
45429,210,140,40,80,0,0,470
45430,200,160,120,80,0,0,560
45431,240,120,40,0,0,0,400
45432,190,120,80,80,160,0,630
45433,220,120,120,80,0,0,540
45434,170,120,120,80,160,0,650
45435,230,160,80,80,0,0,550
45436,200,140,80,0,0,0,420
45437,220,140,40,0,0,0,400
45438,180,160,120,80,0,0,540
45439,180,60,80,80,160,0,560
45440,180,40,0,0,0,0,220
45441,180,160,160,160,0,0,660
45442,210,120,120,80,0,0,530
45443,170,120,80,80,0,0,450
45444,180,120,120,160,320,320,1220
45445,230,220,200,80,0,0,730
45446,190,160,80,80,160,0,670
45447,180,100,160,160,160,0,760
45448,160,60,40,0,0,0,260
45449,180,140,120,80,160,0,680
45450,180,120,80,80,0,0,460
45451,160,100,80,80,0,0,420
45452,220,160,120,0,0,0,500
45453,220,100,120,0,0,0,440
45454,200,100,80,80,160,0,620
45455,200,160,200,240,320,0,1120
45456,200,140,80,0,0,0,420
45457,160,40,40,80,0,0,320
45458,240,200,160,160,320,320,1400
45459,210,120,160,0,0,0,490
45460,180,160,120,80,160,0,700
45461,170,160,120,80,0,0,530
45462,170,120,160,240,320,0,1010
45463,200,120,80,80,0,0,480
45464,200,80,80,160,160,0,680
45465,170,100,120,160,160,320,1030
45466,190,160,160,80,160,0,750
45467,200,80,80,0,0,0,360
45468,160,120,120,160,160,0,720
45469,180,160,160,160,320,0,980
45470,190,160,80,0,0,0,430
45471,190,100,40,0,0,0,330
45472,190,140,120,240,160,0,850
45473,190,120,160,80,0,0,550
45474,210,140,120,160,160,0,790
45475,210,140,120,160,0,0,630
45476,200,160,120,0,0,0,480
45477,200,120,80,80,0,0,480
45478,160,140,40,80,160,0,580
45479,220,100,160,160,320,0,960
45480,230,160,160,80,0,0,630
45481,210,100,40,80,0,0,430
45482,180,140,120,160,320,0,920
45483,210,140,80,80,0,0,510
45484,190,120,120,80,160,0,670
45485,210,120,200,240,160,0,930
45486,200,100,80,0,0,0,380
45487,210,100,80,0,0,0,390
45488,180,100,0,0,0,0,280
45489,190,120,160,240,160,0,870
45490,190,100,40,80,0,0,410
45491,210,160,80,80,0,0,530
45492,210,120,80,0,0,0,410
45493,160,60,40,80,0,0,340
45494,190,120,120,80,0,0,510
45495,210,140,120,160,160,320,1110
45496,180,120,40,80,0,0,420
45497,190,160,160,160,160,0,830
45498,170,80,160,160,160,0,730
45499,200,100,120,80,0,0,500
45500,190,120,120,0,0,0,430
45501,200,140,120,160,320,0,940
45502,210,160,120,160,320,0,970
45503,210,120,80,0,0,0,410
45504,230,140,120,240,0,0,730
45505,210,160,80,80,160,0,690
45506,170,100,40,0,0,0,310
45507,190,120,120,80,160,0,670
45508,170,40,80,160,160,0,610
45509,190,180,240,160,320,320,1410
45510,230,120,120,160,0,0,630
45511,180,180,160,80,160,0,760
45512,200,140,80,80,0,0,500
45513,200,120,160,80,0,0,560
45514,210,120,80,80,160,320,970
45515,200,180,120,80,160,0,740
45516,180,180,160,240,320,320,1400
45517,220,140,120,160,320,320,1280
45518,150,100,120,160,0,0,530
45519,230,140,40,80,0,0,490
45520,210,120,160,80,160,0,730
45521,200,100,40,80,160,0,580
45522,170,120,80,80,160,0,610
45523,210,160,160,160,0,0,690
45524,220,100,80,160,0,0,560
45525,200,100,80,80,0,0,460
45526,240,120,120,80,160,0,720
45527,190,100,120,80,0,0,490
45528,180,180,160,160,0,0,680
45529,170,100,40,80,160,0,550
45530,210,180,160,80,0,0,630
45531,190,100,40,0,0,0,330
45532,180,140,120,80,160,0,680
45533,180,100,120,160,160,320,1040
45534,170,100,200,160,160,0,790
45535,170,100,40,80,0,0,390
45536,220,160,0,0,0,0,380
45537,230,180,120,80,0,0,610
45538,200,120,80,80,160,0,640
45539,160,80,120,160,160,0,680
45540,200,100,120,160,0,0,580
45541,160,120,120,80,160,0,640
45542,180,120,160,160,0,0,620
45543,210,160,80,0,0,0,450
45544,140,60,0,0,0,0,200
45545,190,140,120,160,320,0,930
45546,190,120,120,80,160,320,990
45547,240,100,40,80,160,0,620
45548,200,180,160,240,160,0,940
45549,220,120,40,80,160,320,940
45550,240,100,80,80,160,320,980
45551,240,120,120,160,160,0,800
45552,160,100,40,80,160,0,540
45553,190,140,120,80,160,0,690
45554,200,160,200,240,160,0,960
45555,210,180,240,80,0,0,710
45556,180,180,120,80,0,0,560
45557,150,100,120,160,0,0,530
45558,230,140,160,160,0,0,690
45559,210,140,40,0,0,0,390
45560,200,120,120,160,160,0,760
45561,190,140,80,80,0,0,490
45562,180,80,80,80,160,0,580
45563,200,140,120,160,320,0,940
45564,190,40,80,80,0,0,390
45565,220,120,120,160,160,0,780
45566,190,180,80,0,0,0,450
45567,240,160,80,80,160,0,720
45568,230,180,120,0,0,0,530
45569,180,180,120,160,160,0,800
45570,210,160,200,160,320,0,1050
45571,200,80,80,80,0,0,440
45572,160,100,160,160,0,0,580
45573,230,100,80,0,0,0,410
45574,220,140,120,160,160,0,800
45575,240,140,40,80,0,0,500
45576,210,140,160,160,160,0,830
45577,200,140,80,80,160,0,660
45578,210,80,120,160,320,320,1210
45579,180,120,160,160,320,0,940
45580,180,140,200,160,320,320,1320
45581,220,100,120,160,160,0,760
45582,190,120,80,0,0,0,390
45583,220,80,80,80,0,0,460
45584,190,160,200,80,160,0,790
45585,200,120,120,160,320,0,920
45586,200,140,200,240,320,320,1420
45587,200,120,120,80,160,0,680
45588,180,80,120,240,320,320,1260
45589,150,140,120,80,0,0,490
45590,190,140,80,160,160,320,1050
45591,180,100,160,160,160,0,760
45592,200,120,160,80,160,0,720
45593,210,180,80,0,0,0,470
45594,170,140,160,160,160,0,790
45595,230,120,120,80,0,0,550
45596,240,120,120,80,160,0,720
45597,180,140,200,160,0,0,680
45598,190,140,120,80,160,0,690
45599,190,160,120,80,160,0,710
45600,200,120,120,80,160,0,680
45601,200,120,160,160,320,0,960
45602,180,40,40,80,160,0,500
45603,210,100,80,80,0,0,470
45604,170,120,80,80,0,0,450
45605,160,120,80,80,160,0,600
45606,190,120,120,80,160,0,670
45607,230,160,120,80,160,0,750
45608,180,140,160,80,0,0,560
45609,170,120,80,0,0,0,370
45610,210,100,40,80,160,0,590
45611,170,100,80,80,0,0,430
45612,190,80,80,0,0,0,350
45613,180,160,160,80,0,0,580
45614,190,180,120,160,160,0,810
45615,190,120,160,160,320,0,950
45616,220,140,120,0,0,0,480
45617,140,120,80,160,160,0,660
45618,210,120,80,80,0,0,490
45619,200,100,40,80,160,0,580
45620,220,100,80,160,160,0,720
45621,210,120,120,160,320,0,930
45622,190,80,120,80,160,0,630
45623,210,160,40,80,0,0,490
45624,200,80,40,80,160,0,560
45625,180,100,160,80,160,320,1000
45626,200,160,160,160,320,0,1000
45627,180,100,120,80,0,0,480
45628,190,160,120,0,0,0,470
45629,200,140,120,80,0,0,540
45630,210,40,0,0,0,0,250
45631,210,140,160,80,160,0,750
45632,170,120,120,160,0,0,570
45633,190,100,80,0,0,0,370
45634,210,80,120,80,160,0,650
45635,170,200,240,240,320,0,1170
45636,210,140,80,0,0,0,430
45637,170,80,80,160,320,0,810
45638,170,140,160,160,160,320,1110
45639,180,120,120,160,0,0,580
45640,210,80,80,80,160,320,930
45641,210,160,80,0,0,0,450
45642,170,120,40,0,0,0,330
45643,230,160,80,160,320,0,950
45644,230,120,80,0,0,0,430
45645,170,80,40,0,0,0,290
45646,160,80,80,160,320,0,800
45647,180,140,120,0,0,0,440
45648,210,140,80,80,160,320,990
45649,210,120,120,160,320,0,930
45650,200,160,80,80,160,320,1000
45651,200,80,80,0,0,0,360
45652,200,120,80,80,160,0,640
45653,200,120,120,160,0,0,600
45654,200,120,160,160,160,0,800
45655,190,160,80,80,0,0,510
45656,150,120,120,160,0,0,550
45657,170,120,120,80,0,0,490
45658,170,180,160,160,160,0,830
45659,190,80,120,160,160,0,710
45660,190,120,40,0,0,0,350
45661,170,140,160,160,160,0,790
45662,210,120,200,240,160,0,930
45663,210,80,120,80,160,0,650
45664,190,80,40,80,160,0,550
45665,220,120,80,80,0,0,500
45666,180,120,80,80,160,0,620
45667,190,100,80,80,0,0,450
45668,180,120,80,80,160,0,620
45669,220,120,120,160,320,0,940
45670,160,80,80,80,160,320,880
45671,180,100,80,80,160,0,600
45672,210,140,160,160,160,0,830
45673,220,120,80,80,0,0,500
45674,210,140,120,0,0,0,470
45675,230,100,80,80,160,0,650
45676,180,120,40,80,160,0,580
45677,230,100,120,80,160,0,690
45678,180,140,120,80,160,0,680
45679,230,180,120,80,0,0,610
45680,220,160,120,240,160,0,900
45681,170,140,120,0,0,0,430
45682,190,120,120,160,160,0,750
45683,160,120,160,0,0,0,440
45684,180,140,160,0,0,0,480
45685,200,180,80,80,160,0,700
45686,200,140,120,80,160,320,1020
45687,180,140,80,160,160,0,720
45688,210,100,80,160,320,0,870
45689,200,160,160,160,0,0,680
45690,220,80,120,80,0,0,500
45691,220,200,160,160,0,0,740
45692,210,180,120,0,0,0,510
45693,220,160,240,160,160,0,940
45694,210,100,120,160,160,0,750
45695,200,80,40,80,160,0,560
45696,200,160,160,160,160,0,840
45697,180,160,120,0,0,0,460
45698,230,100,120,160,160,0,770
45699,190,120,80,80,0,0,470
45700,240,180,160,160,160,0,900
45701,210,180,120,160,160,320,1150
45702,200,120,40,80,160,0,600
45703,190,60,40,80,0,0,370
45704,200,120,80,80,160,0,640
45705,240,180,160,240,160,0,980
45706,160,80,80,80,0,0,400
45707,200,140,120,80,160,0,700
45708,230,160,200,240,160,0,990
45709,190,140,200,160,320,320,1330
45710,170,140,160,0,0,0,470
45711,190,160,40,80,0,0,470
45712,210,140,120,80,160,0,710
45713,210,140,80,160,160,0,750
45714,220,100,80,160,160,0,720
45715,200,140,80,80,160,0,660
45716,230,140,40,80,160,0,650
45717,200,160,160,160,160,0,840
45718,220,140,120,80,160,0,720
45719,180,100,120,160,0,0,560
45720,210,100,40,0,0,0,350
45721,230,120,120,80,160,0,710
45722,190,160,120,160,160,0,790
45723,190,120,80,0,0,0,390
45724,230,160,160,160,160,0,870
45725,220,200,80,0,0,0,500
45726,200,120,80,160,320,0,880
45727,200,40,80,80,160,0,560
45728,220,120,80,160,0,0,580
45729,200,140,120,80,160,0,700
45730,200,100,80,80,0,0,460
45731,210,100,120,80,160,0,670
45732,190,120,80,0,0,0,390
45733,190,100,120,80,0,0,490
45734,180,80,120,80,0,0,460
45735,230,80,80,160,320,0,870
45736,220,120,120,160,160,0,780
45737,210,120,160,80,160,0,730
45738,150,80,80,80,0,0,390
45739,210,80,120,0,0,0,410
45740,190,100,40,0,0,0,330
45741,200,140,120,80,160,0,700
45742,150,80,40,80,160,0,510
45743,170,140,120,160,160,320,1070
45744,200,100,40,0,0,0,340
45745,190,140,200,160,160,320,1170
45746,150,120,120,160,160,0,710
45747,200,140,160,160,160,0,820
45748,230,120,40,0,0,0,390
45749,170,140,120,240,0,0,670
45750,180,80,40,80,160,0,540
45751,170,140,120,160,320,320,1230
45752,210,180,40,80,160,0,670
45753,190,100,40,80,160,0,570
45754,230,160,200,240,160,0,990
45755,200,80,40,80,160,0,560
45756,200,160,120,0,0,0,480
45757,200,120,160,80,0,0,560
45758,220,100,120,80,160,0,680
45759,210,140,120,160,160,320,1110
45760,220,120,160,160,0,0,660
45761,210,120,120,80,0,0,530
45762,190,120,40,0,0,0,350
45763,210,100,120,160,160,320,1070
45764,190,120,120,80,160,0,670
45765,190,60,80,160,160,0,650
45766,200,160,80,0,0,0,440
45767,220,180,120,160,0,0,680
45768,240,120,0,0,0,0,360
45769,200,100,120,160,0,0,580
45770,150,100,80,160,160,0,650
45771,210,80,120,160,0,0,570
45772,210,80,80,160,160,320,1010
45773,190,140,160,240,160,0,890
45774,160,160,80,0,0,0,400
45775,210,160,80,80,160,320,1010
45776,180,160,120,160,160,0,780
45777,210,200,120,240,160,0,930
45778,180,80,40,80,0,0,380
45779,160,80,120,160,320,0,840
45780,210,120,200,240,160,0,930
45781,190,60,80,80,160,320,890
45782,200,120,0,0,0,0,320
45783,220,120,40,0,0,0,380
45784,210,120,120,160,0,0,610
45785,160,160,120,80,160,0,680
45786,200,140,80,80,0,0,500
45787,220,140,40,80,0,0,480
45788,170,140,120,80,160,0,670
45789,210,120,40,80,0,0,450
45790,220,120,40,0,0,0,380
45791,240,120,80,80,160,0,680
45792,230,180,160,80,160,0,810
45793,170,140,120,160,160,0,750
45794,220,120,160,240,320,320,1380
45795,200,180,160,240,160,320,1260
45796,180,120,80,0,0,0,380
45797,180,140,120,160,160,0,760
45798,260,180,40,80,160,0,720
45799,190,200,160,160,320,0,1030
45800,180,140,120,80,0,0,520
45801,180,160,160,160,160,0,820
45802,250,140,120,80,0,0,590
45803,210,120,40,0,0,0,370
45804,220,120,80,0,0,0,420
45805,180,100,40,80,160,0,560
45806,190,140,80,80,160,0,650
45807,170,120,200,160,0,0,650
45808,220,160,120,160,160,0,820
45809,240,120,120,160,160,0,800
45810,230,220,160,80,160,0,850
45811,170,140,80,80,0,0,470
45812,190,120,80,0,0,0,390
45813,170,120,120,160,320,0,890
45814,160,120,120,160,160,0,720
45815,200,140,80,160,160,0,740
45816,220,160,120,160,0,0,660
45817,180,120,160,240,320,0,1020
45818,230,180,120,160,0,0,690
45819,160,100,120,160,160,0,700
45820,200,160,120,80,160,0,720
45821,190,180,160,80,160,0,770
45822,180,120,40,80,160,0,580
45823,220,160,120,160,320,0,980
45824,190,100,40,80,0,0,410
45825,200,100,40,80,0,0,420
45826,210,180,80,160,320,0,950
45827,230,120,120,80,160,0,710
45828,150,140,80,160,320,0,850
45829,220,140,120,240,320,0,1040
45830,190,140,80,80,160,0,650
45831,200,120,40,80,160,0,600
45832,180,140,240,160,160,0,880
45833,220,120,160,160,0,0,660
45834,220,100,80,160,160,0,720
45835,180,120,80,160,320,320,1180
45836,210,200,160,160,320,0,1050
45837,200,140,80,0,0,0,420
45838,190,100,120,160,160,0,730
45839,190,140,160,160,0,0,650
45840,220,160,80,80,0,0,540
45841,210,160,200,160,160,320,1210
45842,210,140,80,0,0,0,430
45843,190,100,80,80,160,0,610
45844,210,160,160,160,0,0,690
45845,190,120,120,160,160,0,750
45846,200,100,80,160,160,0,700
45847,190,80,80,160,160,0,670
45848,210,100,160,240,320,320,1350
45849,190,80,40,0,0,0,310
45850,230,40,80,80,0,0,430
45851,210,120,160,80,0,0,570
45852,230,140,120,240,0,0,730
45853,180,140,120,80,0,0,520
45854,160,140,160,160,160,0,780
45855,190,100,80,80,0,0,450
45856,180,100,80,0,0,0,360
45857,190,120,120,160,160,0,750
45858,210,160,160,160,0,0,690
45859,210,200,200,160,0,0,770
45860,190,200,120,160,0,0,670
45861,180,100,80,80,0,0,440
45862,200,100,40,0,0,0,340
45863,220,120,240,160,320,320,1380
45864,230,80,80,160,0,0,550
45865,200,100,80,160,320,320,1180
45866,170,140,80,80,160,0,630
45867,230,120,80,80,160,0,670
45868,140,140,200,80,0,0,560
45869,220,140,160,160,320,320,1320
45870,240,140,160,80,0,0,620
45871,210,160,160,80,0,0,610
45872,200,80,40,0,0,0,320
45873,170,160,120,160,160,320,1090
45874,200,100,80,0,0,0,380
45875,170,160,120,80,160,0,690
45876,200,180,200,160,160,0,900
45877,170,100,40,0,0,0,310
45878,200,100,80,80,0,0,460
45879,170,120,120,80,160,0,650
45880,210,100,80,80,0,0,470
45881,200,80,40,80,160,0,560
45882,190,120,80,160,160,0,710
45883,180,140,160,80,0,0,560
45884,210,80,80,80,160,0,610
45885,210,100,40,80,160,0,590
45886,190,120,120,160,160,0,750
45887,190,140,200,320,160,320,1330
45888,180,120,80,0,0,0,380
45889,220,100,80,0,0,0,400
45890,200,100,120,160,0,0,580
45891,190,120,80,0,0,0,390
45892,160,80,0,0,0,0,240
45893,200,120,120,240,160,0,840
45894,180,100,80,80,0,0,440
45895,200,120,160,80,0,0,560
45896,140,80,80,80,160,0,540
45897,160,140,160,160,160,0,780
45898,170,100,160,0,0,0,430
45899,240,120,120,80,0,0,560
45900,200,120,160,160,160,0,800
45901,150,120,120,160,160,0,710
45902,170,120,40,80,160,0,570
45903,200,180,240,80,160,0,860
45904,190,140,120,160,320,320,1250
45905,190,140,160,160,0,0,650
45906,170,160,120,0,0,0,450
45907,200,80,120,160,320,0,880
45908,200,120,80,80,0,0,480
45909,190,100,80,80,0,0,450
45910,230,100,80,80,160,0,650
45911,180,120,0,0,0,0,300
45912,200,120,80,0,0,0,400
45913,260,80,80,160,160,0,740
45914,190,140,120,80,160,0,690
45915,200,140,40,80,160,0,620
45916,180,80,40,80,160,0,540
45917,190,100,80,80,160,0,610
45918,210,120,80,160,320,320,1210
45919,190,80,80,160,0,0,510
45920,180,120,40,80,0,0,420
45921,220,140,160,80,160,0,760
45922,220,140,160,240,160,320,1240
45923,230,100,40,0,0,0,370
45924,180,120,160,160,160,0,780
45925,190,120,80,160,160,320,1030
45926,230,200,200,240,160,0,1030
45927,220,120,120,80,160,0,700
45928,180,100,80,80,160,0,600
45929,210,120,120,160,160,0,770
45930,180,60,80,160,160,320,960
45931,240,220,120,80,160,0,820
45932,220,120,120,160,160,320,1100
45933,180,120,40,0,0,0,340
45934,140,60,80,80,160,0,520
45935,160,120,120,160,0,0,560
45936,190,120,80,160,160,0,710
45937,230,100,80,80,160,320,970
45938,210,160,80,80,160,0,690
45939,220,140,80,80,160,0,680
45940,220,120,160,160,320,0,980
45941,160,80,120,80,160,320,920
45942,220,120,120,0,0,0,460
45943,210,200,120,0,0,0,530
45944,140,80,120,160,0,0,500
45945,210,120,120,160,160,0,770
45946,180,140,120,80,160,0,680
45947,190,120,40,0,0,0,350
45948,230,100,120,160,160,320,1090
45949,210,140,160,80,0,0,590
45950,180,100,40,0,0,0,320
45951,200,120,40,0,0,0,360
45952,200,100,40,80,160,0,580
45953,200,140,80,160,160,0,740
45954,180,80,80,80,160,0,580
45955,210,160,80,160,320,320,1250
45956,210,180,160,80,0,0,630
45957,180,140,80,80,160,0,640
45958,210,160,200,160,160,320,1210
45959,220,100,80,80,0,0,480
45960,220,120,120,80,160,0,700
45961,210,100,120,80,0,0,510
45962,170,120,120,160,320,0,890
45963,230,80,120,80,160,0,670
45964,210,120,120,80,160,0,690
45965,160,140,120,160,320,0,900
45966,200,120,200,160,0,0,680
45967,200,120,120,0,0,0,440
45968,150,120,80,0,0,0,350
45969,220,120,40,80,0,0,460
45970,230,140,120,80,160,0,730
45971,190,140,120,160,0,0,610
45972,210,200,160,160,160,0,890
45973,230,120,40,0,0,0,390
45974,210,120,120,80,160,0,690
45975,210,160,160,160,160,0,850
45976,200,80,120,80,0,0,480
45977,200,60,40,80,160,0,540
45978,150,100,80,80,160,0,570
45979,210,80,80,80,0,0,450
45980,190,100,80,160,160,320,1010
45981,160,100,80,80,160,0,580
45982,180,140,120,160,320,0,920
45983,200,100,80,80,0,0,460
45984,180,140,120,160,320,0,920
45985,200,160,120,80,160,0,720
45986,180,140,40,80,0,0,440
45987,180,140,160,240,160,0,880
45988,180,80,80,160,320,0,820
45989,220,100,80,160,160,0,720
45990,170,100,80,80,0,0,430
45991,200,140,40,80,0,0,460
45992,200,140,160,160,0,0,660
45993,240,120,80,80,160,0,680
45994,200,100,120,160,160,0,740
45995,220,140,80,80,160,320,1000
45996,200,140,160,160,160,0,820
45997,200,140,200,160,320,0,1020
45998,210,140,120,160,320,0,950
45999,190,160,160,240,160,320,1230
46000,210,140,160,240,160,320,1230
46001,230,160,120,80,160,0,750
46002,160,160,160,160,160,0,800
46003,210,80,160,80,0,0,530
46004,190,80,80,160,160,0,670
46005,180,180,40,0,0,0,400
46006,220,160,80,0,0,0,460
46007,190,140,160,240,320,320,1370
46008,200,160,160,160,160,0,840
46009,170,100,120,160,0,0,550
46010,200,160,160,160,160,0,840
46011,170,120,120,80,0,0,490
46012,190,100,80,80,160,0,610
46013,130,100,80,80,160,320,870
46014,150,80,80,80,160,0,550
46015,180,140,120,80,160,320,1000
46016,250,140,120,160,160,0,830
46017,120,40,80,160,160,320,880
46018,200,160,120,160,160,0,800
46019,190,140,120,160,160,0,770
46020,170,60,80,80,0,0,390
46021,240,180,120,80,160,0,780
46022,200,80,80,160,160,320,1000
46023,170,120,160,80,160,0,690
46024,190,160,40,80,160,320,950
46025,180,100,80,80,0,0,440
46026,170,120,80,80,160,0,610
46027,240,100,120,80,0,0,540
46028,220,80,0,0,0,0,300
46029,200,120,80,0,0,0,400
46030,190,120,120,80,0,0,510
46031,180,80,120,160,0,0,540
46032,220,160,120,240,160,320,1220
46033,230,160,120,80,0,0,590
46034,170,120,160,0,0,0,450
46035,190,140,80,160,160,0,730
46036,210,200,160,80,0,0,650
46037,190,160,120,80,160,0,710
46038,160,80,0,0,0,0,240
46039,190,120,160,160,320,0,950
46040,210,80,160,240,320,320,1330
46041,180,80,80,80,160,0,580
46042,190,100,120,80,160,320,970
46043,210,120,120,160,160,320,1090
46044,200,120,80,160,320,0,880
46045,200,160,40,80,160,0,640
46046,190,80,80,80,0,0,430
46047,200,100,40,0,0,0,340
46048,190,160,80,0,0,0,430
46049,190,160,120,160,0,0,630
46050,210,180,40,0,0,0,430
46051,200,100,120,160,160,0,740
46052,170,120,160,80,0,0,530
46053,200,120,80,80,0,0,480
46054,180,140,160,0,0,0,480
46055,190,80,160,160,160,0,750
46056,220,180,120,80,160,320,1080
46057,180,120,120,160,320,0,900
46058,210,100,120,80,0,0,510
46059,210,60,120,80,160,0,630
46060,200,120,80,80,0,0,480
46061,190,120,120,160,160,0,750
46062,230,140,120,160,0,0,650
46063,210,140,120,240,160,0,870
46064,220,100,40,80,0,0,440
46065,220,100,40,0,0,0,360
46066,220,120,80,160,0,0,580
46067,230,120,160,160,160,0,830
46068,230,140,160,80,160,0,770
46069,200,120,80,80,0,0,480
46070,230,140,120,80,160,0,730
46071,160,40,40,80,160,0,480
46072,200,180,120,240,320,320,1380
46073,200,160,80,160,320,0,920
46074,190,100,160,160,320,0,930
46075,200,140,160,240,160,320,1220
46076,200,120,80,80,160,0,640
46077,170,80,80,80,0,0,410
46078,190,200,160,80,160,320,1110
46079,230,160,120,80,0,0,590
46080,200,120,80,0,0,0,400
46081,190,160,160,160,0,0,670
46082,180,80,120,0,0,0,380
46083,150,80,0,0,0,0,230
46084,190,120,80,160,160,0,710
46085,210,100,80,80,0,0,470
46086,250,140,160,160,320,0,1030
46087,160,180,80,80,160,0,660
46088,190,160,120,80,160,0,710
46089,160,100,160,80,0,0,500
46090,210,160,80,0,0,0,450
46091,180,80,120,160,320,320,1180
46092,220,160,120,80,0,0,580
46093,200,160,160,0,0,0,520
46094,200,160,160,160,160,0,840
46095,190,140,160,80,160,0,730
46096,190,80,40,0,0,0,310
46097,200,120,80,80,160,0,640
46098,190,120,80,80,0,0,470
46099,210,120,120,160,320,0,930
46100,180,120,80,80,160,0,620
46101,210,180,160,240,160,0,950
46102,160,80,160,80,160,0,640
46103,200,200,160,240,0,0,800
46104,210,100,80,0,0,0,390
46105,220,60,40,0,0,0,320
46106,200,140,80,80,0,0,500
46107,170,60,40,0,0,0,270
46108,210,100,40,0,0,0,350
46109,220,120,120,160,0,0,620
46110,200,180,200,240,320,0,1140
46111,210,80,80,0,0,0,370
46112,220,140,40,80,160,0,640
46113,190,140,160,160,160,0,810
46114,190,80,80,160,320,0,830
46115,240,140,120,80,0,0,580
46116,240,160,80,0,0,0,480
46117,140,100,80,80,160,0,560
46118,200,140,40,80,160,320,940
46119,160,80,120,160,160,0,680
46120,210,140,160,160,160,0,830
46121,230,100,80,160,0,0,570
46122,170,140,160,160,320,0,950
46123,180,80,80,80,160,320,900
46124,170,80,120,80,160,0,610
46125,180,80,80,0,0,0,340
46126,230,140,120,160,0,0,650
46127,190,80,80,160,0,0,510
46128,210,100,80,80,160,0,630
46129,210,120,40,80,160,0,610
46130,210,180,200,240,160,0,990
46131,220,160,160,160,320,0,1020
46132,180,120,120,80,160,0,660
46133,190,140,240,240,320,0,1130
46134,210,160,200,240,320,320,1450
46135,170,100,80,80,160,0,590
46136,220,160,120,80,0,0,580
46137,200,100,160,0,0,0,460
46138,190,80,80,80,160,0,590
46139,210,120,160,80,0,0,570
46140,230,140,160,80,160,0,770
46141,220,140,120,80,160,0,720
46142,220,120,0,0,0,0,340
46143,180,140,120,160,0,0,600
46144,160,80,80,160,160,0,640
46145,180,160,120,160,160,320,1100
46146,210,140,160,160,0,0,670
46147,210,140,160,160,160,0,830
46148,170,140,120,160,160,0,750
46149,190,140,40,0,0,0,370
46150,190,160,80,80,0,0,510
46151,180,60,0,0,0,0,240
46152,210,120,120,160,160,0,770
46153,150,60,80,80,160,0,530
46154,190,120,120,160,320,0,910
46155,190,120,80,80,160,0,630
46156,200,100,40,0,0,0,340
46157,200,160,200,160,160,0,880
46158,200,80,40,0,0,0,320
46159,190,140,120,160,320,0,930
46160,210,140,80,0,0,0,430
46161,220,120,80,80,0,0,500
46162,200,100,80,80,0,0,460
46163,200,60,40,80,160,320,860
46164,180,160,160,80,0,0,580
46165,150,80,80,160,320,320,1110
46166,160,60,80,80,160,0,540
46167,210,140,40,80,0,0,470
46168,190,80,120,80,0,0,470
46169,170,140,120,80,0,0,510
46170,180,120,120,80,160,320,980
46171,230,200,120,80,160,0,790
46172,210,100,40,80,0,0,430
46173,220,140,40,80,160,0,640
46174,210,100,160,80,160,0,710
46175,240,180,80,160,0,0,660
46176,230,120,40,80,160,0,630
46177,190,100,40,80,160,0,570
46178,230,180,200,160,160,0,930
46179,190,120,80,160,160,0,710
46180,220,160,120,160,160,0,820
46181,180,140,80,80,160,0,640
46182,200,120,120,160,160,0,760
46183,200,120,120,160,0,0,600
46184,190,100,120,160,0,0,570
46185,210,140,120,160,160,0,790
46186,200,160,200,80,0,0,640
46187,240,180,160,160,160,0,900
46188,210,100,120,160,160,0,750
46189,200,120,40,80,0,0,440
46190,200,100,80,80,0,0,460
46191,230,140,120,80,0,0,570
46192,170,140,80,160,0,0,550
46193,170,120,120,240,320,0,970
46194,200,120,80,80,160,320,960
46195,220,60,0,0,0,0,280
46196,200,160,120,240,320,0,1040
46197,190,140,160,240,160,320,1210
46198,250,140,80,160,320,320,1270
46199,210,160,120,160,160,0,810
46200,260,200,120,80,160,0,820
46201,170,100,80,80,160,0,590
46202,230,180,120,160,160,0,850
46203,210,80,0,0,0,0,290
46204,170,60,40,0,0,0,270
46205,210,100,80,0,0,0,390
46206,230,140,120,80,160,320,1050
46207,200,120,120,80,0,0,520
46208,200,100,80,160,0,0,540
46209,180,120,160,80,160,0,700
46210,180,140,120,160,0,0,600
46211,230,160,40,0,0,0,430
46212,200,140,80,160,0,0,580
46213,180,140,160,80,0,0,560
46214,210,100,120,80,0,0,510
46215,220,140,120,80,0,0,560
46216,190,80,80,80,160,0,590
46217,190,140,160,240,320,0,1050
46218,210,120,40,80,160,0,610
46219,190,100,40,80,0,0,410
46220,210,140,40,0,0,0,390
46221,210,100,120,160,0,0,590
46222,180,140,80,160,160,0,720
46223,180,60,80,80,160,320,880
46224,210,160,80,80,160,0,690
46225,150,120,80,160,160,320,990
46226,160,140,120,160,0,0,580
46227,230,180,120,160,320,0,1010
46228,230,100,40,80,160,0,610
46229,210,140,160,160,160,320,1150
46230,170,100,160,80,160,0,670
46231,220,180,200,320,160,0,1080
46232,240,80,120,80,160,320,1000
46233,210,180,160,0,0,0,550
46234,220,220,160,80,0,0,680
46235,180,100,120,160,160,320,1040
46236,180,140,160,80,160,0,720
46237,190,140,80,80,160,320,970
46238,220,100,40,80,160,0,600
46239,140,100,120,160,320,0,840
46240,150,80,120,160,160,0,670
46241,200,160,80,0,0,0,440
46242,200,160,120,160,160,0,800
46243,210,80,80,80,160,0,610
46244,250,120,80,80,0,0,530
46245,250,180,160,80,160,0,830
46246,180,100,80,80,160,0,600
46247,200,120,80,80,160,0,640
46248,240,140,200,160,160,0,900
46249,210,120,160,80,160,0,730
46250,190,120,80,160,160,0,710
46251,200,140,80,160,160,0,740
46252,190,140,80,80,160,0,650
46253,140,160,240,240,320,320,1420
46254,220,160,120,80,0,0,580
46255,230,140,120,160,320,0,970
46256,170,160,160,160,0,0,650
46257,160,60,40,80,160,0,500
46258,230,140,200,160,320,320,1370
46259,190,140,120,80,160,0,690
46260,190,100,120,160,160,0,730
46261,200,140,120,160,320,0,940
46262,190,160,200,240,0,0,790
46263,150,60,120,80,160,0,570
46264,180,120,120,160,320,0,900
46265,190,100,40,80,160,0,570
46266,160,140,160,80,0,0,540
46267,230,80,160,160,0,0,630
46268,210,180,160,80,160,0,790
46269,200,80,80,160,160,0,680
46270,150,60,40,0,0,0,250
46271,170,140,120,80,160,0,670
46272,210,140,80,160,160,0,750
46273,180,160,80,80,160,0,660
46274,200,80,80,80,0,0,440
46275,170,60,40,80,0,0,350
46276,250,180,120,160,160,0,870
46277,190,100,80,80,160,0,610
46278,190,140,120,160,160,320,1090
46279,170,120,160,240,160,0,850
46280,200,80,40,0,0,0,320
46281,160,60,80,80,160,0,540
46282,170,120,200,160,160,0,810
46283,210,140,80,80,160,0,670
46284,170,120,120,80,160,0,650
46285,190,120,120,160,160,0,750
46286,160,120,160,160,160,0,760
46287,230,200,160,0,0,0,590
46288,180,80,40,80,0,0,380
46289,190,100,160,160,0,0,610
46290,220,160,120,80,160,0,740
46291,170,160,40,80,160,0,610
46292,170,80,80,80,160,0,570
46293,180,160,160,80,0,0,580
46294,210,100,120,160,0,0,590
46295,190,120,160,160,320,320,1270
46296,230,120,80,0,0,0,430
46297,220,160,0,0,0,0,380
46298,200,140,80,80,0,0,500
46299,220,120,120,160,160,0,780
46300,200,80,80,80,0,0,440
46301,210,140,120,0,0,0,470
46302,180,160,120,160,160,0,780
46303,220,80,80,160,160,0,700
46304,180,100,40,0,0,0,320
46305,160,100,80,0,0,0,340
46306,180,80,40,80,160,320,860
46307,190,120,120,160,160,0,750
46308,150,100,120,160,160,0,690
46309,180,140,80,80,160,320,960
46310,190,80,40,80,160,0,550
46311,190,80,80,0,0,0,350
46312,220,120,80,80,0,0,500
46313,160,120,80,160,0,0,520
46314,190,200,200,240,0,0,830
46315,180,160,120,160,320,320,1260
46316,200,160,200,80,160,0,800
46317,230,140,120,80,160,0,730
46318,200,100,120,80,160,0,660
46319,210,120,160,160,160,0,810
46320,210,180,80,80,160,0,710
46321,230,120,120,0,0,0,470
46322,200,100,80,80,0,0,460
46323,180,100,120,160,160,0,720
46324,190,80,120,80,160,0,630
46325,190,140,160,240,160,320,1210
46326,210,80,80,160,320,320,1170
46327,190,140,200,160,160,0,850
46328,170,120,80,0,0,0,370
46329,180,160,160,80,0,0,580
46330,180,100,160,80,160,0,680
46331,160,120,80,80,0,0,440
46332,140,100,40,80,0,0,360
46333,150,140,40,80,160,0,570
46334,200,160,120,160,0,0,640
46335,190,120,80,80,160,0,630
46336,180,120,120,160,320,0,900
46337,210,80,80,160,320,320,1170
46338,200,120,120,160,160,320,1080
46339,200,100,40,0,0,0,340
46340,230,140,120,160,160,0,810
46341,240,140,200,160,160,0,900
46342,200,100,160,160,160,0,780
46343,240,140,120,80,160,320,1060
46344,210,120,160,80,0,0,570
46345,220,180,120,0,0,0,520
46346,200,100,120,160,160,0,740
46347,200,100,120,160,320,0,900
46348,220,140,120,160,0,0,640
46349,230,140,80,160,320,0,930
46350,210,140,120,240,320,0,1030
46351,210,140,120,80,160,0,710
46352,200,60,120,80,160,0,620
46353,170,140,120,0,0,0,430
46354,210,60,40,80,160,0,550
46355,180,120,120,240,160,0,820
46356,200,80,40,80,0,0,400
46357,200,120,80,80,160,0,640
46358,200,80,80,0,0,0,360
46359,210,120,120,160,0,0,610
46360,200,100,120,160,0,0,580
46361,220,120,80,0,0,0,420
46362,170,100,80,80,160,0,590
46363,180,120,80,80,160,0,620
46364,220,180,200,160,320,0,1080
46365,220,100,80,80,160,0,640
46366,220,180,160,160,160,320,1200
46367,250,160,200,160,160,320,1250
46368,180,160,160,80,0,0,580
46369,210,140,120,80,0,0,550
46370,180,80,40,80,160,0,540
46371,230,140,80,80,160,320,1010
46372,200,60,80,80,160,0,580
46373,170,80,40,80,0,0,370
46374,190,80,80,80,0,0,430
46375,160,100,80,80,160,320,900
46376,150,120,80,80,0,0,430
46377,240,100,80,80,160,0,660
46378,180,120,160,80,0,0,540
46379,180,100,80,160,160,0,680
46380,190,140,120,0,0,0,450
46381,190,120,80,160,160,0,710
46382,250,100,40,0,0,0,390
46383,250,140,120,80,160,320,1070
46384,240,160,200,80,160,0,840
46385,150,80,80,80,0,0,390
46386,210,60,80,0,0,0,350
46387,160,140,120,160,320,0,900
46388,210,140,80,0,0,0,430
46389,190,180,40,0,0,0,410
46390,220,120,80,160,160,320,1060
46391,190,60,120,240,320,0,930
46392,170,120,160,160,160,320,1090
46393,220,160,200,160,160,0,900
46394,170,120,120,160,160,0,730
46395,170,100,160,80,0,0,510
46396,200,180,120,80,160,320,1060
46397,200,120,40,80,160,0,600
46398,190,220,200,240,160,0,1010
46399,230,160,160,160,160,0,870
46400,210,120,120,240,320,0,1010
46401,200,100,80,0,0,0,380
46402,190,60,80,80,0,0,410
46403,240,160,120,80,0,0,600
46404,180,180,160,80,160,0,760
46405,230,140,160,80,0,0,610
46406,200,80,40,0,0,0,320
46407,210,140,120,80,0,0,550
46408,170,140,120,80,160,0,670
46409,240,100,80,80,160,0,660
46410,220,140,120,0,0,0,480
46411,200,140,120,80,160,0,700
46412,180,100,40,80,0,0,400
46413,250,120,120,160,160,0,810
46414,210,100,80,0,0,0,390
46415,200,120,40,80,160,0,600
46416,220,120,40,80,0,0,460
46417,210,140,80,0,0,0,430
46418,170,140,160,80,160,0,710
46419,170,100,40,80,160,0,550
46420,210,140,40,0,0,0,390
46421,220,120,120,160,0,0,620
46422,150,120,160,160,0,0,590
46423,190,120,80,80,160,0,630
46424,170,80,40,0,0,0,290
46425,180,100,80,80,0,0,440
46426,220,120,120,80,0,0,540
46427,180,80,80,160,0,0,500
46428,170,100,0,0,0,0,270
46429,190,100,160,160,160,0,770
46430,170,100,160,240,0,0,670
46431,200,140,80,80,0,0,500
46432,210,160,160,80,160,0,770
46433,120,80,40,80,160,0,480
46434,190,80,120,80,0,0,470
46435,240,160,200,80,160,320,1160
46436,180,80,80,0,0,0,340
46437,220,100,40,0,0,0,360
46438,190,120,80,0,0,0,390
46439,220,140,160,160,160,0,840
46440,210,140,200,160,160,0,870
46441,210,160,160,160,320,320,1330
46442,160,100,120,80,0,0,460
46443,220,160,80,80,160,0,700
46444,190,140,160,160,160,0,810
46445,200,160,200,240,0,0,800
46446,160,180,160,0,0,0,500
46447,160,140,200,240,160,0,900
46448,160,60,80,80,160,320,860
46449,210,120,160,80,0,0,570
46450,180,120,80,80,160,0,620
46451,200,120,160,240,160,0,880
46452,200,120,80,80,160,0,640
46453,190,120,80,80,160,0,630
46454,210,120,80,80,160,0,650
46455,210,140,120,160,160,0,790
46456,200,180,120,0,0,0,500
46457,180,100,160,0,0,0,440
46458,200,100,120,240,320,0,980
46459,220,100,80,80,160,0,640
46460,180,120,120,240,160,320,1140
46461,160,140,80,160,160,0,700
46462,170,100,160,240,0,0,670
46463,220,100,120,80,0,0,520
46464,200,160,80,0,0,0,440
46465,190,100,40,80,160,0,570
46466,210,100,40,0,0,0,350
46467,240,140,160,240,320,0,1100
46468,240,200,160,80,160,0,840
46469,190,120,40,80,0,0,430
46470,250,180,240,160,0,0,830
46471,240,140,40,80,160,0,660
46472,200,120,120,80,160,0,680
46473,160,80,80,0,0,0,320
46474,150,100,160,80,0,0,490
46475,210,120,120,160,320,320,1250
46476,150,120,0,0,0,0,270
46477,210,120,120,160,160,0,770
46478,200,100,120,160,160,0,740
46479,200,100,80,80,0,0,460
46480,210,120,120,160,160,0,770
46481,200,140,120,80,0,0,540
46482,220,100,80,80,160,0,640
46483,220,100,80,80,0,0,480
46484,180,60,40,80,0,0,360
46485,240,120,40,80,160,0,640
46486,220,100,80,80,160,0,640
46487,240,160,120,160,160,0,840
46488,180,160,80,80,0,0,500
46489,140,100,80,80,160,0,560
46490,160,100,120,80,160,320,940
46491,220,140,120,80,0,0,560
46492,180,100,120,160,0,0,560
46493,210,160,120,0,0,0,490
46494,160,100,80,160,160,320,980
46495,200,160,160,0,0,0,520
46496,190,160,200,0,0,0,550
46497,180,160,160,160,0,0,660
46498,240,100,120,160,0,0,620
46499,200,140,80,80,160,0,660
46500,170,80,80,80,160,0,570
46501,190,120,120,80,160,0,670
46502,190,140,120,160,320,320,1250
46503,190,100,80,80,0,0,450
46504,190,60,40,0,0,0,290
46505,180,100,120,0,0,0,400
46506,220,120,120,160,160,0,780
46507,190,120,80,80,0,0,470
46508,230,140,80,80,160,0,690
46509,220,140,120,160,0,0,640
46510,160,60,80,80,160,0,540
46511,180,80,0,0,0,0,260
46512,170,160,40,0,0,0,370
46513,180,120,160,240,160,0,860
46514,230,120,160,0,0,0,510
46515,220,140,40,80,0,0,480
46516,200,100,80,80,0,0,460
46517,220,160,80,80,160,320,1020
46518,260,160,80,80,160,0,740
46519,190,100,120,160,320,0,890
46520,200,120,40,80,0,0,440
46521,220,120,40,80,0,0,460
46522,190,120,40,0,0,0,350
46523,200,100,40,80,160,320,900
46524,200,80,120,160,160,0,720
46525,220,100,80,80,160,0,640
46526,200,60,40,80,160,0,540
46527,190,20,0,0,0,0,210
46528,180,120,120,160,0,0,580
46529,200,100,120,0,0,0,420
46530,180,40,0,0,0,0,220
46531,230,140,120,160,160,0,810
46532,210,100,160,240,320,0,1030
46533,190,80,120,80,160,0,630
46534,200,60,0,0,0,0,260
46535,150,120,80,80,160,0,590
46536,230,200,120,80,0,0,630
46537,190,160,160,240,320,0,1070
46538,130,60,40,0,0,0,230
46539,240,140,40,0,0,0,420
46540,190,120,120,160,0,0,590
46541,180,120,40,0,0,0,340
46542,210,100,80,0,0,0,390
46543,180,220,120,80,0,0,600
46544,230,120,160,80,0,0,590
46545,230,160,200,80,160,0,830
46546,170,140,160,80,160,0,710
46547,200,180,120,160,0,0,660
46548,170,80,40,0,0,0,290
46549,200,120,160,80,160,0,720
46550,180,160,160,240,160,0,900
46551,200,140,40,80,160,320,940
46552,230,160,200,80,0,0,670
46553,230,180,200,80,0,0,690
46554,230,140,160,240,320,320,1410
46555,180,100,120,80,160,0,640
46556,230,160,200,160,320,0,1070
46557,220,180,160,160,0,0,720
46558,200,180,120,80,0,0,580
46559,170,80,80,80,0,0,410
46560,210,120,120,80,160,0,690
46561,220,140,120,160,160,320,1120
46562,220,160,160,160,160,0,860
46563,200,140,120,160,160,0,780
46564,180,100,120,160,160,0,720
46565,190,180,80,80,160,0,690
46566,210,120,120,80,0,0,530
46567,180,80,40,0,0,0,300
46568,210,60,80,80,160,320,910
46569,220,140,160,80,160,0,760
46570,160,120,120,160,160,320,1040
46571,190,160,160,80,160,320,1070
46572,200,120,0,0,0,0,320
46573,210,160,200,160,0,0,730
46574,170,140,120,0,0,0,430
46575,200,100,80,80,0,0,460
46576,210,120,160,80,0,0,570
46577,220,200,200,240,160,320,1340
46578,200,80,80,160,0,0,520
46579,170,60,80,160,320,0,790
46580,170,60,0,0,0,0,230
46581,200,120,120,160,0,0,600
46582,210,120,80,80,0,0,490
46583,230,120,120,80,160,0,710
46584,190,140,80,80,0,0,490
46585,160,60,0,0,0,0,220
46586,200,100,120,240,160,0,820
46587,190,180,120,160,320,0,970
46588,200,100,80,0,0,0,380
46589,210,120,40,80,0,0,450
46590,170,120,120,160,0,0,570
46591,200,140,0,0,0,0,340
46592,180,120,120,80,160,0,660
46593,190,80,120,80,0,0,470
46594,220,160,120,80,160,0,740
46595,220,100,120,80,0,0,520
46596,210,100,80,0,0,0,390
46597,190,140,160,80,0,0,570
46598,220,140,80,0,0,0,440
46599,220,120,120,160,0,0,620
46600,170,160,80,80,0,0,490
46601,190,100,80,160,320,0,850
46602,170,80,40,80,160,0,530
46603,190,100,40,0,0,0,330
46604,210,120,80,0,0,0,410
46605,200,100,40,0,0,0,340
46606,220,180,160,240,320,0,1120
46607,170,100,80,160,160,320,990
46608,240,160,160,80,160,0,800
46609,170,140,160,80,160,320,1030
46610,220,160,120,160,0,0,660
46611,170,140,80,80,0,0,470
46612,210,100,40,80,0,0,430
46613,180,120,40,0,0,0,340
46614,160,80,80,80,0,0,400
46615,210,100,40,80,160,0,590
46616,200,100,80,160,0,0,540
46617,160,100,120,0,0,0,380
46618,180,100,40,0,0,0,320
46619,180,140,160,160,160,0,800
46620,210,100,80,80,160,0,630
46621,180,120,200,160,320,320,1300
46622,200,120,40,80,0,0,440
46623,190,120,40,0,0,0,350
46624,200,140,120,80,160,0,700
46625,210,80,120,240,160,0,810
46626,210,120,160,80,160,0,730
46627,190,160,160,160,320,320,1310
46628,240,60,80,80,160,0,620
46629,240,100,120,160,160,0,780
46630,190,160,160,160,320,320,1310
46631,160,80,80,80,160,0,560
46632,220,100,120,160,160,0,760
46633,200,80,80,80,160,320,920
46634,180,120,160,160,320,320,1260
46635,200,120,120,80,160,0,680
46636,230,200,200,240,160,320,1350
46637,210,180,120,160,320,0,990
46638,190,200,120,80,160,0,750
46639,180,120,120,80,160,0,660
46640,170,120,160,0,0,0,450
46641,220,160,200,240,160,0,980
46642,200,120,40,0,0,0,360
46643,200,160,200,160,320,320,1360
46644,190,200,160,160,160,0,870
46645,210,160,160,80,160,0,770
46646,190,160,80,80,0,0,510
46647,250,80,40,80,0,0,450
46648,220,140,120,80,160,0,720
46649,180,140,120,80,160,0,680
46650,180,140,160,160,0,0,640
46651,210,140,120,0,0,0,470
46652,210,180,160,160,160,320,1190
46653,210,80,120,80,0,0,490
46654,210,120,80,0,0,0,410
46655,210,100,120,80,0,0,510
46656,220,140,80,160,160,0,760
46657,180,80,40,80,0,0,380
46658,190,120,120,160,160,0,750
46659,220,180,200,160,160,0,920
46660,180,100,80,160,320,0,840
46661,170,140,80,80,160,320,950
46662,180,120,120,80,160,0,660
46663,220,120,160,80,0,0,580
46664,180,140,200,240,320,320,1400
46665,230,100,120,160,160,320,1090
46666,180,80,80,0,0,0,340
46667,210,80,40,80,160,0,570
46668,210,160,120,160,160,0,810
46669,160,120,120,240,160,0,800
46670,190,120,120,80,0,0,510
46671,200,120,80,80,0,0,480
46672,180,80,80,80,160,0,580
46673,180,140,120,160,160,0,760
46674,180,160,120,80,0,0,540
46675,170,80,80,160,160,0,650
46676,190,120,80,80,0,0,470
46677,220,160,160,240,160,0,940
46678,170,140,40,0,0,0,350
46679,210,120,120,160,320,0,930
46680,200,120,160,240,0,0,720
46681,170,100,120,0,0,0,390
46682,180,200,240,160,160,0,940
46683,170,80,80,160,160,0,650
46684,180,140,80,160,160,0,720
46685,240,140,120,80,0,0,580
46686,190,140,160,160,320,320,1290
46687,150,40,80,0,0,0,270
46688,200,140,160,80,0,0,580
46689,210,160,160,240,160,0,930
46690,170,140,160,240,320,0,1030
46691,170,120,80,0,0,0,370
46692,200,120,200,240,320,320,1400
46693,190,120,80,80,160,320,950
46694,210,140,80,0,0,0,430
46695,240,80,80,160,160,0,720
46696,190,120,80,80,160,320,950
46697,220,120,120,80,160,0,700
46698,170,140,80,0,0,0,390
46699,170,140,120,0,0,0,430
46700,240,160,120,80,160,0,760
46701,210,160,160,240,320,320,1410
46702,220,100,80,160,320,320,1200
46703,210,140,80,80,0,0,510
46704,230,180,120,160,160,320,1170
46705,240,100,120,80,160,0,700
46706,210,140,120,240,320,0,1030
46707,200,120,80,80,0,0,480
46708,170,60,40,0,0,0,270
46709,200,120,40,80,160,0,600
46710,180,120,120,160,160,320,1060
46711,190,120,0,0,0,0,310
46712,180,120,160,80,160,0,700
46713,200,80,40,0,0,0,320
46714,200,220,160,80,160,0,820
46715,200,60,120,80,160,0,620
46716,180,120,80,80,160,0,620
46717,210,140,160,0,0,0,510
46718,220,60,40,80,160,0,560
46719,230,140,120,80,160,0,730
46720,230,140,120,160,0,0,650
46721,170,60,80,160,160,0,630
46722,210,100,120,80,160,0,670
46723,220,100,120,240,320,0,1000
46724,190,100,120,0,0,0,410
46725,180,120,40,0,0,0,340
46726,180,180,120,80,0,0,560
46727,160,100,80,160,160,0,660
46728,200,100,120,0,0,0,420
46729,240,100,80,80,160,0,660
46730,190,100,120,80,0,0,490
46731,220,120,160,80,160,0,740
46732,230,120,120,80,160,0,710
46733,150,100,120,160,160,0,690
46734,160,100,120,0,0,0,380
46735,210,120,80,80,160,0,650
46736,150,120,80,0,0,0,350
46737,230,120,120,80,0,0,550
46738,220,180,160,240,320,0,1120
46739,180,80,120,80,160,0,620
46740,210,80,120,160,160,320,1050
46741,190,100,80,160,160,0,690
46742,180,120,80,80,0,0,460
46743,180,100,120,80,0,0,480
46744,190,80,40,80,160,0,550
46745,240,120,80,0,0,0,440
46746,230,120,120,80,0,0,550
46747,220,100,120,80,160,0,680
46748,170,160,120,80,160,0,690
46749,220,140,120,80,0,0,560
46750,210,100,40,0,0,0,350
46751,230,120,120,80,160,0,710
46752,230,80,40,80,0,0,430
46753,230,140,80,160,0,0,610
46754,230,160,160,160,160,0,870
46755,200,100,0,0,0,0,300
46756,210,180,120,80,0,0,590
46757,200,120,80,80,160,0,640
46758,190,80,80,80,0,0,430
46759,200,140,80,80,0,0,500
46760,200,60,40,0,0,0,300
46761,230,160,160,80,160,0,790
46762,240,180,200,240,0,0,860
46763,220,140,40,0,0,0,400
46764,210,140,80,0,0,0,430
46765,200,140,80,80,160,0,660
46766,220,160,160,160,160,0,860
46767,180,80,80,160,160,0,660
46768,200,120,40,0,0,0,360
46769,210,120,120,80,160,320,1010
46770,180,100,80,80,160,0,600
46771,230,180,160,240,320,0,1130
46772,190,120,80,80,160,0,630
46773,190,140,120,0,0,0,450
46774,220,140,120,0,0,0,480
46775,250,120,200,240,320,0,1130
46776,200,100,120,240,320,0,980
46777,230,120,80,80,160,0,670
46778,210,140,80,80,0,0,510
46779,210,120,120,80,160,0,690
46780,210,120,120,80,160,320,1010
46781,170,100,120,0,0,0,390
46782,210,120,40,0,0,0,370
46783,180,100,120,80,160,0,640
46784,240,160,120,80,0,0,600
46785,190,40,40,0,0,0,270
46786,220,200,120,0,0,0,540
46787,140,120,120,160,0,0,540
46788,160,80,40,0,0,0,280
46789,180,120,80,80,160,320,940
46790,190,160,200,80,160,0,790
46791,210,160,80,80,160,0,690
46792,210,100,120,160,320,0,910
46793,230,140,160,80,160,0,770
46794,190,120,40,80,160,0,590
46795,180,100,80,160,160,0,680
46796,200,140,40,80,160,0,620
46797,170,160,240,240,0,0,810
46798,180,120,160,80,0,0,540
46799,240,120,40,80,0,0,480
46800,210,120,120,0,0,0,450
46801,210,120,120,80,160,0,690
46802,210,100,80,0,0,0,390
46803,190,140,120,80,160,320,1010
46804,190,140,40,0,0,0,370
46805,130,100,80,80,160,0,550
46806,200,120,160,80,0,0,560
46807,230,160,160,80,0,0,630
46808,190,100,160,160,0,0,610
46809,230,160,120,80,160,0,750
46810,210,180,120,160,160,0,830
46811,160,140,200,160,0,0,660
46812,190,100,80,80,160,0,610
46813,180,60,80,80,160,0,560
46814,210,120,120,80,0,0,530
46815,250,100,80,80,0,0,510
46816,190,120,160,160,160,0,790
46817,180,60,80,160,160,0,640
46818,190,60,80,0,0,0,330
46819,210,140,200,160,320,0,1030
46820,180,120,80,0,0,0,380
46821,220,100,80,80,0,0,480
46822,200,120,80,80,0,0,480
46823,220,140,160,160,160,0,840
46824,230,160,120,0,0,0,510
46825,170,140,120,240,320,320,1310
46826,200,80,80,80,160,0,600
46827,200,120,80,80,0,0,480
46828,200,120,40,0,0,0,360
46829,160,80,80,80,160,0,560
46830,190,80,80,80,0,0,430
46831,180,80,40,80,160,0,540
46832,190,100,120,80,0,0,490
46833,200,140,120,160,160,0,780
46834,170,140,160,160,160,320,1110
46835,210,120,80,80,160,0,650
46836,190,160,160,160,320,0,990
46837,180,140,200,160,160,0,840
46838,180,100,80,0,0,0,360
46839,200,120,80,160,160,0,720
46840,230,100,160,160,160,0,810
46841,250,160,120,80,0,0,610
46842,220,100,120,80,160,0,680
46843,210,100,80,160,320,320,1190
46844,240,160,200,240,160,0,1000
46845,160,160,160,160,160,0,800
46846,250,160,160,80,160,0,810
46847,220,160,200,160,0,0,740
46848,160,60,80,160,160,0,620
46849,200,120,160,80,160,320,1040
46850,210,120,80,80,0,0,490
46851,210,140,120,80,0,0,550
46852,210,80,120,0,0,0,410
46853,190,60,0,0,0,0,250
46854,210,160,120,80,160,0,730
46855,230,180,160,0,0,0,570
46856,230,120,160,80,160,0,750
46857,170,120,160,240,160,320,1170
46858,200,140,160,80,160,0,740
46859,170,100,80,0,0,0,350
46860,210,140,80,0,0,0,430
46861,170,100,160,80,0,0,510
46862,190,140,40,0,0,0,370
46863,200,80,40,80,160,0,560
46864,220,160,120,80,160,0,740
46865,170,100,120,80,160,0,630
46866,210,80,80,160,160,320,1010
46867,170,80,40,0,0,0,290
46868,200,120,160,160,160,320,1120
46869,210,160,80,80,160,0,690
46870,210,160,160,160,320,0,1010
46871,220,120,40,80,160,0,620
46872,170,120,160,80,160,320,1010
46873,200,120,80,80,0,0,480
46874,180,100,40,0,0,0,320
46875,230,180,160,160,160,0,890
46876,190,100,80,80,160,0,610
46877,200,140,200,80,0,0,620
46878,210,140,80,80,0,0,510
46879,220,180,120,160,0,0,680
46880,160,120,120,80,160,0,640
46881,220,160,160,160,160,0,860
46882,190,100,80,80,0,0,450
46883,130,140,80,80,0,0,430
46884,210,140,120,160,160,0,790
46885,170,60,0,0,0,0,230
46886,200,80,120,80,160,0,640
46887,230,180,120,80,160,0,770
46888,180,120,160,80,0,0,540
46889,200,100,120,80,160,320,980
46890,260,120,80,80,0,0,540
46891,190,60,80,160,160,0,650
46892,190,80,80,160,160,0,670
46893,220,100,160,80,160,0,720
46894,200,160,160,80,160,0,760
46895,200,140,40,0,0,0,380
46896,230,220,160,160,160,0,930
46897,230,120,80,80,160,0,670
46898,210,160,80,160,320,0,930
46899,250,120,120,160,320,0,970
46900,170,140,80,80,160,0,630
46901,170,120,120,160,320,0,890
46902,200,140,120,160,160,0,780
46903,170,100,80,80,0,0,430
46904,210,120,160,160,160,0,810
46905,190,120,120,240,160,0,830
46906,200,180,80,80,0,0,540
46907,230,200,160,0,0,0,590
46908,180,140,120,160,160,320,1080
46909,170,140,80,80,0,0,470
46910,210,200,160,80,160,0,810
46911,200,120,80,0,0,0,400
46912,200,40,80,80,160,0,560
46913,170,100,120,80,0,0,470
46914,210,180,80,80,160,0,710
46915,230,200,200,240,160,0,1030
46916,220,80,40,80,160,0,580
46917,180,120,160,80,0,0,540
46918,190,100,40,80,0,0,410
46919,180,100,120,160,160,0,720
46920,190,160,40,80,160,0,630
46921,200,160,120,160,320,0,960
46922,160,120,80,160,320,320,1160
46923,210,120,160,80,0,0,570
46924,240,140,160,0,0,0,540
46925,190,100,80,80,160,320,930
46926,210,140,160,80,0,0,590
46927,180,160,80,160,320,320,1220
46928,180,120,80,160,0,0,540
46929,220,120,40,0,0,0,380
46930,200,120,0,0,0,0,320
46931,190,80,80,80,160,0,590
46932,220,120,80,0,0,0,420
46933,160,140,200,80,160,0,740
46934,250,140,120,0,0,0,510
46935,210,160,160,160,160,0,850
46936,200,140,160,0,0,0,500
46937,170,120,120,80,160,320,970
46938,180,120,120,80,160,320,980
46939,170,80,40,0,0,0,290
46940,190,80,80,0,0,0,350
46941,240,120,120,160,320,320,1280
46942,200,120,120,80,160,0,680
46943,150,60,40,80,0,0,330
46944,190,120,80,160,320,0,870
46945,200,160,160,160,320,0,1000
46946,200,80,40,0,0,0,320
46947,180,120,120,160,320,0,900
46948,190,120,120,80,0,0,510
46949,230,160,240,240,320,0,1190
46950,200,120,80,80,0,0,480
46951,220,140,120,160,160,0,800
46952,190,120,40,80,160,320,910
46953,210,180,120,80,160,0,750
46954,210,100,0,0,0,0,310
46955,160,100,120,80,160,0,620
46956,210,120,80,160,160,0,730
46957,210,180,40,80,160,0,670
46958,170,100,120,160,160,0,710
46959,200,120,80,80,160,0,640
46960,210,140,80,160,160,0,750
46961,200,180,120,0,0,0,500
46962,210,160,120,160,160,320,1130
46963,190,140,80,80,0,0,490
46964,220,140,160,240,320,320,1400
46965,220,120,120,80,0,0,540
46966,210,160,80,0,0,0,450
46967,210,80,80,160,160,0,690
46968,200,100,160,160,320,320,1260
46969,210,100,80,0,0,0,390
46970,220,120,0,0,0,0,340
46971,190,140,80,80,160,0,650
46972,190,100,80,0,0,0,370
46973,160,100,80,0,0,0,340
46974,240,140,80,160,160,0,780
46975,190,160,200,160,0,0,710
46976,200,120,80,80,160,0,640
46977,150,120,120,80,0,0,470
46978,230,140,40,0,0,0,410
46979,210,80,80,80,0,0,450
46980,250,140,120,160,160,0,830
46981,140,80,80,80,160,0,540
46982,250,180,200,160,320,320,1430
46983,220,120,80,80,160,0,660
46984,190,140,120,160,160,0,770
46985,180,120,120,80,160,0,660
46986,190,60,40,80,0,0,370
46987,180,160,120,0,0,0,460
46988,180,160,80,160,160,0,740
46989,180,160,160,80,160,0,740
46990,210,120,80,0,0,0,410
46991,200,120,120,160,160,0,760
46992,210,140,120,0,0,0,470
46993,170,100,120,160,320,320,1190
46994,210,140,120,80,0,0,550
46995,170,80,80,160,320,0,810
46996,210,180,120,80,0,0,590
46997,220,120,80,80,0,0,500
46998,250,180,120,80,0,0,630
46999,220,180,120,160,320,320,1320
47000,210,120,80,80,160,0,650
47001,210,100,80,80,160,0,630
47002,230,160,120,80,0,0,590
47003,180,140,40,80,0,0,440
47004,180,120,160,160,160,0,780
47005,190,100,80,160,320,320,1170
47006,220,100,160,160,320,0,960
47007,200,120,160,240,160,0,880
47008,200,120,160,80,160,0,720
47009,170,140,80,80,0,0,470
47010,170,100,120,160,320,0,870
47011,200,140,120,80,160,0,700
47012,190,120,80,160,320,0,870
47013,180,120,40,0,0,0,340
47014,220,140,160,160,320,0,1000
47015,200,140,40,80,0,0,460
47016,170,120,0,0,0,0,290
47017,160,80,0,0,0,0,240
47018,190,180,200,160,160,0,890
47019,190,120,120,160,160,0,750
47020,160,160,120,80,160,0,680
47021,200,160,120,0,0,0,480
47022,240,80,160,240,320,0,1040
47023,160,100,120,80,160,320,940
47024,250,120,120,160,160,0,810
47025,190,80,40,80,160,0,550
47026,250,100,80,80,160,320,990
47027,240,80,80,0,0,0,400
47028,250,140,120,0,0,0,510
47029,170,120,120,80,0,0,490
47030,180,80,40,80,0,0,380
47031,180,160,80,0,0,0,420
47032,210,120,160,160,0,0,650
47033,210,80,40,0,0,0,330
47034,220,160,120,160,160,0,820
47035,150,60,80,160,160,0,610
47036,190,140,200,160,0,0,690
47037,200,120,80,0,0,0,400
47038,180,60,80,160,160,0,640
47039,230,140,80,0,0,0,450
47040,200,80,40,80,0,0,400
47041,180,80,40,80,160,0,540
47042,160,120,120,160,160,0,720
47043,210,180,160,160,320,320,1350
47044,240,80,80,80,160,0,640
47045,220,100,120,160,160,0,760
47046,220,140,120,240,320,0,1040
47047,160,60,40,0,0,0,260
47048,170,100,40,80,160,0,550
47049,190,140,120,80,160,0,690
47050,160,100,120,160,160,0,700
47051,160,80,80,160,160,0,640
47052,200,160,80,80,160,0,680
47053,190,100,160,160,160,0,770
47054,220,120,160,80,160,0,740
47055,200,100,80,80,160,0,620
47056,210,80,40,80,0,0,410
47057,190,140,120,160,320,0,930
47058,200,120,160,160,160,0,800
47059,220,120,120,80,0,0,540
47060,190,160,160,240,160,0,910
47061,190,100,40,0,0,0,330
47062,220,160,200,80,160,0,820
47063,180,100,80,0,0,0,360
47064,160,140,80,160,0,0,540
47065,200,200,200,240,320,0,1160
47066,170,80,40,80,0,0,370
47067,230,140,80,80,0,0,530
47068,170,140,40,80,0,0,430
47069,170,120,80,160,0,0,530
47070,180,100,80,0,0,0,360
47071,180,120,120,160,160,320,1060
47072,190,80,40,0,0,0,310
47073,170,160,160,80,160,0,730
47074,200,140,160,160,160,0,820
47075,200,140,160,240,160,320,1220
47076,200,120,120,160,160,320,1080
47077,220,180,80,0,0,0,480
47078,190,140,80,80,160,0,650
47079,210,140,80,80,160,0,670
47080,200,140,120,160,320,0,940
47081,210,160,40,80,160,0,650
47082,230,140,80,80,160,0,690
47083,180,120,120,80,160,0,660
47084,190,160,160,240,320,320,1390
47085,210,180,80,80,160,0,710
47086,180,120,40,80,160,0,580
47087,160,120,120,80,160,320,960
47088,170,100,40,80,160,0,550
47089,180,140,200,240,320,320,1400
47090,160,120,80,80,160,0,600
47091,180,180,0,0,0,0,360
47092,170,60,40,80,0,0,350
47093,210,120,120,160,160,320,1090
47094,220,100,80,80,160,0,640
47095,210,80,120,160,320,320,1210
47096,180,140,120,160,160,0,760
47097,180,100,120,80,160,0,640
47098,210,140,80,0,0,0,430
47099,190,100,160,240,320,320,1330
47100,200,200,120,0,0,0,520
47101,210,120,160,80,0,0,570
47102,200,100,120,160,160,0,740
47103,200,160,160,160,160,320,1160
47104,130,120,40,0,0,0,290
47105,180,80,0,0,0,0,260
47106,210,100,80,160,160,320,1030
47107,200,120,120,160,160,0,760
47108,190,100,80,80,0,0,450
47109,170,120,80,80,160,0,610
47110,240,80,120,160,160,0,760
47111,170,120,40,80,160,0,570
47112,200,160,120,80,160,320,1040
47113,210,100,80,0,0,0,390
47114,170,160,160,80,0,0,570
47115,200,140,160,80,160,0,740
47116,190,100,120,160,160,0,730
47117,140,60,120,80,160,0,560
47118,180,100,80,160,160,0,680
47119,200,120,40,0,0,0,360
47120,240,180,160,160,0,0,740
47121,170,100,120,80,0,0,470
47122,200,200,160,160,160,0,880
47123,210,140,40,0,0,0,390
47124,210,140,160,240,0,0,750
47125,220,120,120,80,0,0,540
47126,190,140,160,80,0,0,570
47127,180,40,40,80,160,0,500
47128,220,120,120,80,160,0,700
47129,230,140,120,160,320,0,970
47130,220,140,120,160,160,0,800
47131,230,160,120,160,160,0,830
47132,180,120,120,160,0,0,580
47133,190,160,160,80,160,320,1070
47134,200,140,120,80,0,0,540
47135,230,140,200,160,160,0,890
47136,180,80,40,0,0,0,300
47137,200,80,40,0,0,0,320
47138,200,100,120,160,160,320,1060
47139,200,140,120,160,160,320,1100
47140,200,100,120,160,160,320,1060
47141,160,120,40,80,160,0,560
47142,160,80,40,80,160,0,520
47143,190,120,160,80,0,0,550
47144,180,120,120,0,0,0,420
47145,180,60,120,80,160,0,600
47146,170,120,80,0,0,0,370
47147,180,160,160,0,0,0,500
47148,210,140,120,80,160,0,710
47149,200,80,80,80,160,0,600
47150,210,120,40,0,0,0,370
47151,200,120,80,80,0,0,480
47152,140,60,40,0,0,0,240
47153,180,140,120,240,160,0,840
47154,170,100,120,0,0,0,390
47155,200,100,160,80,0,0,540
47156,220,160,160,0,0,0,540
47157,180,100,120,160,160,0,720
47158,210,160,160,80,160,0,770
47159,180,160,120,160,160,0,780
47160,230,160,80,80,0,0,550
47161,200,200,160,80,0,0,640
47162,180,100,80,160,320,0,840
47163,170,120,80,0,0,0,370
47164,190,120,40,0,0,0,350
47165,200,100,80,80,0,0,460
47166,140,60,40,0,0,0,240
47167,220,140,80,80,160,0,680
47168,230,160,160,240,160,0,950
47169,230,180,120,80,160,0,770
47170,220,140,40,80,160,0,640
47171,200,160,80,80,0,0,520
47172,230,120,80,0,0,0,430
47173,220,100,120,80,160,0,680
47174,200,120,80,0,0,0,400
47175,210,100,120,160,320,0,910
47176,200,120,200,240,320,0,1080
47177,210,100,80,80,0,0,470
47178,200,140,40,80,160,0,620
47179,210,140,160,160,0,0,670
47180,160,140,120,80,0,0,500
47181,170,80,160,240,160,320,1130
47182,210,140,160,160,160,0,830
47183,180,140,120,80,160,0,680
47184,220,100,40,0,0,0,360
47185,190,120,120,160,320,0,910
47186,220,160,160,160,160,0,860
47187,210,200,120,160,160,0,850
47188,200,160,120,80,160,0,720
47189,170,100,120,160,160,0,710
47190,200,120,200,160,160,0,840
47191,190,100,120,80,0,0,490
47192,200,140,160,0,0,0,500
47193,210,140,40,0,0,0,390
47194,220,100,80,80,0,0,480
47195,180,120,80,0,0,0,380
47196,200,120,160,160,160,0,800
47197,210,140,160,240,160,0,910
47198,170,180,240,160,320,0,1070
47199,230,100,120,80,160,0,690
47200,170,120,160,160,160,0,770
47201,210,160,120,80,160,0,730
47202,150,80,80,80,0,0,390
47203,170,120,120,160,160,0,730
47204,150,40,40,0,0,0,230
47205,190,120,160,240,320,0,1030
47206,190,100,80,80,0,0,450
47207,200,140,80,0,0,0,420
47208,190,140,160,80,0,0,570
47209,170,60,80,80,160,0,550
47210,180,120,80,80,160,0,620
47211,200,120,80,80,0,0,480
47212,190,80,80,80,160,320,910
47213,230,140,160,160,160,0,850
47214,200,120,160,80,160,0,720
47215,180,60,80,160,160,0,640
47216,220,120,80,160,160,0,740
47217,210,120,40,0,0,0,370
47218,210,100,120,160,320,0,910
47219,210,140,120,160,320,320,1270
47220,200,140,120,80,0,0,540
47221,200,80,80,80,0,0,440
47222,190,120,120,0,0,0,430
47223,180,120,160,0,0,0,460
47224,160,100,120,160,320,320,1180
47225,210,160,200,80,160,0,810
47226,210,140,200,80,0,0,630
47227,230,140,120,160,160,0,810
47228,190,120,160,80,160,320,1030
47229,170,100,160,160,0,0,590
47230,220,160,160,240,160,0,940
47231,170,100,120,80,160,0,630
47232,210,120,40,0,0,0,370
47233,230,120,120,0,0,0,470
47234,190,120,40,0,0,0,350
47235,150,140,80,80,160,0,610
47236,170,60,80,160,0,0,470
47237,180,140,120,160,160,0,760
47238,200,100,160,80,0,0,540
47239,190,120,200,160,160,0,830
47240,220,120,120,80,160,0,700
47241,180,100,120,240,160,0,800
47242,190,80,120,160,0,0,550
47243,200,100,80,0,0,0,380
47244,190,100,40,0,0,0,330
47245,190,120,160,80,160,0,710
47246,190,140,120,80,160,0,690
47247,210,160,160,0,0,0,530
47248,220,100,80,80,0,0,480
47249,210,120,120,0,0,0,450
47250,200,140,160,160,160,320,1140
47251,210,140,80,80,160,0,670
47252,230,140,80,80,0,0,530
47253,240,120,120,160,0,0,640
47254,170,120,80,0,0,0,370
47255,230,140,160,160,160,0,850
47256,190,80,120,160,320,320,1190
47257,170,80,0,0,0,0,250
47258,190,120,160,160,160,0,790
47259,170,120,120,80,0,0,490
47260,190,140,40,80,160,320,930
47261,200,160,80,80,160,0,680
47262,200,100,80,160,0,0,540
47263,180,60,80,80,160,320,880
47264,190,80,40,80,0,0,390
47265,190,120,80,160,160,0,710
47266,170,120,80,80,160,0,610
47267,200,120,40,80,0,0,440
47268,170,60,80,0,0,0,310
47269,230,100,120,80,160,0,690
47270,210,100,120,80,0,0,510
47271,180,80,40,0,0,0,300
47272,180,120,160,160,0,0,620
47273,220,140,120,160,160,0,800
47274,200,140,40,80,0,0,460
47275,150,160,200,240,160,0,910
47276,150,120,160,80,0,0,510
47277,210,120,120,80,160,0,690
47278,140,100,80,80,160,320,880
47279,220,100,160,160,160,0,800
47280,200,120,40,80,160,320,920
47281,200,180,80,80,160,320,1020
47282,180,180,160,160,0,0,680
47283,220,100,80,160,0,0,560
47284,200,140,40,0,0,0,380
47285,190,140,80,80,0,0,490
47286,220,140,120,0,0,0,480
47287,200,160,120,80,160,0,720
47288,200,140,80,0,0,0,420
47289,200,120,120,80,160,0,680
47290,210,160,160,160,160,320,1170
47291,190,100,40,80,160,0,570
47292,200,140,120,160,320,320,1260
47293,200,140,80,80,160,0,660
47294,180,100,80,80,0,0,440
47295,160,160,200,80,0,0,600
47296,190,120,120,80,160,0,670
47297,220,180,80,80,160,0,720
47298,230,160,40,80,0,0,510
47299,190,140,160,240,160,0,890
47300,200,100,120,160,160,0,740
47301,240,180,80,80,0,0,580
47302,220,180,120,160,160,0,840
47303,200,140,160,80,160,0,740
47304,230,120,160,160,160,0,830
47305,160,120,120,80,0,0,480
47306,190,100,40,0,0,0,330
47307,180,120,80,160,160,0,700
47308,200,140,80,160,160,320,1060
47309,190,120,120,0,0,0,430
47310,210,140,160,160,320,0,990
47311,200,160,200,80,160,320,1120
47312,170,120,120,80,160,0,650
47313,160,100,120,240,320,320,1260
47314,220,120,160,80,160,0,740
47315,200,120,40,0,0,0,360
47316,200,140,160,240,160,0,900
47317,190,140,120,80,0,0,530
47318,190,120,160,160,320,320,1270
47319,210,100,120,80,0,0,510
47320,160,120,120,160,160,0,720
47321,200,120,160,160,320,320,1280
47322,190,160,200,240,160,320,1270
47323,160,100,120,240,160,320,1100
47324,170,60,80,0,0,0,310
47325,240,120,80,80,160,0,680
47326,200,100,80,80,160,0,620
47327,210,80,40,80,0,0,410
47328,200,120,120,160,320,0,920
47329,220,120,120,80,160,0,700
47330,230,100,120,80,0,0,530
47331,230,160,160,240,160,320,1270
47332,170,80,40,80,160,0,530
47333,230,100,40,0,0,0,370
47334,190,100,80,0,0,0,370
47335,230,180,240,80,0,0,730
47336,220,120,40,0,0,0,380
47337,170,80,40,80,160,0,530
47338,230,80,120,160,320,0,910
47339,210,40,40,80,160,0,530
47340,220,160,120,80,0,0,580
47341,210,140,160,160,0,0,670
47342,210,160,120,80,0,0,570
47343,210,120,120,80,160,0,690
47344,240,120,120,160,320,0,960
47345,170,100,120,80,0,0,470
47346,200,120,80,80,0,0,480
47347,220,100,80,0,0,0,400
47348,180,100,40,80,160,0,560
47349,180,120,120,160,320,0,900
47350,210,160,120,80,160,320,1050
47351,210,120,40,80,160,320,930
47352,220,140,40,80,0,0,480
47353,170,80,80,160,320,0,810
47354,150,120,200,160,160,0,790
47355,170,100,120,80,0,0,470
47356,230,120,120,160,0,0,630
47357,210,100,160,160,160,0,790
47358,190,160,120,80,0,0,550
47359,210,180,120,160,160,0,830
47360,190,80,80,160,160,0,670
47361,250,180,160,80,160,0,830
47362,180,120,80,80,0,0,460
47363,160,100,80,160,160,0,660
47364,190,80,40,80,160,0,550
47365,180,120,120,80,160,320,980
47366,230,120,120,160,160,0,790
47367,220,120,160,160,160,0,820
47368,180,160,80,0,0,0,420
47369,160,100,40,80,160,0,540
47370,210,160,160,80,160,0,770
47371,210,160,120,160,160,0,810
47372,190,160,80,80,0,0,510
47373,200,60,80,80,160,0,580
47374,160,120,80,80,160,0,600
47375,190,200,120,0,0,0,510
47376,220,140,120,80,160,0,720
47377,240,140,80,0,0,0,460
47378,190,180,200,160,160,0,890
47379,190,80,80,80,0,0,430
47380,180,120,80,160,0,0,540
47381,200,80,160,0,0,0,440
47382,180,100,120,160,160,320,1040
47383,180,100,80,80,160,0,600
47384,150,100,120,160,320,320,1170
47385,180,140,80,0,0,0,400
47386,190,160,80,80,160,0,670
47387,180,100,120,160,160,0,720
47388,180,80,80,160,0,0,500
47389,170,60,40,80,0,0,350
47390,220,120,160,160,160,0,820
47391,180,120,80,80,160,320,940
47392,200,120,80,160,320,0,880
47393,180,80,80,0,0,0,340
47394,180,100,120,160,0,0,560
47395,200,140,200,160,320,320,1340
47396,210,160,40,80,160,320,970
47397,170,120,80,80,0,0,450
47398,200,120,40,80,0,0,440
47399,200,100,80,80,0,0,460
47400,210,160,160,240,320,0,1090
47401,250,160,120,160,160,320,1170
47402,240,100,160,160,160,0,820
47403,210,80,80,80,0,0,450
47404,180,100,120,0,0,0,400
47405,250,100,120,160,320,0,950
47406,170,120,40,80,160,0,570
47407,200,100,80,0,0,0,380
47408,190,100,160,80,160,0,690
47409,170,80,40,80,0,0,370
47410,190,120,160,160,160,0,790
47411,160,80,80,80,160,0,560
47412,150,60,80,0,0,0,290
47413,180,120,40,80,160,0,580
47414,190,100,120,160,320,320,1210
47415,180,80,40,0,0,0,300
47416,200,120,120,160,0,0,600
47417,230,120,0,0,0,0,350
47418,260,160,120,80,160,0,780
47419,220,180,160,0,0,0,560
47420,160,100,40,80,160,0,540
47421,220,120,160,160,160,0,820
47422,240,140,120,160,160,0,820
47423,210,140,80,80,160,0,670
47424,190,120,80,80,160,0,630
47425,200,100,80,160,160,0,700
47426,250,120,80,160,160,0,770
47427,230,120,120,80,160,0,710
47428,250,100,80,80,0,0,510
47429,230,160,80,0,0,0,470
47430,200,160,80,80,160,320,1000
47431,230,120,80,80,160,320,990
47432,180,120,160,160,320,0,940
47433,130,80,40,80,0,0,330
47434,190,160,160,240,320,320,1390
47435,190,180,160,240,160,0,930
47436,170,160,120,80,160,0,690
47437,180,100,120,0,0,0,400
47438,160,120,120,160,160,0,720
47439,210,140,120,160,160,0,790
47440,210,200,120,0,0,0,530
47441,220,100,120,240,320,320,1320
47442,170,180,120,80,160,0,710
47443,230,180,120,80,160,0,770
47444,240,60,80,80,0,0,460
47445,150,100,80,80,160,0,570
47446,200,100,80,80,0,0,460
47447,220,200,200,160,0,0,780
47448,210,140,200,240,320,0,1110
47449,170,100,80,80,160,0,590
47450,190,120,160,240,160,320,1190
47451,190,60,80,80,160,0,570
47452,200,140,120,80,160,0,700
47453,190,80,120,80,0,0,470
47454,140,60,40,80,160,320,800
47455,200,140,120,160,0,0,620
47456,160,120,160,240,320,320,1320
47457,210,60,120,80,160,0,630
47458,200,140,0,0,0,0,340
47459,190,120,40,80,160,320,910
47460,210,100,40,80,160,0,590
47461,220,160,160,160,0,0,700
47462,170,60,80,160,160,0,630
47463,160,60,80,0,0,0,300
47464,160,60,40,80,160,0,500
47465,180,100,120,160,320,0,880
47466,230,180,160,160,160,0,890
47467,210,120,40,80,0,0,450
47468,200,120,80,160,320,320,1200
47469,190,100,80,160,160,0,690
47470,210,100,80,80,160,0,630
47471,220,140,80,80,0,0,520
47472,190,140,40,80,0,0,450
47473,210,160,120,80,0,0,570
47474,210,180,120,80,160,0,750
47475,140,60,120,160,0,0,480
47476,230,120,200,240,160,0,950
47477,190,120,80,80,160,0,630
47478,180,140,120,160,0,0,600
47479,210,120,0,0,0,0,330
47480,210,120,80,80,160,0,650
47481,180,100,120,160,320,0,880
47482,200,140,160,0,0,0,500
47483,210,120,40,80,160,0,610
47484,180,140,80,80,160,320,960
47485,200,120,80,0,0,0,400
47486,190,120,120,80,0,0,510
47487,140,100,120,160,320,0,840
47488,200,160,40,80,0,0,480
47489,210,100,160,160,320,0,950
47490,150,100,80,160,160,0,650
47491,190,120,160,80,0,0,550
47492,180,160,120,160,160,0,780
47493,210,160,0,0,0,0,370
47494,190,160,160,160,160,0,830
47495,190,140,120,80,160,320,1010
47496,170,100,120,0,0,0,390
47497,190,120,160,240,160,0,870
47498,210,120,120,160,160,0,770
47499,220,120,40,0,0,0,380
47500,180,120,120,160,160,0,740
47501,210,140,120,80,0,0,550
47502,170,120,80,80,160,0,610
47503,210,100,80,80,160,0,630
47504,200,80,80,0,0,0,360
47505,180,140,80,160,320,0,880
47506,200,140,120,0,0,0,460
47507,180,80,40,0,0,0,300
47508,170,140,160,160,0,0,630
47509,200,80,80,160,160,0,680
47510,220,160,80,0,0,0,460
47511,180,120,80,80,0,0,460
47512,220,140,0,0,0,0,360
47513,210,100,120,160,160,0,750
47514,210,160,40,80,160,0,650
47515,220,140,80,160,160,0,760
47516,210,160,80,0,0,0,450
47517,170,120,120,160,160,0,730
47518,210,100,80,160,160,0,710
47519,190,180,160,80,160,0,770
47520,170,120,200,240,320,320,1370
47521,250,180,80,80,160,0,750
47522,200,160,80,0,0,0,440
47523,160,80,80,0,0,0,320
47524,220,160,80,80,160,0,700
47525,190,160,120,80,0,0,550
47526,220,120,80,160,320,0,900
47527,210,160,120,160,160,0,810
47528,220,120,80,160,160,0,740
47529,190,80,80,0,0,0,350
47530,190,100,80,0,0,0,370
47531,240,180,200,80,160,320,1180
47532,240,140,80,0,0,0,460
47533,210,120,80,80,160,0,650
47534,180,80,40,80,0,0,380
47535,200,140,120,240,160,0,860
47536,180,120,80,0,0,0,380
47537,190,100,40,0,0,0,330
47538,200,140,120,160,320,0,940
47539,160,60,40,80,160,0,500
47540,170,60,40,80,160,0,510
47541,220,180,120,0,0,0,520
47542,190,160,120,80,0,0,550
47543,190,120,40,80,160,0,590
47544,150,120,120,160,0,0,550
47545,200,180,200,80,160,0,820
47546,200,120,120,80,160,320,1000
47547,240,180,240,160,0,0,820
47548,220,100,0,0,0,0,320
47549,180,160,200,160,160,0,860
47550,230,140,120,0,0,0,490
47551,170,100,120,80,160,320,950
47552,180,100,120,80,0,0,480
47553,210,180,120,80,0,0,590
47554,200,120,120,80,160,0,680
47555,190,100,120,80,160,320,970
47556,160,100,40,0,0,0,300
47557,160,60,120,160,160,320,980
47558,180,160,80,160,320,0,900
47559,190,160,160,80,160,0,750
47560,220,20,40,80,160,0,520
47561,210,160,120,0,0,0,490
47562,180,120,80,80,160,0,620
47563,210,160,120,160,320,320,1290
47564,220,140,120,160,160,0,800
47565,130,120,160,240,160,0,810
47566,220,160,200,0,0,0,580
47567,250,140,80,160,160,0,790
47568,200,200,160,0,0,0,560
47569,230,100,0,0,0,0,330
47570,210,140,120,80,160,320,1030
47571,180,160,120,80,160,0,700
47572,220,180,160,80,160,0,800
47573,180,120,80,80,0,0,460
47574,200,100,80,80,160,0,620
47575,190,60,80,80,160,320,890
47576,180,120,160,160,160,0,780
47577,210,120,40,0,0,0,370
47578,170,120,80,80,0,0,450
47579,200,120,80,0,0,0,400
47580,220,140,40,0,0,0,400
47581,130,160,80,160,320,320,1170
47582,200,80,40,80,160,0,560
47583,170,100,120,240,320,0,950
47584,210,80,120,160,320,320,1210
47585,180,180,80,80,160,0,680
47586,180,140,200,160,320,0,1000
47587,200,120,80,160,160,0,720
47588,170,80,40,0,0,0,290
47589,230,160,80,80,0,0,550
47590,200,140,80,80,0,0,500
47591,180,160,120,0,0,0,460
47592,200,140,120,160,160,0,780
47593,190,100,160,160,320,0,930
47594,220,160,120,0,0,0,500
47595,200,160,120,160,320,0,960
47596,220,160,160,240,160,0,940
47597,210,120,120,0,0,0,450
47598,220,100,120,80,160,0,680
47599,180,120,80,80,0,0,460
47600,210,140,40,0,0,0,390
47601,210,140,80,80,0,0,510
47602,180,100,40,80,160,320,880
47603,170,100,80,160,160,0,670
47604,190,120,120,160,160,0,750
47605,210,100,120,160,160,0,750
47606,170,80,160,80,160,320,970
47607,190,100,40,0,0,0,330
47608,180,120,80,0,0,0,380
47609,180,40,80,80,0,0,380
47610,180,100,40,80,160,320,880
47611,190,140,160,0,0,0,490
47612,180,140,120,80,160,0,680
47613,220,140,40,0,0,0,400
47614,190,180,160,80,160,0,770
47615,220,120,120,160,160,0,780
47616,160,100,120,80,160,0,620
47617,150,140,120,80,0,0,490
47618,160,120,120,80,0,0,480
47619,210,100,40,80,160,0,590
47620,170,160,0,0,0,0,330
47621,200,120,160,80,160,0,720
47622,190,160,240,160,160,0,910
47623,180,200,200,160,160,0,900
47624,200,120,160,80,0,0,560
47625,180,100,40,0,0,0,320
47626,250,140,80,80,160,320,1030
47627,230,80,160,160,160,0,790
47628,170,140,160,80,160,0,710
47629,170,120,80,80,160,320,930
47630,200,100,120,160,160,0,740
47631,190,160,160,240,320,320,1390
47632,200,80,40,0,0,0,320
47633,160,100,80,80,160,0,580
47634,200,80,80,160,160,0,680
47635,150,80,80,80,160,0,550
47636,180,180,160,160,0,0,680
47637,220,140,80,0,0,0,440
47638,230,180,120,160,160,0,850
47639,230,140,120,160,0,0,650
47640,210,140,120,80,160,0,710
47641,200,100,120,0,0,0,420
47642,250,180,200,80,0,0,710
47643,220,120,120,160,160,0,780
47644,200,120,120,160,0,0,600
47645,180,120,160,80,160,0,700
47646,200,120,40,80,160,0,600
47647,220,140,120,80,160,0,720
47648,210,100,80,80,160,320,950
47649,220,100,40,0,0,0,360
47650,220,100,160,160,160,0,800
47651,230,80,80,80,0,0,470
47652,170,100,80,80,0,0,430
47653,160,80,80,160,320,0,800
47654,200,120,160,160,0,0,640
47655,170,100,0,0,0,0,270
47656,190,180,160,240,320,0,1090
47657,210,120,80,80,0,0,490
47658,270,100,40,80,160,0,650
47659,190,140,80,160,160,0,730
47660,220,120,80,0,0,0,420
47661,200,100,160,80,160,0,700
47662,190,160,120,0,0,0,470
47663,200,100,120,160,320,0,900
47664,180,100,80,0,0,0,360
47665,180,80,80,0,0,0,340
47666,250,140,40,0,0,0,430
47667,200,120,160,80,160,0,720
47668,220,120,80,160,0,0,580
47669,210,60,40,80,0,0,390
47670,220,140,120,160,320,320,1280
47671,180,120,0,0,0,0,300
47672,170,120,80,0,0,0,370
47673,140,120,120,80,160,320,940
47674,210,140,120,80,0,0,550
47675,230,140,80,160,320,0,930
47676,190,80,120,160,320,320,1190
47677,190,100,40,80,0,0,410
47678,220,140,40,80,0,0,480
47679,190,100,80,0,0,0,370
47680,160,100,80,80,160,320,900
47681,200,160,200,160,0,0,720
47682,240,60,40,0,0,0,340
47683,190,60,80,80,160,320,890
47684,190,100,120,80,160,320,970
47685,190,120,80,80,160,0,630
47686,190,180,40,0,0,0,410
47687,190,160,160,160,160,0,830
47688,220,160,200,80,0,0,660
47689,220,100,0,0,0,0,320
47690,220,160,120,80,0,0,580
47691,200,140,80,80,160,320,980
47692,190,180,160,80,160,0,770
47693,210,180,120,0,0,0,510
47694,220,100,80,160,320,320,1200
47695,230,80,120,80,0,0,510
47696,200,80,80,160,320,0,840
47697,210,140,120,80,0,0,550
47698,160,120,120,240,160,0,800
47699,200,100,80,80,160,0,620
47700,210,140,200,160,160,0,870
47701,160,160,80,80,160,320,960
47702,210,120,80,0,0,0,410
47703,170,80,80,80,0,0,410
47704,150,160,80,160,160,0,710
47705,140,120,120,160,160,0,700
47706,210,100,160,160,160,0,790
47707,210,140,160,80,0,0,590
47708,200,120,120,160,160,0,760
47709,220,140,40,0,0,0,400
47710,210,200,160,80,160,320,1130
47711,190,140,80,0,0,0,410
47712,170,80,80,80,160,0,570
47713,160,100,40,80,160,0,540
47714,210,120,160,80,0,0,570
47715,220,120,40,80,160,0,620
47716,210,140,120,160,160,0,790
47717,200,140,160,160,160,320,1140
47718,200,100,80,80,0,0,460
47719,210,120,120,80,160,320,1010
47720,200,160,120,80,160,0,720
47721,240,100,80,80,0,0,500
47722,230,160,200,240,160,0,990
47723,190,120,40,80,160,320,910
47724,220,60,80,80,160,0,600
47725,190,120,160,160,0,0,630
47726,220,160,200,240,160,0,980
47727,190,180,120,160,160,320,1130
47728,170,100,120,0,0,0,390
47729,170,60,80,0,0,0,310
47730,220,140,160,160,160,0,840
47731,190,100,160,160,160,320,1090
47732,230,200,160,80,160,320,1150
47733,170,140,120,160,160,0,750
47734,200,100,120,0,0,0,420
47735,200,100,40,0,0,0,340
47736,220,100,80,80,160,0,640
47737,190,120,80,0,0,0,390
47738,200,120,120,80,160,0,680
47739,150,100,80,80,160,0,570
47740,200,80,120,80,0,0,480
47741,200,120,120,160,0,0,600
47742,180,80,40,80,160,0,540
47743,150,80,80,160,160,0,630
47744,220,180,160,240,160,320,1280
47745,180,80,80,80,160,0,580
47746,190,120,120,80,160,0,670
47747,190,120,120,80,160,0,670
47748,200,140,120,0,0,0,460
47749,170,60,40,0,0,0,270
47750,210,120,120,0,0,0,450
47751,180,140,40,80,0,0,440
47752,180,80,40,80,160,320,860
47753,180,80,80,80,0,0,420
47754,190,120,80,80,0,0,470
47755,220,100,40,80,160,0,600
47756,230,120,160,80,0,0,590
47757,200,140,40,80,160,0,620
47758,220,120,80,80,160,0,660
47759,210,100,120,80,160,0,670
47760,230,140,120,80,0,0,570
47761,180,100,40,80,0,0,400
47762,180,80,80,160,160,320,980
47763,170,60,80,80,0,0,390
47764,240,160,40,0,0,0,440
47765,210,180,120,160,160,0,830
47766,200,160,160,80,0,0,600
47767,190,120,120,80,0,0,510
47768,190,140,120,160,320,0,930
47769,220,140,160,240,160,0,920
47770,150,80,80,0,0,0,310
47771,200,60,0,0,0,0,260
47772,240,80,80,80,0,0,480
47773,210,140,120,80,160,320,1030
47774,200,140,120,160,160,0,780
47775,210,80,80,80,0,0,450
47776,190,140,80,80,0,0,490
47777,160,120,80,160,320,320,1160
47778,190,160,80,160,0,0,590
47779,210,120,80,80,160,320,970
47780,200,120,80,0,0,0,400
47781,190,100,80,80,160,0,610
47782,220,120,120,80,160,320,1020
47783,210,80,40,0,0,0,330
47784,200,140,120,160,160,0,780
47785,200,120,120,0,0,0,440
47786,180,80,80,160,160,0,660
47787,220,100,80,80,160,0,640
47788,200,140,160,160,0,0,660
47789,170,120,80,0,0,0,370
47790,210,120,200,240,0,0,770
47791,190,100,80,80,0,0,450
47792,190,100,80,0,0,0,370
47793,250,160,120,80,160,0,770
47794,230,100,120,160,320,0,930
47795,230,120,160,160,160,0,830
47796,170,140,120,80,160,320,990
47797,230,140,80,160,320,0,930
47798,230,120,120,160,160,0,790
47799,230,140,160,80,0,0,610
47800,210,80,120,80,160,0,650
47801,200,100,160,240,0,0,700
47802,260,200,120,80,0,0,660
47803,210,140,120,0,0,0,470
47804,180,120,160,240,160,0,860
47805,190,120,200,240,320,0,1070
47806,180,140,200,0,0,0,520
47807,210,120,120,160,320,0,930
47808,210,100,80,0,0,0,390
47809,250,160,160,160,160,0,890
47810,190,120,80,80,0,0,470
47811,180,160,200,160,160,0,860
47812,160,60,80,80,160,0,540
47813,220,120,40,80,160,0,620
47814,210,100,80,160,320,320,1190
47815,230,160,200,160,160,0,910
47816,190,120,0,0,0,0,310
47817,210,100,0,0,0,0,310
47818,170,160,120,160,320,320,1250
47819,230,180,80,160,160,0,810
47820,190,160,80,160,160,0,750
47821,150,100,120,160,320,320,1170
47822,210,120,80,160,160,0,730
47823,220,100,80,0,0,0,400
47824,210,100,40,80,160,0,590
47825,210,180,80,160,160,0,790
47826,170,80,40,80,0,0,370
47827,210,160,120,0,0,0,490
47828,170,100,80,0,0,0,350
47829,240,120,120,80,0,0,560
47830,210,160,200,240,160,320,1290
47831,190,120,40,0,0,0,350
47832,170,80,120,160,0,0,530
47833,170,100,120,160,320,0,870
47834,140,100,80,80,160,0,560
47835,170,100,120,80,0,0,470
47836,170,100,120,160,160,0,710
47837,160,140,120,160,320,0,900
47838,150,80,120,80,0,0,430
47839,210,180,120,80,160,320,1070
47840,220,180,120,80,160,320,1080
47841,210,100,40,80,0,0,430
47842,160,120,120,80,160,0,640
47843,230,140,80,160,160,0,770
47844,150,120,80,0,0,0,350
47845,160,60,40,80,160,0,500
47846,210,80,80,80,0,0,450
47847,210,120,120,80,160,0,690
47848,250,160,120,80,160,0,770
47849,210,160,80,80,160,0,690
47850,180,120,120,80,160,0,660
47851,200,60,40,80,160,0,540
47852,190,120,40,80,160,320,910
47853,210,160,120,240,160,0,890
47854,230,200,160,240,320,0,1150
47855,190,140,120,80,160,0,690
47856,170,100,120,160,160,320,1030
47857,170,100,40,80,160,0,550
47858,180,100,40,80,0,0,400
47859,180,140,120,80,160,0,680
47860,220,80,120,80,0,0,500
47861,210,100,120,80,160,320,990
47862,200,100,120,160,160,0,740
47863,170,140,80,80,160,0,630
47864,170,140,120,80,160,0,670
47865,180,100,40,80,0,0,400
47866,200,120,80,80,160,0,640
47867,170,160,120,160,160,0,770
47868,130,140,200,160,160,0,790
47869,180,100,80,160,320,320,1160
47870,130,40,40,80,0,0,290
47871,220,120,120,160,160,0,780
47872,210,180,200,0,0,0,590
47873,180,140,80,160,160,0,720
47874,170,140,160,80,160,0,710
47875,170,140,80,160,160,0,710
47876,180,180,160,160,160,320,1160
47877,210,140,80,160,0,0,590
47878,140,100,120,80,160,0,600
47879,210,100,120,80,0,0,510
47880,170,60,40,80,160,0,510
47881,190,100,80,80,160,0,610
47882,150,80,80,160,160,0,630
47883,210,80,160,160,160,0,770
47884,150,120,80,80,0,0,430
47885,170,120,120,0,0,0,410
47886,210,140,160,80,160,0,750
47887,180,60,40,0,0,0,280
47888,200,120,120,80,0,0,520
47889,210,80,80,80,160,0,610
47890,230,160,40,80,0,0,510
47891,210,140,40,80,0,0,470
47892,200,140,160,240,320,320,1380
47893,140,60,80,80,0,0,360
47894,180,140,160,80,160,0,720
47895,190,140,160,240,320,0,1050
47896,200,160,120,160,320,320,1280
47897,180,140,80,160,0,0,560
47898,200,160,80,80,160,0,680
47899,210,120,120,160,0,0,610
47900,170,100,160,240,160,0,830
47901,200,140,200,160,160,0,860
47902,160,60,40,80,160,0,500
47903,200,120,120,160,160,0,760
47904,200,120,120,0,0,0,440
47905,200,80,40,80,160,0,560
47906,220,80,80,80,160,0,620
47907,200,120,120,160,320,0,920
47908,190,100,80,0,0,0,370
47909,170,120,160,80,160,0,690
47910,170,100,80,0,0,0,350
47911,160,100,120,80,0,0,460
47912,170,100,80,160,320,0,830
47913,170,120,120,0,0,0,410
47914,210,140,160,80,160,0,750
47915,200,160,80,80,160,0,680
47916,200,120,160,160,0,0,640
47917,200,40,40,0,0,0,280
47918,190,100,120,160,160,0,730
47919,240,160,80,80,0,0,560
47920,230,120,40,80,160,0,630
47921,210,100,120,80,160,0,670
47922,180,100,160,80,160,0,680
47923,170,120,80,80,160,320,930
47924,180,140,80,80,0,0,480
47925,190,120,80,160,160,0,710
47926,220,120,160,240,160,0,900
47927,190,100,120,80,0,0,490
47928,200,180,80,0,0,0,460
47929,200,140,120,240,160,0,860
47930,190,120,40,80,0,0,430
47931,170,140,80,80,0,0,470
47932,160,120,80,80,160,0,600
47933,200,140,120,80,160,0,700
47934,200,220,160,160,160,0,900
47935,200,140,120,160,0,0,620
47936,250,140,80,160,160,0,790
47937,190,80,40,80,0,0,390
47938,210,120,120,160,160,320,1090
47939,210,120,80,80,0,0,490
47940,180,160,200,160,160,0,860
47941,200,120,160,160,320,0,960
47942,200,100,40,0,0,0,340
47943,180,140,80,80,160,0,640
47944,210,140,80,80,160,320,990
47945,180,120,0,0,0,0,300
47946,180,120,80,80,0,0,460
47947,220,140,160,160,160,320,1160
47948,210,140,120,160,160,0,790
47949,190,100,120,80,0,0,490
47950,150,120,160,160,160,0,750
47951,150,120,80,0,0,0,350
47952,200,60,120,0,0,0,380
47953,170,180,160,80,160,320,1070
47954,180,100,40,80,160,0,560
47955,210,160,160,160,320,320,1330
47956,200,160,80,80,160,320,1000
47957,200,40,80,80,0,0,400
47958,160,140,120,160,160,0,740
47959,190,140,80,160,160,0,730
47960,210,160,160,80,0,0,610
47961,180,120,120,80,160,0,660
47962,180,140,80,80,160,0,640
47963,190,100,120,80,160,0,650
47964,200,140,40,0,0,0,380
47965,190,160,160,80,160,0,750
47966,190,120,160,80,0,0,550
47967,190,140,120,0,0,0,450
47968,200,80,80,0,0,0,360
47969,180,80,160,160,160,0,740
47970,220,220,160,160,320,320,1400
47971,170,140,160,240,160,0,870
47972,110,40,40,80,0,0,270
47973,190,160,120,80,0,0,550
47974,170,100,120,160,320,320,1190
47975,170,100,120,80,160,320,950
47976,180,80,80,0,0,0,340
47977,180,60,40,80,0,0,360
47978,180,120,120,240,320,320,1300
47979,180,180,80,160,160,320,1080
47980,160,100,120,80,160,0,620
47981,230,120,120,160,160,0,790
47982,240,140,40,80,0,0,500
47983,180,160,240,80,160,0,820
47984,200,140,80,80,0,0,500
47985,200,100,80,0,0,0,380
47986,170,120,160,80,0,0,530
47987,190,140,40,80,0,0,450
47988,170,60,0,0,0,0,230
47989,200,140,120,80,160,0,700
47990,140,100,120,0,0,0,360
47991,200,120,80,160,160,0,720
47992,170,80,0,0,0,0,250
47993,190,160,160,240,320,0,1070
47994,210,80,80,160,320,0,850
47995,210,140,120,160,160,0,790
47996,190,120,80,160,320,320,1190
47997,180,120,160,160,160,0,780
47998,200,180,120,160,320,0,980
47999,210,160,40,80,0,0,490
48000,170,120,120,80,160,0,650
48001,170,160,160,160,160,0,810
48002,190,120,120,160,160,0,750
48003,190,140,120,160,0,0,610
48004,190,140,160,160,0,0,650
48005,240,120,80,160,0,0,600
48006,180,140,0,0,0,0,320
48007,150,120,40,0,0,0,310
48008,200,80,40,80,160,320,880
48009,160,80,80,160,320,320,1120
48010,190,120,160,160,0,0,630
48011,200,160,160,80,0,0,600
48012,180,160,40,80,160,0,620
48013,230,160,80,0,0,0,470
48014,160,80,160,160,160,320,1040
48015,200,140,40,0,0,0,380
48016,210,120,80,80,0,0,490
48017,200,60,80,80,160,0,580
48018,170,100,120,160,160,0,710
48019,190,100,120,160,320,0,890
48020,240,100,80,0,0,0,420
48021,180,100,80,80,0,0,440
48022,240,100,40,0,0,0,380
48023,200,120,80,160,320,0,880
48024,230,100,120,160,160,320,1090
48025,210,160,160,240,160,320,1250
48026,220,100,40,80,0,0,440
48027,150,140,120,80,160,0,650
48028,200,80,80,80,160,0,600
48029,160,160,120,0,0,0,440
48030,210,140,80,0,0,0,430
48031,200,160,120,160,320,0,960
48032,140,100,40,80,0,0,360
48033,170,120,120,160,320,0,890
48034,170,120,40,80,160,0,570
48035,180,80,40,80,160,0,540
48036,190,80,40,0,0,0,310
48037,180,120,80,160,160,0,700
48038,180,140,80,80,160,0,640
48039,200,100,160,160,0,0,620
48040,230,100,160,160,160,0,810
48041,240,200,160,160,320,0,1080
48042,180,100,160,80,0,0,520
48043,190,100,120,160,160,320,1050
48044,160,140,120,80,0,0,500
48045,220,140,80,160,160,0,760
48046,160,140,120,80,160,0,660
48047,150,120,160,240,320,0,990
48048,180,100,40,0,0,0,320
48049,190,80,80,80,160,0,590
48050,180,100,80,80,160,0,600
48051,200,140,160,160,160,320,1140
48052,190,120,120,160,0,0,590
48053,190,120,120,160,0,0,590
48054,130,80,160,160,0,0,530
48055,260,200,200,160,160,0,980
48056,230,180,80,80,160,0,730
48057,210,80,80,80,160,320,930
48058,150,60,40,0,0,0,250
48059,150,60,80,80,160,0,530
48060,190,160,120,80,160,320,1030
48061,220,160,160,240,160,320,1260
48062,190,120,120,0,0,0,430
48063,160,140,80,0,0,0,380
48064,210,140,40,80,160,0,630
48065,200,120,120,160,160,320,1080
48066,190,80,80,160,160,0,670
48067,160,80,120,80,160,0,600
48068,190,140,160,240,160,320,1210
48069,200,120,40,0,0,0,360
48070,210,160,80,80,0,0,530
48071,190,120,80,80,160,0,630
48072,180,80,120,240,320,320,1260
48073,170,80,80,160,160,0,650
48074,190,100,80,80,160,320,930
48075,210,120,120,0,0,0,450
48076,180,160,160,240,160,0,900
48077,190,100,160,80,160,0,690
48078,250,120,40,0,0,0,410
48079,180,60,40,80,0,0,360
48080,170,120,80,80,160,0,610
48081,180,140,120,80,0,0,520
48082,240,180,120,80,0,0,620
48083,250,160,120,80,160,0,770
48084,240,120,120,0,0,0,480
48085,200,180,200,160,0,0,740
48086,210,140,120,160,160,320,1110
48087,150,80,0,0,0,0,230
48088,200,140,160,160,160,0,820
48089,190,120,160,80,160,320,1030
48090,160,120,120,240,160,0,800
48091,190,120,80,0,0,0,390
48092,220,160,120,80,160,0,740
48093,200,140,120,160,320,0,940
48094,220,140,80,160,320,0,920
48095,210,100,80,0,0,0,390
48096,230,80,40,80,160,0,590
48097,220,80,80,160,160,0,700
48098,200,100,120,80,160,0,660
48099,190,160,200,80,0,0,630
48100,190,160,120,80,0,0,550
48101,210,60,80,80,0,0,430
48102,200,120,120,80,160,320,1000
48103,210,100,80,80,160,0,630
48104,190,100,80,160,0,0,530
48105,220,100,120,0,0,0,440
48106,170,160,80,0,0,0,410
48107,150,140,160,80,160,0,690
48108,190,140,160,240,320,0,1050
48109,220,120,80,80,160,0,660
48110,280,180,160,160,0,0,780
48111,190,140,160,160,160,320,1130
48112,150,80,120,160,160,0,670
48113,210,100,40,80,160,0,590
48114,180,60,0,0,0,0,240
48115,180,100,80,160,320,320,1160
48116,160,80,80,80,0,0,400
48117,170,120,120,80,160,0,650
48118,220,120,80,0,0,0,420
48119,230,120,120,80,0,0,550
48120,250,100,0,0,0,0,350
48121,190,140,80,160,0,0,570
48122,240,180,120,160,160,320,1180
48123,180,120,80,80,160,0,620
48124,210,220,160,80,160,0,830
48125,220,120,160,160,160,0,820
48126,190,140,80,80,160,320,970
48127,190,100,80,160,320,320,1170
48128,180,140,200,160,160,320,1160
48129,130,120,120,80,160,0,610
48130,180,140,120,160,160,0,760
48131,150,100,120,80,0,0,450
48132,170,140,120,160,160,320,1070
48133,170,120,160,160,160,0,770
48134,230,120,80,0,0,0,430
48135,230,180,160,80,0,0,650
48136,200,180,40,80,0,0,500
48137,190,160,160,80,160,0,750
48138,230,120,80,160,160,0,750
48139,210,200,200,240,320,0,1170
48140,210,160,120,80,0,0,570
48141,240,80,80,80,160,0,640
48142,180,100,80,0,0,0,360
48143,170,140,160,160,0,0,630
48144,170,60,40,80,160,320,830
48145,180,100,80,80,0,0,440
48146,200,140,120,160,0,0,620
48147,200,200,160,160,160,0,880
48148,210,100,40,80,160,0,590
48149,200,100,80,0,0,0,380
48150,150,80,80,80,160,0,550
48151,230,160,160,160,160,0,870
48152,160,100,40,0,0,0,300
48153,190,160,120,160,160,0,790
48154,180,100,40,0,0,0,320
48155,210,140,120,80,160,0,710
48156,200,80,120,240,160,0,800
48157,220,160,120,160,320,0,980
48158,220,120,80,0,0,0,420
48159,180,120,120,160,160,0,740
48160,180,140,80,160,160,0,720
48161,180,120,120,80,160,0,660
48162,180,100,160,240,160,0,840
48163,210,140,80,0,0,0,430
48164,190,140,80,80,0,0,490
48165,180,100,80,80,0,0,440
48166,190,120,80,0,0,0,390
48167,200,120,80,160,320,0,880
48168,230,160,80,80,160,0,710
48169,190,160,160,160,160,0,830
48170,180,120,200,160,0,0,660
48171,190,60,80,0,0,0,330
48172,220,120,160,80,0,0,580
48173,190,140,160,0,0,0,490
48174,250,140,120,80,160,0,750
48175,220,120,40,80,0,0,460
48176,210,180,160,80,160,320,1110
48177,170,160,120,160,160,0,770
48178,160,140,160,80,160,0,700
48179,180,100,120,160,160,320,1040
48180,240,140,80,80,160,0,700
48181,230,180,200,80,160,0,850
48182,190,120,160,80,160,0,710
48183,230,140,160,80,0,0,610
48184,170,140,120,0,0,0,430
48185,160,80,120,160,160,0,680
48186,180,60,80,80,0,0,400
48187,200,160,120,80,160,0,720
48188,170,100,120,160,160,320,1030
48189,170,60,80,80,160,0,550
48190,210,100,80,160,160,0,710
48191,210,120,120,160,160,0,770
48192,180,120,120,80,0,0,500
48193,190,160,200,160,160,0,870
48194,190,80,40,80,0,0,390
48195,190,100,40,0,0,0,330
48196,200,80,80,0,0,0,360
48197,220,160,120,0,0,0,500
48198,200,120,200,160,160,0,840
48199,180,80,120,160,0,0,540
48200,180,120,160,160,160,0,780
48201,220,100,40,0,0,0,360
48202,230,140,80,80,160,0,690
48203,160,100,40,80,0,0,380
48204,200,180,120,80,160,0,740
48205,210,120,40,80,160,0,610
48206,190,80,80,80,160,0,590
48207,190,100,80,160,0,0,530
48208,280,180,160,160,0,0,780
48209,220,140,80,80,160,0,680
48210,200,100,40,0,0,0,340
48211,170,100,120,0,0,0,390
48212,190,180,80,80,0,0,530
48213,180,160,120,0,0,0,460
48214,170,80,120,80,160,0,610
48215,170,100,80,0,0,0,350
48216,240,120,120,160,160,0,800
48217,200,140,160,160,160,320,1140
48218,160,140,120,80,160,0,660
48219,150,60,40,80,160,0,490
48220,190,100,160,160,160,320,1090
48221,190,200,160,240,0,0,790
48222,190,60,40,80,0,0,370
48223,170,80,40,0,0,0,290
48224,200,120,0,0,0,0,320
48225,170,120,120,160,160,0,730
48226,200,120,40,80,160,320,920
48227,200,80,40,80,0,0,400
48228,200,180,280,240,0,0,900
48229,200,140,120,160,160,0,780
48230,170,80,80,80,0,0,410
48231,200,80,120,80,0,0,480
48232,210,160,200,80,0,0,650
48233,210,120,120,80,160,320,1010
48234,170,100,80,80,0,0,430
48235,190,140,40,0,0,0,370
48236,240,160,200,80,160,0,840
48237,180,140,120,80,160,0,680
48238,210,140,160,160,0,0,670
48239,210,60,0,0,0,0,270
48240,190,140,120,0,0,0,450
48241,240,140,120,0,0,0,500
48242,240,120,120,0,0,0,480
48243,210,100,120,80,0,0,510
48244,190,80,80,160,160,320,990
48245,190,100,80,80,160,0,610
48246,210,140,80,80,0,0,510
48247,210,160,120,160,160,0,810
48248,160,140,80,80,160,0,620
48249,170,120,120,80,160,320,970
48250,220,100,120,80,0,0,520
48251,140,120,80,160,320,320,1140
48252,210,100,160,160,160,0,790
48253,160,100,120,240,160,0,780
48254,240,180,120,160,320,320,1340
48255,220,120,40,80,160,0,620
48256,190,120,80,80,160,0,630
48257,200,100,80,160,160,0,700
48258,210,120,120,80,160,0,690
48259,240,140,80,80,0,0,540
48260,210,140,120,80,160,0,710
48261,200,140,160,240,320,0,1060
48262,210,120,120,80,0,0,530
48263,170,140,80,160,160,0,710
48264,130,100,160,160,160,0,710
48265,200,160,120,160,320,0,960
48266,160,120,40,0,0,0,320
48267,180,180,160,80,0,0,600
48268,200,100,120,80,0,0,500
48269,190,120,80,0,0,0,390
48270,170,120,120,160,160,0,730
48271,230,100,120,80,0,0,530
48272,210,100,80,80,160,0,630
48273,170,140,160,80,160,320,1030
48274,200,120,120,0,0,0,440
48275,160,120,80,80,0,0,440
48276,180,80,80,0,0,0,340
48277,210,140,160,240,320,0,1070
48278,210,100,120,160,320,0,910
48279,220,180,120,160,160,320,1160
48280,210,120,120,160,160,0,770
48281,180,160,160,80,0,0,580
48282,190,140,160,80,160,0,730
48283,160,80,40,80,160,0,520
48284,230,180,120,80,160,320,1090
48285,210,100,80,160,0,0,550
48286,190,160,80,80,160,0,670
48287,210,120,120,160,160,320,1090
48288,150,60,80,80,0,0,370
48289,190,80,80,80,0,0,430
48290,220,120,120,80,160,0,700
48291,190,80,40,0,0,0,310
48292,210,120,120,80,0,0,530
48293,200,120,160,80,160,0,720
48294,190,60,80,0,0,0,330
48295,260,140,80,80,160,0,720
48296,220,140,120,0,0,0,480
48297,200,140,120,80,0,0,540
48298,180,120,160,160,160,0,780
48299,200,160,120,80,160,0,720
48300,180,100,80,80,160,0,600
48301,170,140,120,160,0,0,590
48302,210,100,80,0,0,0,390
48303,180,80,40,80,160,0,540
48304,190,100,80,160,0,0,530
48305,160,100,80,80,160,0,580
48306,190,100,80,80,160,0,610
48307,240,160,80,160,320,320,1280
48308,180,100,160,0,0,0,440
48309,170,160,160,160,0,0,650
48310,210,120,80,80,0,0,490
48311,200,80,120,160,320,320,1200
48312,180,100,120,80,160,0,640
48313,210,100,120,0,0,0,430
48314,160,100,40,0,0,0,300
48315,190,80,0,0,0,0,270
48316,190,120,40,80,160,0,590
48317,200,140,120,240,0,0,700
48318,200,200,240,160,160,0,960
48319,180,120,80,80,0,0,460
48320,220,180,80,0,0,0,480
48321,180,100,120,160,320,0,880
48322,200,180,80,80,0,0,540
48323,190,140,40,80,0,0,450
48324,220,200,80,0,0,0,500
48325,140,100,120,80,0,0,440
48326,190,120,40,0,0,0,350
48327,160,120,120,80,160,0,640
48328,190,120,40,0,0,0,350
48329,130,80,80,80,0,0,370
48330,190,120,120,80,160,0,670
48331,190,120,160,80,0,0,550
48332,200,60,40,0,0,0,300
48333,190,160,120,160,160,0,790
48334,180,160,80,0,0,0,420
48335,200,140,160,80,0,0,580
48336,220,140,0,0,0,0,360
48337,200,140,240,160,320,0,1060
48338,160,120,160,0,0,0,440
48339,190,120,80,160,160,0,710
48340,210,100,120,160,0,0,590
48341,190,100,40,80,160,320,890
48342,230,160,160,160,160,0,870
48343,170,100,160,80,160,0,670
48344,160,140,80,80,160,0,620
48345,220,100,80,80,0,0,480
48346,200,120,120,80,0,0,520
48347,230,120,80,80,0,0,510
48348,190,100,80,80,0,0,450
48349,140,160,120,80,0,0,500
48350,250,160,120,80,160,0,770
48351,220,140,80,0,0,0,440
48352,190,60,40,0,0,0,290
48353,180,140,120,80,0,0,520
48354,180,80,120,80,0,0,460
48355,240,180,200,160,320,0,1100
48356,200,160,120,0,0,0,480
48357,190,140,80,0,0,0,410
48358,190,180,160,160,160,0,850
48359,210,200,160,80,160,0,810
48360,210,100,120,160,160,0,750
48361,180,140,120,160,320,320,1240
48362,170,120,40,0,0,0,330
48363,200,200,120,80,160,0,760
48364,200,120,40,80,0,0,440
48365,150,100,120,80,0,0,450
48366,220,180,120,160,160,0,840
48367,190,160,80,160,160,320,1070
48368,200,160,160,240,160,0,920
48369,180,80,40,0,0,0,300
48370,200,120,120,80,0,0,520
48371,180,120,80,80,160,0,620
48372,180,140,40,80,160,0,600
48373,170,120,40,80,160,0,570
48374,210,100,80,160,320,0,870
48375,180,120,80,80,160,0,620
48376,200,160,80,160,320,0,920
48377,190,140,40,0,0,0,370
48378,200,140,120,80,160,0,700
48379,160,100,120,80,160,0,620
48380,190,160,160,80,0,0,590
48381,190,100,40,80,0,0,410
48382,210,80,80,160,160,0,690
48383,220,120,80,80,0,0,500
48384,190,140,80,0,0,0,410
48385,200,100,40,80,160,0,580
48386,200,180,80,160,0,0,620
48387,220,120,80,160,160,0,740
48388,190,80,40,80,0,0,390
48389,210,140,120,80,160,0,710
48390,130,60,80,80,160,0,510
48391,190,120,160,80,0,0,550
48392,180,80,120,160,320,0,860
48393,160,100,120,80,160,0,620
48394,170,80,120,80,0,0,450
48395,140,140,120,160,0,0,560
48396,190,140,120,160,320,0,930
48397,180,80,80,0,0,0,340
48398,180,100,120,160,160,0,720
48399,200,120,80,80,160,320,960
48400,190,120,40,0,0,0,350
48401,180,80,120,0,0,0,380
48402,160,140,80,80,0,0,460
48403,190,120,120,80,160,0,670
48404,210,100,80,0,0,0,390
48405,230,140,120,160,160,0,810
48406,190,140,120,160,320,320,1250
48407,170,100,40,80,160,0,550
48408,200,140,120,160,0,0,620
48409,180,120,160,80,0,0,540
48410,200,80,40,80,0,0,400
48411,220,100,80,80,0,0,480
48412,220,140,160,240,160,0,920
48413,170,120,120,0,0,0,410
48414,220,120,120,80,0,0,540
48415,230,120,120,80,160,0,710
48416,220,160,120,0,0,0,500
48417,160,140,160,320,320,0,1100
48418,220,180,160,160,320,0,1040
48419,200,140,120,80,160,0,700
48420,200,140,80,80,160,320,980
48421,200,120,160,80,0,0,560
48422,200,100,120,160,160,0,740
48423,170,100,120,160,320,320,1190
48424,210,140,120,80,160,320,1030
48425,180,100,120,0,0,0,400
48426,160,120,80,0,0,0,360
48427,200,100,120,80,0,0,500
48428,200,100,80,160,0,0,540
48429,200,140,200,160,160,320,1180
48430,200,140,160,160,0,0,660
48431,200,100,120,80,0,0,500
48432,140,100,160,80,160,320,960
48433,190,160,120,0,0,0,470
48434,230,140,80,0,0,0,450
48435,200,100,40,80,0,0,420
48436,190,180,120,160,160,0,810
48437,180,120,120,160,160,0,740
48438,220,160,80,0,0,0,460
48439,170,120,160,160,160,0,770
48440,240,160,40,0,0,0,440
48441,180,200,120,80,160,0,740
48442,130,80,80,80,160,0,530
48443,170,100,120,240,160,0,790
48444,200,140,120,160,160,0,780
48445,180,140,80,80,160,0,640
48446,210,160,160,160,160,0,850
48447,140,100,80,0,0,0,320
48448,190,180,120,80,160,0,730
48449,160,120,160,160,320,0,920
48450,160,140,40,80,160,0,580
48451,230,60,40,0,0,0,330
48452,210,80,80,160,320,0,850
48453,190,140,120,80,160,0,690
48454,240,120,120,160,160,0,800
48455,190,120,80,160,160,0,710
48456,170,60,80,0,0,0,310
48457,230,140,120,80,0,0,570
48458,180,120,40,0,0,0,340
48459,180,80,80,80,160,0,580
48460,150,100,80,80,0,0,410
48461,210,120,80,0,0,0,410
48462,230,140,80,80,160,0,690
48463,180,140,200,160,160,0,840
48464,180,120,120,80,160,0,660
48465,140,140,120,80,160,0,640
48466,190,140,80,160,320,0,890
48467,220,120,80,160,160,0,740
48468,210,140,80,80,160,320,990
48469,220,140,80,0,0,0,440
48470,170,120,160,80,0,0,530
48471,190,140,120,80,160,320,1010
48472,220,160,80,80,160,0,700
48473,210,140,200,160,160,0,870
48474,190,140,120,80,160,0,690
48475,190,120,160,160,160,320,1110
48476,200,140,200,160,160,0,860
48477,200,100,40,0,0,0,340
48478,230,160,160,0,0,0,550
48479,200,100,120,0,0,0,420
48480,160,100,80,80,0,0,420
48481,210,140,80,80,160,0,670
48482,150,140,160,80,160,0,690
48483,210,100,80,0,0,0,390
48484,210,120,40,0,0,0,370
48485,200,140,80,0,0,0,420
48486,200,80,120,240,320,0,960
48487,190,180,80,80,0,0,530
48488,170,140,200,80,160,0,750
48489,230,200,240,160,160,0,990
48490,190,120,80,80,160,320,950
48491,180,100,80,160,0,0,520
48492,170,120,160,160,160,0,770
48493,200,160,120,160,0,0,640
48494,230,40,40,80,0,0,390
48495,200,160,120,160,0,0,640
48496,210,200,120,240,160,0,930
48497,210,140,160,160,160,320,1150
48498,190,160,120,0,0,0,470
48499,180,100,120,80,0,0,480
48500,220,140,40,80,160,0,640
48501,180,160,160,0,0,0,500
48502,230,140,40,80,0,0,490
48503,190,100,80,0,0,0,370
48504,230,140,160,80,0,0,610
48505,200,120,80,160,320,320,1200
48506,190,100,120,80,160,0,650
48507,170,160,120,80,160,0,690
48508,190,140,120,80,160,0,690
48509,220,180,120,80,160,0,760
48510,170,140,40,80,160,0,590
48511,150,80,120,80,160,0,590
48512,170,160,120,160,160,0,770
48513,180,120,80,0,0,0,380
48514,170,140,200,240,320,320,1390
48515,200,100,40,80,0,0,420
48516,210,120,40,80,0,0,450
48517,200,80,160,160,320,0,920
48518,230,120,80,80,0,0,510
48519,170,80,80,160,160,0,650
48520,150,60,0,0,0,0,210
48521,180,140,160,80,0,0,560
48522,210,160,160,160,0,0,690
48523,240,140,160,240,320,0,1100
48524,190,140,120,0,0,0,450
48525,220,120,40,80,160,0,620
48526,140,140,80,80,0,0,440
48527,170,80,40,0,0,0,290
48528,200,80,40,80,160,0,560
48529,190,100,120,80,160,320,970
48530,210,100,40,0,0,0,350
48531,180,140,120,160,320,320,1240
48532,180,140,160,80,160,0,720
48533,180,120,40,80,160,0,580
48534,200,80,80,80,160,0,600
48535,180,120,80,160,0,0,540
48536,210,140,120,160,160,0,790
48537,200,80,80,80,160,0,600
48538,190,160,200,160,160,320,1190
48539,180,120,120,80,0,0,500
48540,190,160,120,80,160,0,710
48541,220,120,160,160,160,320,1140
48542,210,160,160,160,320,0,1010
48543,240,200,120,80,160,0,800
48544,180,160,80,0,0,0,420
48545,220,100,40,0,0,0,360
48546,190,140,0,0,0,0,330
48547,200,120,160,160,160,0,800
48548,190,120,80,160,160,0,710
48549,220,120,160,160,0,0,660
48550,220,160,160,160,320,0,1020
48551,190,100,80,0,0,0,370
48552,190,140,120,80,0,0,530
48553,160,120,80,80,160,0,600
48554,210,80,80,0,0,0,370
48555,220,140,160,80,0,0,600
48556,200,180,160,240,320,0,1100
48557,200,100,80,80,0,0,460
48558,170,140,160,160,160,320,1110
48559,170,120,120,80,0,0,490
48560,220,60,80,0,0,0,360
48561,170,100,120,160,160,320,1030
48562,200,120,120,160,0,0,600
48563,210,80,120,0,0,0,410
48564,230,160,40,0,0,0,430
48565,220,180,120,160,320,0,1000
48566,230,160,40,80,160,0,670
48567,150,80,80,80,160,0,550
48568,180,100,80,0,0,0,360
48569,220,160,200,160,160,0,900
48570,210,180,160,160,160,320,1190
48571,170,120,40,80,160,0,570
48572,190,160,120,240,0,0,710
48573,220,100,80,80,160,0,640
48574,230,180,120,160,160,0,850
48575,210,80,120,80,160,0,650
48576,180,120,80,160,0,0,540
48577,190,140,120,0,0,0,450
48578,200,160,200,160,160,0,880
48579,180,100,120,240,320,0,960
48580,220,140,40,0,0,0,400
48581,200,120,80,160,0,0,560
48582,190,80,40,0,0,0,310
48583,190,160,80,80,160,0,670
48584,210,160,160,240,160,320,1250
48585,220,100,80,80,160,0,640
48586,190,160,40,0,0,0,390
48587,180,100,120,160,320,0,880
48588,230,160,40,80,0,0,510
48589,190,120,120,80,160,0,670
48590,210,140,120,80,0,0,550
48591,180,100,80,160,320,0,840
48592,150,80,80,80,160,0,550
48593,180,80,40,80,160,0,540
48594,150,120,120,80,0,0,470
48595,230,120,40,80,0,0,470
48596,240,120,160,80,160,0,760
48597,230,160,120,80,160,0,750
48598,190,20,0,0,0,0,210
48599,210,140,120,160,160,0,790
48600,170,160,80,80,0,0,490
48601,220,140,80,80,160,320,1000
48602,170,120,80,0,0,0,370
48603,200,200,200,80,160,0,840
48604,170,120,120,0,0,0,410
48605,170,80,120,80,160,0,610
48606,230,100,40,0,0,0,370
48607,210,100,80,80,0,0,470
48608,210,120,80,80,160,0,650
48609,200,100,160,160,320,0,940
48610,200,80,120,80,160,0,640
48611,180,120,40,0,0,0,340
48612,210,160,160,240,320,0,1090
48613,210,160,120,160,160,0,810
48614,230,100,120,80,0,0,530
48615,190,120,80,80,160,0,630
48616,220,160,120,80,160,0,740
48617,150,80,120,80,0,0,430
48618,190,100,120,80,0,0,490
48619,180,80,120,240,320,0,940
48620,200,120,120,240,160,0,840
48621,210,120,120,240,160,0,850
48622,240,100,120,240,160,0,860
48623,170,100,160,240,160,0,830
48624,230,200,160,160,0,0,750
48625,200,160,200,80,0,0,640
48626,210,100,80,80,0,0,470
48627,220,140,120,160,0,0,640
48628,190,180,200,80,0,0,650
48629,200,120,80,80,0,0,480
48630,180,200,200,240,160,0,980
48631,190,180,200,80,160,0,810
48632,210,160,120,0,0,0,490
48633,210,180,80,80,160,0,710
48634,190,120,120,160,160,0,750
48635,180,80,120,160,320,0,860
48636,210,180,200,240,160,320,1310
48637,200,120,200,80,0,0,600
48638,190,80,80,80,0,0,430
48639,240,140,160,160,0,0,700
48640,170,80,80,0,0,0,330
48641,220,120,80,80,160,0,660
48642,170,80,40,80,160,0,530
48643,230,100,120,0,0,0,450
48644,200,160,120,0,0,0,480
48645,200,100,80,160,320,0,860
48646,190,120,80,160,160,0,710
48647,240,160,160,160,160,0,880
48648,180,160,40,80,160,320,940
48649,190,120,200,80,160,0,750
48650,210,160,120,160,160,0,810
48651,230,160,120,0,0,0,510
48652,170,120,80,0,0,0,370
48653,230,220,160,80,160,0,850
48654,220,120,120,80,160,320,1020
48655,210,140,80,80,160,0,670
48656,190,60,120,160,160,0,690
48657,170,140,40,80,160,0,590
48658,170,80,120,160,0,0,530
48659,200,140,120,0,0,0,460
48660,200,140,120,160,0,0,620
48661,200,140,160,80,0,0,580
48662,200,100,80,0,0,0,380
48663,160,80,40,80,0,0,360
48664,200,160,120,80,0,0,560
48665,200,100,40,80,160,0,580
48666,220,120,160,80,160,320,1060
48667,220,140,120,160,160,0,800
48668,180,160,160,160,160,0,820
48669,200,80,0,0,0,0,280
48670,210,140,80,80,160,0,670
48671,220,120,80,160,320,0,900
48672,150,120,160,240,0,0,670
48673,180,160,120,240,160,0,860
48674,200,100,120,0,0,0,420
48675,190,80,120,80,0,0,470
48676,230,180,120,0,0,0,530
48677,210,140,80,80,0,0,510
48678,190,60,40,80,0,0,370
48679,200,80,120,80,0,0,480
48680,160,140,160,160,160,0,780
48681,180,120,120,80,0,0,500
48682,210,100,160,160,160,0,790
48683,160,100,160,80,160,0,660
48684,220,160,80,80,160,0,700
48685,150,120,120,80,0,0,470
48686,180,140,160,160,320,0,960
48687,210,180,40,80,0,0,510
48688,240,180,200,240,160,0,1020
48689,200,100,200,160,160,0,820
48690,170,80,80,0,0,0,330
48691,190,160,80,80,160,0,670
48692,210,120,160,160,160,0,810
48693,240,140,120,160,160,320,1140
48694,230,100,80,80,0,0,490
48695,190,100,40,80,160,0,570
48696,210,120,160,160,160,0,810
48697,210,120,120,80,0,0,530
48698,190,120,120,80,0,0,510
48699,170,140,120,80,0,0,510
48700,200,120,200,160,160,0,840
48701,200,140,40,80,160,0,620
48702,210,120,120,160,160,0,770
48703,190,120,80,0,0,0,390
48704,200,100,80,80,160,0,620
48705,160,100,120,160,160,0,700
48706,230,120,120,160,160,320,1110
48707,210,60,120,80,160,0,630
48708,190,120,160,80,0,0,550
48709,200,120,160,80,160,0,720
48710,190,60,120,160,320,320,1170
48711,170,80,80,80,160,0,570
48712,200,120,120,0,0,0,440
48713,220,180,80,80,0,0,560
48714,220,140,120,160,320,320,1280
48715,180,120,80,0,0,0,380
48716,190,180,120,160,320,0,970
48717,190,60,0,0,0,0,250
48718,190,160,160,160,160,0,830
48719,240,160,120,80,0,0,600
48720,180,120,80,80,0,0,460
48721,230,160,120,0,0,0,510
48722,190,180,240,240,160,0,1010
48723,200,120,80,0,0,0,400
48724,180,80,40,80,0,0,380
48725,170,140,200,160,0,0,670
48726,210,80,80,80,160,0,610
48727,170,80,160,160,320,0,890
48728,210,180,160,80,160,0,790
48729,230,180,200,80,160,320,1170
48730,200,120,160,80,0,0,560
48731,190,100,80,160,320,0,850
48732,150,80,80,0,0,0,310
48733,170,80,80,0,0,0,330
48734,200,120,80,80,160,0,640
48735,220,100,80,80,0,0,480
48736,160,120,120,160,0,0,560
48737,200,120,120,160,320,0,920
48738,230,80,80,80,160,0,630
48739,210,120,0,0,0,0,330
48740,190,120,80,80,160,0,630
48741,230,120,80,0,0,0,430
48742,190,120,120,0,0,0,430
48743,200,120,160,160,160,0,800
48744,210,120,80,80,0,0,490
48745,170,140,120,80,160,0,670
48746,200,200,120,160,320,0,1000
48747,200,120,120,80,0,0,520
48748,210,160,200,160,160,0,890
48749,180,160,40,0,0,0,380
48750,200,200,200,160,160,0,920
48751,150,100,80,80,160,320,890
48752,190,100,80,80,160,0,610
48753,190,100,80,80,160,0,610
48754,200,120,160,80,0,0,560
48755,190,140,160,160,0,0,650
48756,190,80,40,80,160,0,550
48757,180,60,80,0,0,0,320
48758,190,120,120,160,160,0,750
48759,190,140,160,80,160,320,1050
48760,230,120,120,160,0,0,630
48761,210,120,160,160,0,0,650
48762,220,160,120,160,160,0,820
48763,190,120,40,80,0,0,430
48764,190,100,120,160,160,320,1050
48765,180,120,80,0,0,0,380
48766,180,40,40,80,160,320,820
48767,150,140,80,160,160,320,1010
48768,180,160,160,240,160,0,900
48769,150,60,80,160,320,0,770
48770,200,120,120,80,0,0,520
48771,180,120,120,80,160,0,660
48772,220,120,80,80,160,0,660
48773,170,120,120,160,160,0,730
48774,180,80,40,80,0,0,380
48775,240,160,160,240,160,0,960
48776,160,80,80,80,160,0,560
48777,180,80,40,80,160,0,540
48778,180,80,80,80,160,0,580
48779,210,120,40,80,0,0,450
48780,170,100,160,80,160,320,990
48781,170,80,40,0,0,0,290
48782,190,100,80,80,0,0,450
48783,200,60,80,0,0,0,340
48784,180,160,120,80,160,0,700
48785,160,80,120,160,0,0,520
48786,180,100,80,0,0,0,360
48787,190,100,120,80,160,0,650
48788,200,180,120,240,0,0,740
48789,190,140,160,160,0,0,650
48790,150,120,120,160,0,0,550
48791,200,60,80,160,160,320,980
48792,180,120,120,80,160,0,660
48793,200,100,80,80,0,0,460
48794,210,100,120,240,320,0,990
48795,180,120,160,240,160,0,860
48796,210,80,0,0,0,0,290
48797,160,120,80,80,0,0,440
48798,200,120,160,160,0,0,640
48799,230,120,40,80,160,0,630
48800,220,100,120,0,0,0,440
48801,170,140,160,240,320,0,1030
48802,190,160,80,0,0,0,430
48803,200,160,160,80,0,0,600
48804,160,80,40,80,160,0,520
48805,200,160,120,160,0,0,640
48806,200,160,80,160,320,0,920
48807,190,80,40,80,160,0,550
48808,160,140,160,80,0,0,540
48809,200,100,40,80,160,0,580
48810,240,140,120,80,160,320,1060
48811,230,140,120,80,0,0,570
48812,150,40,0,0,0,0,190
48813,200,120,80,160,160,0,720
48814,190,120,40,80,0,0,430
48815,160,80,40,80,0,0,360
48816,210,140,160,160,0,0,670
48817,170,100,160,160,160,0,750
48818,200,120,80,160,160,320,1040
48819,180,140,80,160,0,0,560
48820,180,140,40,0,0,0,360
48821,180,80,120,160,320,320,1180
48822,180,100,80,160,0,0,520
48823,180,120,120,80,0,0,500
48824,240,140,160,160,320,0,1020
48825,180,140,160,160,160,0,800
48826,200,160,120,80,0,0,560
48827,160,160,120,160,160,320,1080
48828,170,100,80,80,0,0,430
48829,210,100,120,80,0,0,510
48830,210,120,120,0,0,0,450
48831,200,160,120,160,160,0,800
48832,200,160,200,80,160,0,800
48833,230,160,160,80,0,0,630
48834,210,120,40,80,160,0,610
48835,230,180,160,240,160,0,970
48836,190,140,80,160,320,0,890
48837,180,120,160,80,0,0,540
48838,200,100,80,160,320,0,860
48839,190,140,120,160,320,320,1250
48840,150,140,120,0,0,0,410
48841,200,100,120,0,0,0,420
48842,210,160,40,80,0,0,490
48843,180,120,160,240,160,0,860
48844,170,140,120,160,160,0,750
48845,190,120,40,80,160,0,590
48846,180,80,0,0,0,0,260
48847,200,120,80,80,0,0,480
48848,200,120,120,0,0,0,440
48849,190,140,160,240,160,320,1210
48850,200,160,80,160,0,0,600
48851,210,120,120,80,160,0,690
48852,190,60,40,80,160,0,530
48853,180,100,80,0,0,0,360
48854,160,120,120,160,320,0,880
48855,230,160,40,0,0,0,430
48856,180,100,80,0,0,0,360
48857,190,80,40,80,0,0,390
48858,190,140,120,160,320,320,1250
48859,200,160,160,160,320,0,1000
48860,190,160,160,160,0,0,670
48861,190,120,120,80,160,0,670
48862,190,120,120,80,160,0,670
48863,200,100,120,240,320,320,1300
48864,210,140,80,80,160,0,670
48865,190,160,80,80,160,0,670
48866,210,120,80,160,0,0,570
48867,190,80,120,80,160,0,630
48868,190,120,120,160,320,0,910
48869,220,120,80,80,160,0,660
48870,190,140,80,80,160,0,650
48871,230,100,120,160,0,0,610
48872,190,160,120,160,320,0,950
48873,190,180,120,80,160,0,730
48874,200,100,120,80,160,0,660
48875,160,120,200,160,160,320,1120
48876,190,140,80,80,160,0,650
48877,230,100,40,0,0,0,370
48878,220,80,80,80,160,0,620
48879,170,120,80,80,160,0,610
48880,180,100,40,80,0,0,400
48881,200,120,80,80,0,0,480
48882,190,140,80,80,160,0,650
48883,170,100,120,160,0,0,550
48884,190,140,80,80,0,0,490
48885,190,180,200,160,160,0,890
48886,190,180,160,160,160,0,850
48887,200,80,40,0,0,0,320
48888,200,140,160,160,0,0,660
48889,190,120,120,80,0,0,510
48890,220,180,200,160,0,0,760
48891,160,120,80,80,0,0,440
48892,180,80,120,160,160,0,700
48893,210,140,80,80,160,0,670
48894,150,40,0,0,0,0,190
48895,160,80,80,160,160,0,640
48896,170,120,160,240,160,0,850
48897,230,160,120,80,0,0,590
48898,240,120,160,160,0,0,680
48899,180,140,160,240,320,320,1360
48900,190,120,80,160,160,0,710
48901,180,80,120,160,320,0,860
48902,220,100,160,160,160,0,800
48903,220,140,160,80,160,0,760
48904,200,140,160,0,0,0,500
48905,180,80,120,240,160,0,780
48906,200,120,80,80,160,0,640
48907,180,140,80,0,0,0,400
48908,200,160,80,80,0,0,520
48909,190,100,80,80,160,320,930
48910,190,100,80,80,160,0,610
48911,240,100,80,80,160,0,660
48912,220,60,40,80,160,0,560
48913,150,120,160,240,160,0,830
48914,210,80,120,240,160,0,810
48915,180,160,120,160,0,0,620
48916,170,80,80,0,0,0,330
48917,220,140,200,240,160,0,960
48918,180,120,120,80,160,0,660
48919,180,100,120,160,160,0,720
48920,190,60,40,80,160,320,850
48921,180,100,120,80,160,0,640
48922,220,140,160,160,0,0,680
48923,230,100,40,80,0,0,450
48924,210,140,200,160,320,320,1350
48925,210,140,40,0,0,0,390
48926,180,140,160,80,0,0,560
48927,220,80,80,80,160,0,620
48928,190,100,40,80,160,0,570
48929,220,140,80,80,0,0,520
48930,210,140,120,0,0,0,470
48931,170,120,80,160,160,0,690
48932,140,80,80,160,320,0,780
48933,190,140,120,80,160,0,690
48934,210,200,120,80,160,320,1090
48935,190,140,120,80,0,0,530
48936,220,200,80,160,0,0,660
48937,230,120,40,0,0,0,390
48938,180,140,160,160,160,0,800
48939,210,120,160,160,160,0,810
48940,180,120,80,80,160,0,620
48941,190,60,40,0,0,0,290
48942,190,20,0,0,0,0,210
48943,190,120,120,160,160,0,750
48944,210,100,80,80,0,0,470
48945,200,120,80,0,0,0,400
48946,170,100,120,80,160,0,630
48947,230,120,120,80,160,0,710
48948,170,100,120,160,0,0,550
48949,220,100,120,160,0,0,600
48950,200,140,120,0,0,0,460
48951,160,100,40,0,0,0,300
48952,220,80,0,0,0,0,300
48953,200,200,40,80,160,0,680
48954,260,100,80,80,0,0,520
48955,210,180,120,80,0,0,590
48956,210,140,160,160,160,320,1150
48957,210,120,160,160,160,0,810
48958,170,80,120,80,160,320,930
48959,200,200,240,160,0,0,800
48960,250,140,160,240,160,320,1270
48961,170,100,80,80,160,0,590
48962,180,60,120,240,320,320,1240
48963,190,80,40,0,0,0,310
48964,140,100,120,240,160,0,760
48965,190,140,80,80,160,320,970
48966,200,140,120,80,0,0,540
48967,210,140,80,160,160,0,750
48968,170,80,120,80,160,0,610
48969,220,80,40,80,160,320,900
48970,240,100,120,160,160,0,780
48971,180,140,80,160,0,0,560
48972,200,180,120,160,160,320,1140
48973,220,120,120,80,160,0,700
48974,180,60,80,80,0,0,400
48975,170,100,120,80,160,320,950
48976,160,100,120,80,160,0,620
48977,190,80,120,160,320,0,870
48978,180,180,160,160,320,320,1320
48979,180,120,80,80,0,0,460
48980,150,80,80,80,0,0,390
48981,180,120,80,160,0,0,540
48982,170,160,160,80,160,0,730
48983,190,80,120,160,160,0,710
48984,170,140,160,160,320,0,950
48985,190,120,200,160,160,0,830
48986,210,80,40,80,160,0,570
48987,160,120,120,160,160,0,720
48988,170,100,120,80,160,0,630
48989,240,160,120,80,0,0,600
48990,220,80,80,80,0,0,460
48991,190,100,80,160,320,0,850
48992,170,140,40,80,0,0,430
48993,220,120,120,80,0,0,540
48994,250,120,80,0,0,0,450
48995,200,140,160,80,0,0,580
48996,210,220,240,160,0,0,830
48997,180,80,80,80,0,0,420
48998,220,160,80,80,160,320,1020
48999,180,100,120,160,160,0,720
49000,180,120,160,160,320,320,1260
49001,200,100,40,0,0,0,340
49002,220,140,80,0,0,0,440
49003,200,140,80,80,0,0,500
49004,210,100,80,80,160,320,950
49005,160,80,120,160,0,0,520
49006,200,120,160,80,160,0,720
49007,190,140,80,80,160,0,650
49008,190,120,120,80,0,0,510
49009,200,60,80,0,0,0,340
49010,230,200,120,0,0,0,550
49011,210,140,120,80,0,0,550
49012,190,80,120,80,160,0,630
49013,190,100,80,0,0,0,370
49014,200,80,40,80,160,320,880
49015,170,140,80,80,160,0,630
49016,210,160,160,160,320,0,1010
49017,230,120,120,80,0,0,550
49018,200,100,80,80,0,0,460
49019,150,120,120,80,160,320,950
49020,230,140,120,80,0,0,570
49021,230,160,80,80,160,0,710
49022,230,120,40,0,0,0,390
49023,240,140,160,240,320,320,1420
49024,140,120,200,160,320,320,1260
49025,190,180,120,80,160,0,730
49026,230,160,160,80,160,0,790
49027,200,100,120,160,160,0,740
49028,190,60,0,0,0,0,250
49029,190,100,120,80,0,0,490
49030,180,140,120,160,160,0,760
49031,210,140,80,80,160,0,670
49032,170,140,160,240,320,0,1030
49033,190,60,40,80,160,0,530
49034,220,140,160,160,0,0,680
49035,210,140,120,80,0,0,550
49036,200,200,80,160,160,0,800
49037,220,80,80,160,160,0,700
49038,220,120,120,80,0,0,540
49039,250,60,40,80,160,0,590
49040,190,160,160,80,0,0,590
49041,190,80,80,80,0,0,430
49042,190,120,160,160,0,0,630
49043,210,100,80,160,160,0,710
49044,250,140,120,80,160,0,750
49045,170,80,80,80,0,0,410
49046,210,140,80,160,320,0,910
49047,200,80,80,0,0,0,360
49048,200,120,120,160,160,0,760
49049,230,120,160,160,160,0,830
49050,220,60,40,0,0,0,320
49051,200,100,80,80,0,0,460
49052,200,100,80,80,160,320,940
49053,210,100,120,80,0,0,510
49054,180,120,120,80,160,320,980
49055,210,80,80,80,0,0,450
49056,150,80,40,0,0,0,270
49057,210,140,80,160,0,0,590
49058,210,60,40,80,0,0,390
49059,180,100,40,0,0,0,320
49060,180,140,120,80,0,0,520
49061,220,160,120,160,320,320,1300
49062,230,140,80,80,0,0,530
49063,200,120,80,0,0,0,400
49064,220,120,40,80,160,0,620
49065,140,140,80,80,160,0,600
49066,190,160,120,160,160,320,1110
49067,140,60,120,240,320,0,880
49068,200,120,120,160,320,0,920
49069,220,120,80,80,160,0,660
49070,190,140,40,0,0,0,370
49071,210,100,80,0,0,0,390
49072,210,160,160,0,0,0,530
49073,160,80,120,160,160,0,680
49074,200,120,120,80,0,0,520
49075,240,140,120,0,0,0,500
49076,170,120,160,80,160,0,690
49077,180,100,80,80,160,0,600
49078,180,100,40,80,160,320,880
49079,170,80,80,80,160,320,890
49080,200,140,120,160,320,0,940
49081,260,140,120,80,0,0,600
49082,210,140,160,80,160,0,750
49083,200,120,120,80,160,320,1000
49084,220,180,160,80,160,0,800
49085,220,80,120,160,320,320,1220
49086,190,80,160,80,160,0,670
49087,220,100,80,0,0,0,400
49088,160,100,40,80,160,0,540
49089,230,140,160,160,160,0,850
49090,190,100,40,80,0,0,410
49091,200,80,120,0,0,0,400
49092,230,140,40,80,160,0,650
49093,180,100,80,160,160,0,680
49094,160,80,120,80,0,0,440
49095,150,80,80,160,320,320,1110
49096,200,120,160,80,160,0,720
49097,210,160,120,160,0,0,650
49098,180,120,80,80,160,0,620
49099,190,100,120,160,0,0,570
49100,190,140,120,80,160,0,690
49101,210,100,80,0,0,0,390
49102,190,120,40,80,160,0,590
49103,210,60,40,0,0,0,310
49104,160,120,120,160,160,0,720
49105,180,120,80,80,0,0,460
49106,200,80,40,80,160,0,560
49107,180,160,120,80,160,0,700
49108,210,80,80,80,160,0,610
49109,170,120,40,80,160,0,570
49110,230,140,120,80,0,0,570
49111,200,80,120,0,0,0,400
49112,210,140,120,80,160,0,710
49113,220,140,160,160,0,0,680
49114,210,100,120,160,160,0,750
49115,190,100,80,0,0,0,370
49116,200,120,120,160,160,320,1080
49117,180,80,40,0,0,0,300
49118,190,140,80,80,160,0,650
49119,230,160,40,0,0,0,430
49120,210,180,120,160,160,0,830
49121,140,60,80,80,0,0,360
49122,200,140,80,160,160,320,1060
49123,180,100,120,80,160,0,640
49124,210,100,80,80,0,0,470
49125,180,100,120,0,0,0,400
49126,220,120,120,160,160,0,780
49127,170,180,160,80,0,0,590
49128,190,140,40,80,160,320,930
49129,280,120,120,80,0,0,600
49130,220,160,160,80,160,0,780
49131,190,120,120,80,160,0,670
49132,250,180,120,80,0,0,630
49133,180,80,80,0,0,0,340
49134,190,140,160,80,160,320,1050
49135,200,120,40,80,160,320,920
49136,220,120,120,160,160,0,780
49137,180,120,160,160,0,0,620
49138,190,140,80,0,0,0,410
49139,210,120,80,160,320,0,890
49140,180,120,80,80,160,0,620
49141,200,120,80,0,0,0,400
49142,160,120,120,80,160,0,640
49143,230,160,80,80,160,0,710
49144,170,100,120,80,0,0,470
49145,200,140,120,160,320,0,940
49146,190,140,40,80,160,320,930
49147,200,140,80,160,320,0,900
49148,200,140,120,160,160,0,780
49149,170,80,120,240,0,0,610
49150,230,120,80,160,160,0,750
49151,170,100,80,80,160,0,590
49152,190,140,40,80,0,0,450
49153,180,120,160,240,320,0,1020
49154,210,140,80,0,0,0,430
49155,170,100,80,80,0,0,430
49156,140,160,160,80,0,0,540
49157,200,100,160,160,160,0,780
49158,220,140,80,80,0,0,520
49159,170,100,120,160,160,0,710
49160,190,100,80,80,0,0,450
49161,220,140,120,160,160,0,800
49162,220,180,200,80,0,0,680
49163,190,160,160,80,0,0,590
49164,220,160,40,80,160,0,660
49165,190,80,120,80,160,0,630
49166,200,80,120,160,160,320,1040
49167,210,140,200,80,160,0,790
49168,210,80,40,0,0,0,330
49169,200,120,160,80,160,0,720
49170,200,200,120,160,0,0,680
49171,140,40,40,0,0,0,220
49172,190,140,160,80,160,0,730
49173,210,80,120,80,0,0,490
49174,210,160,80,80,0,0,530
49175,220,140,80,80,0,0,520
49176,160,100,120,160,320,0,860
49177,190,160,160,80,160,0,750
49178,230,80,80,80,0,0,470
49179,230,160,160,160,320,0,1030
49180,180,140,160,80,0,0,560
49181,220,100,80,80,0,0,480
49182,200,100,120,160,0,0,580
49183,210,140,120,160,0,0,630
49184,230,120,80,160,160,0,750
49185,200,120,80,0,0,0,400
49186,150,100,120,80,160,0,610
49187,190,100,160,160,320,320,1250
49188,200,100,80,80,0,0,460
49189,170,100,40,80,0,0,390
49190,230,140,40,0,0,0,410
49191,210,140,160,80,0,0,590
49192,170,140,80,80,0,0,470
49193,190,140,40,80,0,0,450
49194,200,140,120,160,320,320,1260
49195,200,100,80,160,160,0,700
49196,180,120,120,160,160,0,740
49197,210,100,80,80,160,0,630
49198,240,100,120,80,160,0,700
49199,230,20,40,80,160,0,530
49200,170,120,160,80,0,0,530
49201,210,140,160,80,0,0,590
49202,240,120,80,160,160,0,760
49203,170,60,80,0,0,0,310
49204,200,140,200,240,160,320,1260
49205,210,140,80,80,160,0,670
49206,210,140,40,80,0,0,470
49207,170,80,80,80,160,0,570
49208,190,160,40,80,0,0,470
49209,170,80,80,80,160,320,890
49210,180,100,80,160,160,0,680
49211,170,120,120,80,160,0,650
49212,190,120,160,240,320,320,1350
49213,200,140,80,80,0,0,500
49214,170,100,40,80,0,0,390
49215,240,140,120,80,160,320,1060
49216,210,160,120,80,160,0,730
49217,180,140,0,0,0,0,320
49218,180,140,40,0,0,0,360
49219,210,100,80,160,320,320,1190
49220,190,60,40,0,0,0,290
49221,180,140,40,80,160,320,920
49222,220,100,120,80,160,0,680
49223,190,120,80,80,160,0,630
49224,180,100,120,160,0,0,560
49225,180,140,80,80,0,0,480
49226,170,80,80,80,160,0,570
49227,210,120,120,160,320,320,1250
49228,200,100,120,160,160,0,740
49229,210,140,80,0,0,0,430
49230,190,160,200,80,160,320,1110
49231,240,100,120,80,160,320,1020
49232,220,140,120,160,160,0,800
49233,190,120,80,80,160,0,630
49234,190,120,40,80,160,0,590
49235,200,140,200,80,160,0,780
49236,230,120,160,160,160,0,830
49237,220,60,80,160,160,0,680
49238,200,80,120,0,0,0,400
49239,190,120,120,240,0,0,670
49240,190,140,160,240,320,0,1050
49241,190,120,80,80,160,0,630
49242,220,120,120,80,160,0,700
49243,190,120,40,0,0,0,350
49244,190,100,80,80,160,0,610
49245,210,140,40,0,0,0,390
49246,180,100,160,80,0,0,520
49247,220,120,80,0,0,0,420
49248,200,200,200,80,0,0,680
49249,190,140,120,240,160,0,850
49250,170,140,120,160,160,0,750
49251,170,120,120,160,0,0,570
49252,180,80,120,0,0,0,380
49253,170,80,80,160,160,0,650
49254,180,140,80,80,160,0,640
49255,210,160,160,80,0,0,610
49256,170,120,160,160,0,0,610
49257,160,120,200,160,160,0,800
49258,160,80,80,160,160,320,960
49259,180,100,40,80,0,0,400
49260,210,140,120,160,160,320,1110
49261,210,200,120,80,160,0,770
49262,180,120,80,80,160,320,940
49263,210,120,120,160,160,0,770
49264,210,140,120,0,0,0,470
49265,150,120,120,160,160,0,710
49266,210,120,80,160,320,0,890
49267,220,180,80,80,160,0,720
49268,170,180,200,160,160,0,870
49269,200,140,120,240,160,0,860
49270,200,100,120,160,160,0,740
49271,160,80,80,80,160,0,560
49272,230,180,120,80,160,0,770
49273,200,140,120,160,160,0,780
49274,190,120,0,0,0,0,310
49275,200,100,120,160,160,0,740
49276,220,120,120,80,160,0,700
49277,200,120,40,0,0,0,360
49278,180,100,40,80,160,0,560
49279,200,140,200,240,320,320,1420
49280,190,140,160,160,160,0,810
49281,210,80,80,80,160,0,610
49282,210,140,160,160,0,0,670
49283,190,120,120,160,320,320,1230
49284,240,180,200,80,0,0,700
49285,210,80,80,80,160,0,610
49286,170,120,80,0,0,0,370
49287,180,180,200,0,0,0,560
49288,200,80,80,80,160,0,600
49289,240,80,80,80,160,320,960
49290,190,120,80,80,160,0,630
49291,160,120,80,160,320,0,840
49292,190,120,120,80,0,0,510
49293,210,120,80,80,160,0,650
49294,170,40,80,80,0,0,370
49295,210,180,120,0,0,0,510
49296,180,60,0,0,0,0,240
49297,200,120,80,80,0,0,480
49298,220,120,0,0,0,0,340
49299,170,160,160,80,160,0,730
49300,200,100,80,0,0,0,380
49301,220,120,120,80,0,0,540
49302,200,140,120,80,0,0,540
49303,180,140,120,160,0,0,600
49304,170,160,240,160,160,320,1210
49305,190,160,160,160,160,0,830
49306,190,120,120,80,160,0,670
49307,230,120,120,80,160,0,710
49308,200,100,80,80,0,0,460
49309,190,140,120,160,160,0,770
49310,180,80,80,160,160,320,980
49311,210,60,0,0,0,0,270
49312,190,80,120,80,160,0,630
49313,180,100,120,160,160,0,720
49314,180,160,120,80,160,0,700
49315,170,100,80,80,160,0,590
49316,170,120,80,160,160,0,690
49317,210,200,120,160,0,0,690
49318,190,100,120,160,160,0,730
49319,260,200,0,0,0,0,460
49320,180,120,120,160,320,0,900
49321,190,160,160,0,0,0,510
49322,170,120,160,240,0,0,690
49323,190,120,120,160,320,0,910
49324,170,80,80,160,160,0,650
49325,180,120,0,0,0,0,300
49326,190,140,120,240,0,0,690
49327,200,120,80,80,160,0,640
49328,210,80,120,160,160,320,1050
49329,180,120,160,80,160,0,700
49330,210,100,80,80,160,0,630
49331,180,120,160,160,0,0,620
49332,160,60,0,0,0,0,220
49333,230,140,120,160,320,0,970
49334,190,80,80,80,160,0,590
49335,190,100,80,80,160,320,930
49336,240,100,40,0,0,0,380
49337,210,80,120,240,320,0,970
49338,230,120,80,160,320,0,910
49339,160,140,120,160,160,0,740
49340,240,180,160,160,320,0,1060
49341,170,80,160,160,160,0,730
49342,170,140,120,80,0,0,510
49343,210,80,80,160,320,0,850
49344,180,160,200,240,160,0,940
49345,200,160,160,160,160,0,840
49346,200,100,160,160,320,320,1260
49347,230,120,80,160,160,0,750
49348,210,180,200,80,0,0,670
49349,190,60,80,80,0,0,410
49350,220,160,120,80,0,0,580
49351,190,100,120,80,160,0,650
49352,200,200,200,320,320,320,1560
49353,200,120,120,80,0,0,520
49354,230,160,160,80,0,0,630
49355,180,160,80,80,160,320,980
49356,190,100,120,0,0,0,410
49357,170,120,120,160,0,0,570
49358,190,160,160,240,320,320,1390
49359,240,140,40,80,160,320,980
49360,160,140,160,160,320,0,940
49361,230,160,80,0,0,0,470
49362,220,120,120,160,160,0,780
49363,190,120,80,0,0,0,390
49364,200,120,120,160,160,0,760
49365,210,160,200,80,160,0,810
49366,190,160,200,160,160,0,870
49367,210,180,40,80,160,0,670
49368,220,140,80,80,0,0,520
49369,160,80,40,0,0,0,280
49370,230,160,120,160,0,0,670
49371,230,100,80,80,160,0,650
49372,160,60,80,80,0,0,380
49373,210,140,80,80,160,320,990
49374,180,100,120,80,0,0,480
49375,170,100,40,80,160,0,550
49376,230,160,200,240,320,0,1150
49377,210,160,120,160,160,0,810
49378,180,120,160,240,160,320,1180
49379,220,140,120,0,0,0,480
49380,220,60,40,80,160,320,880
49381,210,140,80,160,160,0,750
49382,190,140,120,80,160,0,690
49383,150,60,40,80,0,0,330
49384,180,100,120,80,0,0,480
49385,210,80,80,80,160,0,610
49386,180,140,200,160,0,0,680
49387,170,80,80,80,160,0,570
49388,230,120,120,80,160,0,710
49389,130,60,80,80,160,0,510
49390,190,120,160,160,320,0,950
49391,160,120,160,80,160,320,1000
49392,180,80,0,0,0,0,260
49393,210,200,200,240,320,0,1170
49394,220,120,80,160,160,0,740
49395,230,120,160,160,160,0,830
49396,170,80,80,80,160,320,890
49397,190,80,40,80,160,0,550
49398,200,100,40,0,0,0,340
49399,200,80,80,160,160,0,680
49400,190,160,120,160,0,0,630
49401,220,140,80,80,160,0,680
49402,210,180,160,160,160,320,1190
49403,190,60,80,0,0,0,330
49404,150,100,40,80,160,0,530
49405,150,100,120,80,0,0,450
49406,200,120,80,0,0,0,400
49407,220,100,160,160,0,0,640
49408,210,140,120,80,0,0,550
49409,230,120,160,160,160,0,830
49410,200,120,80,0,0,0,400
49411,190,100,120,160,160,320,1050
49412,210,120,40,80,160,0,610
49413,210,100,40,80,160,0,590
49414,190,80,40,0,0,0,310
49415,220,140,80,80,160,0,680
49416,180,60,40,0,0,0,280
49417,210,160,200,160,160,0,890
49418,150,80,120,80,160,320,910
49419,220,100,40,80,160,0,600
49420,200,100,80,80,160,0,620
49421,190,120,120,160,320,0,910
49422,190,160,80,80,160,0,670
49423,200,140,160,80,0,0,580
49424,240,220,200,160,320,0,1140
49425,210,60,120,80,160,0,630
49426,210,100,120,80,160,0,670
49427,180,100,120,0,0,0,400
49428,190,100,160,80,0,0,530
49429,200,160,200,160,160,0,880
49430,180,120,120,80,160,0,660
49431,230,160,160,240,0,0,790
49432,220,100,80,0,0,0,400
49433,160,120,80,0,0,0,360
49434,190,140,200,160,160,0,850
49435,220,160,40,0,0,0,420
49436,220,120,120,80,160,320,1020
49437,200,60,80,160,0,0,500
49438,190,100,0,0,0,0,290
49439,200,80,80,80,0,0,440
49440,200,120,120,80,0,0,520
49441,230,160,120,80,160,0,750
49442,190,140,120,160,320,0,930
49443,200,100,120,0,0,0,420
49444,180,100,80,160,160,320,1000
49445,180,100,80,160,160,0,680
49446,190,120,80,80,0,0,470
49447,200,140,120,80,160,320,1020
49448,190,160,40,0,0,0,390
49449,190,100,80,80,160,0,610
49450,200,140,120,160,160,0,780
49451,210,100,120,80,0,0,510
49452,190,140,120,160,160,0,770
49453,240,120,160,160,160,0,840
49454,190,160,120,0,0,0,470
49455,210,120,40,0,0,0,370
49456,210,140,120,0,0,0,470
49457,200,140,200,240,320,0,1100
49458,200,100,160,160,160,0,780
49459,180,100,80,80,160,0,600
49460,220,100,120,80,0,0,520
49461,190,80,40,80,160,320,870
49462,190,160,120,80,160,0,710
49463,190,140,80,80,0,0,490
49464,250,100,80,0,0,0,430
49465,200,120,120,80,0,0,520
49466,230,120,80,80,0,0,510
49467,190,100,80,160,160,0,690
49468,200,120,160,80,0,0,560
49469,200,140,120,160,0,0,620
49470,230,100,80,160,160,0,730
49471,200,160,80,80,0,0,520
49472,170,180,160,160,160,0,830
49473,190,100,40,0,0,0,330
49474,220,160,160,0,0,0,540
49475,220,120,80,160,160,320,1060
49476,190,140,80,160,160,0,730
49477,200,160,120,80,0,0,560
49478,230,160,160,160,160,0,870
49479,250,220,200,0,0,0,670
49480,150,100,120,0,0,0,370
49481,210,120,40,80,160,0,610
49482,220,100,80,160,160,0,720
49483,200,120,160,80,160,0,720
49484,210,180,40,0,0,0,430
49485,220,120,120,160,0,0,620
49486,180,120,120,0,0,0,420
49487,180,120,120,160,320,0,900
49488,210,140,80,160,320,0,910
49489,190,100,120,80,160,0,650
49490,160,160,160,160,160,0,800
49491,160,100,80,0,0,0,340
49492,220,160,120,80,160,0,740
49493,200,120,80,80,0,0,480
49494,200,180,120,160,320,0,980
49495,210,40,0,0,0,0,250
49496,230,60,40,80,0,0,410
49497,220,160,160,80,160,0,780
49498,190,80,40,0,0,0,310
49499,190,100,80,80,160,0,610
49500,190,120,80,80,160,0,630
49501,220,100,40,80,0,0,440
49502,230,120,80,80,0,0,510
49503,250,180,160,160,160,0,910
49504,180,100,160,0,0,0,440
49505,170,140,160,160,320,0,950
49506,160,80,80,0,0,0,320
49507,190,100,80,160,320,0,850
49508,180,60,40,0,0,0,280
49509,190,140,160,160,320,0,970
49510,150,120,40,0,0,0,310
49511,220,200,160,160,160,0,900
49512,220,160,160,240,320,320,1420
49513,180,120,120,80,0,0,500
49514,200,140,160,240,320,320,1380
49515,170,140,80,80,0,0,470
49516,200,120,80,80,160,0,640
49517,210,140,120,160,320,320,1270
49518,210,140,120,80,0,0,550
49519,180,140,80,80,160,320,960
49520,160,100,80,80,160,0,580
49521,190,160,160,80,0,0,590
49522,220,180,240,160,320,320,1440
49523,200,40,0,0,0,0,240
49524,200,180,160,160,160,0,860
49525,160,120,40,0,0,0,320
49526,210,120,120,0,0,0,450
49527,180,160,200,240,160,0,940
49528,210,200,160,160,160,0,890
49529,170,140,200,240,320,320,1390
49530,220,120,120,0,0,0,460
49531,130,80,40,80,160,0,490
49532,180,60,80,80,160,320,880
49533,180,180,160,160,320,0,1000
49534,190,160,160,80,160,0,750
49535,200,80,0,0,0,0,280
49536,180,80,80,80,160,0,580
49537,190,100,80,160,320,0,850
49538,190,60,80,160,320,320,1130
49539,240,180,80,0,0,0,500
49540,200,120,40,80,160,0,600
49541,190,80,40,80,0,0,390
49542,180,100,40,80,160,0,560
49543,180,120,40,80,160,0,580
49544,220,60,0,0,0,0,280
49545,170,60,80,80,0,0,390
49546,190,100,80,80,0,0,450
49547,200,100,80,80,160,0,620
49548,160,80,80,160,0,0,480
49549,220,100,80,160,320,320,1200
49550,180,140,120,240,160,320,1160
49551,150,80,160,240,160,0,790
49552,220,120,120,160,160,0,780
49553,200,140,200,160,0,0,700
49554,190,100,120,160,320,0,890
49555,220,60,80,80,160,0,600
49556,200,100,40,0,0,0,340
49557,230,120,40,0,0,0,390
49558,210,160,160,160,320,0,1010
49559,170,80,40,80,160,0,530
49560,200,120,160,160,0,0,640
49561,220,120,80,80,160,0,660
49562,170,100,80,80,0,0,430
49563,250,140,40,80,160,320,990
49564,150,120,120,160,320,0,870
49565,190,60,80,80,160,0,570
49566,200,140,120,160,160,320,1100
49567,200,140,120,160,160,0,780
49568,250,160,160,240,160,0,970
49569,210,160,160,0,0,0,530
49570,230,140,120,80,0,0,570
49571,200,120,80,80,160,0,640
49572,170,80,160,160,0,0,570
49573,160,60,80,0,0,0,300
49574,180,120,200,160,160,320,1140
49575,210,100,120,80,0,0,510
49576,180,80,40,80,0,0,380
49577,200,80,40,0,0,0,320
49578,180,120,120,240,160,0,820
49579,210,140,120,240,320,0,1030
49580,190,160,160,160,0,0,670
49581,210,100,40,80,160,0,590
49582,230,100,80,80,0,0,490
49583,240,140,80,80,160,0,700
49584,150,160,200,240,320,0,1070
49585,180,100,80,80,160,320,920
49586,170,100,120,0,0,0,390
49587,190,180,120,80,0,0,570
49588,210,140,80,80,160,0,670
49589,180,200,80,0,0,0,460
49590,220,140,160,80,0,0,600
49591,200,180,160,80,160,0,780
49592,270,140,120,80,160,320,1090
49593,180,180,120,80,0,0,560
49594,190,120,120,80,160,320,990
49595,210,120,120,0,0,0,450
49596,190,160,160,160,0,0,670
49597,190,100,120,160,160,0,730
49598,240,100,120,160,160,0,780
49599,200,120,80,80,0,0,480
49600,190,160,120,160,320,320,1270
49601,170,100,80,80,160,0,590
49602,190,120,80,80,160,0,630
49603,200,60,80,160,160,0,660
49604,200,160,160,240,160,320,1240
49605,170,140,160,240,320,320,1350
49606,190,100,120,160,0,0,570
49607,200,140,160,160,0,0,660
49608,220,120,80,80,160,0,660
49609,220,100,80,80,0,0,480
49610,200,160,160,160,0,0,680
49611,200,140,160,160,160,0,820
49612,200,120,160,80,0,0,560
49613,220,120,80,160,160,0,740
49614,220,100,120,160,160,0,760
49615,210,80,40,80,160,0,570
49616,210,180,160,160,0,0,710
49617,180,80,80,80,0,0,420
49618,210,160,200,240,160,0,970
49619,220,160,120,160,160,0,820
49620,200,100,80,80,160,0,620
49621,220,120,80,160,160,0,740
49622,160,120,160,160,160,0,760
49623,230,100,80,80,160,0,650
49624,230,140,200,160,160,320,1210
49625,180,80,160,160,320,0,900
49626,210,120,120,0,0,0,450
49627,180,60,80,0,0,0,320
49628,160,100,80,80,160,0,580
49629,200,140,160,80,0,0,580
49630,230,140,120,80,0,0,570
49631,200,140,40,0,0,0,380
49632,180,160,200,240,320,0,1100
49633,210,80,40,0,0,0,330
49634,150,140,120,80,0,0,490
49635,160,120,120,160,160,0,720
49636,230,180,200,160,160,0,930
49637,180,100,200,160,0,0,640
49638,210,120,120,160,160,320,1090
49639,180,140,0,0,0,0,320
49640,210,140,40,80,160,0,630
49641,200,140,120,80,160,0,700
49642,220,100,120,160,0,0,600
49643,190,60,0,0,0,0,250
49644,200,120,160,160,160,0,800
49645,200,100,80,80,0,0,460
49646,230,140,80,80,160,0,690
49647,220,100,120,160,320,320,1240
49648,180,100,80,80,160,0,600
49649,220,160,80,160,320,320,1260
49650,210,80,120,160,0,0,570
49651,190,100,120,0,0,0,410
49652,230,160,160,240,160,0,950
49653,170,120,40,80,0,0,410
49654,180,60,40,80,0,0,360
49655,180,140,120,80,0,0,520
49656,220,80,80,80,160,0,620
49657,220,140,120,160,160,0,800
49658,230,180,120,160,160,0,850
49659,190,100,40,0,0,0,330
49660,180,160,120,80,160,0,700
49661,210,140,160,0,0,0,510
49662,240,180,160,160,0,0,740
49663,200,120,120,160,320,0,920
49664,220,100,80,160,160,0,720
49665,160,60,120,240,160,320,1060
49666,200,120,40,80,160,0,600
49667,190,100,120,80,0,0,490
49668,200,100,40,80,160,320,900
49669,230,120,120,160,160,0,790
49670,180,140,80,80,0,0,480
49671,180,100,120,80,160,0,640
49672,190,100,80,80,0,0,450
49673,230,180,120,240,320,0,1090
49674,170,80,80,80,0,0,410
49675,200,80,40,0,0,0,320
49676,210,100,120,160,160,0,750
49677,180,140,160,160,320,0,960
49678,170,180,160,160,160,0,830
49679,170,100,120,80,160,0,630
49680,180,120,120,160,160,320,1060
49681,190,180,160,160,320,0,1010
49682,190,140,160,160,160,0,810
49683,210,120,160,160,160,0,810
49684,180,100,80,80,160,0,600
49685,220,200,80,0,0,0,500
49686,190,100,80,160,160,0,690
49687,210,180,240,160,160,0,950
49688,200,180,200,160,320,320,1380
49689,200,120,120,240,160,0,840
49690,250,100,80,0,0,0,430
49691,190,200,160,80,160,0,790
49692,170,140,200,80,160,0,750
49693,200,120,120,160,160,0,760
49694,190,180,160,160,160,320,1170
49695,170,160,120,80,160,320,1010
49696,190,120,120,80,0,0,510
49697,210,140,200,80,0,0,630
49698,160,100,80,80,160,320,900
49699,220,160,120,80,160,0,740
49700,190,80,80,80,160,0,590
49701,220,100,80,0,0,0,400
49702,190,100,40,0,0,0,330
49703,210,160,40,0,0,0,410
49704,170,160,160,160,320,0,970
49705,210,160,120,0,0,0,490
49706,210,120,160,80,160,0,730
49707,210,80,40,0,0,0,330
49708,240,100,120,0,0,0,460
49709,190,120,120,80,160,0,670
49710,200,80,120,160,0,0,560
49711,200,140,80,0,0,0,420
49712,170,120,80,80,160,0,610
49713,180,120,80,160,160,0,700
49714,250,160,80,80,160,0,730
49715,210,140,80,80,0,0,510
49716,160,80,120,80,160,0,600
49717,180,100,120,80,160,0,640
49718,210,160,40,80,0,0,490
49719,200,100,80,0,0,0,380
49720,190,140,160,160,320,320,1290
49721,230,120,80,160,320,320,1230
49722,170,100,40,0,0,0,310
49723,240,160,240,240,160,320,1360
49724,180,140,160,0,0,0,480
49725,160,100,120,160,320,0,860
49726,240,100,120,160,160,0,780
49727,200,140,160,240,160,0,900
49728,190,140,120,80,0,0,530
49729,180,80,40,0,0,0,300
49730,200,80,80,80,160,320,920
49731,220,140,80,0,0,0,440
49732,210,140,120,160,160,0,790
49733,180,60,40,0,0,0,280
49734,190,140,80,160,0,0,570
49735,220,100,120,80,160,0,680
49736,210,120,80,80,0,0,490
49737,240,200,120,80,0,0,640
49738,200,120,160,0,0,0,480
49739,210,80,120,0,0,0,410
49740,160,120,120,240,320,0,960
49741,180,40,40,0,0,0,260
49742,230,160,160,160,160,320,1190
49743,220,100,40,0,0,0,360
49744,200,100,40,80,160,0,580
49745,230,140,160,160,160,0,850
49746,170,120,0,0,0,0,290
49747,230,120,120,160,160,0,790
49748,220,140,120,80,0,0,560
49749,200,120,80,160,320,320,1200
49750,200,160,120,240,160,0,880
49751,140,60,80,80,0,0,360
49752,200,120,160,160,160,0,800
49753,190,160,120,240,320,0,1030
49754,190,120,80,80,0,0,470
49755,150,120,120,160,160,0,710
49756,200,120,160,80,0,0,560
49757,210,140,160,0,0,0,510
49758,180,80,40,80,160,0,540
49759,210,180,80,80,0,0,550
49760,170,180,160,80,0,0,590
49761,180,100,80,160,320,0,840
49762,160,160,80,0,0,0,400
49763,230,140,120,80,160,0,730
49764,200,200,200,240,320,0,1160
49765,200,60,80,160,160,0,660
49766,180,140,120,160,0,0,600
49767,200,100,80,80,160,320,940
49768,170,80,120,160,0,0,530
49769,180,140,160,80,160,0,720
49770,190,140,120,80,160,0,690
49771,200,140,160,160,160,0,820
49772,210,120,160,80,160,320,1050
49773,190,40,40,0,0,0,270
49774,190,140,120,0,0,0,450
49775,180,100,120,80,160,0,640
49776,210,120,120,0,0,0,450
49777,210,120,80,80,0,0,490
49778,230,100,0,0,0,0,330
49779,180,80,120,80,160,0,620
49780,200,160,40,0,0,0,400
49781,220,100,80,80,160,0,640
49782,180,60,80,0,0,0,320
49783,200,80,80,80,160,320,920
49784,210,140,120,160,160,0,790
49785,230,100,80,80,160,0,650
49786,220,120,80,160,160,0,740
49787,230,180,280,80,0,0,770
49788,230,180,160,160,0,0,730
49789,210,100,120,240,160,0,830
49790,220,60,80,80,160,0,600
49791,210,80,80,80,160,0,610
49792,220,180,160,160,160,320,1200
49793,200,120,80,80,0,0,480
49794,210,160,120,160,160,320,1130
49795,190,160,80,80,160,320,990
49796,210,80,160,80,0,0,530
49797,200,180,160,240,0,0,780
49798,150,120,120,80,160,0,630
49799,180,120,80,0,0,0,380
49800,190,100,80,80,160,0,610
49801,230,100,80,80,0,0,490
49802,140,100,80,0,0,0,320
49803,170,160,80,80,0,0,490
49804,200,120,120,0,0,0,440
49805,180,120,80,160,160,320,1020
49806,200,120,40,0,0,0,360
49807,180,120,160,240,160,0,860
49808,210,120,120,160,160,320,1090
49809,200,140,120,160,320,320,1260
49810,180,60,80,160,0,0,480
49811,220,120,120,0,0,0,460
49812,200,180,160,80,160,0,780
49813,210,100,0,0,0,0,310
49814,200,100,80,0,0,0,380
49815,200,100,80,160,160,0,700
49816,160,60,40,0,0,0,260
49817,240,160,160,240,320,0,1120
49818,190,140,120,80,160,0,690
49819,200,160,120,80,0,0,560
49820,190,80,0,0,0,0,270
49821,190,140,40,80,160,320,930
49822,220,140,120,240,160,0,880
49823,190,140,120,160,160,0,770
49824,150,120,80,160,160,0,670
49825,190,60,40,80,160,0,530
49826,140,120,120,80,0,0,460
49827,200,160,160,160,320,320,1320
49828,200,140,120,160,320,0,940
49829,170,120,160,160,160,0,770
49830,190,40,0,0,0,0,230
49831,200,60,80,80,160,0,580
49832,220,80,40,80,0,0,420
49833,200,120,160,80,0,0,560
49834,200,100,40,80,160,320,900
49835,170,80,160,80,160,0,650
49836,210,140,80,80,160,0,670
49837,170,100,120,160,160,0,710
49838,210,120,160,160,160,320,1130
49839,240,120,120,160,320,0,960
49840,190,120,80,80,0,0,470
49841,170,120,200,160,160,0,810
49842,220,100,120,80,160,0,680
49843,160,120,80,80,0,0,440
49844,170,180,80,160,320,0,910
49845,160,100,40,0,0,0,300
49846,170,140,160,160,160,0,790
49847,210,40,40,80,160,0,530
49848,230,140,80,0,0,0,450
49849,190,100,40,0,0,0,330
49850,140,100,120,160,160,320,1000
49851,220,140,240,240,160,0,1000
49852,210,120,120,160,0,0,610
49853,180,140,80,0,0,0,400
49854,190,160,160,160,320,320,1310
49855,170,100,120,160,160,0,710
49856,220,120,0,0,0,0,340
49857,180,120,80,0,0,0,380
49858,160,140,120,160,160,0,740
49859,190,80,80,160,160,0,670
49860,200,180,160,0,0,0,540
49861,190,140,80,80,0,0,490
49862,190,100,120,160,160,320,1050
49863,230,160,120,160,160,0,830
49864,200,140,200,160,0,0,700
49865,190,140,120,80,160,0,690
49866,160,140,80,80,160,0,620
49867,200,100,120,0,0,0,420
49868,210,140,160,160,160,320,1150
49869,190,100,120,160,160,0,730
49870,210,120,120,160,0,0,610
49871,150,100,160,160,160,320,1050
49872,190,120,160,160,320,0,950
49873,190,160,120,160,160,0,790
49874,230,140,160,160,160,0,850
49875,190,120,80,80,160,0,630
49876,140,60,0,0,0,0,200
49877,190,120,120,160,320,0,910
49878,200,120,120,160,320,320,1240
49879,170,100,120,0,0,0,390
49880,150,160,80,80,0,0,470
49881,220,100,80,0,0,0,400
49882,220,200,120,240,320,0,1100
49883,250,140,160,80,160,0,790
49884,220,140,160,160,0,0,680
49885,190,80,80,80,160,0,590
49886,220,80,0,0,0,0,300
49887,190,100,120,80,160,0,650
49888,220,80,0,0,0,0,300
49889,190,180,200,160,320,0,1050
49890,150,120,80,80,0,0,430
49891,220,180,80,160,160,0,800
49892,220,140,160,80,160,0,760
49893,220,180,80,80,0,0,560
49894,200,140,80,0,0,0,420
49895,210,120,120,160,320,0,930
49896,220,180,120,0,0,0,520
49897,200,140,160,160,320,0,980
49898,230,140,80,80,0,0,530
49899,150,120,120,160,0,0,550
49900,210,140,160,0,0,0,510
49901,200,80,80,160,160,0,680
49902,210,180,120,80,0,0,590
49903,220,200,40,80,0,0,540
49904,160,140,120,0,0,0,420
49905,190,100,80,160,320,0,850
49906,190,120,80,80,160,0,630
49907,180,140,120,160,160,0,760
49908,160,100,40,0,0,0,300
49909,160,80,40,0,0,0,280
49910,150,60,80,80,160,0,530
49911,150,120,120,160,320,320,1190
49912,170,100,40,80,0,0,390
49913,200,140,160,160,320,320,1300
49914,180,140,120,160,160,0,760
49915,180,120,120,160,160,0,740
49916,190,100,120,80,160,0,650
49917,170,60,120,160,320,320,1150
49918,170,100,160,80,160,0,670
49919,150,120,160,240,320,0,990
49920,210,180,40,0,0,0,430
49921,170,120,120,80,0,0,490
49922,200,80,120,240,160,0,800
49923,220,160,120,160,160,0,820
49924,180,100,120,160,0,0,560
49925,200,120,80,160,160,0,720
49926,190,120,80,80,0,0,470
49927,200,160,160,160,160,0,840
49928,250,80,40,80,160,0,610
49929,200,140,160,160,160,0,820
49930,220,160,160,160,0,0,700
49931,220,100,120,80,160,320,1000
49932,220,140,160,240,0,0,760
49933,190,140,120,80,0,0,530
49934,170,100,80,80,160,320,910
49935,180,140,120,80,0,0,520
49936,200,80,160,0,0,0,440
49937,200,120,120,80,0,0,520
49938,190,60,40,0,0,0,290
49939,170,80,0,0,0,0,250
49940,190,80,80,80,0,0,430
49941,210,160,160,240,320,320,1410
49942,160,140,0,0,0,0,300
49943,160,100,120,0,0,0,380
49944,190,140,80,0,0,0,410
49945,210,160,160,80,160,0,770
49946,210,160,120,80,160,0,730
49947,200,160,200,80,0,0,640
49948,200,80,40,0,0,0,320
49949,180,140,120,160,0,0,600
49950,240,140,80,80,160,0,700
49951,210,160,160,160,160,0,850
49952,260,200,80,0,0,0,540
49953,220,140,120,0,0,0,480
49954,170,180,80,0,0,0,430
49955,170,160,120,80,160,0,690
49956,200,140,80,80,0,0,500
49957,140,100,80,80,160,0,560
49958,170,120,160,160,160,0,770
49959,210,120,160,240,320,320,1370
49960,200,80,80,80,0,0,440
49961,210,140,160,160,160,320,1150
49962,200,80,80,80,160,0,600
49963,260,180,160,160,160,0,920
49964,200,140,40,80,160,0,620
49965,180,160,120,80,160,320,1020
49966,210,140,120,160,0,0,630
49967,170,120,120,160,320,0,890
49968,220,140,120,160,160,320,1120
49969,210,120,0,0,0,0,330
49970,210,80,120,160,320,0,890
49971,160,140,120,160,0,0,580
49972,200,80,120,160,160,320,1040
49973,200,140,120,160,320,0,940
49974,190,160,80,0,0,0,430
49975,180,140,120,160,320,320,1240
49976,210,120,40,0,0,0,370
49977,180,60,40,80,160,0,520
49978,220,180,80,160,0,0,640
49979,140,80,80,80,160,320,860
49980,160,160,120,160,0,0,600
49981,190,120,160,80,160,0,710
49982,170,60,80,80,0,0,390
49983,220,140,120,80,160,0,720
49984,200,100,120,80,160,320,980
49985,160,40,40,0,0,0,240
49986,160,120,40,80,160,320,880
49987,140,40,40,0,0,0,220
49988,180,100,80,80,160,0,600
49989,180,100,80,80,160,0,600
49990,170,120,200,240,160,320,1210
49991,160,60,80,0,0,0,300
49992,220,100,40,80,160,0,600
49993,230,60,80,160,160,0,690
49994,170,180,160,160,320,0,990
49995,160,140,120,240,0,0,660
49996,160,80,120,0,0,0,360
49997,210,160,80,80,160,320,1010
49998,240,80,40,0,0,0,360
49999,210,180,160,160,160,0,870
50000,200,120,120,240,160,0,840
50001,200,100,80,80,0,0,460
50002,210,140,120,160,160,0,790
50003,200,80,80,80,160,0,600
50004,210,100,120,160,160,0,750
50005,160,60,0,0,0,0,220
50006,200,140,200,80,160,320,1100
50007,130,100,120,80,0,0,430
50008,200,120,80,80,160,0,640
50009,160,80,80,160,320,0,800
50010,190,140,120,160,160,0,770
50011,220,160,80,80,160,320,1020
50012,190,180,120,160,160,0,810
50013,220,140,160,160,320,0,1000
50014,230,140,120,80,160,0,730
50015,170,100,80,80,0,0,430
50016,210,160,120,80,160,0,730
50017,200,120,160,80,160,0,720
50018,180,120,80,80,160,0,620
50019,180,100,160,160,160,0,760
50020,200,100,120,80,0,0,500
50021,180,120,160,160,160,320,1100
50022,210,140,120,160,160,0,790
50023,160,120,120,160,320,0,880
50024,220,160,120,0,0,0,500
50025,170,80,40,0,0,0,290
50026,190,100,40,80,0,0,410
50027,140,120,160,160,160,320,1060
50028,220,180,120,160,160,0,840
50029,190,100,120,80,160,0,650
50030,180,80,40,0,0,0,300
50031,190,140,120,80,160,320,1010
50032,190,100,0,0,0,0,290
50033,200,120,120,80,0,0,520
50034,220,60,120,0,0,0,400
50035,210,140,80,160,160,0,750
50036,200,140,80,160,0,0,580
50037,200,140,160,160,160,0,820
50038,170,160,80,80,0,0,490
50039,200,120,80,0,0,0,400
50040,220,140,160,240,0,0,760
50041,180,100,40,80,0,0,400
50042,200,140,160,160,320,320,1300
50043,190,140,0,0,0,0,330
50044,160,100,80,0,0,0,340
50045,180,120,160,80,160,320,1020
50046,180,120,80,0,0,0,380
50047,150,80,160,80,160,0,630
50048,180,140,120,160,160,0,760
50049,200,160,120,160,160,0,800
50050,210,160,160,80,0,0,610
50051,180,120,160,160,160,0,780
50052,140,80,80,0,0,0,300
50053,190,160,160,80,0,0,590
50054,160,100,40,0,0,0,300
50055,180,180,120,80,160,0,720
50056,180,100,80,0,0,0,360
50057,180,100,120,80,0,0,480
50058,180,120,40,0,0,0,340
50059,200,120,40,80,160,0,600
50060,170,120,80,160,320,0,850
50061,200,60,40,80,160,0,540
50062,220,100,80,0,0,0,400
50063,220,120,120,80,0,0,540
50064,200,160,120,80,0,0,560
50065,190,100,80,160,320,0,850
50066,170,180,120,80,0,0,550
50067,200,160,200,80,0,0,640
50068,210,140,120,0,0,0,470
50069,210,120,80,160,160,320,1050
50070,210,160,160,80,160,0,770
50071,190,120,40,80,0,0,430
50072,240,140,160,240,320,0,1100
50073,210,180,160,160,0,0,710
50074,230,140,120,80,160,0,730
50075,210,140,80,80,0,0,510
50076,230,120,40,80,0,0,470
50077,210,120,160,160,160,0,810
50078,210,80,80,80,160,0,610
50079,200,160,120,160,320,0,960
50080,170,100,80,80,0,0,430
50081,190,100,40,0,0,0,330
50082,200,120,120,80,160,0,680
50083,230,100,120,160,160,0,770
50084,170,80,120,80,0,0,450
50085,200,120,80,160,0,0,560
50086,250,120,80,80,160,0,690
50087,210,120,120,160,160,0,770
50088,180,100,160,160,160,0,760
50089,190,100,40,0,0,0,330
50090,200,100,80,80,160,0,620
50091,220,120,160,160,160,0,820
50092,160,100,120,160,160,320,1020
50093,210,100,40,0,0,0,350
50094,190,160,160,160,0,0,670
50095,220,120,80,80,160,0,660
50096,200,80,40,0,0,0,320
50097,190,80,80,80,160,0,590
50098,210,160,200,240,320,0,1130
50099,240,180,160,160,160,0,900
50100,210,100,160,160,160,0,790
50101,180,180,120,80,0,0,560
50102,230,120,160,160,160,0,830
50103,200,140,40,0,0,0,380
50104,190,80,160,160,160,0,750
50105,200,80,80,80,160,0,600
50106,240,160,200,80,0,0,680
50107,230,100,40,0,0,0,370
50108,170,100,80,80,160,0,590
50109,160,100,80,0,0,0,340
50110,190,100,40,0,0,0,330
50111,220,140,160,240,160,0,920
50112,200,120,160,160,160,0,800
50113,250,120,40,80,160,0,650
50114,190,180,200,160,320,0,1050
50115,210,140,40,0,0,0,390
50116,200,80,80,160,160,0,680
50117,200,120,120,160,160,0,760
50118,180,140,80,160,0,0,560
50119,140,140,120,240,320,0,960
50120,180,120,120,160,320,320,1220
50121,180,100,80,160,0,0,520
50122,210,120,120,240,320,320,1330
50123,220,160,80,80,160,320,1020
50124,210,120,80,160,160,0,730
50125,210,120,80,80,160,0,650
50126,220,140,120,0,0,0,480
50127,160,80,80,80,160,0,560
50128,210,120,80,160,160,0,730
50129,140,120,160,240,320,320,1300
50130,200,100,80,0,0,0,380
50131,190,120,80,80,0,0,470
50132,190,80,80,0,0,0,350
50133,230,160,120,80,160,0,750
50134,170,140,80,160,160,0,710
50135,190,180,160,160,160,0,850
50136,240,140,160,80,0,0,620
50137,230,160,160,0,0,0,550
50138,220,120,80,160,320,0,900
50139,190,120,120,160,160,0,750
50140,160,160,120,80,0,0,520
50141,240,160,160,160,0,0,720
50142,180,80,160,80,160,0,660
50143,230,100,40,0,0,0,370
50144,210,120,120,80,160,0,690
50145,200,120,80,0,0,0,400
50146,180,140,40,0,0,0,360
50147,220,120,160,240,320,0,1060
50148,220,140,160,240,320,320,1400
50149,180,80,120,80,0,0,460
50150,180,100,120,160,160,320,1040
50151,180,120,160,240,160,0,860
50152,220,140,200,160,160,0,880
50153,170,120,120,160,320,320,1210
50154,210,140,120,0,0,0,470
50155,220,140,120,80,0,0,560
50156,180,160,40,0,0,0,380
50157,180,100,80,80,160,0,600
50158,200,120,120,160,0,0,600
50159,210,120,40,0,0,0,370
50160,210,140,80,160,320,0,910
50161,180,140,40,80,160,0,600
50162,180,100,160,80,0,0,520
50163,160,140,120,240,320,320,1300
50164,160,100,120,160,160,0,700
50165,190,140,80,80,160,320,970
50166,160,80,40,0,0,0,280
50167,170,80,80,80,160,0,570
50168,260,120,40,0,0,0,420
50169,210,120,120,80,0,0,530
50170,220,140,160,80,160,0,760
50171,160,100,0,0,0,0,260
50172,210,120,40,80,160,0,610
50173,200,240,160,160,0,0,760
50174,200,200,160,240,320,0,1120
50175,160,140,160,160,160,0,780
50176,220,120,160,80,0,0,580
50177,180,140,160,0,0,0,480
50178,200,140,80,0,0,0,420
50179,150,100,80,80,0,0,410
50180,180,100,80,160,160,320,1000
50181,220,200,80,80,0,0,580
50182,220,120,80,80,160,0,660
50183,160,160,160,80,0,0,560
50184,220,180,80,80,160,0,720
50185,150,160,200,240,0,0,750
50186,190,100,80,80,160,0,610
50187,190,60,40,0,0,0,290
50188,230,120,80,80,0,0,510
50189,200,180,120,80,160,0,740
50190,220,60,80,80,160,0,600
50191,180,120,80,160,320,0,860
50192,230,100,80,80,160,0,650
50193,190,100,120,80,0,0,490
50194,190,160,120,160,0,0,630
50195,220,160,200,80,160,0,820
50196,200,120,120,240,320,0,1000
50197,150,120,200,160,160,0,790
50198,230,180,120,160,160,0,850
50199,200,140,80,80,160,0,660
50200,220,140,120,80,160,0,720
50201,190,120,160,160,160,0,790
50202,200,140,80,80,0,0,500
50203,190,120,200,80,160,320,1070
50204,230,120,160,240,160,0,910
50205,150,80,160,80,160,0,630
50206,220,200,120,80,0,0,620
50207,170,120,160,160,160,0,770
50208,250,140,120,160,160,320,1150
50209,170,100,120,160,160,0,710
50210,200,120,160,80,0,0,560
50211,190,120,40,0,0,0,350
50212,210,100,40,0,0,0,350
50213,200,120,80,160,320,320,1200
50214,200,160,120,80,160,0,720
50215,170,80,40,80,0,0,370
50216,200,140,160,80,160,0,740
50217,160,140,200,160,160,0,820
50218,220,140,120,80,160,0,720
50219,160,60,80,80,160,0,540
50220,190,100,80,80,160,0,610
50221,210,80,80,160,320,320,1170
50222,220,120,80,80,160,0,660
50223,170,120,120,240,160,0,810
50224,140,100,160,80,160,0,640
50225,190,120,160,80,160,0,710
50226,180,100,120,160,160,0,720
50227,240,160,160,160,320,320,1360
50228,210,180,120,160,160,0,830
50229,210,120,40,80,0,0,450
50230,200,140,160,80,0,0,580
50231,200,180,80,80,0,0,540
50232,240,180,200,240,0,0,860
50233,190,80,120,80,0,0,470
50234,190,100,120,80,160,0,650
50235,160,60,80,80,160,320,860
50236,210,140,120,80,0,0,550
50237,190,120,80,80,160,0,630
50238,200,160,120,80,160,320,1040
50239,210,160,80,80,160,0,690
50240,170,100,0,0,0,0,270
50241,190,140,160,240,0,0,730
50242,200,140,160,240,320,320,1380
50243,170,100,120,80,160,0,630
50244,200,180,200,240,160,0,980
50245,180,140,120,160,160,0,760
50246,140,80,40,80,160,320,820
50247,220,120,120,80,0,0,540
50248,210,80,120,80,160,0,650
50249,190,80,80,80,0,0,430
50250,230,120,120,160,160,0,790
50251,230,120,80,0,0,0,430
50252,170,140,40,80,160,0,590
50253,210,160,160,80,160,320,1090
50254,200,100,80,80,0,0,460
50255,210,120,80,80,0,0,490
50256,220,180,160,240,320,0,1120
50257,190,100,40,80,0,0,410
50258,210,100,160,160,320,320,1270
50259,210,120,160,160,160,0,810
50260,170,40,40,0,0,0,250
50261,220,180,120,80,0,0,600
50262,200,100,160,80,160,320,1020
50263,210,120,160,240,160,0,890
50264,230,180,160,160,320,0,1050
50265,210,120,40,0,0,0,370
50266,230,160,0,0,0,0,390
50267,180,140,40,80,160,0,600
50268,160,80,40,80,160,0,520
50269,160,100,160,160,160,0,740
50270,230,100,120,80,160,0,690
50271,230,120,80,0,0,0,430
50272,180,120,120,80,0,0,500
50273,180,160,120,160,160,0,780
50274,210,120,80,0,0,0,410
50275,160,120,200,160,160,0,800
50276,220,140,80,80,160,320,1000
50277,200,120,80,160,160,0,720
50278,180,140,0,0,0,0,320
50279,220,80,80,80,160,320,940
50280,230,140,120,80,0,0,570
50281,170,80,80,80,160,0,570
50282,260,140,80,80,0,0,560
50283,220,140,120,160,0,0,640
50284,230,140,80,80,160,0,690
50285,180,140,80,80,0,0,480
50286,180,120,80,160,160,320,1020
50287,250,160,120,160,0,0,690
50288,170,120,80,160,160,0,690
50289,160,120,160,240,0,0,680
50290,190,120,120,160,320,0,910
50291,200,140,200,240,0,0,780
50292,180,140,120,80,160,320,1000
50293,200,80,80,0,0,0,360
50294,210,140,40,0,0,0,390
50295,180,60,80,80,160,0,560
50296,190,200,120,80,0,0,590
50297,210,40,40,80,0,0,370
50298,200,100,80,80,160,0,620
50299,210,100,120,80,160,0,670
50300,160,100,40,0,0,0,300
50301,180,120,120,160,320,0,900
50302,180,160,160,80,160,0,740
50303,180,180,160,80,0,0,600
50304,190,100,80,80,0,0,450
50305,200,160,80,80,160,320,1000
50306,190,140,80,80,0,0,490
50307,220,120,160,240,320,0,1060
50308,210,120,80,160,160,0,730
50309,220,120,80,160,160,0,740
50310,190,180,200,80,0,0,650
50311,190,100,120,160,160,0,730
50312,200,140,160,0,0,0,500
50313,180,160,120,0,0,0,460
50314,200,180,120,80,0,0,580
50315,170,80,80,160,320,0,810
50316,160,100,160,160,320,0,900
50317,180,120,160,160,160,0,780
50318,210,140,160,160,160,0,830
50319,180,80,80,160,320,0,820
50320,180,140,120,160,160,0,760
50321,220,140,120,80,0,0,560
50322,190,80,80,80,0,0,430
50323,230,140,120,160,0,0,650
50324,190,140,120,0,0,0,450
50325,230,120,120,160,320,320,1270
50326,200,60,40,0,0,0,300
50327,210,60,80,0,0,0,350
50328,210,80,40,80,0,0,410
50329,160,80,80,80,0,0,400
50330,210,120,120,0,0,0,450
50331,190,180,200,160,0,0,730
50332,210,100,80,0,0,0,390
50333,190,100,120,160,160,0,730
50334,220,100,40,80,0,0,440
50335,210,80,40,0,0,0,330
50336,200,140,80,80,0,0,500
50337,210,140,80,80,0,0,510
50338,200,140,80,0,0,0,420
50339,190,140,80,0,0,0,410
50340,190,120,80,160,0,0,550
50341,170,100,80,80,160,0,590
50342,190,140,120,160,160,0,770
50343,150,100,120,160,160,320,1010
50344,210,100,80,80,0,0,470
50345,210,160,160,80,0,0,610
50346,210,100,80,160,160,0,710
50347,170,80,80,80,160,320,890
50348,230,120,80,160,160,0,750
50349,230,200,240,160,0,0,830
50350,240,80,120,240,320,320,1320
50351,180,160,240,80,0,0,660
50352,220,120,0,0,0,0,340
50353,190,180,160,160,160,0,850
50354,190,120,40,80,0,0,430
50355,220,140,120,80,160,0,720
50356,210,100,40,80,0,0,430
50357,180,140,200,240,0,0,760
50358,210,80,120,160,160,0,730
50359,220,160,120,80,160,0,740
50360,180,100,120,160,160,0,720
50361,220,160,80,0,0,0,460
50362,180,160,120,80,160,0,700
50363,170,100,80,80,0,0,430
50364,200,160,120,160,160,0,800
50365,160,80,80,160,160,0,640
50366,200,120,80,80,160,0,640
50367,180,120,80,80,0,0,460
50368,200,140,160,80,0,0,580
50369,150,120,80,80,0,0,430
50370,180,80,120,160,160,0,700
50371,200,120,80,80,0,0,480
50372,210,160,120,80,0,0,570
50373,210,100,40,80,0,0,430
50374,190,80,80,80,160,320,910
50375,200,100,40,0,0,0,340
50376,210,160,80,80,160,0,690
50377,200,160,160,160,160,320,1160
50378,180,120,40,80,160,0,580
50379,190,120,80,160,160,0,710
50380,240,180,160,160,320,0,1060
50381,230,80,40,80,160,0,590
50382,200,140,120,160,0,0,620
50383,190,160,160,80,160,0,750
50384,190,140,120,80,0,0,530
50385,140,100,120,160,160,320,1000
50386,190,140,80,160,320,0,890
50387,170,140,160,160,320,320,1270
50388,210,140,200,240,160,0,950
50389,170,80,160,80,0,0,490
50390,190,100,80,80,160,0,610
50391,240,180,80,160,320,0,980
50392,210,120,80,0,0,0,410
50393,230,180,160,80,0,0,650
50394,220,160,120,240,0,0,740
50395,140,160,160,240,320,320,1340
50396,180,160,80,80,160,0,660
50397,170,120,120,80,0,0,490
50398,180,160,200,240,320,0,1100
50399,200,100,80,160,0,0,540
50400,210,180,240,160,160,0,950
50401,220,140,200,80,160,0,800
50402,190,120,80,160,0,0,550
50403,180,120,80,80,0,0,460
50404,210,180,80,160,160,0,790
50405,200,140,160,160,0,0,660
50406,230,120,80,80,0,0,510
50407,200,120,40,0,0,0,360
50408,160,80,120,80,160,0,600
50409,230,180,120,80,160,0,770
50410,180,60,40,80,160,0,520
50411,150,80,120,160,0,0,510
50412,260,180,80,160,160,0,840
50413,180,100,200,80,160,0,720
50414,160,80,80,80,0,0,400
50415,200,140,120,0,0,0,460
50416,200,140,80,80,0,0,500
50417,190,140,160,80,0,0,570
50418,190,140,160,160,320,0,970
50419,240,160,80,80,0,0,560
50420,190,140,160,80,0,0,570
50421,180,100,80,0,0,0,360
50422,200,100,80,160,160,0,700
50423,170,120,40,0,0,0,330
50424,190,80,160,80,0,0,510
50425,180,80,120,160,160,0,700
50426,190,120,40,80,160,0,590
50427,150,100,120,160,160,0,690
50428,230,120,80,80,0,0,510
50429,210,180,120,160,0,0,670
50430,180,140,160,240,160,0,880
50431,210,160,80,80,160,0,690
50432,170,120,120,160,0,0,570
50433,190,80,120,80,0,0,470
50434,200,100,120,80,0,0,500
50435,200,140,160,160,320,0,980
50436,200,100,120,80,160,0,660
50437,160,100,120,160,160,0,700
50438,200,120,80,160,320,320,1200
50439,140,100,0,0,0,0,240
50440,180,140,200,240,160,320,1240
50441,230,160,80,160,0,0,630
50442,190,120,120,160,160,320,1070
50443,200,120,40,80,0,0,440
50444,160,160,80,0,0,0,400
50445,200,120,120,240,160,0,840
50446,160,100,80,160,160,320,980
50447,170,140,120,80,160,320,990
50448,240,160,40,80,160,0,680
50449,200,140,120,80,160,0,700
50450,200,140,120,160,160,320,1100
50451,170,120,120,160,160,0,730
50452,200,60,80,80,160,320,900
50453,180,100,120,160,320,0,880
50454,210,100,40,80,160,320,910
50455,160,140,160,0,0,0,460
50456,190,100,160,160,160,0,770
50457,170,120,120,160,0,0,570
50458,200,180,120,80,0,0,580
50459,190,80,80,80,160,0,590
50460,190,160,160,80,160,320,1070
50461,140,140,120,80,0,0,480
50462,210,120,160,80,160,0,730
50463,190,140,160,80,0,0,570
50464,220,100,120,240,320,0,1000
50465,180,100,40,0,0,0,320
50466,210,120,120,160,160,0,770
50467,200,120,0,0,0,0,320
50468,160,120,160,80,160,320,1000
50469,160,140,160,80,160,320,1020
50470,210,100,120,160,160,0,750
50471,220,140,80,160,0,0,600
50472,210,100,80,160,160,0,710
50473,190,120,80,80,160,320,950
50474,200,140,40,80,160,0,620
50475,200,120,120,160,160,0,760
50476,210,140,80,0,0,0,430
50477,170,80,40,0,0,0,290
50478,210,140,120,80,160,0,710
50479,190,160,120,80,0,0,550
50480,190,120,80,0,0,0,390
50481,170,160,80,80,160,0,650
50482,200,100,80,160,0,0,540
50483,200,160,160,160,160,0,840
50484,210,200,120,80,160,0,770
50485,200,120,80,0,0,0,400
50486,200,160,80,160,160,0,760
50487,210,100,0,0,0,0,310
50488,200,100,80,80,160,320,940
50489,230,140,120,0,0,0,490
50490,210,100,40,80,160,320,910
50491,220,120,120,160,0,0,620
50492,160,80,120,80,0,0,440
50493,170,100,120,80,0,0,470
50494,220,80,40,0,0,0,340
50495,170,120,80,0,0,0,370
50496,180,140,120,80,160,0,680
50497,200,140,120,80,0,0,540
50498,190,100,40,80,160,0,570
50499,160,100,80,160,160,0,660
50500,230,160,160,240,320,320,1430
50501,250,160,80,80,0,0,570
50502,190,160,160,80,160,0,750
50503,200,100,160,80,160,0,700
50504,180,140,120,80,160,0,680
50505,190,140,80,0,0,0,410
50506,190,80,80,0,0,0,350
50507,200,100,80,80,160,0,620
50508,190,140,120,80,0,0,530
50509,230,180,160,160,0,0,730
50510,230,100,80,80,160,320,970
50511,180,100,120,80,160,0,640
50512,150,120,160,160,160,0,750
50513,210,80,40,0,0,0,330
50514,220,160,160,0,0,0,540
50515,240,120,80,80,160,320,1000
50516,190,100,80,160,320,320,1170
50517,180,120,120,160,320,0,900
50518,190,140,80,80,160,0,650
50519,210,140,160,80,160,0,750
50520,210,100,80,80,0,0,470
50521,150,60,80,160,160,320,930
50522,180,100,160,80,160,0,680
50523,180,60,40,80,160,0,520
50524,180,100,120,240,320,0,960
50525,210,100,40,80,160,0,590
50526,190,120,120,0,0,0,430
50527,180,120,80,80,160,0,620
50528,190,140,120,160,160,0,770
50529,190,140,160,240,160,0,890
50530,180,120,40,0,0,0,340
50531,260,100,40,0,0,0,400
50532,190,100,80,80,0,0,450
50533,210,100,80,80,160,0,630
50534,260,140,80,80,0,0,560
50535,170,80,80,0,0,0,330
50536,190,100,80,80,160,0,610
50537,200,120,120,80,160,0,680
50538,190,120,80,0,0,0,390
50539,190,80,80,80,0,0,430
50540,210,120,120,80,160,0,690
50541,170,140,200,160,160,0,830
50542,180,120,80,160,160,0,700
50543,210,140,160,160,160,0,830
50544,200,100,200,160,320,0,980
50545,160,100,80,80,160,0,580
50546,200,160,160,160,160,0,840
50547,210,100,120,80,0,0,510
50548,190,120,160,0,0,0,470
50549,200,100,120,160,160,0,740
50550,190,100,120,80,160,0,650
50551,170,120,120,80,0,0,490
50552,220,120,120,160,160,0,780
50553,230,140,80,0,0,0,450
50554,220,140,160,160,0,0,680
50555,210,120,160,160,160,0,810
50556,180,120,200,160,160,320,1140
50557,190,100,80,80,0,0,450
50558,220,100,80,80,160,0,640
50559,210,80,40,80,160,0,570
50560,240,140,80,80,160,0,700
50561,190,60,80,80,0,0,410
50562,180,160,120,160,160,0,780
50563,190,100,40,80,160,0,570
50564,180,100,40,80,160,0,560
50565,230,120,80,80,0,0,510
50566,180,160,40,80,0,0,460
50567,160,80,40,80,160,0,520
50568,200,160,120,160,0,0,640
50569,210,140,80,160,160,320,1070
50570,210,120,120,80,0,0,530
50571,140,120,80,80,160,320,900
50572,190,160,240,0,0,0,590
50573,200,80,120,160,160,0,720
50574,180,100,120,80,160,0,640
50575,160,80,120,160,0,0,520
50576,170,140,80,80,160,0,630
50577,190,140,80,160,320,320,1210
50578,180,180,200,240,0,0,800
50579,230,160,160,160,160,0,870
50580,170,160,120,80,0,0,530
50581,190,120,80,160,320,320,1190
50582,180,120,160,160,320,0,940
50583,190,140,160,160,320,0,970
50584,160,60,120,80,0,0,420
50585,200,120,80,160,160,0,720
50586,220,120,120,160,320,320,1260
50587,160,80,80,80,0,0,400
50588,180,100,0,0,0,0,280
50589,150,80,80,160,320,320,1110
50590,220,140,80,80,160,0,680
50591,230,120,160,160,160,320,1150
50592,210,140,0,0,0,0,350
50593,210,100,120,80,160,320,990
50594,210,100,80,80,160,0,630
50595,190,140,80,80,160,0,650
50596,200,100,120,160,0,0,580
50597,200,140,160,160,160,320,1140
50598,200,160,80,80,0,0,520
50599,230,140,120,80,0,0,570
50600,200,120,160,80,160,0,720
50601,160,140,120,160,320,320,1220
50602,200,100,40,80,160,0,580
50603,240,100,80,80,0,0,500
50604,170,80,120,240,320,0,930
50605,210,120,80,160,160,0,730
50606,220,200,160,80,160,0,820
50607,180,60,40,0,0,0,280
50608,120,180,120,80,0,0,500
50609,200,140,80,0,0,0,420
50610,220,180,120,80,160,0,760
50611,200,120,120,80,160,0,680
50612,190,120,80,160,160,320,1030
50613,170,100,40,80,0,0,390
50614,220,140,160,0,0,0,520
50615,210,160,160,160,160,0,850
50616,220,120,120,160,160,0,780
50617,210,120,40,80,0,0,450
50618,230,100,0,0,0,0,330
50619,200,160,80,0,0,0,440
50620,210,140,120,0,0,0,470
50621,170,60,40,80,160,0,510
50622,240,180,200,240,320,320,1500
50623,220,140,160,160,160,0,840
50624,190,160,80,80,160,320,990
50625,200,120,80,0,0,0,400
50626,200,140,160,240,160,0,900
50627,220,220,160,80,0,0,680
50628,180,120,160,80,160,0,700
50629,220,100,200,240,160,0,920
50630,230,120,120,160,320,320,1270
50631,200,120,80,80,0,0,480
50632,210,140,120,0,0,0,470
50633,170,60,120,80,160,320,910
50634,220,120,120,160,160,0,780
50635,160,120,80,0,0,0,360
50636,170,100,80,0,0,0,350
50637,190,140,80,0,0,0,410
50638,230,160,160,80,160,0,790
50639,180,120,80,80,160,320,940
50640,150,140,120,160,0,0,570
50641,180,60,40,0,0,0,280
50642,180,120,80,80,160,0,620
50643,220,120,80,80,0,0,500
50644,200,80,120,80,160,0,640
50645,180,140,40,0,0,0,360
50646,190,160,160,240,320,320,1390
50647,170,120,120,160,160,0,730
50648,200,120,160,160,0,0,640
50649,170,140,120,0,0,0,430
50650,180,180,200,80,0,0,640
50651,230,80,40,0,0,0,350
50652,210,200,120,80,160,0,770
50653,170,80,120,160,320,0,850
50654,170,100,120,160,160,320,1030
50655,240,120,200,240,160,0,960
50656,200,120,160,160,320,320,1280
50657,170,100,80,0,0,0,350
50658,210,100,0,0,0,0,310
50659,160,120,160,160,320,0,920
50660,220,100,80,0,0,0,400
50661,180,80,80,160,0,0,500
50662,190,120,160,80,160,320,1030
50663,210,180,240,240,160,320,1350
50664,200,100,80,160,320,0,860
50665,220,180,80,80,0,0,560
50666,200,140,80,160,160,0,740
50667,210,140,160,80,0,0,590
50668,140,60,80,80,160,0,520
50669,190,160,80,0,0,0,430
50670,180,140,160,160,0,0,640
50671,160,160,120,80,160,0,680
50672,170,140,120,160,160,320,1070
50673,140,100,120,80,0,0,440
50674,190,100,80,0,0,0,370
50675,190,160,80,160,160,0,750
50676,190,120,40,80,160,0,590
50677,190,180,120,80,160,0,730
50678,160,100,80,0,0,0,340
50679,160,120,80,80,160,0,600
50680,200,140,40,0,0,0,380
50681,210,140,200,160,160,0,870
50682,190,80,80,0,0,0,350
50683,210,160,160,240,320,0,1090
50684,190,140,80,80,160,0,650
50685,220,60,80,160,320,320,1160
50686,200,120,80,160,160,320,1040
50687,120,40,40,0,0,0,200
50688,200,160,160,0,0,0,520
50689,190,180,200,80,160,0,810
50690,210,140,160,80,160,0,750
50691,200,180,200,160,160,0,900
50692,200,140,80,160,320,320,1220
50693,200,140,120,160,0,0,620
50694,200,120,80,80,160,0,640
50695,200,160,120,0,0,0,480
50696,180,40,0,0,0,0,220
50697,220,180,120,0,0,0,520
50698,180,80,40,80,0,0,380
50699,210,120,120,80,160,0,690
50700,200,160,160,160,160,0,840
50701,140,100,120,80,160,0,600
50702,180,80,40,80,160,0,540
50703,190,140,80,80,0,0,490
50704,210,100,120,160,0,0,590
50705,170,120,120,80,0,0,490
50706,180,120,40,80,160,0,580
50707,220,120,120,80,0,0,540
50708,190,140,120,160,160,0,770
50709,200,140,80,160,160,0,740
50710,180,80,80,0,0,0,340
50711,200,120,80,0,0,0,400
50712,160,100,120,160,0,0,540
50713,210,120,120,80,0,0,530
50714,220,140,120,160,160,0,800
50715,220,100,120,240,320,320,1320
50716,230,120,80,80,160,0,670
50717,200,100,80,0,0,0,380
50718,220,120,120,160,320,0,940
50719,130,60,40,80,160,0,470
50720,200,120,120,80,160,0,680
50721,190,140,160,80,0,0,570
50722,170,120,80,160,160,0,690
50723,160,140,80,80,0,0,460
50724,210,180,80,80,160,0,710
50725,180,140,120,0,0,0,440
50726,220,140,120,160,160,0,800
50727,150,80,120,160,320,0,830
50728,260,140,120,160,160,320,1160
50729,210,140,40,80,0,0,470
50730,200,140,80,80,160,0,660
50731,200,100,120,160,160,0,740
50732,230,160,120,160,0,0,670
50733,170,60,80,0,0,0,310
50734,210,140,80,160,0,0,590
50735,200,200,240,160,160,0,960
50736,200,140,160,160,160,0,820
50737,180,100,80,160,320,320,1160
50738,160,60,80,80,0,0,380
50739,200,100,40,0,0,0,340
50740,160,80,120,80,0,0,440
50741,220,120,40,0,0,0,380
50742,200,120,160,80,160,0,720
50743,190,80,40,80,160,0,550
50744,150,100,80,80,0,0,410
50745,240,80,40,0,0,0,360
50746,210,140,40,0,0,0,390
50747,180,140,160,0,0,0,480
50748,200,160,160,0,0,0,520
50749,190,100,80,160,160,0,690
50750,200,160,120,160,320,320,1280
50751,180,180,80,80,0,0,520
50752,230,80,40,80,160,0,590
50753,170,100,80,0,0,0,350
50754,210,160,120,160,160,0,810
50755,170,200,160,240,320,320,1410
50756,190,80,80,0,0,0,350
50757,200,120,160,240,320,320,1360
50758,190,120,80,80,0,0,470
50759,190,160,160,240,320,320,1390
50760,230,140,160,160,160,0,850
50761,170,60,80,0,0,0,310
50762,220,120,120,80,0,0,540
50763,210,180,120,80,0,0,590
50764,230,120,80,80,0,0,510
50765,190,80,80,160,320,0,830
50766,150,80,80,80,0,0,390
50767,220,160,80,80,160,0,700
50768,210,180,160,160,160,0,870
50769,210,120,40,80,160,320,930
50770,180,120,80,80,0,0,460
50771,190,100,120,160,160,0,730
50772,220,140,80,80,160,0,680
50773,160,60,80,80,0,0,380
50774,230,180,120,80,160,320,1090
50775,200,120,120,160,0,0,600
50776,240,100,160,80,160,0,740
50777,160,80,40,0,0,0,280
50778,240,100,120,80,160,0,700
50779,230,180,120,160,160,0,850
50780,250,100,120,160,320,320,1270
50781,160,80,80,80,0,0,400
50782,190,100,160,160,160,320,1090
50783,170,80,120,80,0,0,450
50784,190,140,160,160,160,320,1130
50785,230,160,120,80,160,0,750
50786,190,100,120,160,160,0,730
50787,200,100,80,80,160,0,620
50788,240,180,160,80,160,0,820
50789,170,140,160,80,0,0,550
50790,130,100,160,240,320,320,1270
50791,200,120,0,0,0,0,320
50792,180,140,80,80,0,0,480
50793,190,100,160,160,0,0,610
50794,180,120,80,80,0,0,460
50795,230,80,80,0,0,0,390
50796,210,80,160,80,160,0,690
50797,220,100,80,160,160,0,720
50798,200,80,40,80,0,0,400
50799,210,120,80,80,160,0,650
50800,220,140,40,0,0,0,400
50801,180,120,120,80,0,0,500
50802,200,160,160,240,0,0,760
50803,220,180,120,80,160,0,760
50804,160,140,120,160,160,0,740
50805,190,120,120,160,160,0,750
50806,160,100,160,80,160,0,660
50807,230,120,120,80,160,0,710
50808,210,120,160,160,320,0,970
50809,250,160,120,160,160,0,850
50810,220,160,0,0,0,0,380
50811,200,100,120,0,0,0,420
50812,210,120,120,0,0,0,450
50813,200,140,80,160,160,0,740
50814,210,160,120,160,160,0,810
50815,170,100,120,160,160,0,710
50816,200,160,160,160,160,320,1160
50817,180,100,120,0,0,0,400
50818,190,140,120,80,160,0,690
50819,160,120,120,160,160,0,720
50820,180,140,120,160,160,0,760
50821,200,140,120,80,160,0,700
50822,190,100,80,80,0,0,450
50823,180,120,160,160,160,0,780
50824,170,120,80,160,320,0,850
50825,190,140,120,80,160,0,690
50826,180,100,160,80,160,0,680
50827,190,80,120,80,160,320,950
50828,180,140,120,0,0,0,440
50829,190,120,120,160,0,0,590
50830,150,120,120,160,160,0,710
50831,240,80,80,0,0,0,400
50832,200,160,240,80,160,320,1160
50833,200,60,40,0,0,0,300
50834,180,100,80,0,0,0,360
50835,190,100,120,160,160,0,730
50836,190,120,120,160,320,0,910
50837,190,120,160,80,0,0,550
50838,190,60,0,0,0,0,250
50839,220,180,160,160,320,320,1360
50840,200,160,80,160,160,0,760
50841,170,100,120,160,320,0,870
50842,240,120,80,80,160,0,680
50843,240,200,160,80,160,0,840
50844,180,100,80,80,0,0,440
50845,210,100,120,80,160,0,670
50846,240,160,80,80,160,0,720
50847,200,80,80,80,0,0,440
50848,200,100,80,0,0,0,380
50849,160,100,80,0,0,0,340
50850,230,140,160,160,0,0,690
50851,230,120,40,80,0,0,470
50852,200,120,80,0,0,0,400
50853,200,180,80,80,0,0,540
50854,160,160,160,80,160,320,1040
50855,170,140,40,0,0,0,350
50856,210,140,160,80,160,0,750
50857,150,120,200,160,160,0,790
50858,170,100,80,80,0,0,430
50859,200,140,40,0,0,0,380
50860,200,100,120,0,0,0,420
50861,210,120,160,160,0,0,650
50862,210,100,80,80,0,0,470
50863,220,120,160,160,320,320,1300
50864,230,160,160,160,160,0,870
50865,210,160,120,160,160,0,810
50866,200,140,160,160,160,0,820
50867,200,100,80,160,160,0,700
50868,210,100,160,160,320,0,950
50869,160,60,80,80,160,0,540
50870,220,120,120,160,160,320,1100
50871,160,80,80,80,160,0,560
50872,190,120,40,80,0,0,430
50873,190,80,120,160,160,0,710
50874,200,100,80,80,0,0,460
50875,180,160,120,0,0,0,460
50876,170,80,120,80,0,0,450
50877,200,120,40,80,160,0,600
50878,180,60,80,80,160,0,560
50879,160,120,80,160,160,0,680
50880,190,120,120,160,0,0,590
50881,210,120,0,0,0,0,330
50882,250,160,160,160,160,0,890
50883,190,120,120,80,0,0,510
50884,210,100,160,160,160,320,1110
50885,160,120,120,160,320,0,880
50886,180,80,40,80,160,0,540
50887,170,80,80,80,160,0,570
50888,220,120,120,80,160,0,700
50889,220,100,120,160,160,0,760
50890,190,160,160,160,160,0,830
50891,210,160,160,80,160,0,770
50892,180,120,120,160,160,320,1060
50893,190,140,160,160,0,0,650
50894,190,180,80,0,0,0,450
50895,160,140,160,80,160,320,1020
50896,220,80,80,80,160,0,620
50897,190,100,120,80,160,0,650
50898,190,120,120,0,0,0,430
50899,190,100,40,0,0,0,330
50900,220,120,120,160,0,0,620
50901,220,140,120,80,0,0,560
50902,270,160,160,160,160,0,910
50903,220,120,40,80,0,0,460
50904,200,200,120,80,0,0,600
50905,210,120,120,80,0,0,530
50906,210,160,120,160,0,0,650
50907,200,160,120,160,320,0,960
50908,220,180,80,80,0,0,560
50909,190,160,200,160,0,0,710
50910,200,80,80,80,160,0,600
50911,190,120,40,80,0,0,430
50912,170,60,120,160,320,0,830
50913,200,120,80,0,0,0,400
50914,210,140,160,0,0,0,510
50915,200,80,80,80,160,0,600
50916,170,100,120,160,320,0,870
50917,230,120,80,160,160,320,1070
50918,200,180,160,80,160,0,780
50919,170,100,40,80,0,0,390
50920,180,80,40,0,0,0,300
50921,150,80,80,80,0,0,390
50922,190,120,120,80,160,0,670
50923,210,140,160,240,160,0,910
50924,150,80,40,80,160,0,510
50925,180,120,120,160,160,0,740
50926,200,100,160,80,0,0,540
50927,210,160,80,80,0,0,530
50928,190,140,80,160,320,0,890
50929,190,160,120,160,160,320,1110
50930,230,140,160,80,0,0,610
50931,220,180,200,160,0,0,760
50932,210,120,160,240,320,0,1050
50933,180,120,160,160,160,0,780
50934,190,100,200,240,320,320,1370
50935,200,120,160,160,0,0,640
50936,190,120,80,160,160,0,710
50937,170,80,80,80,160,0,570
50938,230,200,240,160,0,0,830
50939,200,120,160,80,0,0,560
50940,220,100,80,80,160,0,640
50941,180,180,120,160,0,0,640
50942,170,160,120,160,320,0,930
50943,150,120,80,0,0,0,350
50944,240,80,0,0,0,0,320
50945,150,100,80,80,160,0,570
50946,230,120,80,160,160,0,750
50947,180,120,160,80,160,0,700
50948,200,140,160,80,160,0,740
50949,200,120,80,80,160,0,640
50950,180,140,160,160,160,320,1120
50951,200,120,120,240,160,0,840
50952,160,120,80,160,160,0,680
50953,220,140,200,160,160,0,880
50954,170,140,120,160,320,0,910
50955,140,100,120,80,160,320,920
50956,170,120,120,160,160,0,730
50957,190,140,160,0,0,0,490
50958,230,120,160,160,320,0,990
50959,220,140,120,160,160,0,800
50960,190,60,40,0,0,0,290
50961,210,140,160,0,0,0,510
50962,210,120,80,80,160,0,650
50963,230,120,40,0,0,0,390
50964,180,80,120,80,0,0,460
50965,190,60,40,0,0,0,290
50966,200,120,80,160,160,0,720
50967,220,180,80,80,160,320,1040
50968,180,180,160,160,320,0,1000
50969,150,140,200,80,160,0,730
50970,210,120,80,80,160,0,650
50971,190,140,40,0,0,0,370
50972,190,120,0,0,0,0,310
50973,190,160,40,0,0,0,390
50974,170,80,80,80,160,0,570
50975,250,200,200,240,160,0,1050
50976,190,140,160,160,160,0,810
50977,210,160,160,80,160,0,770
50978,210,160,120,160,160,0,810
50979,230,100,80,80,0,0,490
50980,140,140,120,160,160,320,1040
50981,240,160,200,240,320,320,1480
50982,180,120,160,80,0,0,540
50983,190,160,120,160,320,0,950
50984,180,120,120,160,160,320,1060
50985,200,140,120,160,320,0,940
50986,200,160,80,80,160,0,680
50987,160,100,40,80,160,0,540
50988,190,140,120,80,160,0,690
50989,240,140,80,80,160,0,700
50990,160,140,120,160,320,0,900
50991,210,100,80,0,0,0,390
50992,180,120,40,0,0,0,340
50993,230,140,80,80,0,0,530
50994,180,120,120,80,160,0,660
50995,230,100,40,0,0,0,370
50996,220,200,120,0,0,0,540
50997,150,120,160,80,160,0,670
50998,190,100,40,0,0,0,330
50999,220,160,160,80,160,0,780
51000,210,80,120,80,0,0,490
51001,220,40,40,80,160,320,860
51002,200,140,160,80,0,0,580
51003,240,180,120,80,160,0,780
51004,170,100,40,0,0,0,310
51005,240,160,120,160,320,0,1000
51006,240,160,200,160,160,0,920
51007,220,120,80,80,160,0,660
51008,210,140,80,80,160,0,670
51009,190,100,80,80,160,320,930
51010,240,180,120,160,160,0,860
51011,230,100,120,160,160,320,1090
51012,170,100,160,80,0,0,510
51013,200,120,120,160,160,0,760
51014,200,140,120,0,0,0,460
51015,160,140,160,160,0,0,620
51016,200,180,200,160,160,0,900
51017,160,80,120,160,0,0,520
51018,150,140,120,80,160,0,650
51019,210,140,120,160,320,0,950
51020,180,120,80,80,0,0,460
51021,240,120,120,160,160,0,800
51022,200,160,200,160,160,0,880
51023,150,140,80,0,0,0,370
51024,200,100,80,160,320,0,860
51025,210,100,80,0,0,0,390
51026,160,60,80,0,0,0,300
51027,190,60,80,80,0,0,410
51028,220,80,120,160,160,0,740
51029,200,60,40,80,160,0,540
51030,210,160,80,80,0,0,530
51031,190,140,200,240,320,0,1090
51032,190,140,240,240,320,0,1130
51033,220,140,120,160,0,0,640
51034,210,160,160,160,160,0,850
51035,210,140,120,160,320,0,950
51036,250,120,120,160,160,320,1130
51037,170,60,80,80,160,0,550
51038,200,80,80,80,0,0,440
51039,210,140,160,80,160,0,750
51040,140,20,40,80,0,0,280
51041,190,80,80,160,320,0,830
51042,190,100,80,80,160,0,610
51043,200,120,80,80,160,0,640
51044,210,80,120,80,160,0,650
51045,230,220,200,160,160,0,970
51046,210,80,80,80,160,0,610
51047,200,160,160,80,160,0,760
51048,200,140,80,80,0,0,500
51049,170,140,200,80,160,320,1070
51050,210,160,200,80,160,0,810
51051,220,140,160,160,320,0,1000
51052,260,140,160,160,0,0,720
51053,210,100,120,80,160,0,670
51054,180,120,160,240,0,0,700
51055,200,80,40,80,160,320,880
51056,200,140,200,80,0,0,620
51057,190,120,160,80,0,0,550
51058,180,120,120,160,160,320,1060
51059,170,140,160,160,160,0,790
51060,210,160,160,80,0,0,610
51061,180,160,80,80,160,0,660
51062,180,100,120,80,0,0,480
51063,200,80,0,0,0,0,280
51064,180,120,120,160,0,0,580
51065,200,100,40,80,160,0,580
51066,210,160,80,0,0,0,450
51067,180,180,40,0,0,0,400
51068,200,160,80,80,160,0,680
51069,190,120,120,80,160,0,670
51070,150,80,120,80,0,0,430
51071,160,120,160,80,160,320,1000
51072,150,80,80,0,0,0,310
51073,190,140,120,0,0,0,450
51074,250,160,80,80,0,0,570
51075,170,140,80,160,160,0,710
51076,200,160,120,80,160,0,720
51077,170,120,160,160,320,320,1250
51078,190,140,80,0,0,0,410
51079,200,100,40,0,0,0,340
51080,220,140,160,240,320,320,1400
51081,180,200,200,160,320,320,1380
51082,160,100,120,160,0,0,540
51083,190,120,80,80,160,0,630
51084,180,100,120,160,160,0,720
51085,190,100,120,80,0,0,490
51086,180,80,80,160,0,0,500
51087,180,100,40,80,160,0,560
51088,190,60,0,0,0,0,250
51089,180,120,120,0,0,0,420
51090,210,100,40,0,0,0,350
51091,210,160,200,80,0,0,650
51092,210,120,80,160,160,0,730
51093,200,160,40,80,0,0,480
51094,230,160,200,80,160,0,830
51095,190,120,80,80,160,0,630
51096,170,80,120,240,160,0,770
51097,190,180,200,160,320,0,1050
51098,200,140,160,0,0,0,500
51099,210,120,120,80,160,0,690
51100,170,120,160,240,160,0,850
51101,230,200,160,160,320,0,1070
51102,200,160,200,80,0,0,640
51103,180,140,40,0,0,0,360
51104,200,120,80,0,0,0,400
51105,220,140,160,160,0,0,680
51106,220,180,240,160,0,0,800
51107,180,120,40,80,0,0,420
51108,200,160,120,160,320,320,1280
51109,240,120,160,0,0,0,520
51110,180,100,120,80,160,0,640
51111,190,120,80,80,160,0,630
51112,160,100,40,0,0,0,300
51113,180,120,80,80,0,0,460
51114,200,60,80,0,0,0,340
51115,190,100,120,160,320,0,890
51116,190,100,80,0,0,0,370
51117,240,120,80,0,0,0,440
51118,190,100,120,160,0,0,570
51119,170,100,80,160,160,0,670
51120,180,120,120,80,160,0,660
51121,210,140,120,80,0,0,550
51122,220,180,40,0,0,0,440
51123,200,140,80,160,160,0,740
51124,230,140,120,80,0,0,570
51125,220,100,120,160,320,0,920
51126,190,120,120,160,320,0,910
51127,220,120,80,80,0,0,500
51128,180,100,120,80,160,0,640
51129,180,80,80,160,320,320,1140
51130,140,140,80,80,0,0,440
51131,200,100,120,160,160,320,1060
51132,200,80,0,0,0,0,280
51133,180,140,80,0,0,0,400
51134,190,120,0,0,0,0,310
51135,180,140,160,80,160,0,720
51136,150,60,0,0,0,0,210
51137,180,140,120,0,0,0,440
51138,210,160,160,160,0,0,690
51139,190,140,200,240,320,320,1410
51140,220,80,80,160,0,0,540
51141,160,60,80,80,160,320,860
51142,160,60,40,80,160,0,500
51143,220,160,120,160,0,0,660
51144,210,140,160,160,160,0,830
51145,210,80,80,0,0,0,370
51146,220,120,120,160,0,0,620
51147,180,100,160,80,0,0,520
51148,140,120,160,80,0,0,500
51149,160,120,120,160,160,0,720
51150,190,160,80,0,0,0,430
51151,160,120,160,80,160,0,680
51152,210,120,120,80,0,0,530
51153,220,180,120,80,0,0,600
51154,150,80,120,160,160,0,670
51155,220,180,160,80,160,320,1120
51156,200,100,80,80,160,0,620
51157,170,160,80,160,160,0,730
51158,200,140,40,0,0,0,380
51159,180,140,80,80,0,0,480
51160,170,140,80,80,160,320,950
51161,200,60,80,80,160,0,580
51162,190,120,120,160,160,320,1070
51163,170,80,40,0,0,0,290
51164,230,100,0,0,0,0,330
51165,190,120,120,240,160,0,830
51166,220,140,120,80,160,320,1040
51167,210,180,40,80,160,0,670
51168,210,160,80,160,160,0,770
51169,220,160,160,240,160,0,940
51170,210,140,80,0,0,0,430
51171,150,160,120,160,320,0,910
51172,230,120,80,80,160,0,670
51173,200,100,120,80,160,0,660
51174,210,100,80,160,160,0,710
51175,240,120,120,80,160,0,720
51176,240,160,160,0,0,0,560
51177,180,160,120,240,160,320,1180
51178,200,160,160,240,0,0,760
51179,200,100,80,80,160,320,940
51180,190,160,80,80,0,0,510
51181,200,120,80,80,160,0,640
51182,240,160,120,80,160,320,1080
51183,210,160,40,80,0,0,490
51184,150,100,120,80,160,0,610
51185,180,160,160,160,160,0,820
51186,220,160,40,80,160,320,980
51187,220,140,120,160,160,0,800
51188,250,180,80,0,0,0,510
51189,230,160,120,160,320,320,1310
51190,190,60,80,80,160,0,570
51191,150,120,120,160,160,0,710
51192,190,80,40,80,160,0,550
51193,210,160,160,160,0,0,690
51194,210,100,80,80,160,0,630
51195,160,100,40,0,0,0,300
51196,220,180,120,160,160,320,1160
51197,190,100,40,80,160,0,570
51198,190,100,80,160,160,0,690
51199,180,100,40,80,0,0,400
51200,220,120,120,80,160,320,1020
51201,200,100,120,160,0,0,580
51202,210,100,40,0,0,0,350
51203,230,60,120,80,160,0,650
51204,230,180,120,0,0,0,530
51205,220,180,200,240,0,0,840
51206,180,100,120,160,160,0,720
51207,220,140,80,80,160,0,680
51208,230,180,120,80,160,0,770
51209,230,120,80,0,0,0,430
51210,230,120,120,160,160,320,1110
51211,210,120,120,160,160,0,770
51212,200,100,120,80,0,0,500
51213,210,160,200,80,160,0,810
51214,180,100,80,160,160,0,680
51215,200,160,160,80,0,0,600
51216,200,120,200,80,160,0,760
51217,230,140,40,80,0,0,490
51218,190,80,40,80,0,0,390
51219,200,120,80,0,0,0,400
51220,200,140,40,0,0,0,380
51221,180,140,80,80,160,0,640
51222,230,140,80,80,160,0,690
51223,220,100,120,80,0,0,520
51224,170,140,120,160,160,320,1070
51225,150,60,40,80,160,0,490
51226,220,140,80,80,160,0,680
51227,200,140,160,160,0,0,660
51228,170,120,160,80,0,0,530
51229,190,80,80,160,0,0,510
51230,160,120,40,80,160,0,560
51231,210,140,160,80,160,320,1070
51232,180,100,120,160,320,0,880
51233,230,200,160,80,160,0,830
51234,220,120,160,240,160,0,900
51235,180,140,0,0,0,0,320
51236,170,180,160,160,0,0,670
51237,230,160,120,160,160,0,830
51238,190,40,40,80,160,0,510
51239,200,160,80,0,0,0,440
51240,210,140,160,240,160,0,910
51241,210,160,200,0,0,0,570
51242,150,100,120,160,160,0,690
51243,210,120,80,80,0,0,490
51244,140,120,40,80,160,0,540
51245,200,180,120,160,160,0,820
51246,160,100,80,80,0,0,420
51247,200,140,120,160,160,0,780
51248,160,100,80,80,160,0,580
51249,220,120,80,80,0,0,500
51250,160,60,80,80,0,0,380
51251,200,120,160,80,0,0,560
51252,200,100,120,240,160,0,820
51253,220,40,80,80,160,0,580
51254,200,100,160,160,160,0,780
51255,210,100,120,80,0,0,510
51256,230,140,120,160,0,0,650
51257,190,80,120,80,160,0,630
51258,180,120,160,160,160,0,780
51259,170,60,80,160,160,0,630
51260,210,100,160,80,0,0,550
51261,190,100,160,160,160,0,770
51262,230,220,120,80,0,0,650
51263,200,120,120,160,0,0,600
51264,210,160,80,80,0,0,530
51265,150,140,40,0,0,0,330
51266,140,80,40,0,0,0,260
51267,200,140,80,160,160,0,740
51268,150,140,120,80,0,0,490
51269,230,100,80,0,0,0,410
51270,160,100,80,0,0,0,340
51271,200,160,120,80,160,0,720
51272,190,120,80,80,160,0,630
51273,200,80,120,160,0,0,560
51274,180,180,160,160,320,320,1320
51275,200,120,40,80,0,0,440
51276,220,200,160,240,0,0,820
51277,210,120,120,160,160,320,1090
51278,220,100,0,0,0,0,320
51279,200,120,120,80,160,0,680
51280,200,180,200,80,160,0,820
51281,200,140,160,160,320,320,1300
51282,210,160,160,160,160,320,1170
51283,160,140,120,80,160,0,660
51284,190,140,160,80,160,0,730
51285,190,140,80,80,160,0,650
51286,200,140,160,80,160,0,740
51287,190,100,80,0,0,0,370
51288,130,80,80,160,0,0,450
51289,200,120,120,0,0,0,440
51290,170,140,120,160,0,0,590
51291,180,100,120,160,160,320,1040
51292,200,120,120,160,0,0,600
51293,180,160,120,160,0,0,620
51294,190,160,80,80,160,0,670
51295,230,120,160,160,320,0,990
51296,190,140,80,160,0,0,570
51297,200,100,160,160,0,0,620
51298,160,100,120,80,160,0,620
51299,170,120,120,80,0,0,490
51300,160,80,80,80,160,0,560
51301,180,160,160,80,160,0,740
51302,220,120,120,80,0,0,540
51303,230,120,0,0,0,0,350
51304,230,80,80,80,160,0,630
51305,160,140,80,160,0,0,540
51306,180,100,40,0,0,0,320
51307,230,180,40,80,160,0,690
51308,200,100,80,80,0,0,460
51309,190,60,40,80,0,0,370
51310,210,80,80,0,0,0,370
51311,200,120,80,80,160,0,640
51312,210,120,160,240,160,0,890
51313,180,80,40,0,0,0,300
51314,190,160,120,80,160,0,710
51315,220,160,120,80,160,0,740
51316,220,120,80,0,0,0,420
51317,190,200,80,0,0,0,470
51318,220,180,160,240,320,0,1120
51319,190,140,120,80,160,0,690
51320,190,180,120,160,160,0,810
51321,170,100,80,160,320,0,830
51322,220,120,80,80,0,0,500
51323,170,100,120,80,0,0,470
51324,170,100,40,0,0,0,310
51325,170,140,160,0,0,0,470
51326,140,80,40,80,0,0,340
51327,200,120,160,0,0,0,480
51328,220,100,80,160,160,0,720
51329,210,180,160,0,0,0,550
51330,210,180,200,160,160,0,910
51331,180,120,120,80,160,320,980
51332,190,200,160,80,0,0,630
51333,220,140,80,80,0,0,520
51334,140,60,40,0,0,0,240
51335,160,80,80,160,160,0,640
51336,190,140,120,80,0,0,530
51337,210,100,120,80,0,0,510
51338,210,140,160,160,0,0,670
51339,200,80,80,0,0,0,360
51340,200,140,160,240,320,320,1380
51341,170,80,120,80,160,0,610
51342,230,120,120,80,0,0,550
51343,160,100,160,0,0,0,420
51344,190,100,120,0,0,0,410
51345,170,120,120,80,160,0,650
51346,160,140,120,160,320,0,900
51347,210,180,0,0,0,0,390
51348,200,80,80,160,320,0,840
51349,210,120,80,80,160,0,650
51350,180,80,40,0,0,0,300
51351,160,160,160,160,160,0,800
51352,160,100,120,160,320,0,860
51353,210,40,80,160,0,0,490
51354,190,160,160,160,160,0,830
51355,250,80,120,160,0,0,610
51356,220,160,160,80,0,0,620
51357,190,60,40,80,160,0,530
51358,170,100,120,160,0,0,550
51359,230,140,160,80,0,0,610
51360,210,60,40,80,0,0,390
51361,170,160,120,80,160,0,690
51362,240,160,120,80,0,0,600
51363,250,140,80,0,0,0,470
51364,200,120,80,80,160,0,640
51365,210,120,160,240,160,320,1210
51366,190,120,120,0,0,0,430
51367,210,160,80,80,0,0,530
51368,170,100,80,80,160,0,590
51369,220,140,120,80,0,0,560
51370,170,120,120,160,160,320,1050
51371,200,120,120,160,160,0,760
51372,170,60,80,160,160,0,630
51373,190,100,40,0,0,0,330
51374,200,100,80,160,0,0,540
51375,170,160,200,0,0,0,530
51376,200,160,80,0,0,0,440
51377,180,140,160,160,160,0,800
51378,200,160,120,160,160,0,800
51379,230,180,80,80,0,0,570
51380,220,140,160,80,160,0,760
51381,210,120,160,80,160,320,1050
51382,150,60,40,0,0,0,250
51383,190,100,80,80,0,0,450
51384,200,120,80,0,0,0,400
51385,190,100,80,80,0,0,450
51386,180,100,120,80,0,0,480
51387,190,80,120,80,0,0,470
51388,200,160,160,240,160,0,920
51389,180,100,80,80,160,0,600
51390,190,100,80,0,0,0,370
51391,190,60,80,80,160,0,570
51392,210,160,160,80,0,0,610
51393,230,140,120,160,320,0,970
51394,140,80,120,160,160,0,660
51395,170,100,120,160,160,0,710
51396,230,180,120,160,160,0,850
51397,170,140,160,160,160,0,790
51398,200,80,80,160,160,0,680
51399,190,80,120,160,160,0,710
51400,240,80,40,0,0,0,360
51401,240,140,160,160,160,0,860
51402,230,100,80,80,0,0,490
51403,240,140,160,240,320,320,1420
51404,180,140,160,160,160,0,800
51405,150,100,80,80,160,320,890
51406,170,140,120,160,320,320,1230
51407,180,100,120,80,160,0,640
51408,220,140,80,160,320,0,920
51409,220,60,80,160,320,0,840
51410,210,120,80,0,0,0,410
51411,170,120,40,0,0,0,330
51412,200,120,40,80,160,0,600
51413,180,100,160,160,160,0,760
51414,210,140,80,80,160,0,670
51415,190,80,80,0,0,0,350
51416,180,120,120,80,160,0,660
51417,210,160,160,80,160,0,770
51418,190,120,200,160,160,0,830
51419,180,180,160,240,160,0,920
51420,100,60,40,0,0,0,200
51421,180,20,0,0,0,0,200
51422,180,100,0,0,0,0,280
51423,200,160,200,160,160,320,1200
51424,200,100,80,0,0,0,380
51425,240,140,120,0,0,0,500
51426,170,100,40,0,0,0,310
51427,170,120,80,80,160,0,610
51428,250,140,40,80,160,0,670
51429,170,100,80,0,0,0,350
51430,190,140,160,80,160,0,730
51431,200,100,120,160,320,0,900
51432,200,120,40,0,0,0,360
51433,230,200,160,240,160,0,990
51434,170,100,120,160,320,0,870
51435,190,180,160,160,0,0,690
51436,220,160,160,80,0,0,620
51437,250,140,160,0,0,0,550
51438,200,140,80,80,160,0,660
51439,190,140,160,160,160,0,810
51440,240,140,120,160,160,320,1140
51441,210,120,160,80,160,0,730
51442,200,120,120,0,0,0,440
51443,220,100,80,80,160,0,640
51444,220,100,160,160,160,0,800
51445,180,160,120,160,160,320,1100
51446,200,100,40,0,0,0,340
51447,210,160,160,160,160,0,850
51448,210,100,80,80,160,0,630
51449,210,100,160,240,320,0,1030
51450,190,140,120,0,0,0,450
51451,190,120,40,0,0,0,350
51452,190,60,80,160,160,320,970
51453,220,140,40,80,160,320,960
51454,210,140,80,80,160,0,670
51455,210,80,120,160,160,0,730
51456,200,140,120,80,160,0,700
51457,170,120,120,160,160,0,730
51458,200,120,40,80,160,320,920
51459,210,140,40,80,160,0,630
51460,200,80,40,80,0,0,400
51461,160,60,80,0,0,0,300
51462,200,60,40,0,0,0,300
51463,250,100,80,160,160,0,750
51464,210,80,80,0,0,0,370
51465,150,60,80,160,160,0,610
51466,180,140,120,80,160,320,1000
51467,190,120,120,80,160,320,990
51468,190,60,40,80,0,0,370
51469,200,120,120,80,0,0,520
51470,190,140,120,240,320,0,1010
51471,200,100,80,80,160,0,620
51472,210,160,80,160,160,0,770
51473,180,120,80,0,0,0,380
51474,190,160,80,80,160,0,670
51475,210,80,40,80,160,320,890
51476,190,100,120,240,320,320,1290
51477,220,160,160,80,0,0,620
51478,200,100,40,0,0,0,340
51479,180,80,120,80,0,0,460
51480,160,120,120,160,160,0,720
51481,210,80,80,80,160,0,610
51482,190,120,160,160,0,0,630
51483,230,160,200,0,0,0,590
51484,250,140,200,240,320,0,1150
51485,190,120,40,80,160,320,910
51486,170,120,120,160,160,320,1050
51487,190,100,160,80,0,0,530
51488,230,120,80,0,0,0,430
51489,150,120,80,160,160,320,990
51490,200,100,80,160,160,0,700
51491,200,160,200,240,160,0,960
51492,210,140,120,80,160,0,710
51493,190,100,40,0,0,0,330
51494,210,140,240,160,160,0,910
51495,190,120,80,80,160,0,630
51496,190,140,80,160,160,0,730
51497,130,80,40,80,160,0,490
51498,180,80,80,160,160,0,660
51499,210,160,120,80,0,0,570
51500,210,100,120,160,160,0,750
51501,160,160,160,160,160,0,800
51502,200,140,80,80,0,0,500
51503,260,140,40,0,0,0,440
51504,190,120,160,240,320,320,1350
51505,220,140,120,80,160,320,1040
51506,180,120,120,240,160,0,820
51507,200,100,80,160,320,0,860
51508,220,60,80,80,160,0,600
51509,220,60,80,80,0,0,440
51510,150,120,120,240,160,0,790
51511,200,160,200,240,320,320,1440
51512,160,140,200,240,160,0,900
51513,150,100,40,0,0,0,290
51514,220,140,80,0,0,0,440
51515,230,120,80,80,0,0,510
51516,200,140,160,80,160,0,740
51517,210,160,120,80,160,0,730
51518,180,80,120,80,160,0,620
51519,220,160,120,80,160,0,740
51520,230,160,160,80,0,0,630
51521,220,100,120,0,0,0,440
51522,250,140,200,240,320,0,1150
51523,240,140,160,240,320,0,1100
51524,190,160,120,80,160,0,710
51525,200,160,120,80,160,320,1040
51526,170,120,80,160,160,0,690
51527,220,100,120,240,160,0,840
51528,220,140,120,80,160,0,720
51529,220,140,160,80,0,0,600
51530,190,120,40,0,0,0,350
51531,200,120,120,80,160,0,680
51532,180,100,80,0,0,0,360
51533,170,120,120,80,0,0,490
51534,160,60,80,80,160,320,860
51535,180,100,80,80,0,0,440
51536,180,140,40,0,0,0,360
51537,250,140,120,80,0,0,590
51538,210,80,40,0,0,0,330
51539,250,140,120,80,0,0,590
51540,170,80,40,80,160,0,530
51541,190,120,80,80,160,0,630
51542,210,80,80,80,160,0,610
51543,230,200,160,160,160,0,910
51544,190,160,80,80,0,0,510
51545,220,120,160,240,160,0,900
51546,180,180,120,160,320,0,960
51547,210,120,160,240,320,320,1370
51548,180,140,160,160,160,320,1120
51549,160,60,80,80,160,0,540
51550,180,100,160,160,160,0,760
51551,210,140,120,80,160,0,710
51552,230,140,80,80,0,0,530
51553,240,120,120,160,320,0,960
51554,210,120,40,0,0,0,370
51555,160,100,40,0,0,0,300
51556,190,140,120,0,0,0,450
51557,210,100,160,160,320,0,950
51558,200,140,120,240,320,320,1340
51559,190,100,80,80,160,0,610
51560,220,160,160,160,160,0,860
51561,180,100,80,80,160,320,920
51562,190,100,40,0,0,0,330
51563,210,120,80,80,0,0,490
51564,170,180,120,80,160,0,710
51565,190,140,160,80,160,0,730
51566,200,120,120,80,160,0,680
51567,180,80,80,80,160,0,580
51568,160,100,120,160,320,320,1180
51569,200,80,80,80,160,0,600
51570,210,120,40,80,160,0,610
51571,190,80,80,80,160,0,590
51572,250,180,160,160,160,320,1230
51573,210,160,200,80,160,0,810
51574,190,100,40,0,0,0,330
51575,230,60,80,160,160,0,690
51576,190,140,160,160,160,320,1130
51577,220,100,80,160,0,0,560
51578,200,180,120,160,320,0,980
51579,160,120,120,240,320,0,960
51580,200,120,0,0,0,0,320
51581,200,80,80,160,160,320,1000
51582,210,100,80,80,160,0,630
51583,210,120,120,80,0,0,530
51584,190,100,80,80,0,0,450
51585,240,140,160,160,320,0,1020
51586,200,140,160,160,160,320,1140
51587,200,120,160,240,160,0,880
51588,160,100,80,80,160,0,580
51589,180,100,80,0,0,0,360
51590,250,160,120,160,160,0,850
51591,150,140,200,160,160,0,810
51592,170,100,40,0,0,0,310
51593,140,80,80,160,160,0,620
51594,220,160,80,80,160,320,1020
51595,210,120,120,160,160,320,1090
51596,220,160,160,240,160,0,940
51597,220,120,120,160,160,0,780
51598,230,120,120,160,320,0,950
51599,180,140,160,160,160,320,1120
51600,170,160,160,80,160,0,730
51601,210,160,200,80,0,0,650
51602,200,180,160,80,0,0,620
51603,170,100,120,80,160,320,950
51604,200,160,80,80,160,0,680
51605,210,140,80,160,160,0,750
51606,200,80,80,80,0,0,440
51607,160,60,80,80,160,320,860
51608,200,160,80,80,160,0,680
51609,210,160,80,80,160,0,690
51610,220,140,160,160,160,320,1160
51611,210,120,120,80,0,0,530
51612,200,120,80,0,0,0,400
51613,200,160,200,80,0,0,640
51614,250,140,80,160,320,320,1270
51615,190,80,120,160,320,320,1190
51616,160,100,120,160,160,0,700
51617,210,180,120,0,0,0,510
51618,190,100,80,160,160,0,690
51619,190,100,80,80,160,0,610
51620,210,80,80,160,160,0,690
51621,140,80,80,80,160,0,540
51622,200,100,120,160,160,320,1060
51623,190,160,80,0,0,0,430
51624,210,160,120,160,160,0,810
51625,200,120,120,0,0,0,440
51626,190,100,120,80,0,0,490
51627,160,100,120,160,160,0,700
51628,220,60,80,80,160,0,600
51629,140,120,40,80,0,0,380
51630,220,160,160,160,160,0,860
51631,170,160,120,80,0,0,530
51632,190,120,120,0,0,0,430
51633,170,120,160,240,160,0,850
51634,190,120,200,80,160,320,1070
51635,180,40,40,80,160,0,500
51636,220,140,120,160,160,0,800
51637,200,140,120,160,160,0,780
51638,170,160,120,160,160,320,1090
51639,210,140,120,160,0,0,630
51640,170,120,160,160,0,0,610
51641,190,160,200,160,160,0,870
51642,210,100,160,80,0,0,550
51643,220,140,200,320,160,0,1040
51644,230,120,120,80,160,0,710
51645,200,80,80,0,0,0,360
51646,220,100,40,80,0,0,440
51647,200,120,120,160,160,320,1080
51648,170,160,120,160,160,0,770
51649,200,100,120,160,0,0,580
51650,220,140,160,80,0,0,600
51651,210,140,80,0,0,0,430
51652,220,140,80,160,160,0,760
51653,180,160,160,160,160,320,1140
51654,190,60,0,0,0,0,250
51655,240,80,40,0,0,0,360
51656,210,160,120,160,160,320,1130
51657,180,100,80,160,0,0,520
51658,220,140,120,240,320,320,1360
51659,170,120,160,240,0,0,690
51660,170,140,120,80,160,0,670
51661,190,120,160,160,0,0,630
51662,220,180,80,160,0,0,640
51663,230,100,80,80,160,0,650
51664,160,60,0,0,0,0,220
51665,210,160,80,80,160,320,1010
51666,180,100,40,80,160,0,560
51667,180,100,120,80,160,0,640
51668,190,120,120,80,0,0,510
51669,170,60,80,80,0,0,390
51670,190,160,120,80,0,0,550
51671,170,120,40,80,0,0,410
51672,210,160,120,160,160,0,810
51673,220,140,160,160,320,0,1000
51674,180,80,80,80,0,0,420
51675,230,140,120,160,160,0,810
51676,190,100,80,80,160,0,610
51677,210,180,120,80,160,320,1070
51678,210,180,40,0,0,0,430
51679,220,80,40,80,160,320,900
51680,200,60,40,80,0,0,380
51681,220,140,80,80,160,0,680
51682,170,80,160,80,160,320,970
51683,160,60,40,0,0,0,260
51684,200,140,160,160,0,0,660
51685,210,160,160,160,160,320,1170
51686,240,140,80,160,160,0,780
51687,160,140,120,80,160,0,660
51688,180,120,120,160,160,320,1060
51689,170,80,120,160,320,0,850
51690,190,120,80,160,160,0,710
51691,170,100,0,0,0,0,270
51692,200,140,120,0,0,0,460
51693,230,160,120,80,160,0,750
51694,140,80,80,160,320,0,780
51695,180,100,80,160,320,0,840
51696,180,80,120,80,0,0,460
51697,200,140,80,0,0,0,420
51698,220,120,120,80,0,0,540
51699,230,60,80,0,0,0,370
51700,230,180,120,80,0,0,610
51701,170,100,120,80,160,0,630
51702,200,80,80,80,160,0,600
51703,190,120,80,0,0,0,390
51704,190,140,160,160,160,0,810
51705,220,80,80,0,0,0,380
51706,200,80,80,80,160,0,600
51707,210,140,40,80,160,0,630
51708,220,120,120,80,0,0,540
51709,190,80,40,80,160,0,550
51710,190,160,120,80,0,0,550
51711,170,140,80,80,0,0,470
51712,160,100,40,0,0,0,300
51713,180,120,120,160,0,0,580
51714,230,160,160,160,160,320,1190
51715,210,100,80,80,0,0,470
51716,190,200,200,160,160,0,910
51717,150,80,160,80,0,0,470
51718,210,160,120,80,160,0,730
51719,200,80,40,80,0,0,400
51720,200,100,40,80,160,0,580
51721,220,120,120,240,320,0,1020
51722,250,80,0,0,0,0,330
51723,210,200,160,80,0,0,650
51724,180,120,120,0,0,0,420
51725,190,100,120,160,160,0,730
51726,250,180,120,160,160,0,870
51727,190,120,40,80,160,0,590
51728,190,140,200,160,320,0,1010
51729,210,100,120,240,320,320,1310
51730,230,100,80,0,0,0,410
51731,170,60,40,0,0,0,270
51732,150,100,120,160,160,320,1010
51733,250,140,160,80,0,0,630
51734,220,140,120,0,0,0,480
51735,210,160,120,240,0,0,730
51736,180,120,80,80,0,0,460
51737,180,100,80,80,160,0,600
51738,180,140,160,0,0,0,480
51739,220,80,80,80,0,0,460
51740,170,140,120,0,0,0,430
51741,220,100,120,80,0,0,520
51742,190,80,120,160,160,0,710
51743,240,140,120,80,160,0,740
51744,180,120,160,80,160,320,1020
51745,190,100,120,0,0,0,410
51746,190,100,40,80,160,0,570
51747,200,180,160,160,160,0,860
51748,230,160,80,160,320,320,1270
51749,190,100,80,80,160,0,610
51750,190,160,80,80,160,0,670
51751,190,100,40,0,0,0,330
51752,180,140,80,80,0,0,480
51753,200,100,0,0,0,0,300
51754,180,120,120,80,160,0,660
51755,160,80,80,80,160,0,560
51756,200,180,200,160,160,0,900
51757,200,160,120,0,0,0,480
51758,170,120,80,80,160,320,930
51759,180,100,120,0,0,0,400
51760,180,120,120,80,0,0,500
51761,160,120,160,160,160,0,760
51762,180,80,80,80,0,0,420
51763,210,180,160,160,160,0,870
51764,230,140,40,80,160,320,970
51765,230,120,40,80,160,0,630
51766,240,80,80,80,0,0,480
51767,200,200,200,240,160,320,1320
51768,230,160,80,80,0,0,550
51769,230,100,80,80,160,320,970
51770,210,60,80,80,0,0,430
51771,170,120,120,160,320,0,890
51772,200,160,80,80,0,0,520
51773,190,140,240,80,160,320,1130
51774,230,160,80,80,160,0,710
51775,170,100,80,80,0,0,430
51776,210,100,120,80,160,0,670
51777,180,140,200,240,160,0,920
51778,220,180,80,80,0,0,560
51779,210,160,80,0,0,0,450
51780,180,120,40,80,160,0,580
51781,240,100,120,160,0,0,620
51782,180,100,120,160,320,320,1200
51783,170,160,160,240,320,320,1370
51784,250,100,120,80,160,0,710
51785,200,140,200,80,160,0,780
51786,200,120,160,240,0,0,720
51787,210,160,160,240,160,0,930
51788,190,140,80,160,160,0,730
51789,190,80,40,80,160,320,870
51790,180,140,120,80,0,0,520
51791,170,140,160,0,0,0,470
51792,200,140,80,80,0,0,500
51793,220,160,160,160,160,0,860
51794,190,140,120,80,160,0,690
51795,220,140,160,80,0,0,600
51796,190,160,240,240,160,0,990
51797,220,120,120,160,160,0,780
51798,240,120,80,80,0,0,520
51799,220,180,160,0,0,0,560
51800,210,120,80,80,160,0,650
51801,190,120,160,160,320,0,950
51802,170,120,120,80,160,0,650
51803,270,200,120,80,160,0,830
51804,170,140,160,240,320,320,1350
51805,200,140,120,160,160,320,1100
51806,180,120,120,160,320,0,900
51807,170,140,160,240,320,0,1030
51808,230,100,120,160,0,0,610
51809,220,180,120,160,0,0,680
51810,180,200,200,160,0,0,740
51811,200,140,120,0,0,0,460
51812,220,140,120,160,160,0,800
51813,180,120,80,0,0,0,380
51814,220,120,80,80,0,0,500
51815,170,80,40,0,0,0,290
51816,190,120,40,80,0,0,430
51817,190,140,160,80,0,0,570
51818,210,120,120,80,160,0,690
51819,200,140,120,80,160,0,700
51820,220,140,120,80,0,0,560
51821,160,100,40,80,0,0,380
51822,190,120,120,240,320,320,1310
51823,250,120,120,80,160,0,730
51824,220,120,80,160,160,0,740
51825,190,140,80,80,160,320,970
51826,210,120,40,80,160,320,930
51827,200,60,0,0,0,0,260
51828,220,140,80,80,160,320,1000
51829,210,180,0,0,0,0,390
51830,210,160,120,80,0,0,570
51831,180,80,120,160,160,0,700
51832,210,160,120,160,160,0,810
51833,180,100,120,0,0,0,400
51834,190,120,80,160,160,0,710
51835,210,60,80,80,0,0,430
51836,170,160,160,80,0,0,570
51837,210,180,80,80,160,0,710
51838,230,200,120,80,160,320,1110
51839,200,120,160,80,0,0,560
51840,190,200,120,0,0,0,510
51841,200,160,80,80,160,320,1000
51842,220,140,120,240,320,0,1040
51843,220,140,80,80,160,0,680
51844,190,80,40,0,0,0,310
51845,160,140,120,160,160,0,740
51846,170,140,120,160,0,0,590
51847,210,120,200,240,0,0,770
51848,210,160,80,80,0,0,530
51849,250,180,120,80,160,0,790
51850,180,120,80,80,160,0,620
51851,170,100,80,0,0,0,350
51852,200,120,80,80,0,0,480
51853,220,120,80,80,0,0,500
51854,170,120,120,80,160,0,650
51855,230,120,120,160,160,0,790
51856,180,100,120,160,0,0,560
51857,240,160,40,0,0,0,440
51858,210,100,40,0,0,0,350
51859,250,120,80,0,0,0,450
51860,180,80,40,80,160,0,540
51861,190,180,160,160,160,0,850
51862,200,120,120,160,160,0,760
51863,240,140,120,80,0,0,580
51864,210,160,160,80,0,0,610
51865,210,100,120,0,0,0,430
51866,190,100,80,80,160,320,930
51867,180,120,40,0,0,0,340
51868,220,100,120,0,0,0,440
51869,200,120,200,160,320,320,1320
51870,170,100,120,80,0,0,470
51871,210,80,80,80,160,320,930
51872,190,100,40,0,0,0,330
51873,190,140,120,80,160,0,690
51874,210,120,120,160,160,0,770
51875,180,100,0,0,0,0,280
51876,210,160,40,80,160,0,650
51877,220,160,160,80,160,0,780
51878,160,100,40,80,0,0,380
51879,190,140,200,80,0,0,610
51880,180,100,120,0,0,0,400
51881,220,140,120,160,160,0,800
51882,190,160,200,160,160,0,870
51883,170,140,160,0,0,0,470
51884,170,60,40,80,160,0,510
51885,180,140,120,80,160,320,1000
51886,220,140,160,160,320,0,1000
51887,250,160,40,80,0,0,530
51888,210,100,40,80,0,0,430
51889,180,140,80,160,160,0,720
51890,190,100,80,160,160,0,690
51891,230,180,120,80,0,0,610
51892,210,100,40,80,0,0,430
51893,180,160,40,0,0,0,380
51894,180,140,120,80,0,0,520
51895,210,120,80,80,160,320,970
51896,180,100,80,80,160,0,600
51897,180,160,200,80,160,0,780
51898,210,80,40,0,0,0,330
51899,180,140,120,0,0,0,440
51900,210,180,160,160,320,320,1350
51901,220,140,80,160,160,0,760
51902,150,80,80,80,160,0,550
51903,220,120,120,80,0,0,540
51904,210,100,120,160,160,0,750
51905,240,140,160,240,160,0,940
51906,220,180,80,0,0,0,480
51907,200,80,160,160,160,320,1080
51908,150,120,120,80,160,0,630
51909,190,120,120,80,160,0,670
51910,170,60,80,160,0,0,470
51911,170,80,80,160,160,0,650
51912,210,120,80,80,0,0,490
51913,230,100,40,0,0,0,370
51914,170,80,80,160,0,0,490
51915,250,160,160,240,160,320,1290
51916,170,100,160,80,160,320,990
51917,200,100,120,80,160,0,660
51918,170,80,80,80,160,0,570
51919,220,120,160,160,320,0,980
51920,220,160,200,80,160,0,820
51921,180,120,80,80,0,0,460
51922,190,140,160,160,320,0,970
51923,190,180,160,160,160,0,850
51924,190,180,200,80,160,0,810
51925,170,80,80,80,0,0,410
51926,180,100,40,80,160,0,560
51927,190,140,80,0,0,0,410
51928,180,140,80,80,160,0,640
51929,240,100,120,80,0,0,540
51930,170,80,80,0,0,0,330
51931,170,140,40,80,0,0,430
51932,160,60,80,80,160,0,540
51933,180,120,80,0,0,0,380
51934,220,140,160,160,0,0,680
51935,230,120,160,160,160,0,830
51936,180,140,120,240,160,320,1160
51937,180,160,40,80,160,320,940
51938,160,60,40,80,160,0,500
51939,200,140,120,80,160,0,700
51940,210,120,80,160,320,0,890
51941,220,140,80,160,320,0,920
51942,190,80,80,80,160,0,590
51943,180,100,160,240,0,0,680
51944,210,140,200,80,160,0,790
51945,190,100,80,80,160,320,930
51946,190,120,120,80,160,0,670
51947,210,180,160,160,160,320,1190
51948,170,40,80,80,160,0,530
51949,190,100,80,80,160,0,610
51950,240,120,80,0,0,0,440
51951,200,120,80,0,0,0,400
51952,190,120,40,0,0,0,350
51953,230,100,80,80,160,0,650
51954,210,120,120,160,160,0,770
51955,200,120,40,80,160,0,600
51956,200,80,80,160,160,0,680
51957,180,60,40,80,160,0,520
51958,200,100,40,80,0,0,420
51959,200,160,80,0,0,0,440
51960,190,120,40,80,160,0,590
51961,210,140,80,160,320,320,1230
51962,200,100,40,0,0,0,340
51963,140,100,40,80,160,0,520
51964,200,120,160,160,160,0,800
51965,200,160,120,80,0,0,560
51966,200,120,120,0,0,0,440
51967,220,120,120,80,160,0,700
51968,150,100,40,0,0,0,290
51969,200,100,40,80,160,320,900
51970,190,100,40,80,160,0,570
51971,220,140,120,80,160,0,720
51972,170,160,160,80,160,0,730
51973,190,80,120,80,0,0,470
51974,180,140,120,0,0,0,440
51975,200,80,80,0,0,0,360
51976,230,160,80,0,0,0,470
51977,180,80,40,80,160,0,540
51978,240,100,40,80,0,0,460
51979,220,160,160,240,160,0,940
51980,170,180,200,240,320,0,1110
51981,230,120,80,80,160,0,670
51982,200,100,40,0,0,0,340
51983,190,140,160,160,160,0,810
51984,180,80,120,80,0,0,460
51985,230,120,80,160,160,0,750
51986,180,120,120,80,160,0,660
51987,190,60,0,0,0,0,250
51988,200,100,120,160,320,320,1220
51989,180,100,120,160,0,0,560
51990,190,140,120,160,160,0,770
51991,120,60,80,80,160,0,500
51992,170,100,120,160,320,0,870
51993,210,120,40,80,160,320,930
51994,180,100,80,80,160,320,920
51995,180,140,160,240,320,320,1360
51996,170,120,80,80,160,0,610
51997,200,100,200,160,0,0,660
51998,190,160,160,160,160,0,830
51999,150,80,120,160,0,0,510
52000,190,160,120,160,160,0,790
52001,240,120,120,80,160,0,720
52002,200,120,120,240,160,0,840
52003,200,60,80,0,0,0,340
52004,200,120,120,160,160,320,1080
52005,240,100,80,80,160,0,660
52006,190,160,120,0,0,0,470
52007,180,100,80,80,160,0,600
52008,240,200,80,160,160,0,840
52009,220,160,160,240,160,0,940
52010,220,140,200,160,320,0,1040
52011,190,140,120,0,0,0,450
52012,200,100,80,80,0,0,460
52013,220,120,80,80,160,320,980
52014,160,100,40,0,0,0,300
52015,200,100,160,0,0,0,460
52016,200,160,120,80,160,0,720
52017,200,80,80,80,160,0,600
52018,240,100,120,160,160,0,780
52019,150,80,80,80,160,0,550
52020,210,100,40,0,0,0,350
52021,190,120,120,160,160,0,750
52022,120,100,80,0,0,0,300
52023,180,140,120,160,160,0,760
52024,210,100,40,0,0,0,350
52025,220,140,120,160,320,0,960
52026,180,120,80,0,0,0,380
52027,170,80,80,80,160,0,570
52028,200,160,200,160,160,0,880
52029,180,120,80,160,160,320,1020
52030,210,180,120,160,0,0,670
52031,190,100,0,0,0,0,290
52032,220,200,160,80,0,0,660
52033,190,140,80,80,160,320,970
52034,190,140,160,80,0,0,570
52035,170,100,80,160,320,0,830
52036,210,120,160,160,160,0,810
52037,170,120,120,240,160,0,810
52038,210,120,200,240,320,0,1090
52039,190,100,160,80,160,0,690
52040,210,80,40,0,0,0,330
52041,210,160,160,160,160,0,850
52042,190,120,40,80,160,0,590
52043,190,80,80,160,320,0,830
52044,190,120,160,160,320,320,1270
52045,190,100,160,160,160,0,770
52046,160,60,40,0,0,0,260
52047,200,120,120,80,160,0,680
52048,180,80,80,80,0,0,420
52049,180,140,160,160,160,0,800
52050,190,120,80,0,0,0,390
52051,190,100,120,0,0,0,410
52052,200,160,120,160,0,0,640
52053,180,140,120,80,0,0,520
52054,200,160,120,80,0,0,560
52055,180,80,120,80,160,0,620
52056,180,120,120,0,0,0,420
52057,200,120,80,80,160,320,960
52058,210,180,40,80,160,0,670
52059,210,120,40,0,0,0,370
52060,220,160,80,80,160,0,700
52061,220,200,160,240,160,0,980
52062,210,120,120,80,160,0,690
52063,210,120,40,80,0,0,450
52064,220,120,200,320,320,320,1500
52065,170,120,120,160,320,0,890
52066,220,80,80,0,0,0,380
52067,210,120,120,160,160,0,770
52068,200,100,80,160,320,0,860
52069,180,140,80,0,0,0,400
52070,230,80,40,80,0,0,430
52071,200,80,80,80,160,0,600
52072,230,200,120,160,160,0,870
52073,200,100,160,160,160,0,780
52074,210,140,120,160,160,0,790
52075,220,120,120,80,160,320,1020
52076,180,140,120,80,0,0,520
52077,180,120,80,160,160,320,1020
52078,210,160,160,80,160,0,770
52079,250,140,160,160,160,320,1190
52080,200,140,120,160,160,0,780
52081,190,80,120,80,0,0,470
52082,150,120,80,80,0,0,430
52083,240,140,120,160,160,0,820
52084,160,160,160,240,320,0,1040
52085,180,120,120,80,160,0,660
52086,220,180,120,160,320,320,1320
52087,170,120,40,0,0,0,330
52088,250,180,160,80,0,0,670
52089,210,120,80,80,0,0,490
52090,160,120,80,0,0,0,360
52091,170,100,40,0,0,0,310
52092,200,180,160,0,0,0,540
52093,220,160,160,160,160,0,860
52094,230,100,80,80,160,0,650
52095,190,140,80,80,0,0,490
52096,210,160,120,160,160,0,810
52097,210,160,120,160,160,0,810
52098,190,40,40,80,160,0,510
52099,200,100,120,80,160,0,660
52100,200,160,120,160,320,320,1280
52101,220,160,160,160,320,320,1340
52102,170,140,160,240,0,0,710
52103,190,120,80,80,160,0,630
52104,170,80,40,80,160,0,530
52105,200,140,80,0,0,0,420
52106,170,140,80,0,0,0,390
52107,230,180,160,160,0,0,730
52108,200,140,120,80,160,0,700
52109,210,160,120,160,160,0,810
52110,170,60,40,80,160,0,510
52111,190,120,160,160,160,320,1110
52112,170,80,80,160,160,0,650
52113,180,120,120,80,160,320,980
52114,210,120,80,160,160,0,730
52115,180,140,40,80,0,0,440
52116,200,160,120,80,0,0,560
52117,180,140,160,160,160,0,800
52118,240,180,200,160,160,320,1260
52119,190,80,0,0,0,0,270
52120,210,100,160,240,160,0,870
52121,240,140,80,0,0,0,460
52122,160,140,160,80,160,0,700
52123,190,120,80,0,0,0,390
52124,170,100,160,160,160,320,1070
52125,200,160,80,160,320,0,920
52126,190,80,80,160,0,0,510
52127,200,120,120,160,160,0,760
52128,220,140,160,80,160,0,760
52129,190,120,80,80,160,0,630
52130,230,120,120,0,0,0,470
52131,230,120,80,80,0,0,510
52132,230,100,120,80,160,0,690
52133,180,120,120,80,0,0,500
52134,230,100,40,0,0,0,370
52135,200,160,200,160,0,0,720
52136,220,180,200,160,320,0,1080
52137,210,100,120,160,160,0,750
52138,190,120,160,160,160,0,790
52139,210,100,160,160,160,0,790
52140,190,60,80,0,0,0,330
52141,200,60,0,0,0,0,260
52142,170,80,40,80,0,0,370
52143,200,80,120,80,0,0,480
52144,180,180,160,240,0,0,760
52145,170,120,80,80,0,0,450
52146,200,120,120,160,320,320,1240
52147,190,180,120,80,160,320,1050
52148,200,160,120,80,160,0,720
52149,190,120,40,80,0,0,430
52150,190,60,80,0,0,0,330
52151,180,140,120,160,0,0,600
52152,170,120,200,160,160,0,810
52153,180,100,120,80,160,0,640
52154,260,120,80,0,0,0,460
52155,190,100,0,0,0,0,290
52156,160,120,120,240,160,0,800
52157,190,180,160,160,160,0,850
52158,140,120,160,160,160,0,740
52159,240,120,80,80,160,0,680
52160,180,140,160,80,160,0,720
52161,240,120,120,240,160,0,880
52162,220,180,120,160,160,0,840
52163,220,120,80,80,160,0,660
52164,200,140,160,160,0,0,660
52165,200,180,160,0,0,0,540
52166,220,120,80,80,160,0,660
52167,200,40,40,0,0,0,280
52168,200,120,120,160,160,320,1080
52169,210,100,80,80,160,0,630
52170,200,140,120,160,160,0,780
52171,170,80,160,160,160,0,730
52172,190,100,40,0,0,0,330
52173,220,140,160,80,160,0,760
52174,170,120,80,80,0,0,450
52175,210,160,200,80,0,0,650
52176,190,140,120,160,320,0,930
52177,250,140,200,160,160,0,910
52178,190,120,120,160,0,0,590
52179,160,80,80,0,0,0,320
52180,200,100,120,80,160,0,660
52181,200,60,40,80,0,0,380
52182,200,100,120,80,0,0,500
52183,140,140,120,80,160,0,640
52184,190,140,120,160,160,320,1090
52185,170,80,80,160,0,0,490
52186,240,180,120,160,0,0,700
52187,200,100,120,80,160,0,660
52188,190,160,120,80,160,320,1030
52189,190,120,160,160,160,0,790
52190,170,100,80,160,0,0,510
52191,220,100,160,240,320,0,1040
52192,190,160,120,80,160,0,710
52193,210,160,120,80,160,0,730
52194,180,120,120,240,320,320,1300
52195,200,80,80,80,160,0,600
52196,180,80,80,80,160,0,580
52197,230,100,160,160,160,0,810
52198,240,140,120,160,160,0,820
52199,190,160,120,80,0,0,550
52200,190,120,80,160,320,0,870
52201,250,120,80,0,0,0,450
52202,180,120,80,80,160,0,620
52203,210,140,160,160,160,0,830
52204,180,140,160,80,160,0,720
52205,200,160,160,80,0,0,600
52206,180,120,120,160,0,0,580
52207,210,120,160,160,160,0,810
52208,190,120,120,80,160,0,670
52209,160,120,160,240,320,0,1000
52210,180,120,120,80,0,0,500
52211,160,80,80,80,160,0,560
52212,200,120,80,160,320,0,880
52213,230,180,120,160,320,0,1010
52214,220,100,80,80,0,0,480
52215,230,140,160,160,160,0,850
52216,230,140,120,80,160,0,730
52217,200,100,120,160,0,0,580
52218,210,120,80,160,320,320,1210
52219,210,140,80,80,0,0,510
52220,150,100,80,80,160,0,570
52221,200,120,120,80,160,0,680
52222,210,120,40,80,160,320,930
52223,180,140,120,80,0,0,520
52224,140,100,120,0,0,0,360
52225,200,140,120,80,160,0,700
52226,220,180,200,160,160,0,920
52227,190,120,80,160,160,0,710
52228,140,140,160,240,320,0,1000
52229,200,140,120,160,320,0,940
52230,200,100,120,160,160,0,740
52231,200,120,160,160,160,0,800
52232,180,140,80,0,0,0,400
52233,180,100,160,160,160,0,760
52234,230,80,40,80,0,0,430
52235,220,120,40,80,160,0,620
52236,220,140,120,240,160,0,880
52237,230,120,120,0,0,0,470
52238,140,160,120,160,0,0,580
52239,190,60,80,80,160,0,570
52240,190,120,160,240,320,0,1030
52241,180,140,80,80,0,0,480
52242,250,100,40,80,0,0,470
52243,190,140,160,80,160,320,1050
52244,210,120,80,160,0,0,570
52245,180,80,160,160,320,0,900
52246,190,80,80,80,160,0,590
52247,220,200,80,160,160,320,1140
52248,210,140,120,0,0,0,470
52249,180,140,80,0,0,0,400
52250,220,140,80,0,0,0,440
52251,200,120,120,80,0,0,520
52252,180,100,160,240,160,320,1160
52253,230,160,200,80,0,0,670
52254,200,120,80,80,160,0,640
52255,210,140,120,240,160,0,870
52256,190,100,120,160,160,0,730
52257,200,120,120,80,160,0,680
52258,230,160,200,240,320,320,1470
52259,230,180,120,160,160,320,1170
52260,160,180,160,80,0,0,580
52261,160,120,80,0,0,0,360
52262,220,120,200,160,160,320,1180
52263,180,120,160,80,160,0,700
52264,220,180,160,0,0,0,560
52265,210,160,80,80,0,0,530
52266,210,120,120,80,160,320,1010
52267,200,140,80,80,0,0,500
52268,210,80,80,80,0,0,450
52269,170,80,80,0,0,0,330
52270,190,120,80,160,160,0,710
52271,210,160,120,240,160,0,890
52272,210,140,160,240,160,320,1230
52273,190,140,120,0,0,0,450
52274,170,140,80,160,160,320,1030
52275,210,60,40,80,160,0,550
52276,210,140,160,240,320,0,1070
52277,200,100,120,160,320,320,1220
52278,180,140,80,0,0,0,400
52279,160,140,80,0,0,0,380
52280,160,60,80,0,0,0,300
52281,210,160,120,160,320,0,970
52282,210,120,120,80,160,320,1010
52283,180,120,40,0,0,0,340
52284,180,200,200,160,160,320,1220
52285,230,180,120,160,0,0,690
52286,220,120,200,80,0,0,620
52287,160,120,120,160,0,0,560
52288,130,120,160,240,320,0,970
52289,180,120,120,160,320,0,900
52290,170,80,80,160,320,0,810
52291,220,80,160,160,320,320,1260
52292,190,140,120,160,160,320,1090
52293,180,120,120,80,0,0,500
52294,230,140,120,80,160,0,730
52295,180,160,120,80,160,0,700
52296,170,100,160,240,320,0,990
52297,180,140,80,80,0,0,480
52298,190,100,120,80,160,0,650
52299,170,100,120,80,160,0,630
52300,160,120,80,80,160,0,600
52301,190,120,120,80,160,320,990
52302,190,120,80,0,0,0,390
52303,180,160,120,80,160,0,700
52304,200,160,80,0,0,0,440
52305,180,60,40,0,0,0,280
52306,220,200,160,80,0,0,660
52307,210,140,160,80,160,0,750
52308,210,100,120,80,160,0,670
52309,210,180,120,80,160,0,750
52310,220,100,80,80,160,0,640
52311,210,80,120,80,160,0,650
52312,190,100,40,80,160,320,890
52313,220,160,200,240,320,0,1140
52314,230,160,80,80,160,0,710
52315,200,80,40,0,0,0,320
52316,220,140,120,160,320,0,960
52317,140,80,120,0,0,0,340
52318,190,100,40,0,0,0,330
52319,220,120,80,80,160,0,660
52320,190,100,120,80,160,0,650
52321,200,160,160,80,0,0,600
52322,200,140,80,80,160,320,980
52323,190,80,120,160,160,320,1030
52324,200,200,160,80,160,0,800
52325,180,120,120,80,0,0,500
52326,190,140,200,240,160,0,930
52327,170,120,80,80,160,0,610
52328,240,200,160,80,0,0,680
52329,170,140,160,160,160,0,790
52330,160,140,160,160,160,0,780
52331,180,120,160,0,0,0,460
52332,190,160,120,240,160,0,870
52333,180,100,40,80,0,0,400
52334,210,140,80,0,0,0,430
52335,220,160,80,0,0,0,460
52336,220,100,120,80,160,0,680
52337,220,120,120,160,160,0,780
52338,220,100,0,0,0,0,320
52339,180,100,120,80,160,0,640
52340,160,140,160,160,160,0,780
52341,160,120,120,80,160,0,640
52342,230,120,160,80,160,0,750
52343,180,120,160,80,160,0,700
52344,150,80,40,80,160,320,830
52345,200,120,120,160,160,0,760
52346,200,140,80,160,160,0,740
52347,240,120,40,80,0,0,480
52348,200,120,80,80,0,0,480
52349,210,80,80,160,320,320,1170
52350,190,160,160,80,160,320,1070
52351,150,140,160,160,160,320,1090
52352,160,120,40,0,0,0,320
52353,210,160,80,0,0,0,450
52354,240,160,200,160,160,0,920
52355,200,120,200,0,0,0,520
52356,190,140,80,80,160,0,650
52357,200,140,120,80,160,0,700
52358,170,140,240,160,160,0,870
52359,170,120,80,80,160,0,610
52360,150,160,120,0,0,0,430
52361,210,140,80,80,160,0,670
52362,180,140,200,160,320,0,1000
52363,160,100,80,80,160,0,580
52364,180,80,80,80,160,320,900
52365,240,160,160,160,0,0,720
52366,210,120,80,80,0,0,490
52367,180,100,120,160,160,320,1040
52368,190,80,40,0,0,0,310
52369,190,120,80,80,0,0,470
52370,230,140,160,80,160,0,770
52371,190,100,160,240,320,320,1330
52372,210,100,40,80,160,320,910
52373,230,120,120,80,160,0,710
52374,200,100,120,0,0,0,420
52375,190,80,80,160,160,0,670
52376,200,120,80,160,320,320,1200
52377,220,120,160,160,160,0,820
52378,170,120,40,0,0,0,330
52379,200,100,40,0,0,0,340
52380,190,120,120,80,160,0,670
52381,220,180,160,160,0,0,720
52382,180,140,120,80,0,0,520
52383,170,100,160,160,160,320,1070
52384,240,180,120,160,0,0,700
52385,210,80,40,80,160,0,570
52386,190,100,120,80,0,0,490
52387,200,120,80,160,160,0,720
52388,140,120,120,160,160,0,700
52389,230,160,80,80,160,320,1030
52390,190,120,80,0,0,0,390
52391,190,100,0,0,0,0,290
52392,210,220,200,80,0,0,710
52393,210,120,120,160,0,0,610
52394,220,140,120,160,320,0,960
52395,180,120,120,80,0,0,500
52396,230,120,80,80,0,0,510
52397,180,60,80,0,0,0,320
52398,190,80,40,80,160,0,550
52399,210,120,80,80,160,0,650
52400,190,120,120,160,160,0,750
52401,220,100,80,80,160,0,640
52402,150,100,120,80,0,0,450
52403,220,140,40,0,0,0,400
52404,190,120,80,80,160,0,630
52405,220,160,160,80,160,320,1100
52406,210,140,160,160,160,0,830
52407,170,100,120,80,160,0,630
52408,180,100,80,0,0,0,360
52409,220,200,160,160,320,0,1060
52410,150,140,120,80,160,320,970
52411,160,140,200,160,320,320,1300
52412,220,100,120,80,160,0,680
52413,190,80,40,80,0,0,390
52414,220,200,160,160,320,0,1060
52415,230,140,120,160,160,320,1130
52416,160,100,40,80,160,0,540
52417,190,120,120,80,0,0,510
52418,160,140,160,80,160,0,700
52419,210,120,80,80,160,320,970
52420,190,120,120,80,0,0,510
52421,180,120,160,80,160,0,700
52422,200,120,160,240,320,320,1360
52423,180,140,120,160,160,0,760
52424,190,140,120,160,320,320,1250
52425,240,160,120,160,160,0,840
52426,180,140,160,160,160,0,800
52427,200,100,200,160,160,320,1140
52428,200,60,120,160,0,0,540
52429,130,80,80,0,0,0,290
52430,180,140,160,240,160,0,880
52431,250,200,120,160,0,0,730
52432,210,100,120,0,0,0,430
52433,180,80,40,80,0,0,380
52434,210,80,160,80,160,0,690
52435,200,180,160,160,160,0,860
52436,170,120,80,80,0,0,450
52437,140,120,160,240,320,0,980
52438,200,100,120,0,0,0,420
52439,230,220,120,80,160,320,1130
52440,210,200,160,160,0,0,730
52441,200,140,120,80,160,0,700
52442,190,120,0,0,0,0,310
52443,200,120,0,0,0,0,320
52444,220,120,40,80,160,0,620
52445,200,180,160,160,160,0,860
52446,130,80,40,0,0,0,250
52447,190,140,160,160,0,0,650
52448,200,60,40,80,160,0,540
52449,200,140,80,80,160,320,980
52450,230,80,40,80,160,320,910
52451,210,120,40,80,0,0,450
52452,200,140,120,160,320,0,940
52453,210,120,120,160,160,0,770
52454,150,120,80,80,160,0,590
52455,180,140,120,80,0,0,520
52456,170,120,160,160,320,0,930
52457,200,160,120,80,160,0,720
52458,190,80,80,0,0,0,350
52459,150,120,40,0,0,0,310
52460,210,80,120,240,160,0,810
52461,210,120,80,160,160,0,730
52462,180,100,120,160,160,0,720
52463,220,160,120,160,0,0,660
52464,160,100,160,80,0,0,500
52465,220,180,200,80,160,0,840
52466,210,140,160,80,0,0,590
52467,130,80,40,80,0,0,330
52468,190,160,160,160,160,0,830
52469,200,120,120,0,0,0,440
52470,210,140,120,160,320,320,1270
52471,210,140,120,80,0,0,550
52472,190,100,80,80,0,0,450
52473,200,120,120,80,160,0,680
52474,190,120,120,160,320,0,910
52475,220,100,80,160,320,320,1200
52476,190,120,80,80,160,0,630
52477,190,180,240,240,160,0,1010
52478,200,160,40,80,160,320,960
52479,200,160,80,80,160,0,680
52480,180,120,160,240,160,0,860
52481,180,40,40,0,0,0,260
52482,160,120,80,80,0,0,440
52483,180,80,80,160,160,0,660
52484,220,140,120,80,0,0,560
52485,200,140,40,0,0,0,380
52486,230,120,80,80,160,0,670
52487,170,140,40,0,0,0,350
52488,260,180,160,160,0,0,760
52489,180,140,80,160,0,0,560
52490,210,140,160,160,320,0,990
52491,200,120,120,160,0,0,600
52492,230,140,120,160,160,320,1130
52493,150,60,40,80,0,0,330
52494,150,100,120,80,160,0,610
52495,220,100,120,160,160,0,760
52496,200,100,160,160,160,0,780
52497,210,140,80,160,0,0,590
52498,190,120,160,240,320,0,1030
52499,210,80,40,0,0,0,330
52500,170,100,0,0,0,0,270
52501,170,120,120,80,160,0,650
52502,190,100,120,160,320,0,890
52503,170,60,40,80,0,0,350
52504,180,160,120,160,160,0,780
52505,220,140,120,80,160,0,720
52506,170,120,120,160,320,0,890
52507,210,140,80,80,0,0,510
52508,180,120,120,160,320,0,900
52509,200,160,80,80,0,0,520
52510,190,140,160,240,320,0,1050
52511,150,120,120,80,160,0,630
52512,210,120,80,80,160,320,970
52513,190,140,160,80,0,0,570
52514,240,160,120,160,160,0,840
52515,190,80,80,80,0,0,430
52516,180,100,80,80,160,0,600
52517,190,140,120,0,0,0,450
52518,210,60,40,80,160,0,550
52519,220,140,120,80,160,0,720
52520,190,80,80,80,160,0,590
52521,220,120,40,80,160,0,620
52522,220,80,80,160,160,0,700
52523,220,60,80,0,0,0,360
52524,220,220,160,80,0,0,680
52525,180,120,120,160,160,0,740
52526,180,120,160,80,160,0,700
52527,220,160,160,160,160,0,860
52528,200,160,40,80,160,0,640
52529,200,120,160,160,320,320,1280
52530,200,140,120,80,0,0,540
52531,230,140,80,160,320,0,930
52532,210,140,160,240,160,0,910
52533,230,200,120,240,320,0,1110
52534,180,120,120,240,320,0,980
52535,240,100,80,160,320,0,900
52536,190,120,160,240,320,320,1350
52537,220,140,80,80,0,0,520
52538,170,120,80,80,160,0,610
52539,230,180,160,160,0,0,730
52540,210,120,160,0,0,0,490
52541,260,180,80,80,160,320,1080
52542,200,100,120,160,0,0,580
52543,200,100,120,160,320,0,900
52544,200,80,120,160,0,0,560
52545,180,120,80,160,320,0,860
52546,190,80,40,80,0,0,390
52547,200,120,40,80,160,0,600
52548,210,120,160,80,160,0,730
52549,210,120,80,0,0,0,410
52550,180,120,120,0,0,0,420
52551,180,60,80,160,160,320,960
52552,210,80,120,160,160,0,730
52553,150,120,80,80,0,0,430
52554,230,200,200,160,160,0,950
52555,220,180,160,80,160,0,800
52556,220,120,40,80,160,0,620
52557,190,100,120,160,0,0,570
52558,180,80,80,160,0,0,500
52559,240,140,120,80,160,0,740
52560,210,140,160,80,0,0,590
52561,210,140,40,0,0,0,390
52562,230,180,80,80,0,0,570
52563,190,100,80,160,160,0,690
52564,190,120,80,80,160,0,630
52565,200,100,80,80,160,0,620
52566,220,140,120,160,320,320,1280
52567,230,160,120,240,320,320,1390
52568,190,80,40,80,160,320,870
52569,200,180,120,160,160,0,820
52570,200,160,160,80,160,320,1080
52571,160,120,80,80,0,0,440
52572,200,60,120,240,320,320,1260
52573,190,100,80,0,0,0,370
52574,150,120,80,160,320,0,830
52575,180,100,40,80,0,0,400
52576,190,140,120,160,160,0,770
52577,250,160,40,0,0,0,450
52578,190,80,120,80,0,0,470
52579,190,120,80,80,160,0,630
52580,170,100,120,80,160,0,630
52581,190,100,80,80,160,0,610
52582,210,160,80,80,0,0,530
52583,220,100,40,0,0,0,360
52584,200,140,160,160,160,0,820
52585,220,100,160,160,160,0,800
52586,190,100,80,160,320,0,850
52587,150,80,120,80,0,0,430
52588,220,120,120,160,320,320,1260
52589,180,120,120,240,320,0,980
52590,180,140,120,80,160,0,680
52591,190,60,80,80,160,0,570
52592,200,140,80,80,160,0,660
52593,170,120,120,80,160,320,970
52594,210,160,200,240,160,0,970
52595,160,140,160,240,320,0,1020
52596,200,100,40,0,0,0,340
52597,200,120,120,0,0,0,440
52598,190,120,120,160,0,0,590
52599,170,140,120,160,160,320,1070
52600,200,160,200,80,160,0,800
52601,180,60,80,80,160,0,560
52602,220,100,120,80,160,0,680
52603,200,140,40,80,0,0,460
52604,190,120,40,0,0,0,350
52605,220,180,160,160,160,0,880
52606,180,120,120,160,160,0,740
52607,210,60,80,160,160,0,670
52608,180,80,40,80,0,0,380
52609,190,120,120,160,160,0,750
52610,210,140,40,0,0,0,390
52611,240,160,80,160,0,0,640
52612,210,140,120,80,160,0,710
52613,160,120,120,80,0,0,480
52614,180,120,120,80,0,0,500
52615,160,100,80,0,0,0,340
52616,180,120,160,80,160,0,700
52617,200,160,120,80,160,0,720
52618,180,100,160,80,160,320,1000
52619,190,100,120,80,160,320,970
52620,210,120,80,80,0,0,490
52621,200,100,160,80,160,0,700
52622,210,80,80,80,160,0,610
52623,200,140,160,160,320,0,980
52624,210,160,200,160,160,320,1210
52625,170,120,80,160,160,0,690
52626,220,140,120,0,0,0,480
52627,170,100,120,0,0,0,390
52628,230,100,80,80,160,0,650
52629,240,120,80,80,0,0,520
52630,210,100,80,80,160,0,630
52631,220,120,120,80,160,0,700
52632,170,120,80,160,160,0,690
52633,230,180,80,160,0,0,650
52634,180,100,80,80,160,0,600
52635,240,100,80,80,160,0,660
52636,160,60,120,80,160,320,900
52637,150,80,0,0,0,0,230
52638,180,100,120,80,160,0,640
52639,230,140,120,80,160,0,730
52640,190,140,160,240,320,320,1370
52641,140,60,80,80,160,0,520
52642,170,140,200,0,0,0,510
52643,150,120,80,0,0,0,350
52644,220,100,80,80,160,0,640
52645,220,100,80,0,0,0,400
52646,190,100,120,160,160,0,730
52647,190,140,80,160,160,0,730
52648,210,120,120,0,0,0,450
52649,170,120,80,80,160,320,930
52650,220,100,80,160,160,320,1040
52651,190,80,120,0,0,0,390
52652,200,140,120,80,160,0,700
52653,170,120,120,0,0,0,410
52654,190,120,120,160,160,0,750
52655,220,140,40,80,160,0,640
52656,190,120,120,80,160,320,990
52657,220,160,120,80,160,0,740
52658,200,100,120,80,160,0,660
52659,240,140,160,80,160,0,780
52660,190,80,80,80,0,0,430
52661,210,140,80,160,0,0,590
52662,200,100,120,160,320,0,900
52663,210,140,80,160,160,0,750
52664,170,140,80,80,0,0,470
52665,190,160,120,80,0,0,550
52666,170,120,120,160,0,0,570
52667,220,120,160,160,320,0,980
52668,180,160,240,240,0,0,820
52669,170,80,120,240,160,0,770
52670,190,80,0,0,0,0,270
52671,200,140,160,80,160,320,1060
52672,190,140,120,160,0,0,610
52673,200,120,120,80,0,0,520
52674,160,120,120,80,0,0,480
52675,210,120,80,0,0,0,410
52676,220,160,120,80,160,0,740
52677,210,120,80,80,160,0,650
52678,180,140,80,80,0,0,480
52679,240,100,80,80,160,0,660
52680,140,140,120,80,160,320,960
52681,180,160,120,160,160,0,780
52682,170,100,120,80,160,0,630
52683,200,40,40,0,0,0,280
52684,190,100,120,160,0,0,570
52685,230,140,40,0,0,0,410
52686,210,100,40,0,0,0,350
52687,170,180,40,0,0,0,390
52688,230,140,120,160,160,0,810
52689,220,140,120,80,160,0,720
52690,230,140,120,80,160,0,730
52691,210,180,120,160,160,0,830
52692,150,80,120,160,320,0,830
52693,210,180,240,160,160,0,950
52694,170,100,80,160,160,0,670
52695,210,140,120,160,0,0,630
52696,200,60,80,0,0,0,340
52697,230,160,160,0,0,0,550
52698,160,100,120,80,160,0,620
52699,200,140,160,240,320,320,1380
52700,170,100,40,0,0,0,310
52701,210,120,120,160,0,0,610
52702,220,160,200,160,160,0,900
52703,220,100,40,0,0,0,360
52704,210,160,80,80,0,0,530
52705,210,120,40,80,0,0,450
52706,210,140,160,240,320,0,1070
52707,190,100,120,160,0,0,570
52708,230,100,120,160,160,0,770
52709,210,120,80,0,0,0,410
52710,220,100,120,160,320,0,920
52711,210,120,160,240,320,0,1050
52712,200,160,40,80,160,0,640
52713,210,100,160,160,160,0,790
52714,220,120,80,80,0,0,500
52715,200,160,160,160,160,0,840
52716,230,160,160,80,160,0,790
52717,220,140,80,0,0,0,440
52718,210,120,40,0,0,0,370
52719,180,80,80,80,0,0,420
52720,190,100,40,0,0,0,330
52721,210,140,200,240,320,320,1430
52722,220,160,80,160,0,0,620
52723,240,140,120,80,0,0,580
52724,210,100,120,160,160,320,1070
52725,190,200,120,80,0,0,590
52726,170,120,80,80,0,0,450
52727,200,80,40,80,0,0,400
52728,160,160,160,160,320,320,1280
52729,240,100,80,160,160,320,1060
52730,170,140,160,160,320,0,950
52731,170,160,120,0,0,0,450
52732,150,80,0,0,0,0,230
52733,220,120,80,80,160,0,660
52734,220,180,160,240,320,0,1120
52735,190,100,160,80,160,0,690
52736,190,160,200,80,160,0,790
52737,240,160,160,80,0,0,640
52738,220,120,120,240,320,320,1340
52739,200,100,120,0,0,0,420
52740,260,140,80,80,0,0,560
52741,200,100,80,80,160,0,620
52742,150,120,120,160,160,0,710
52743,210,140,120,80,160,0,710
52744,160,140,120,80,160,0,660
52745,160,100,40,80,0,0,380
52746,170,140,160,160,160,0,790
52747,170,100,80,160,160,0,670
52748,160,80,120,80,160,320,920
52749,210,140,120,80,160,0,710
52750,180,80,80,160,0,0,500
52751,220,100,120,160,0,0,600
52752,230,140,0,0,0,0,370
52753,180,100,200,160,160,320,1120
52754,210,160,160,80,160,0,770
52755,210,100,80,80,0,0,470
52756,210,100,80,80,160,0,630
52757,190,80,80,160,320,0,830
52758,210,200,80,0,0,0,490
52759,200,140,80,0,0,0,420
52760,210,160,200,240,160,320,1290
52761,130,80,120,160,160,320,970
52762,240,120,80,160,320,320,1240
52763,200,120,120,80,160,0,680
52764,180,80,120,160,160,0,700
52765,230,180,160,80,0,0,650
52766,160,100,160,160,320,0,900
52767,190,80,80,0,0,0,350
52768,220,140,120,0,0,0,480
52769,210,160,160,80,160,0,770
52770,210,140,160,160,0,0,670
52771,220,100,120,160,320,0,920
52772,180,140,120,160,160,0,760
52773,240,140,200,80,160,320,1140
52774,180,120,120,80,160,0,660
52775,190,160,160,160,0,0,670
52776,210,160,120,160,160,320,1130
52777,200,100,80,80,160,0,620
52778,180,140,80,160,320,0,880
52779,170,100,120,80,160,0,630
52780,180,80,40,0,0,0,300
52781,190,120,80,80,160,0,630
52782,180,120,120,80,160,0,660
52783,210,160,80,80,160,0,690
52784,200,100,40,80,0,0,420
52785,180,120,80,80,160,0,620
52786,190,100,160,240,320,320,1330
52787,170,100,80,160,160,0,670
52788,180,100,120,80,0,0,480
52789,170,120,160,160,160,0,770
52790,230,140,120,160,160,0,810
52791,230,180,120,160,160,0,850
52792,210,140,80,160,320,320,1230
52793,200,140,200,160,0,0,700
52794,210,140,160,160,160,320,1150
52795,200,120,80,80,160,0,640
52796,160,100,80,0,0,0,340
52797,200,140,120,0,0,0,460
52798,160,140,120,80,0,0,500
52799,190,120,80,80,0,0,470
52800,250,160,160,160,160,0,890
52801,200,160,120,80,160,0,720
52802,190,120,160,80,0,0,550
52803,240,140,40,0,0,0,420
52804,210,60,120,160,160,0,710
52805,180,80,80,0,0,0,340
52806,230,120,160,160,0,0,670
52807,180,120,160,160,160,0,780
52808,230,180,80,80,160,0,730
52809,180,60,80,80,0,0,400
52810,200,120,80,160,320,0,880
52811,220,140,120,80,160,0,720
52812,230,80,120,160,320,0,910
52813,200,100,120,80,160,0,660
52814,190,80,80,80,160,0,590
52815,180,40,40,80,0,0,340
52816,190,140,160,0,0,0,490
52817,180,120,120,0,0,0,420
52818,170,140,120,80,160,0,670
52819,220,160,120,80,0,0,580
52820,210,160,120,80,160,320,1050
52821,170,120,120,160,160,320,1050
52822,200,140,120,80,160,0,700
52823,180,100,120,0,0,0,400
52824,230,160,120,160,160,0,830
52825,210,140,80,80,160,0,670
52826,180,140,120,240,160,0,840
52827,190,80,40,0,0,0,310
52828,220,120,200,160,160,0,860
52829,200,100,160,80,0,0,540
52830,200,140,80,80,160,320,980
52831,160,80,80,80,160,0,560
52832,190,140,120,80,160,320,1010
52833,170,100,120,80,160,0,630
52834,190,100,80,0,0,0,370
52835,200,100,80,80,160,320,940
52836,200,100,40,0,0,0,340
52837,200,120,0,0,0,0,320
52838,170,120,120,0,0,0,410
52839,200,120,160,80,160,0,720
52840,190,80,80,0,0,0,350
52841,210,100,80,160,160,0,710
52842,200,100,160,160,160,0,780
52843,180,80,120,80,160,0,620
52844,230,100,120,240,320,0,1010
52845,200,100,40,80,160,0,580
52846,200,60,0,0,0,0,260
52847,220,100,120,160,320,0,920
52848,220,140,80,0,0,0,440
52849,220,80,120,80,160,320,980
52850,230,120,160,240,0,0,750
52851,200,120,120,160,160,0,760
52852,180,100,120,160,160,320,1040
52853,220,100,40,80,160,320,920
52854,180,140,120,160,160,0,760
52855,210,140,80,0,0,0,430
52856,220,140,120,80,160,0,720
52857,200,120,160,80,0,0,560
52858,230,140,160,160,320,0,1010
52859,170,120,120,80,0,0,490
52860,180,80,40,80,160,0,540
52861,160,140,120,80,160,0,660
52862,180,80,40,80,160,0,540
52863,210,160,120,80,160,0,730
52864,270,100,80,0,0,0,450
52865,170,80,160,0,0,0,410
52866,180,140,80,80,160,0,640
52867,200,100,80,80,0,0,460
52868,180,100,120,160,0,0,560
52869,140,100,120,160,160,0,680
52870,200,100,120,0,0,0,420
52871,180,140,80,0,0,0,400
52872,250,80,80,80,0,0,490
52873,200,140,200,80,160,0,780
52874,210,120,40,80,160,0,610
52875,210,180,160,0,0,0,550
52876,200,80,40,80,160,0,560
52877,190,120,120,160,0,0,590
52878,250,100,80,80,160,0,670
52879,170,120,120,160,160,0,730
52880,190,120,80,0,0,0,390
52881,180,180,120,80,0,0,560
52882,180,100,80,80,160,0,600
52883,250,120,0,0,0,0,370
52884,170,160,160,160,160,0,810
52885,230,100,80,160,0,0,570
52886,220,120,160,240,160,0,900
52887,210,120,80,80,160,320,970
52888,240,120,120,0,0,0,480
52889,190,80,80,80,0,0,430
52890,150,100,120,160,160,0,690
52891,190,120,80,160,160,0,710
52892,150,80,40,0,0,0,270
52893,190,80,80,80,160,0,590
52894,180,100,120,160,160,0,720
52895,210,120,40,0,0,0,370
52896,150,80,80,80,160,0,550
52897,160,100,80,0,0,0,340
52898,210,60,40,0,0,0,310
52899,190,140,120,240,160,0,850
52900,210,120,160,240,160,0,890
52901,180,100,120,80,160,320,960
52902,180,100,40,80,0,0,400
52903,210,80,120,160,0,0,570
52904,190,120,40,0,0,0,350
52905,170,120,120,160,160,320,1050
52906,220,120,80,160,160,0,740
52907,240,100,80,160,320,0,900
52908,240,160,120,240,160,0,920
52909,150,60,80,80,0,0,370
52910,180,80,80,0,0,0,340
52911,200,120,40,0,0,0,360
52912,190,100,40,80,160,0,570
52913,220,160,120,0,0,0,500
52914,170,60,80,0,0,0,310
52915,150,60,40,80,160,0,490
52916,190,160,160,80,160,0,750
52917,160,120,160,160,160,320,1080
52918,210,120,200,80,160,0,770
52919,190,100,80,80,0,0,450
52920,210,120,120,80,160,0,690
52921,200,120,120,160,320,0,920
52922,170,60,80,80,0,0,390
52923,210,160,200,80,160,0,810
52924,190,100,160,80,160,0,690
52925,210,140,120,160,160,0,790
52926,170,120,200,80,0,0,570
52927,240,140,40,80,160,0,660
52928,190,120,120,160,0,0,590
52929,170,40,40,80,160,320,810
52930,220,140,40,0,0,0,400
52931,190,140,40,0,0,0,370
52932,170,80,80,80,160,0,570
52933,190,140,120,240,160,0,850
52934,210,60,80,80,160,0,590
52935,180,180,160,80,0,0,600
52936,170,140,80,80,0,0,470
52937,170,100,40,80,0,0,390
52938,200,100,120,80,0,0,500
52939,180,100,80,80,160,320,920
52940,200,140,200,80,160,0,780
52941,230,100,120,160,320,0,930
52942,230,100,120,160,160,0,770
52943,160,120,200,160,320,0,960
52944,200,160,80,80,160,0,680
52945,220,120,120,240,160,320,1180
52946,230,160,160,80,160,320,1110
52947,190,160,80,80,160,0,670
52948,170,140,160,160,160,0,790
52949,170,100,40,80,0,0,390
52950,170,140,160,160,0,0,630
52951,150,120,120,80,160,0,630
52952,180,120,80,80,160,0,620
52953,210,120,160,0,0,0,490
52954,210,60,80,80,160,0,590
52955,190,80,40,80,160,0,550
52956,190,180,40,80,160,0,650
52957,180,100,80,80,0,0,440
52958,180,140,200,240,160,0,920
52959,190,160,160,160,0,0,670
52960,210,160,120,80,160,320,1050
52961,220,140,160,160,160,0,840
52962,220,120,80,0,0,0,420
52963,200,80,120,160,0,0,560
52964,250,100,80,80,160,0,670
52965,190,160,120,160,160,0,790
52966,180,140,80,80,160,0,640
52967,200,100,80,80,160,0,620
52968,180,160,120,80,0,0,540
52969,200,100,40,0,0,0,340
52970,170,160,160,80,160,0,730
52971,220,100,80,80,0,0,480
52972,200,140,120,160,0,0,620
52973,170,100,120,80,160,0,630
52974,230,180,120,160,160,320,1170
52975,220,100,80,0,0,0,400
52976,270,140,80,160,0,0,650
52977,170,140,120,0,0,0,430
52978,210,140,160,240,160,0,910
52979,210,140,160,240,160,320,1230
52980,210,140,160,0,0,0,510
52981,210,140,160,240,320,320,1390
52982,170,100,120,0,0,0,390
52983,220,140,160,80,0,0,600
52984,150,100,40,0,0,0,290
52985,170,120,120,80,0,0,490
52986,230,60,80,80,0,0,450
52987,160,100,120,160,320,0,860
52988,190,180,80,80,160,0,690
52989,200,120,80,80,0,0,480
52990,190,140,120,160,0,0,610
52991,190,140,40,80,0,0,450
52992,200,100,40,0,0,0,340
52993,220,200,160,160,320,0,1060
52994,190,100,40,80,160,0,570
52995,180,140,160,80,160,320,1040
52996,190,80,120,80,160,0,630
52997,220,140,120,80,0,0,560
52998,180,140,80,0,0,0,400
52999,230,160,200,160,0,0,750
53000,180,100,120,160,320,320,1200
53001,190,140,120,160,160,0,770
53002,210,100,160,160,0,0,630
53003,170,100,80,80,0,0,430
53004,180,100,160,80,160,320,1000
53005,220,120,80,160,320,0,900
53006,230,80,80,80,160,320,950
53007,220,60,80,80,0,0,440
53008,210,160,160,160,320,0,1010
53009,200,100,80,0,0,0,380
53010,170,160,200,80,0,0,610
53011,200,120,80,0,0,0,400
53012,220,180,80,0,0,0,480
53013,230,200,120,80,160,0,790
53014,230,160,160,240,160,320,1270
53015,260,180,160,160,160,0,920
53016,230,120,160,160,320,320,1310
53017,220,160,120,0,0,0,500
53018,220,200,240,80,0,0,740
53019,200,100,80,80,0,0,460
53020,210,140,80,80,160,0,670
53021,150,120,160,240,0,0,670
53022,180,120,160,80,0,0,540
53023,180,100,80,80,160,0,600
53024,180,120,80,160,320,0,860
53025,210,100,120,80,0,0,510
53026,220,140,160,160,320,0,1000
53027,180,40,0,0,0,0,220
53028,160,120,120,160,160,0,720
53029,230,180,120,80,160,0,770
53030,220,80,80,160,320,0,860
53031,190,120,160,160,160,0,790
53032,190,80,80,160,320,0,830
53033,210,100,40,80,0,0,430
53034,230,100,80,160,0,0,570
53035,180,80,80,80,0,0,420
53036,170,100,160,240,320,320,1310
53037,190,100,80,160,320,0,850
53038,200,140,80,0,0,0,420
53039,240,120,80,0,0,0,440
53040,170,120,120,160,160,0,730
53041,190,140,120,240,320,0,1010
53042,190,120,120,80,160,0,670
53043,230,100,80,0,0,0,410
53044,230,160,120,160,160,0,830
53045,210,120,120,80,0,0,530
53046,190,140,160,0,0,0,490
53047,210,180,120,160,0,0,670
53048,200,100,80,0,0,0,380
53049,210,120,80,0,0,0,410
53050,200,120,160,80,0,0,560
53051,230,100,160,160,0,0,650
53052,200,80,120,160,0,0,560
53053,220,80,80,80,0,0,460
53054,170,60,80,80,0,0,390
53055,170,140,200,160,320,0,990
53056,200,140,200,160,160,320,1180
53057,210,140,160,80,160,0,750
53058,190,140,40,0,0,0,370
53059,190,100,120,160,160,0,730
53060,190,120,120,80,160,0,670
53061,180,160,160,80,0,0,580
53062,200,100,120,80,160,0,660
53063,170,120,160,160,160,0,770
53064,160,160,120,160,160,0,760
53065,200,120,80,80,160,0,640
53066,170,100,120,80,160,0,630
53067,150,140,120,80,0,0,490
53068,160,100,80,80,0,0,420
53069,200,140,80,80,0,0,500
53070,200,140,160,240,320,0,1060
53071,200,140,160,240,160,0,900
53072,250,120,160,160,320,320,1330
53073,220,160,160,80,160,0,780
53074,230,140,120,80,0,0,570
53075,200,200,160,80,160,0,800
53076,190,100,80,160,160,0,690
53077,210,160,120,80,160,320,1050
53078,180,140,120,0,0,0,440
53079,180,60,40,80,160,0,520
53080,190,160,80,80,0,0,510
53081,190,100,160,240,160,0,850
53082,230,160,160,80,0,0,630
53083,210,180,80,80,160,0,710
53084,190,80,40,80,160,0,550
53085,170,100,80,0,0,0,350
53086,200,160,160,160,160,0,840
53087,180,160,200,240,160,0,940
53088,160,140,200,160,160,320,1140
53089,200,140,120,80,160,0,700
53090,200,20,40,80,0,0,340
53091,170,120,80,160,160,0,690
53092,200,120,120,160,160,0,760
53093,200,120,120,160,320,320,1240
53094,190,40,40,80,160,0,510
53095,200,120,80,160,160,320,1040
53096,220,140,80,0,0,0,440
53097,180,140,160,80,160,0,720
53098,160,120,160,160,320,320,1240
53099,230,80,40,80,0,0,430
53100,160,120,120,240,160,0,800
53101,180,140,160,0,0,0,480
53102,160,120,120,160,0,0,560
53103,210,120,80,80,160,0,650
53104,180,100,80,80,160,0,600
53105,200,140,80,80,0,0,500
53106,160,160,120,160,160,0,760
53107,200,80,80,0,0,0,360
53108,200,120,80,160,0,0,560
53109,160,140,200,160,160,0,820
53110,220,120,120,80,160,0,700
53111,220,200,120,160,320,320,1340
53112,230,120,80,80,0,0,510
53113,210,160,80,160,320,0,930
53114,220,140,80,160,320,0,920
53115,210,100,80,160,0,0,550
53116,190,100,80,80,160,0,610
53117,190,160,160,80,0,0,590
53118,160,140,160,240,320,0,1020
53119,210,140,40,0,0,0,390
53120,220,140,120,80,160,0,720
53121,230,160,160,240,320,0,1110
53122,210,140,80,0,0,0,430
53123,150,120,120,80,160,0,630
53124,170,120,80,80,160,0,610
53125,170,80,80,80,0,0,410
53126,170,100,80,80,160,0,590
53127,190,140,120,0,0,0,450
53128,190,120,160,240,320,0,1030
53129,200,120,120,160,160,0,760
53130,180,160,120,240,160,0,860
53131,190,160,160,160,160,0,830
53132,240,160,40,80,160,320,1000
53133,180,120,80,80,0,0,460
53134,170,120,120,80,160,0,650
53135,210,120,80,160,320,0,890
53136,190,120,80,80,0,0,470
53137,200,60,40,80,160,0,540
53138,190,100,120,240,160,0,810
53139,240,160,160,80,160,0,800
53140,220,100,80,160,0,0,560
53141,230,120,120,160,160,320,1110
53142,210,120,40,0,0,0,370
53143,220,140,80,80,160,0,680
53144,180,80,80,80,160,0,580
53145,160,180,160,160,160,0,820
53146,190,120,80,80,0,0,470
53147,200,120,80,80,0,0,480
53148,170,120,120,80,160,0,650
53149,180,140,120,160,160,0,760
53150,160,100,80,80,0,0,420
53151,190,80,120,240,160,0,790
53152,190,140,120,240,0,0,690
53153,200,160,120,0,0,0,480
53154,190,120,80,80,0,0,470
53155,190,160,80,80,160,320,990
53156,200,100,80,80,160,0,620
53157,170,120,120,160,160,320,1050
53158,160,180,240,80,160,0,820
53159,190,220,240,80,0,0,730
53160,220,120,40,80,160,0,620
53161,190,120,80,80,0,0,470
53162,220,140,160,160,160,0,840
53163,180,140,200,160,0,0,680
53164,220,140,120,0,0,0,480
53165,210,120,80,160,320,0,890
53166,250,100,120,160,160,0,790
53167,170,80,120,80,0,0,450
53168,230,160,120,160,160,0,830
53169,200,140,80,80,0,0,500
53170,190,120,40,80,0,0,430
53171,240,180,120,160,160,0,860
53172,220,140,160,160,320,0,1000
53173,210,100,120,80,160,320,990
53174,190,180,80,160,320,320,1250
53175,210,100,80,80,0,0,470
53176,210,120,80,160,320,0,890
53177,240,180,160,80,0,0,660
53178,220,100,40,0,0,0,360
53179,190,140,160,160,0,0,650
53180,160,40,80,0,0,0,280
53181,190,100,80,80,0,0,450
53182,240,100,80,160,160,0,740
53183,200,160,160,160,160,0,840
53184,210,120,160,160,160,0,810
53185,150,80,120,160,160,0,670
53186,210,80,0,0,0,0,290
53187,200,140,80,80,160,0,660
53188,230,180,160,240,320,0,1130
53189,180,100,120,80,0,0,480
53190,190,140,160,160,160,0,810
53191,150,140,120,160,160,0,730
53192,150,100,80,80,160,0,570
53193,190,120,120,80,0,0,510
53194,200,140,200,160,160,0,860
53195,240,120,160,80,0,0,600
53196,220,180,160,160,160,320,1200
53197,170,120,120,80,160,0,650
53198,220,120,80,0,0,0,420
53199,220,140,80,80,160,0,680
53200,190,60,80,160,320,0,810
53201,210,120,160,160,0,0,650
53202,200,80,40,80,160,0,560
53203,200,80,160,160,0,0,600
53204,160,80,80,80,160,320,880
53205,190,160,120,80,160,320,1030
53206,200,120,40,0,0,0,360
53207,150,100,40,80,160,320,850
53208,210,60,40,80,160,0,550
53209,200,100,80,80,160,0,620
53210,220,140,120,80,160,0,720
53211,190,180,200,160,0,0,730
53212,190,120,120,80,0,0,510
53213,190,180,160,80,0,0,610
53214,200,100,40,80,160,0,580
53215,160,100,120,160,160,0,700
53216,220,160,200,160,0,0,740
53217,200,140,160,80,0,0,580
53218,230,100,120,80,160,0,690
53219,210,100,160,80,160,0,710
53220,140,100,120,80,160,0,600
53221,210,120,120,240,0,0,690
53222,190,100,80,80,160,0,610
53223,240,120,80,80,0,0,520
53224,180,60,80,80,0,0,400
53225,210,140,80,0,0,0,430
53226,210,140,120,80,0,0,550
53227,200,140,80,80,160,0,660
53228,210,100,80,80,160,0,630
53229,240,160,160,80,160,0,800
53230,240,140,160,80,160,0,780
53231,170,140,200,240,160,0,910
53232,190,140,40,80,160,320,930
53233,200,140,80,0,0,0,420
53234,210,160,200,160,160,0,890
53235,210,160,120,80,160,0,730
53236,240,200,200,80,160,0,880
53237,210,120,120,160,160,0,770
53238,220,100,160,160,160,0,800
53239,170,60,80,80,160,0,550
53240,240,100,80,0,0,0,420
53241,190,60,80,80,0,0,410
53242,220,160,120,80,0,0,580
53243,210,120,80,160,160,0,730
53244,190,120,160,160,320,320,1270
53245,160,120,160,80,0,0,520
53246,240,80,80,80,160,0,640
53247,180,120,80,80,0,0,460
53248,160,80,0,0,0,0,240
53249,180,140,160,160,0,0,640
53250,200,160,160,160,160,320,1160
53251,160,80,80,160,320,0,800
53252,210,120,80,0,0,0,410
53253,180,100,40,80,160,0,560
53254,170,140,160,80,160,320,1030
53255,230,80,40,0,0,0,350
53256,140,80,120,80,160,0,580
53257,180,60,80,80,0,0,400
53258,230,120,120,160,160,320,1110
53259,190,120,160,0,0,0,470
53260,140,100,40,80,160,320,840
53261,180,100,40,80,0,0,400
53262,190,100,120,160,160,0,730
53263,180,80,40,0,0,0,300
53264,170,120,80,0,0,0,370
53265,170,120,160,160,320,0,930
53266,200,160,40,0,0,0,400
53267,150,100,120,80,0,0,450
53268,250,140,120,80,160,0,750
53269,170,120,40,80,160,0,570
53270,250,160,40,80,160,0,690
53271,160,140,40,0,0,0,340
53272,180,120,120,160,160,0,740
53273,200,160,80,0,0,0,440
53274,190,140,120,160,160,0,770
53275,220,160,200,0,0,0,580
53276,220,140,120,80,0,0,560
53277,230,140,160,160,160,320,1170
53278,220,160,120,80,0,0,580
53279,220,140,120,80,160,320,1040
53280,210,200,160,0,0,0,570
53281,210,80,80,160,320,320,1170
53282,220,160,80,80,160,0,700
53283,200,100,120,160,320,0,900
53284,180,140,80,80,160,0,640
53285,200,100,160,160,160,0,780
53286,160,160,120,80,0,0,520
53287,210,80,120,160,160,0,730
53288,240,140,120,160,0,0,660
53289,200,120,160,160,320,0,960
53290,190,160,200,240,160,320,1270
53291,160,60,80,80,160,0,540
53292,220,160,160,160,160,320,1180
53293,200,100,160,80,160,0,700
53294,200,120,120,240,160,0,840
53295,180,160,80,80,160,0,660
53296,210,100,120,160,160,0,750
53297,180,140,40,80,160,0,600
53298,150,120,120,0,0,0,390
53299,220,160,160,0,0,0,540
53300,210,160,120,160,320,0,970
53301,150,100,80,80,160,0,570
53302,180,180,40,80,160,0,640
53303,200,140,120,160,0,0,620
53304,230,160,200,240,320,320,1470
53305,190,100,80,160,0,0,530
53306,180,80,120,160,160,0,700
53307,240,160,120,160,320,0,1000
53308,210,120,200,240,0,0,770
53309,180,140,120,80,160,0,680
53310,190,160,80,160,160,0,750
53311,200,120,120,160,160,320,1080
53312,200,120,120,160,160,0,760
53313,190,120,160,160,160,0,790
53314,190,180,80,160,160,0,770
53315,190,140,160,80,0,0,570
53316,190,140,120,80,160,0,690
53317,180,120,120,80,0,0,500
53318,200,80,120,160,160,0,720
53319,210,160,120,160,320,320,1290
53320,240,140,40,0,0,0,420
53321,210,200,120,80,0,0,610
53322,210,120,160,240,320,0,1050
53323,210,100,80,160,320,320,1190
53324,180,100,120,80,160,320,960
53325,200,100,80,80,160,320,940
53326,190,120,120,160,320,0,910
53327,170,100,40,80,160,0,550
53328,190,100,80,80,160,320,930
53329,170,100,80,80,0,0,430
53330,180,160,160,160,160,0,820
53331,180,120,120,80,160,0,660
53332,200,140,160,160,320,0,980
53333,180,120,80,160,160,320,1020
53334,180,160,160,80,160,320,1060
53335,160,100,40,80,160,320,860
53336,230,160,120,0,0,0,510
53337,230,120,40,80,160,0,630
53338,200,140,200,0,0,0,540
53339,190,100,120,160,0,0,570
53340,180,120,80,80,160,0,620
53341,220,120,80,80,0,0,500
53342,210,140,120,80,0,0,550
53343,220,140,120,160,0,0,640
53344,160,100,80,80,0,0,420
53345,230,140,200,160,320,0,1050
53346,200,120,160,160,160,320,1120
53347,180,120,160,80,160,320,1020
53348,210,100,160,160,320,0,950
53349,230,200,160,80,0,0,670
53350,230,160,80,80,0,0,550
53351,240,140,80,80,160,0,700
53352,190,80,40,80,160,320,870
53353,200,120,160,240,160,0,880
53354,240,120,120,160,0,0,640
53355,180,100,120,80,0,0,480
53356,160,80,80,0,0,0,320
53357,180,60,80,80,0,0,400
53358,200,140,160,240,160,0,900
53359,220,200,200,160,0,0,780
53360,160,60,80,80,0,0,380
53361,230,100,80,160,160,0,730
53362,150,60,80,0,0,0,290
53363,190,160,120,80,160,0,710
53364,190,140,120,80,160,0,690
53365,150,120,120,160,160,0,710
53366,170,160,160,0,0,0,490
53367,170,140,120,160,0,0,590
53368,210,140,120,80,0,0,550
53369,210,120,160,80,160,0,730
53370,170,140,120,80,160,0,670
53371,250,140,120,160,320,0,990
53372,160,120,160,80,160,0,680
53373,180,100,80,0,0,0,360
53374,200,120,80,80,160,0,640
53375,160,80,40,80,0,0,360
53376,200,120,120,240,320,0,1000
53377,210,140,200,160,320,0,1030
53378,190,120,120,160,160,0,750
53379,190,100,40,80,160,0,570
53380,180,160,80,80,160,0,660
53381,180,140,40,80,160,0,600
53382,180,100,80,80,160,0,600
53383,180,100,120,80,0,0,480
53384,190,160,160,160,160,320,1150
53385,220,120,80,80,160,0,660
53386,170,160,120,160,160,0,770
53387,200,140,120,0,0,0,460
53388,180,160,120,0,0,0,460
53389,180,100,120,160,160,0,720
53390,190,140,160,160,160,0,810
53391,180,80,40,0,0,0,300
53392,190,140,80,80,160,0,650
53393,190,60,80,160,160,0,650
53394,200,80,40,0,0,0,320
53395,220,180,120,0,0,0,520
53396,160,60,120,240,160,0,740
53397,210,120,160,240,160,0,890
53398,190,120,80,0,0,0,390
53399,210,100,120,160,160,320,1070
53400,160,140,120,80,160,0,660
53401,150,140,80,80,0,0,450
53402,150,80,80,80,0,0,390
53403,200,100,120,160,320,320,1220
53404,160,80,120,160,160,320,1000
53405,210,100,120,80,160,0,670
53406,220,140,80,80,160,0,680
53407,210,140,80,0,0,0,430
53408,200,120,160,80,0,0,560
53409,200,120,120,80,160,0,680
53410,190,100,120,80,160,0,650
53411,160,100,80,160,160,0,660
53412,170,80,0,0,0,0,250
53413,220,180,160,160,160,0,880
53414,200,140,80,80,160,0,660
53415,200,160,120,80,160,0,720
53416,210,120,120,240,160,0,850
53417,200,120,120,160,320,0,920
53418,220,140,80,80,160,0,680
53419,210,120,80,80,0,0,490
53420,180,180,200,80,0,0,640
53421,190,160,120,80,160,0,710
53422,200,100,40,0,0,0,340
53423,210,140,120,240,160,0,870
53424,220,60,40,80,0,0,400
53425,190,100,120,0,0,0,410
53426,190,60,80,0,0,0,330
53427,210,80,80,0,0,0,370
53428,190,160,200,160,160,320,1190
53429,220,40,0,0,0,0,260
53430,220,200,120,160,160,0,860
53431,240,140,80,160,160,320,1100
53432,250,160,120,80,0,0,610
53433,200,120,160,160,320,0,960
53434,230,180,200,160,0,0,770
53435,210,200,200,80,0,0,690
53436,280,160,80,0,0,0,520
53437,230,180,40,0,0,0,450
53438,180,140,160,80,160,0,720
53439,160,140,160,160,160,0,780
53440,180,80,80,80,160,0,580
53441,210,140,120,80,160,320,1030
53442,180,140,120,80,160,0,680
53443,190,140,120,160,160,0,770
53444,170,120,160,80,0,0,530
53445,220,140,160,160,0,0,680
53446,190,140,120,80,160,320,1010
53447,190,120,120,80,160,0,670
53448,190,80,80,160,160,320,990
53449,160,60,40,80,160,320,820
53450,250,140,160,240,160,0,950
53451,200,80,40,80,160,0,560
53452,220,140,120,0,0,0,480
53453,210,140,80,80,0,0,510
53454,220,160,120,160,320,320,1300
53455,220,180,160,80,160,0,800
53456,220,100,120,0,0,0,440
53457,200,120,80,80,0,0,480
53458,180,100,40,0,0,0,320
53459,200,120,120,80,160,0,680
53460,170,140,80,80,160,0,630
53461,170,100,80,80,160,0,590
53462,190,100,160,0,0,0,450
53463,200,60,40,80,0,0,380
53464,210,100,80,80,160,0,630
53465,200,120,120,160,160,0,760
53466,170,140,200,240,320,320,1390
53467,170,140,160,160,160,320,1110
53468,210,120,120,240,160,0,850
53469,170,140,80,0,0,0,390
53470,200,140,120,160,0,0,620
53471,180,60,80,80,0,0,400
53472,190,100,120,0,0,0,410
53473,210,140,200,160,160,320,1190
53474,210,140,120,160,0,0,630
53475,220,160,80,0,0,0,460
53476,220,120,120,160,160,0,780
53477,160,140,160,80,160,0,700
53478,190,100,160,80,0,0,530
53479,190,140,120,80,160,0,690
53480,250,140,120,160,160,0,830
53481,210,160,80,80,160,0,690
53482,220,80,40,0,0,0,340
53483,170,100,120,160,160,0,710
53484,230,120,80,160,320,0,910
53485,180,180,160,80,160,320,1080
53486,180,140,120,160,160,320,1080
53487,230,80,80,0,0,0,390
53488,240,200,120,160,160,320,1200
53489,250,100,80,160,160,0,750
53490,210,140,120,160,0,0,630
53491,190,120,120,80,160,0,670
53492,170,100,160,160,160,0,750
53493,180,120,80,80,160,320,940
53494,200,120,120,80,160,0,680
53495,190,140,120,160,0,0,610
53496,160,160,160,160,160,0,800
53497,210,100,80,80,160,0,630
53498,150,120,120,80,0,0,470
53499,190,120,120,0,0,0,430
53500,180,100,160,80,160,0,680
53501,180,160,160,160,320,0,980
53502,200,80,80,80,0,0,440
53503,210,100,40,0,0,0,350
53504,180,100,120,160,160,0,720
53505,200,100,80,80,160,0,620
53506,150,120,120,80,0,0,470
53507,190,120,120,80,160,0,670
53508,160,140,120,80,0,0,500
53509,190,140,160,240,160,320,1210
53510,220,120,160,160,160,0,820
53511,240,80,120,0,0,0,440
53512,210,160,80,80,160,0,690
53513,210,140,120,160,160,0,790
53514,200,140,160,160,320,0,980
53515,150,120,160,160,160,0,750
53516,160,160,120,160,160,320,1080
53517,210,180,80,160,320,0,950
53518,170,80,80,80,0,0,410
53519,210,60,80,0,0,0,350
53520,150,20,0,0,0,0,170
53521,240,200,160,80,0,0,680
53522,150,60,80,80,0,0,370
53523,190,100,40,80,160,0,570
53524,180,120,80,160,0,0,540
53525,180,120,40,0,0,0,340
53526,230,120,80,80,160,0,670
53527,170,60,0,0,0,0,230
53528,180,100,80,160,320,0,840
53529,240,120,120,80,160,0,720
53530,170,120,40,80,0,0,410
53531,180,140,160,80,160,0,720
53532,190,160,160,80,160,0,750
53533,180,120,80,80,160,320,940
53534,210,120,120,0,0,0,450
53535,170,100,120,80,0,0,470
53536,260,180,120,80,160,0,800
53537,190,100,40,80,160,0,570
53538,150,100,120,0,0,0,370
53539,170,180,40,80,0,0,470
53540,210,140,160,80,160,0,750
53541,220,140,160,240,160,0,920
53542,170,140,160,240,160,320,1190
53543,200,140,120,240,160,0,860
53544,180,100,160,80,160,0,680
53545,210,140,120,80,160,0,710
53546,210,120,80,80,160,320,970
53547,250,120,80,160,160,0,770
53548,180,200,280,240,0,0,900
53549,210,140,80,80,0,0,510
53550,200,120,120,160,320,0,920
53551,210,140,80,80,160,0,670
53552,180,160,120,160,320,320,1260
53553,200,160,120,160,160,0,800
53554,250,80,120,0,0,0,450
53555,190,180,120,240,160,0,890
53556,230,180,160,80,160,0,810
53557,180,120,120,160,0,0,580
53558,210,100,160,160,160,320,1110
53559,220,160,120,80,0,0,580
53560,160,120,120,160,160,0,720
53561,240,140,160,80,0,0,620
53562,140,120,80,0,0,0,340
53563,230,160,200,160,160,320,1230
53564,180,160,40,80,0,0,460
53565,170,120,40,0,0,0,330
53566,140,60,40,0,0,0,240
53567,210,120,120,160,160,0,770
53568,200,140,80,160,0,0,580
53569,180,120,40,80,0,0,420
53570,250,60,80,80,160,320,950
53571,190,100,120,160,160,320,1050
53572,200,100,80,80,160,0,620
53573,150,120,120,0,0,0,390
53574,200,180,120,160,160,0,820
53575,190,80,80,160,160,0,670
53576,210,140,120,240,0,0,710
53577,180,120,120,80,0,0,500
53578,210,200,160,0,0,0,570
53579,200,120,120,240,320,0,1000
53580,230,120,80,80,0,0,510
53581,150,100,80,160,320,320,1130
53582,240,140,80,160,160,0,780
53583,210,140,120,160,320,0,950
53584,240,160,120,160,0,0,680
53585,190,100,40,0,0,0,330
53586,220,200,160,160,0,0,740
53587,180,140,80,80,160,0,640
53588,180,140,160,160,320,0,960
53589,200,180,80,80,160,0,700
53590,190,80,120,160,0,0,550
53591,160,160,120,160,0,0,600
53592,170,100,80,0,0,0,350
53593,190,120,120,160,160,0,750
53594,220,80,40,0,0,0,340
53595,220,120,120,80,0,0,540
53596,170,60,40,80,160,0,510
53597,180,60,120,160,320,320,1160
53598,140,100,80,80,0,0,400
53599,230,200,160,160,160,0,910
53600,220,60,0,0,0,0,280
53601,160,100,80,80,160,320,900
53602,180,140,80,0,0,0,400
53603,210,100,160,160,0,0,630
53604,180,120,120,80,160,0,660
53605,200,180,120,160,160,0,820
53606,200,160,80,160,160,0,760
53607,220,160,120,80,0,0,580
53608,180,140,160,160,160,0,800
53609,200,80,0,0,0,0,280
53610,190,200,200,80,0,0,670
53611,200,100,120,80,0,0,500
53612,190,100,80,80,160,0,610
53613,210,120,160,80,0,0,570
53614,210,140,120,80,160,320,1030
53615,210,120,160,160,160,0,810
53616,200,80,120,80,0,0,480
53617,220,100,80,80,160,0,640
53618,210,160,120,160,160,0,810
53619,200,140,120,160,0,0,620
53620,220,120,160,240,320,0,1060
53621,200,140,120,160,0,0,620
53622,140,120,160,0,0,0,420
53623,180,160,160,80,160,320,1060
53624,260,180,160,80,160,0,840
53625,210,100,80,80,160,0,630
53626,200,120,120,80,160,0,680
53627,210,160,200,160,160,0,890
53628,170,100,160,240,320,0,990
53629,200,120,120,80,160,0,680
53630,180,140,120,80,0,0,520
53631,200,140,120,160,160,320,1100
53632,210,80,120,80,160,0,650
53633,190,100,80,80,0,0,450
53634,140,100,120,80,160,0,600
53635,210,120,80,80,0,0,490
53636,250,140,120,80,160,0,750
53637,230,100,120,0,0,0,450
53638,250,200,120,80,0,0,650
53639,180,140,80,160,160,0,720
53640,200,120,0,0,0,0,320
53641,190,120,40,80,160,0,590
53642,180,100,80,80,0,0,440
53643,210,120,80,0,0,0,410
53644,200,120,80,0,0,0,400
53645,200,100,80,0,0,0,380
53646,230,140,80,80,160,320,1010
53647,220,140,120,80,0,0,560
53648,170,140,80,80,0,0,470
53649,210,80,120,160,320,0,890
53650,190,180,160,80,160,320,1090
53651,220,180,160,160,0,0,720
53652,200,100,40,80,160,0,580
53653,200,100,80,80,160,0,620
53654,200,140,200,160,0,0,700
53655,200,100,40,0,0,0,340
53656,170,140,160,240,320,320,1350
53657,170,140,120,80,0,0,510
53658,180,100,120,80,160,0,640
53659,190,120,120,0,0,0,430
53660,190,120,80,0,0,0,390
53661,190,140,160,80,160,320,1050
53662,230,140,120,160,0,0,650
53663,210,120,40,80,160,0,610
53664,160,180,200,80,0,0,620
53665,150,120,120,160,320,320,1190
53666,230,120,160,80,0,0,590
53667,190,80,80,80,160,0,590
53668,200,140,80,0,0,0,420
53669,190,140,40,80,160,0,610
53670,190,140,160,240,160,320,1210
53671,210,100,80,160,160,0,710
53672,220,140,160,240,0,0,760
53673,190,120,120,80,160,0,670
53674,220,100,160,80,0,0,560
53675,190,80,160,160,160,0,750
53676,210,120,80,80,160,0,650
53677,230,140,160,160,160,0,850
53678,180,120,40,0,0,0,340
53679,190,140,160,160,160,320,1130
53680,180,140,120,80,160,0,680
53681,180,80,120,0,0,0,380
53682,240,180,200,160,320,0,1100
53683,210,80,120,80,160,0,650
53684,250,160,160,160,160,0,890
53685,200,80,80,0,0,0,360
53686,210,140,120,160,160,0,790
53687,160,120,120,0,0,0,400
53688,200,80,80,80,0,0,440
53689,190,40,40,0,0,0,270
53690,190,140,200,160,160,0,850
53691,220,80,0,0,0,0,300
53692,180,100,120,160,160,0,720
53693,190,120,40,0,0,0,350
53694,230,120,80,0,0,0,430
53695,220,120,80,80,160,0,660
53696,220,160,240,160,160,0,940
53697,210,160,80,0,0,0,450
53698,140,60,80,80,160,0,520
53699,230,160,80,160,160,320,1110
53700,200,120,120,80,160,320,1000
53701,200,100,40,0,0,0,340
53702,200,100,40,0,0,0,340
53703,170,80,120,160,320,0,850
53704,220,140,80,0,0,0,440
53705,200,80,80,160,320,320,1160
53706,240,120,40,0,0,0,400
53707,210,160,160,240,320,0,1090
53708,200,100,80,160,320,320,1180
53709,190,160,40,0,0,0,390
53710,160,120,160,160,320,320,1240
53711,190,140,80,160,0,0,570
53712,200,140,160,160,160,0,820
53713,230,140,80,80,160,320,1010
53714,210,140,80,160,160,0,750
53715,230,80,40,0,0,0,350
53716,200,120,120,160,160,0,760
53717,170,140,160,240,320,320,1350
53718,200,100,40,80,0,0,420
53719,230,140,80,80,160,0,690
53720,240,180,120,80,160,0,780
53721,140,120,40,0,0,0,300
53722,210,140,80,80,160,320,990
53723,190,120,120,160,160,0,750
53724,200,140,120,80,160,0,700
53725,170,120,120,160,160,0,730
53726,190,140,120,160,320,320,1250
53727,210,80,120,160,160,0,730
53728,200,160,120,160,160,0,800
53729,210,140,0,0,0,0,350
53730,170,100,40,80,160,0,550
53731,190,140,160,160,160,0,810
53732,230,180,80,80,0,0,570
53733,220,180,40,0,0,0,440
53734,220,120,160,0,0,0,500
53735,210,100,80,160,320,320,1190
53736,160,80,120,160,320,0,840
53737,230,80,40,0,0,0,350
53738,210,120,80,80,0,0,490
53739,190,140,80,80,0,0,490
53740,210,160,160,80,160,320,1090
53741,210,80,160,240,0,0,690
53742,150,100,80,80,0,0,410
53743,230,140,160,80,0,0,610
53744,180,120,160,160,160,0,780
53745,220,180,40,0,0,0,440
53746,190,120,80,0,0,0,390
53747,200,140,80,0,0,0,420
53748,210,140,120,80,160,0,710
53749,180,100,160,160,160,0,760
53750,170,160,120,160,160,0,770
53751,210,120,120,80,0,0,530
53752,180,120,120,80,160,0,660
53753,200,120,120,160,160,0,760
53754,180,100,80,80,160,0,600
53755,210,160,120,160,0,0,650
53756,210,100,120,80,160,0,670
53757,220,120,160,80,160,320,1060
53758,180,140,120,80,0,0,520
53759,160,120,80,80,0,0,440
53760,170,180,80,80,0,0,510
53761,220,120,160,160,320,0,980
53762,190,80,40,80,160,0,550
53763,170,100,120,160,320,0,870
53764,210,180,160,160,0,0,710
53765,190,100,80,80,160,320,930
53766,170,80,40,0,0,0,290
53767,240,140,120,80,160,0,740
53768,220,100,80,80,160,0,640
53769,230,120,80,80,160,0,670
53770,250,180,120,240,320,320,1430
53771,170,140,160,240,160,0,870
53772,200,160,120,80,160,0,720
53773,180,140,120,80,0,0,520
53774,210,160,40,80,160,320,970
53775,200,80,80,160,320,320,1160
53776,170,80,80,80,160,320,890
53777,210,100,40,0,0,0,350
53778,200,160,200,160,160,320,1200
53779,220,100,80,160,0,0,560
53780,150,80,120,240,320,0,910
53781,170,100,120,160,160,0,710
53782,190,120,80,160,0,0,550
53783,180,140,160,160,320,0,960
53784,220,120,40,80,0,0,460
53785,210,140,80,80,0,0,510
53786,200,120,80,160,160,0,720
53787,210,120,80,160,320,0,890
53788,200,120,40,80,0,0,440
53789,210,120,80,0,0,0,410
53790,180,120,120,160,160,0,740
53791,200,100,80,80,160,0,620
53792,170,160,160,80,0,0,570
53793,200,140,80,80,0,0,500
53794,210,100,120,80,160,0,670
53795,180,100,80,80,0,0,440
53796,220,80,120,160,160,0,740
53797,190,80,80,80,0,0,430
53798,200,100,160,240,160,0,860
53799,200,80,120,80,0,0,480
53800,180,180,80,160,160,0,760
53801,190,160,120,80,160,0,710
53802,160,80,80,80,160,320,880
53803,240,160,120,80,160,320,1080
53804,200,140,80,160,160,0,740
53805,180,120,160,80,160,0,700
53806,210,120,80,80,160,0,650
53807,240,160,120,80,0,0,600
53808,190,120,120,160,320,0,910
53809,230,100,40,0,0,0,370
53810,200,120,80,160,160,0,720
53811,200,100,0,0,0,0,300
53812,170,80,80,80,160,0,570
53813,230,160,160,80,160,0,790
53814,210,160,120,80,160,0,730
53815,200,180,120,80,0,0,580
53816,200,200,80,160,160,0,800
53817,240,140,160,160,320,0,1020
53818,240,120,80,0,0,0,440
53819,170,120,40,0,0,0,330
53820,200,120,120,160,160,320,1080
53821,190,100,120,80,0,0,490
53822,200,140,120,80,160,0,700
53823,180,120,120,240,320,320,1300
53824,210,140,160,160,160,320,1150
53825,230,140,120,80,160,0,730
53826,190,100,80,80,0,0,450
53827,210,120,120,160,0,0,610
53828,230,80,80,80,160,0,630
53829,230,120,120,160,160,0,790
53830,220,200,40,0,0,0,460
53831,190,120,120,160,160,0,750
53832,190,160,80,80,160,0,670
53833,150,120,120,80,160,0,630
53834,260,160,40,0,0,0,460
53835,170,80,80,80,160,0,570
53836,170,80,0,0,0,0,250
53837,190,60,80,0,0,0,330
53838,220,140,80,80,160,320,1000
53839,230,140,120,160,160,320,1130
53840,210,120,120,160,160,320,1090
53841,200,160,240,240,160,0,1000
53842,190,80,160,80,0,0,510
53843,200,120,80,80,160,0,640
53844,180,80,80,160,160,0,660
53845,220,120,160,240,160,0,900
53846,200,180,200,160,0,0,740
53847,210,100,40,80,0,0,430
53848,200,60,40,80,0,0,380
53849,190,100,80,80,160,0,610
53850,180,40,40,0,0,0,260
53851,180,100,80,80,0,0,440
53852,210,100,80,80,0,0,470
53853,190,100,80,80,160,0,610
53854,160,160,120,80,160,320,1000
53855,240,140,120,160,160,0,820
53856,230,80,80,160,0,0,550
53857,150,100,160,80,0,0,490
53858,160,140,80,160,160,0,700
53859,180,80,160,80,160,0,660
53860,180,100,80,160,160,0,680
53861,180,80,80,80,0,0,420
53862,180,200,40,80,0,0,500
53863,200,160,120,80,0,0,560
53864,210,140,200,80,0,0,630
53865,180,40,0,0,0,0,220
53866,180,60,80,160,160,0,640
53867,220,160,80,0,0,0,460
53868,190,140,80,80,0,0,490
53869,190,120,80,160,160,0,710
53870,240,140,120,80,160,0,740
53871,190,80,80,160,160,0,670
53872,200,120,160,160,0,0,640
53873,190,140,120,80,160,0,690
53874,240,80,40,80,0,0,440
53875,200,160,120,80,160,320,1040
53876,170,160,120,80,160,0,690
53877,230,180,120,0,0,0,530
53878,200,140,120,0,0,0,460
53879,240,120,120,160,160,320,1120
53880,190,100,80,0,0,0,370
53881,180,60,40,80,160,0,520
53882,170,140,120,80,160,0,670
53883,170,100,80,160,320,320,1150
53884,260,120,80,160,160,0,780
53885,200,120,120,80,0,0,520
53886,220,140,120,80,160,0,720
53887,270,140,120,0,0,0,530
53888,180,160,120,80,160,320,1020
53889,210,160,160,160,160,0,850
53890,180,120,120,80,160,0,660
53891,190,140,160,80,160,0,730
53892,170,120,160,240,160,0,850
53893,190,100,80,0,0,0,370
53894,200,80,80,80,0,0,440
53895,170,120,120,160,160,0,730
53896,160,160,120,240,160,0,840
53897,210,140,120,80,0,0,550
53898,180,140,120,160,160,0,760
53899,200,120,80,80,160,0,640
53900,190,160,200,160,0,0,710
53901,190,140,120,80,0,0,530
53902,180,140,160,80,0,0,560
53903,180,100,120,160,0,0,560
53904,210,160,120,80,160,0,730
53905,190,80,40,80,0,0,390
53906,190,140,120,240,320,0,1010
53907,180,120,160,80,0,0,540
53908,220,100,160,160,0,0,640
53909,170,140,40,80,0,0,430
53910,180,180,120,0,0,0,480
53911,220,100,80,160,160,320,1040
53912,210,120,80,160,320,0,890
53913,230,160,200,80,0,0,670
53914,180,80,120,240,320,0,940
53915,160,160,160,80,0,0,560
53916,180,100,40,80,160,0,560
53917,170,120,120,0,0,0,410
53918,240,120,120,0,0,0,480
53919,220,80,40,0,0,0,340
53920,230,160,160,160,160,0,870
53921,230,120,40,80,0,0,470
53922,180,160,160,160,160,320,1140
53923,220,140,80,80,0,0,520
53924,210,180,80,80,160,0,710
53925,170,100,120,160,320,0,870
53926,210,120,120,80,160,0,690
53927,190,120,120,0,0,0,430
53928,170,140,80,80,160,0,630
53929,190,160,160,160,320,320,1310
53930,200,100,120,160,160,0,740
53931,190,100,40,0,0,0,330
53932,190,100,80,160,0,0,530
53933,200,120,80,80,160,0,640
53934,190,160,120,160,160,0,790
53935,170,160,160,80,0,0,570
53936,190,60,40,80,160,0,530
53937,170,160,80,80,160,0,650
53938,180,180,160,80,160,0,760
53939,230,140,160,80,160,0,770
53940,180,80,160,80,0,0,500
53941,220,100,120,80,0,0,520
53942,170,160,120,160,160,0,770
53943,180,160,160,240,160,0,900
53944,220,100,80,0,0,0,400
53945,220,80,40,80,160,320,900
53946,210,140,120,160,160,0,790
53947,190,100,80,160,160,0,690
53948,210,120,120,160,160,0,770
53949,190,100,80,0,0,0,370
53950,190,100,80,80,160,0,610
53951,190,100,80,80,160,0,610
53952,230,140,120,0,0,0,490
53953,220,180,80,160,160,0,800
53954,210,160,160,80,160,0,770
53955,220,100,80,160,320,320,1200
53956,180,60,80,0,0,0,320
53957,210,100,80,160,160,0,710
53958,200,180,160,240,160,0,940
53959,190,120,80,0,0,0,390
53960,170,120,80,80,0,0,450
53961,190,80,40,0,0,0,310
53962,180,100,120,160,160,0,720
53963,190,140,200,240,320,320,1410
53964,230,120,160,240,320,0,1070
53965,180,160,200,160,160,0,860
53966,150,100,80,80,0,0,410
53967,190,140,120,80,0,0,530
53968,230,160,160,160,0,0,710
53969,200,140,160,160,160,0,820
53970,200,140,120,80,0,0,540
53971,220,160,120,80,160,0,740
53972,200,140,80,0,0,0,420
53973,200,160,120,160,160,0,800
53974,190,80,40,0,0,0,310
53975,190,80,80,160,160,0,670
53976,220,160,80,80,0,0,540
53977,190,120,120,240,320,0,990
53978,200,100,40,80,160,0,580
53979,230,140,120,240,160,0,890
53980,210,160,160,160,0,0,690
53981,180,80,40,0,0,0,300
53982,200,180,80,160,320,0,940
53983,190,120,120,160,0,0,590
53984,180,140,120,160,160,0,760
53985,200,80,80,80,160,0,600
53986,180,120,80,0,0,0,380
53987,200,80,80,160,320,320,1160
53988,190,80,40,80,160,0,550
53989,170,60,40,0,0,0,270
53990,200,180,200,80,160,0,820
53991,160,140,40,80,160,0,580
53992,210,160,120,80,160,0,730
53993,170,160,80,80,160,320,970
53994,240,100,120,240,160,0,860
53995,250,160,160,160,160,0,890
53996,190,180,80,160,160,0,770
53997,250,120,120,240,320,0,1050
53998,230,160,160,80,160,0,790
53999,160,120,0,0,0,0,280
54000,230,140,120,0,0,0,490
54001,170,120,160,80,0,0,530
54002,170,60,40,0,0,0,270
54003,200,120,40,0,0,0,360
54004,170,60,40,80,160,0,510
54005,200,140,80,80,160,0,660
54006,200,100,160,160,0,0,620
54007,220,140,120,80,160,0,720
54008,170,140,160,80,0,0,550
54009,180,120,40,80,0,0,420
54010,230,120,120,80,0,0,550
54011,190,100,120,160,0,0,570
54012,160,100,40,80,160,0,540
54013,230,140,80,80,0,0,530
54014,210,160,40,80,160,0,650
54015,200,160,160,0,0,0,520
54016,200,160,160,80,0,0,600
54017,180,120,120,160,320,320,1220
54018,230,140,160,240,320,0,1090
54019,210,140,120,80,160,0,710
54020,200,140,120,0,0,0,460
54021,210,60,40,0,0,0,310
54022,160,120,120,80,0,0,480
54023,210,120,40,80,160,0,610
54024,200,140,120,0,0,0,460
54025,200,120,80,0,0,0,400
54026,190,80,40,80,160,0,550
54027,220,180,160,80,0,0,640
54028,190,120,80,160,160,0,710
54029,230,160,160,80,160,320,1110
54030,220,100,120,80,160,320,1000
54031,150,60,40,0,0,0,250
54032,190,120,80,0,0,0,390
54033,180,120,40,0,0,0,340
54034,200,100,40,0,0,0,340
54035,190,140,120,80,160,0,690
54036,230,180,160,160,160,0,890
54037,190,80,80,160,160,0,670
54038,150,60,80,160,320,320,1090
54039,200,160,120,0,0,0,480
54040,230,140,80,80,160,0,690
54041,190,120,120,160,320,0,910
54042,230,120,80,160,160,0,750
54043,240,220,200,80,0,0,740
54044,200,140,80,160,160,0,740
54045,190,160,160,160,160,0,830
54046,220,160,120,80,0,0,580
54047,200,100,120,240,160,0,820
54048,200,100,120,160,320,0,900
54049,210,120,80,0,0,0,410
54050,200,120,40,0,0,0,360
54051,150,100,80,0,0,0,330
54052,180,100,80,80,0,0,440
54053,180,80,80,80,0,0,420
54054,190,80,80,160,160,0,670
54055,140,80,80,80,0,0,380
54056,210,120,200,160,160,0,850
54057,220,60,40,0,0,0,320
54058,200,60,120,80,160,0,620
54059,230,200,160,80,160,0,830
54060,190,120,120,80,0,0,510
54061,190,140,80,160,160,0,730
54062,200,120,200,80,160,0,760
54063,200,120,120,80,160,0,680
54064,180,80,80,80,0,0,420
54065,170,160,80,160,160,0,730
54066,240,140,80,160,160,320,1100
54067,200,160,120,160,320,0,960
54068,220,120,160,240,320,0,1060
54069,210,60,80,80,160,0,590
54070,170,40,80,80,160,0,530
54071,210,160,160,80,160,0,770
54072,170,140,120,80,160,0,670
54073,230,140,160,80,0,0,610
54074,200,120,160,80,160,0,720
54075,230,120,80,80,160,0,670
54076,210,120,40,80,0,0,450
54077,220,140,200,160,160,0,880
54078,180,160,120,160,160,320,1100
54079,180,80,40,80,160,0,540
54080,200,140,120,80,160,0,700
54081,210,60,40,80,160,320,870
54082,230,140,80,80,160,320,1010
54083,190,200,160,80,160,0,790
54084,200,140,80,0,0,0,420
54085,160,160,120,160,160,0,760
54086,230,140,80,80,0,0,530
54087,200,160,120,160,0,0,640
54088,220,100,120,160,160,320,1080
54089,220,100,40,80,160,0,600
54090,200,180,160,160,0,0,700
54091,180,160,80,80,160,0,660
54092,180,100,80,80,160,0,600
54093,160,140,160,160,160,0,780
54094,210,100,80,80,160,0,630
54095,190,80,80,80,160,0,590
54096,180,160,160,0,0,0,500
54097,190,160,160,160,320,0,990
54098,220,100,120,80,0,0,520
54099,180,120,120,80,160,0,660
54100,200,80,40,0,0,0,320
54101,240,120,40,80,0,0,480
54102,220,140,120,80,160,0,720
54103,200,140,120,0,0,0,460
54104,190,140,160,240,160,0,890
54105,220,100,40,80,160,320,920
54106,230,140,120,80,160,0,730
54107,170,100,120,160,160,0,710
54108,210,100,120,80,160,0,670
54109,190,80,0,0,0,0,270
54110,210,140,80,80,160,0,670
54111,200,100,80,160,160,320,1020
54112,150,60,40,80,160,0,490
54113,210,160,80,80,160,0,690
54114,240,140,80,160,160,0,780
54115,200,100,120,240,320,0,980
54116,200,120,120,0,0,0,440
54117,250,120,120,0,0,0,490
54118,230,100,160,160,160,0,810
54119,170,120,160,80,0,0,530
54120,180,120,160,160,0,0,620
54121,170,100,0,0,0,0,270
54122,170,120,160,240,160,0,850
54123,230,200,160,80,0,0,670
54124,160,100,120,80,160,0,620
54125,180,80,40,0,0,0,300
54126,210,120,120,80,160,0,690
54127,190,100,80,160,160,0,690
54128,260,140,80,80,160,0,720
54129,210,140,120,160,0,0,630
54130,220,140,80,0,0,0,440
54131,210,80,0,0,0,0,290
54132,180,80,120,80,160,0,620
54133,200,60,0,0,0,0,260
54134,230,140,120,160,0,0,650
54135,150,120,120,80,160,0,630
54136,200,40,80,160,160,0,640
54137,220,120,160,160,160,0,820
54138,240,140,120,80,0,0,580
54139,220,80,40,0,0,0,340
54140,170,40,0,0,0,0,210
54141,170,120,160,240,320,0,1010
54142,180,80,120,240,160,320,1100
54143,190,140,120,80,160,0,690
54144,180,140,80,80,0,0,480
54145,160,80,80,160,320,320,1120
54146,190,100,40,80,160,0,570
54147,210,120,80,160,160,0,730
54148,190,80,40,80,0,0,390
54149,210,120,40,0,0,0,370
54150,260,160,160,160,320,0,1060
54151,190,100,80,80,160,0,610
54152,170,100,80,0,0,0,350
54153,230,200,160,0,0,0,590
54154,170,100,40,80,0,0,390
54155,200,120,80,0,0,0,400
54156,170,120,120,80,160,0,650
54157,230,160,160,160,160,320,1190
54158,190,140,120,160,160,0,770
54159,190,140,120,80,0,0,530
54160,190,140,120,80,0,0,530
54161,210,140,120,80,160,0,710
54162,200,140,160,80,160,0,740
54163,200,100,80,160,160,0,700
54164,170,100,40,0,0,0,310
54165,170,140,120,160,160,0,750
54166,200,100,40,80,160,0,580
54167,200,160,80,80,160,0,680
54168,150,120,40,80,160,0,550
54169,150,100,80,0,0,0,330
54170,220,100,40,80,0,0,440
54171,230,40,80,160,320,0,830
54172,190,100,40,80,0,0,410
54173,180,60,120,80,160,0,600
54174,180,160,240,160,160,0,900
54175,190,140,120,80,160,0,690
54176,210,160,160,160,160,0,850
54177,200,100,120,0,0,0,420
54178,200,160,120,160,0,0,640
54179,220,140,80,80,160,0,680
54180,200,100,120,0,0,0,420
54181,190,140,120,80,160,0,690
54182,180,140,160,160,0,0,640
54183,200,140,160,80,0,0,580
54184,200,80,40,0,0,0,320
54185,220,120,160,160,0,0,660
54186,180,120,120,80,160,0,660
54187,210,120,160,0,0,0,490
54188,170,100,80,80,0,0,430
54189,190,160,40,0,0,0,390
54190,180,80,120,80,160,0,620
54191,200,100,160,80,160,0,700
54192,230,160,200,240,320,0,1150
54193,210,140,120,80,0,0,550
54194,200,60,120,80,0,0,460
54195,210,80,40,80,160,0,570
54196,210,160,80,80,160,0,690
54197,190,100,80,80,160,0,610
54198,190,140,120,240,320,0,1010
54199,180,120,80,80,160,0,620
54200,230,120,80,0,0,0,430
54201,230,160,80,80,160,0,710
54202,230,140,80,80,160,0,690
54203,200,80,120,80,0,0,480
54204,210,100,120,80,160,0,670
54205,200,100,80,80,160,0,620
54206,180,100,120,160,160,0,720
54207,190,140,80,80,160,0,650
54208,160,80,120,160,160,0,680
54209,200,120,120,160,160,0,760
54210,150,140,160,80,160,0,690
54211,180,100,80,80,160,0,600
54212,220,100,80,80,160,0,640
54213,180,100,80,0,0,0,360
54214,210,120,120,80,0,0,530
54215,180,100,160,80,0,0,520
54216,200,140,80,160,160,0,740
54217,190,120,120,0,0,0,430
54218,210,140,80,80,160,0,670
54219,210,160,120,80,160,0,730
54220,210,140,120,0,0,0,470
54221,160,80,40,80,160,0,520
54222,170,80,40,0,0,0,290
54223,210,180,160,160,320,320,1350
54224,190,160,80,160,160,320,1070
54225,210,120,120,80,160,0,690
54226,170,60,0,0,0,0,230
54227,190,120,80,80,0,0,470
54228,170,140,120,80,160,0,670
54229,210,100,120,80,0,0,510
54230,240,140,120,80,160,320,1060
54231,140,80,120,160,160,0,660
54232,210,120,80,80,160,0,650
54233,130,100,120,160,160,0,670
54234,210,100,80,80,0,0,470
54235,220,160,120,80,160,0,740
54236,230,140,120,160,160,0,810
54237,220,140,80,80,160,0,680
54238,190,60,80,0,0,0,330
54239,230,120,160,80,160,320,1070
54240,170,100,80,80,0,0,430
54241,220,100,80,0,0,0,400
54242,190,100,40,0,0,0,330
54243,170,120,120,80,160,0,650
54244,150,140,120,160,320,0,890
54245,200,80,40,80,0,0,400
54246,160,120,120,160,160,0,720
54247,220,120,80,160,320,0,900
54248,220,160,120,80,0,0,580
54249,180,120,200,160,320,0,980
54250,220,160,160,160,0,0,700
54251,170,120,120,80,160,0,650
54252,200,160,160,160,0,0,680
54253,200,120,80,80,160,0,640
54254,220,120,120,80,160,0,700
54255,190,80,80,160,160,0,670
54256,200,80,120,240,320,320,1280
54257,170,160,80,0,0,0,410
54258,200,120,120,160,160,0,760
54259,190,120,200,240,160,0,910
54260,190,200,200,160,320,0,1070
54261,170,100,80,80,160,0,590
54262,170,100,80,160,0,0,510
54263,190,140,160,0,0,0,490
54264,220,140,40,80,0,0,480
54265,180,60,120,160,160,0,680
54266,210,140,200,240,160,320,1270
54267,200,100,120,80,160,0,660
54268,180,100,80,160,160,0,680
54269,210,120,0,0,0,0,330
54270,200,160,120,80,160,0,720
54271,200,140,120,160,320,320,1260
54272,270,120,120,80,160,0,750
54273,210,160,160,80,160,0,770
54274,210,80,120,80,160,0,650
54275,170,100,80,0,0,0,350
54276,230,140,120,0,0,0,490
54277,230,140,160,160,320,0,1010
54278,170,80,80,80,160,0,570
54279,200,120,120,160,320,320,1240
54280,240,80,80,0,0,0,400
54281,180,180,160,240,160,0,920
54282,170,120,120,160,320,320,1210
54283,170,120,120,160,160,0,730
54284,170,120,120,160,0,0,570
54285,170,120,80,0,0,0,370
54286,200,100,80,160,0,0,540
54287,200,120,120,160,320,0,920
54288,190,100,120,160,160,320,1050
54289,200,160,40,80,0,0,480
54290,210,160,120,80,0,0,570
54291,210,120,120,160,0,0,610
54292,170,100,80,80,160,320,910
54293,230,80,120,80,0,0,510
54294,180,140,120,80,160,0,680
54295,190,100,40,0,0,0,330
54296,220,100,80,80,160,0,640
54297,180,100,160,160,160,0,760
54298,190,160,200,80,160,0,790
54299,250,140,80,0,0,0,470
54300,170,140,80,80,0,0,470
54301,230,120,80,160,0,0,590
54302,200,140,120,160,160,0,780
54303,190,100,40,80,160,0,570
54304,190,120,0,0,0,0,310
54305,180,120,120,160,160,0,740
54306,220,120,40,80,160,0,620
54307,160,140,160,80,0,0,540
54308,170,140,160,0,0,0,470
54309,160,120,120,80,0,0,480
54310,160,160,160,160,160,0,800
54311,180,120,160,160,160,0,780
54312,200,100,80,80,0,0,460
54313,180,140,120,80,160,320,1000
54314,230,140,120,80,160,0,730
54315,200,120,80,0,0,0,400
54316,160,140,120,80,160,0,660
54317,160,120,0,0,0,0,280
54318,230,80,80,160,160,320,1030
54319,190,100,80,80,160,0,610
54320,220,60,80,80,160,0,600
54321,200,100,80,80,0,0,460
54322,240,120,80,160,160,0,760
54323,190,140,120,160,160,0,770
54324,180,100,120,0,0,0,400
54325,160,80,80,160,160,0,640
54326,250,160,120,80,160,0,770
54327,220,140,160,80,160,0,760
54328,200,120,80,80,160,0,640
54329,210,160,160,80,160,0,770
54330,220,120,80,160,320,0,900
54331,200,40,40,0,0,0,280
54332,190,80,0,0,0,0,270
54333,200,160,160,160,320,0,1000
54334,210,120,120,240,160,0,850
54335,180,180,120,160,160,0,800
54336,150,80,120,0,0,0,350
54337,210,140,160,240,160,0,910
54338,200,120,80,80,0,0,480
54339,160,80,160,0,0,0,400
54340,200,160,80,80,160,0,680
54341,170,120,120,80,160,0,650
54342,240,120,80,80,0,0,520
54343,170,120,120,160,320,0,890
54344,220,100,120,80,160,320,1000
54345,180,80,40,80,0,0,380
54346,170,100,80,80,160,0,590
54347,220,100,80,160,320,320,1200
54348,150,160,120,80,160,320,990
54349,180,140,120,160,160,320,1080
54350,220,160,120,160,320,0,980
54351,200,60,40,80,0,0,380
54352,200,120,160,160,320,0,960
54353,170,120,80,0,0,0,370
54354,190,100,80,0,0,0,370
54355,170,140,80,0,0,0,390
54356,240,160,160,240,160,0,960
54357,240,160,160,160,160,0,880
54358,220,100,120,160,0,0,600
54359,190,100,120,160,0,0,570
54360,180,80,40,0,0,0,300
54361,220,160,40,80,160,0,660
54362,160,120,120,240,320,320,1280
54363,230,120,40,0,0,0,390
54364,200,80,80,0,0,0,360
54365,210,120,80,0,0,0,410
54366,210,100,80,160,160,0,710
54367,180,120,80,160,160,0,700
54368,210,100,40,80,0,0,430
54369,190,60,120,80,0,0,450
54370,200,100,40,80,160,320,900
54371,220,100,120,160,160,0,760
54372,190,140,120,80,160,0,690
54373,180,80,160,240,320,0,980
54374,230,100,80,80,160,0,650
54375,210,120,160,160,160,0,810
54376,230,140,120,160,320,0,970
54377,230,120,120,80,0,0,550
54378,210,140,160,160,0,0,670
54379,210,100,80,80,0,0,470
54380,180,100,120,160,160,0,720
54381,150,120,120,160,160,0,710
54382,220,80,40,80,160,320,900
54383,190,120,0,0,0,0,310
54384,220,120,160,240,160,0,900
54385,180,100,80,80,160,0,600
54386,220,160,160,160,160,0,860
54387,220,120,120,80,0,0,540
54388,220,160,160,240,320,320,1420
54389,190,140,40,80,160,0,610
54390,200,160,160,240,160,320,1240
54391,190,120,80,0,0,0,390
54392,260,140,200,240,160,0,1000
54393,210,80,80,0,0,0,370
54394,210,120,120,160,160,0,770
54395,220,140,160,80,0,0,600
54396,210,160,200,240,160,0,970
54397,220,200,80,160,320,0,980
54398,190,140,40,80,0,0,450
54399,230,160,160,240,160,0,950
54400,170,120,80,0,0,0,370
54401,230,80,0,0,0,0,310
54402,190,180,200,240,160,320,1290
54403,190,100,80,80,0,0,450
54404,130,80,120,160,160,0,650
54405,230,120,120,80,0,0,550
54406,170,140,40,80,160,0,590
54407,170,100,120,240,320,0,950
54408,210,160,120,80,160,0,730
54409,200,100,120,80,160,0,660
54410,220,80,40,80,160,0,580
54411,200,120,120,160,160,0,760
54412,150,120,160,160,320,0,910
54413,180,140,80,160,160,0,720
54414,190,140,40,80,160,0,610
54415,180,100,80,160,320,320,1160
54416,220,140,120,160,160,0,800
54417,190,80,80,80,160,0,590
54418,170,60,120,80,160,320,910
54419,160,60,120,240,320,0,900
54420,200,160,120,0,0,0,480
54421,220,100,120,80,0,0,520
54422,210,80,80,0,0,0,370
54423,190,160,120,80,160,0,710
54424,190,140,80,80,160,0,650
54425,220,140,80,160,160,0,760
54426,180,160,120,80,0,0,540
54427,140,140,160,240,320,0,1000
54428,210,140,120,80,160,0,710
54429,220,140,40,80,0,0,480
54430,210,120,160,240,160,0,890
54431,240,140,120,160,320,0,980
54432,220,100,80,0,0,0,400
54433,210,140,120,160,0,0,630
54434,180,160,80,80,0,0,500
54435,210,160,80,160,320,0,930
54436,180,80,80,160,160,0,660
54437,180,160,240,160,0,0,740
54438,210,120,120,160,160,0,770
54439,200,140,120,160,0,0,620
54440,220,80,120,160,320,0,900
54441,210,60,80,80,160,0,590
54442,210,140,120,80,160,0,710
54443,220,140,160,160,320,0,1000
54444,180,100,0,0,0,0,280
54445,180,140,80,80,160,0,640
54446,170,60,120,80,160,0,590
54447,190,160,40,0,0,0,390
54448,190,100,200,80,160,0,730
54449,190,120,200,160,0,0,670
54450,170,80,80,160,320,0,810
54451,190,80,80,80,0,0,430
54452,230,120,80,80,160,0,670
54453,160,120,40,80,0,0,400
54454,210,120,80,0,0,0,410
54455,170,140,120,160,160,0,750
54456,190,120,120,240,320,0,990
54457,180,140,200,160,160,0,840
54458,200,100,120,160,160,0,740
54459,150,100,120,0,0,0,370
54460,200,120,120,80,160,0,680
54461,170,120,120,160,320,0,890
54462,150,80,80,80,160,0,550
54463,160,100,80,0,0,0,340
54464,170,120,200,240,320,320,1370
54465,170,120,80,80,0,0,450
54466,200,120,160,80,160,0,720
54467,210,140,120,160,160,0,790
54468,190,120,80,0,0,0,390
54469,210,80,120,160,160,0,730
54470,190,100,120,80,160,0,650
54471,190,100,160,80,0,0,530
54472,210,160,120,160,160,320,1130
54473,210,80,120,160,160,0,730
54474,190,100,0,0,0,0,290
54475,200,100,200,240,320,320,1380
54476,210,140,120,160,160,320,1110
54477,180,140,160,80,160,0,720
54478,230,140,120,80,160,0,730
54479,200,140,240,240,160,0,980
54480,150,80,0,0,0,0,230
54481,180,120,120,80,160,320,980
54482,180,140,80,80,0,0,480
54483,160,80,40,80,0,0,360
54484,210,140,80,80,160,0,670
54485,180,120,40,0,0,0,340
54486,190,140,80,80,160,0,650
54487,180,120,40,0,0,0,340
54488,160,80,120,160,160,0,680
54489,220,100,80,80,160,0,640
54490,180,160,40,80,0,0,460
54491,170,100,120,0,0,0,390
54492,260,140,120,240,320,320,1400
54493,280,180,120,160,160,0,900
54494,230,140,160,240,0,0,770
54495,160,120,80,0,0,0,360
54496,220,160,120,80,0,0,580
54497,170,120,160,160,160,0,770
54498,220,100,120,80,0,0,520
54499,200,160,160,80,0,0,600
54500,170,100,120,160,160,0,710
54501,190,120,200,240,160,320,1230
54502,170,100,40,80,0,0,390
54503,240,140,160,80,160,320,1100
54504,200,120,160,240,320,0,1040
54505,170,80,80,80,0,0,410
54506,180,100,120,160,0,0,560
54507,210,160,120,0,0,0,490
54508,190,60,0,0,0,0,250
54509,200,100,80,160,160,320,1020
54510,200,80,40,0,0,0,320
54511,200,120,0,0,0,0,320
54512,140,140,80,80,0,0,440
54513,190,160,160,160,320,0,990
54514,230,120,160,240,320,0,1070
54515,230,160,160,80,160,0,790
54516,210,120,0,0,0,0,330
54517,180,180,80,0,0,0,440
54518,200,60,80,0,0,0,340
54519,180,100,40,80,0,0,400
54520,200,60,40,0,0,0,300
54521,220,160,120,80,160,0,740
54522,200,160,200,240,320,0,1120
54523,170,80,80,80,0,0,410
54524,170,160,120,160,160,0,770
54525,200,100,120,160,160,320,1060
54526,160,60,120,80,160,0,580
54527,170,120,80,0,0,0,370
54528,180,120,80,160,320,0,860
54529,190,40,40,80,0,0,350
54530,200,140,160,80,160,320,1060
54531,180,100,120,160,160,0,720
54532,210,100,80,0,0,0,390
54533,190,80,80,160,320,320,1150
54534,180,160,80,160,0,0,580
54535,230,120,160,160,160,0,830
54536,170,120,120,160,160,320,1050
54537,230,140,160,80,0,0,610
54538,190,80,0,0,0,0,270
54539,180,60,40,80,160,0,520
54540,230,160,160,80,160,0,790
54541,170,60,120,160,0,0,510
54542,170,100,80,80,160,0,590
54543,220,120,80,0,0,0,420
54544,190,100,120,240,160,0,810
54545,230,140,80,80,0,0,530
54546,220,140,80,80,160,320,1000
54547,180,100,80,80,0,0,440
54548,140,120,40,80,160,0,540
54549,210,160,120,160,160,0,810
54550,170,120,80,0,0,0,370
54551,200,140,120,0,0,0,460
54552,210,140,120,80,160,0,710
54553,210,120,80,0,0,0,410
54554,250,120,160,160,0,0,690
54555,180,160,160,160,160,0,820
54556,190,100,160,80,0,0,530
54557,180,120,80,80,160,0,620
54558,210,120,80,80,160,0,650
54559,240,140,160,160,160,320,1180
54560,170,100,120,240,320,0,950
54561,190,140,80,0,0,0,410
54562,250,100,80,80,160,0,670
54563,190,120,40,0,0,0,350
54564,160,100,160,160,0,0,580
54565,210,140,160,80,160,0,750
54566,190,100,80,80,0,0,450
54567,200,140,120,80,0,0,540
54568,250,140,80,0,0,0,470
54569,180,140,80,0,0,0,400
54570,170,160,80,80,160,0,650
54571,170,160,120,80,0,0,530
54572,200,100,80,80,160,0,620
54573,230,180,40,0,0,0,450
54574,190,120,120,80,0,0,510
54575,230,120,120,80,0,0,550
54576,170,120,160,0,0,0,450
54577,200,120,80,80,160,0,640
54578,180,60,40,80,0,0,360
54579,190,100,160,80,0,0,530
54580,220,140,80,80,160,0,680
54581,210,60,40,80,160,0,550
54582,200,100,120,80,0,0,500
54583,150,100,120,160,160,0,690
54584,260,180,80,80,0,0,600
54585,220,140,120,80,0,0,560
54586,180,140,120,80,160,0,680
54587,220,100,160,160,320,0,960
54588,200,100,120,160,0,0,580
54589,150,120,80,80,0,0,430
54590,180,100,80,80,0,0,440
54591,170,140,160,160,160,320,1110
54592,210,120,160,240,160,0,890
54593,190,140,120,160,320,320,1250
54594,150,140,80,0,0,0,370
54595,220,100,120,0,0,0,440
54596,220,160,80,80,160,0,700
54597,230,100,80,80,160,320,970
54598,210,160,120,160,0,0,650
54599,170,160,200,160,320,320,1330
54600,230,160,120,160,160,0,830
54601,210,160,120,160,160,320,1130
54602,190,60,0,0,0,0,250
54603,180,120,120,80,0,0,500
54604,200,100,120,0,0,0,420
54605,200,120,120,80,160,0,680
54606,190,100,120,80,0,0,490
54607,230,180,160,160,160,320,1210
54608,200,100,40,0,0,0,340
54609,210,120,80,80,160,0,650
54610,170,100,80,80,160,0,590
54611,210,140,160,80,0,0,590
54612,170,100,120,160,160,0,710
54613,200,120,200,240,160,0,920
54614,180,80,120,160,160,0,700
54615,170,120,120,0,0,0,410
54616,190,140,160,160,160,0,810
54617,230,180,160,160,0,0,730
54618,210,100,80,80,160,320,950
54619,210,100,80,160,160,0,710
54620,210,140,80,80,0,0,510
54621,200,120,80,0,0,0,400
54622,200,140,120,240,320,320,1340
54623,170,120,120,160,320,0,890
54624,210,120,80,80,160,0,650
54625,170,120,120,160,320,0,890
54626,180,40,40,0,0,0,260
54627,180,100,40,80,160,320,880
54628,220,80,120,80,160,0,660
54629,200,60,80,160,0,0,500
54630,190,100,80,80,0,0,450
54631,180,100,120,160,160,0,720
54632,200,100,120,160,320,320,1220
54633,160,120,40,0,0,0,320
54634,180,120,120,160,160,0,740
54635,210,60,120,160,0,0,550
54636,160,120,120,160,160,0,720
54637,200,100,120,80,160,0,660
54638,130,100,80,160,160,0,630
54639,200,140,200,80,160,0,780
54640,190,100,80,80,0,0,450
54641,240,100,120,80,0,0,540
54642,190,140,120,160,0,0,610
54643,220,140,120,160,160,0,800
54644,180,140,120,80,160,0,680
54645,180,120,160,160,320,0,940
54646,200,160,160,80,0,0,600
54647,190,60,80,80,160,0,570
54648,190,140,120,160,0,0,610
54649,180,120,160,160,320,320,1260
54650,240,160,160,160,160,0,880
54651,200,160,200,160,0,0,720
54652,210,100,80,0,0,0,390
54653,130,60,40,80,0,0,310
54654,190,140,160,160,160,320,1130
54655,210,120,120,80,160,0,690
54656,200,160,120,160,160,0,800
54657,190,100,40,0,0,0,330
54658,240,180,160,240,320,0,1140
54659,210,120,160,160,0,0,650
54660,200,160,80,160,160,0,760
54661,210,120,160,240,160,0,890
54662,150,120,80,80,160,0,590
54663,190,60,80,0,0,0,330
54664,210,80,80,80,0,0,450
54665,210,160,160,80,160,320,1090
54666,170,100,160,80,160,320,990
54667,180,120,80,80,160,320,940
54668,180,120,160,80,160,0,700
54669,230,160,160,80,0,0,630
54670,190,140,160,160,160,320,1130
54671,150,100,160,0,0,0,410
54672,190,60,40,0,0,0,290
54673,220,160,160,240,320,0,1100
54674,230,140,120,160,320,320,1290
54675,170,140,120,160,160,320,1070
54676,180,120,80,160,160,0,700
54677,230,160,200,160,160,0,910
54678,180,120,80,80,160,320,940
54679,190,120,40,0,0,0,350
54680,230,100,120,80,160,0,690
54681,170,140,120,0,0,0,430
54682,190,100,80,160,160,320,1010
54683,220,80,120,160,320,320,1220
54684,230,140,80,80,160,0,690
54685,190,120,80,160,320,320,1190
54686,150,80,120,160,160,0,670
54687,200,140,160,80,0,0,580
54688,200,120,40,80,160,0,600
54689,190,140,80,160,160,0,730
54690,160,100,120,160,160,0,700
54691,190,100,40,80,160,0,570
54692,180,160,160,160,160,320,1140
54693,170,80,80,80,0,0,410
54694,180,100,120,160,160,0,720
54695,210,160,40,80,0,0,490
54696,210,180,160,240,160,0,950
54697,210,100,80,80,160,0,630
54698,210,180,120,80,160,0,750
54699,220,160,120,160,320,0,980
54700,170,100,80,80,0,0,430
54701,210,120,120,80,160,320,1010
54702,210,120,80,160,320,320,1210
54703,170,120,40,0,0,0,330
54704,180,140,120,160,160,0,760
54705,200,160,200,240,320,0,1120
54706,150,80,40,80,160,0,510
54707,150,80,40,80,160,0,510
54708,180,80,40,0,0,0,300
54709,160,120,80,80,0,0,440
54710,190,120,120,80,160,0,670
54711,220,80,80,80,160,0,620
54712,160,140,160,80,160,320,1020
54713,190,160,120,160,0,0,630
54714,160,140,160,160,320,0,940
54715,200,40,40,0,0,0,280
54716,160,80,80,160,160,0,640
54717,150,120,120,0,0,0,390
54718,180,120,120,80,0,0,500
54719,220,180,160,160,0,0,720
54720,180,120,120,80,0,0,500
54721,190,80,80,160,160,0,670
54722,190,120,120,80,160,320,990
54723,230,180,120,80,160,320,1090
54724,200,140,80,80,0,0,500
54725,180,120,40,80,160,0,580
54726,220,160,80,160,0,0,620
54727,170,120,120,80,160,320,970
54728,220,80,80,80,0,0,460
54729,200,100,120,160,0,0,580
54730,210,120,160,160,0,0,650
54731,180,120,80,0,0,0,380
54732,220,140,120,80,160,0,720
54733,200,120,120,160,160,0,760
54734,190,140,80,80,160,0,650
54735,210,120,160,240,0,0,730
54736,220,180,160,240,160,0,960
54737,180,140,80,160,320,0,880
54738,210,160,160,160,160,0,850
54739,180,160,120,160,0,0,620
54740,210,140,0,0,0,0,350
54741,220,100,120,80,160,0,680
54742,210,120,120,80,0,0,530
54743,220,100,120,160,160,0,760
54744,200,140,120,80,160,0,700
54745,160,80,120,160,160,0,680
54746,180,80,80,0,0,0,340
54747,170,120,160,80,160,0,690
54748,170,80,40,80,160,320,850
54749,200,100,40,0,0,0,340
54750,230,160,120,160,160,0,830
54751,170,140,200,80,0,0,590
54752,220,160,40,80,0,0,500
54753,180,120,120,80,160,320,980
54754,180,80,160,160,160,0,740
54755,200,120,40,80,160,0,600
54756,180,60,120,160,320,0,840
54757,200,100,120,0,0,0,420
54758,190,140,160,160,0,0,650
54759,190,140,120,160,160,320,1090
54760,180,160,160,240,160,0,900
54761,190,40,80,80,160,0,550
54762,200,140,160,80,160,0,740
54763,170,80,120,240,160,0,770
54764,170,80,80,80,0,0,410
54765,210,180,120,160,0,0,670
54766,180,120,120,160,160,320,1060
54767,170,160,200,160,160,0,850
54768,170,40,80,80,160,0,530
54769,190,100,120,80,0,0,490
54770,180,100,120,160,160,0,720
54771,180,60,40,80,160,0,520
54772,150,140,80,160,0,0,530
54773,220,100,40,80,0,0,440
54774,190,140,120,160,160,0,770
54775,170,120,160,160,320,0,930
54776,200,120,120,80,0,0,520
54777,220,80,160,160,160,320,1100
54778,230,120,40,80,160,0,630
54779,170,120,120,80,160,0,650
54780,200,120,120,160,160,0,760
54781,170,140,120,0,0,0,430
54782,200,160,40,0,0,0,400
54783,240,120,120,80,0,0,560
54784,210,120,120,80,160,0,690
54785,240,140,120,80,0,0,580
54786,190,120,120,80,160,0,670
54787,170,120,80,80,0,0,450
54788,220,140,160,160,320,320,1320
54789,210,220,120,160,320,320,1350
54790,160,100,80,80,160,0,580
54791,180,120,120,80,0,0,500
54792,230,140,40,0,0,0,410
54793,200,80,40,80,160,0,560
54794,210,100,160,240,160,0,870
54795,200,160,160,160,0,0,680
54796,210,80,80,80,160,0,610
54797,190,180,160,160,0,0,690
54798,180,140,200,80,0,0,600
54799,190,160,80,0,0,0,430
54800,210,160,80,80,0,0,530
54801,170,140,160,240,320,0,1030
54802,170,100,80,80,0,0,430
54803,180,120,120,160,160,0,740
54804,200,140,40,80,0,0,460
54805,220,80,80,80,0,0,460
54806,250,140,160,240,320,320,1430
54807,170,120,80,80,0,0,450
54808,200,100,80,0,0,0,380
54809,220,140,160,80,160,0,760
54810,230,120,40,80,160,0,630
54811,230,100,120,160,320,320,1250
54812,180,120,160,80,160,0,700
54813,220,140,80,160,160,0,760
54814,200,140,160,240,0,0,740
54815,230,140,0,0,0,0,370
54816,220,120,120,240,160,320,1180
54817,200,160,80,160,320,320,1240
54818,180,120,80,80,160,0,620
54819,170,100,80,80,0,0,430
54820,180,80,40,80,0,0,380
54821,200,120,40,0,0,0,360
54822,180,140,120,80,160,0,680
54823,210,120,120,160,0,0,610
54824,160,180,160,160,160,0,820
54825,170,120,120,0,0,0,410
54826,160,100,80,0,0,0,340
54827,200,120,160,160,160,0,800
54828,180,140,160,80,160,0,720
54829,220,200,40,0,0,0,460
54830,190,100,120,80,0,0,490
54831,210,60,40,0,0,0,310
54832,210,140,120,0,0,0,470
54833,190,80,80,80,160,0,590
54834,170,100,80,80,160,0,590
54835,190,160,120,240,320,320,1350
54836,200,120,120,160,0,0,600
54837,210,120,40,80,160,0,610
54838,180,120,120,160,160,320,1060
54839,190,120,120,0,0,0,430
54840,180,100,80,0,0,0,360
54841,180,120,40,0,0,0,340
54842,220,80,40,0,0,0,340
54843,200,100,120,160,0,0,580
54844,160,100,120,80,160,0,620
54845,180,120,40,80,160,0,580
54846,200,180,200,160,160,0,900
54847,160,120,200,80,0,0,560
54848,220,100,80,80,0,0,480
54849,170,120,80,80,160,0,610
54850,200,120,120,0,0,0,440
54851,180,180,160,160,320,0,1000
54852,160,160,160,160,160,0,800
54853,190,120,80,0,0,0,390
54854,210,80,120,80,160,320,970
54855,200,140,80,80,160,0,660
54856,210,120,120,160,160,0,770
54857,230,120,120,0,0,0,470
54858,160,80,80,80,160,0,560
54859,160,100,120,240,160,0,780
54860,180,80,160,80,160,0,660
54861,200,120,120,160,320,320,1240
54862,210,100,160,160,0,0,630
54863,220,80,120,240,320,320,1300
54864,220,160,120,80,160,0,740
54865,180,120,80,160,160,0,700
54866,190,120,160,240,160,0,870
54867,150,120,80,80,160,0,590
54868,240,180,160,160,160,0,900
54869,190,120,40,80,160,0,590
54870,180,120,120,160,320,0,900
54871,170,120,120,160,160,0,730
54872,200,140,80,80,160,320,980
54873,200,140,120,240,320,320,1340
54874,190,140,120,0,0,0,450
54875,180,140,120,80,160,0,680
54876,160,80,120,80,160,0,600
54877,170,80,120,0,0,0,370
54878,240,140,200,160,160,0,900
54879,210,140,160,0,0,0,510
54880,200,120,120,0,0,0,440
54881,200,100,160,240,160,320,1180
54882,200,120,120,160,160,0,760
54883,200,160,120,160,160,0,800
54884,170,80,120,160,160,0,690
54885,150,160,160,160,160,0,790
54886,220,120,80,80,160,0,660
54887,190,140,40,80,0,0,450
54888,220,100,200,80,160,320,1080
54889,160,140,80,0,0,0,380
54890,190,100,40,80,160,0,570
54891,220,160,160,160,320,0,1020
54892,180,140,200,240,320,0,1080
54893,200,100,80,160,320,320,1180
54894,170,60,80,160,0,0,470
54895,200,140,120,160,160,320,1100
54896,170,120,120,160,320,0,890
54897,210,100,40,80,160,0,590
54898,220,160,120,160,320,0,980
54899,180,180,80,160,320,0,920
54900,150,60,80,160,160,0,610
54901,200,100,80,80,0,0,460
54902,230,120,40,80,160,0,630
54903,150,140,160,160,160,0,770
54904,230,140,80,160,320,0,930
54905,180,80,80,80,160,0,580
54906,180,80,40,80,0,0,380
54907,220,180,80,80,160,0,720
54908,220,120,80,80,0,0,500
54909,170,120,120,0,0,0,410
54910,190,80,80,0,0,0,350
54911,240,180,200,160,0,0,780
54912,210,120,80,80,0,0,490
54913,210,140,120,80,0,0,550
54914,190,120,120,160,160,0,750
54915,180,140,200,80,0,0,600
54916,210,140,120,160,160,0,790
54917,210,160,160,80,0,0,610
54918,190,140,40,80,160,0,610
54919,180,120,160,80,160,320,1020
54920,210,140,120,160,0,0,630
54921,190,120,120,160,320,0,910
54922,200,140,80,160,160,0,740
54923,220,140,120,80,160,320,1040
54924,190,180,120,160,160,0,810
54925,220,100,40,80,0,0,440
54926,190,120,80,160,160,0,710
54927,200,100,40,80,0,0,420
54928,230,180,120,160,320,320,1330
54929,210,60,40,80,160,0,550
54930,180,120,120,160,160,0,740
54931,220,200,280,160,160,0,1020
54932,200,100,80,80,160,0,620
54933,210,200,120,80,160,0,770
54934,200,100,120,80,160,0,660
54935,140,80,120,80,160,0,580
54936,200,160,160,240,160,0,920
54937,210,120,120,160,0,0,610
54938,190,100,80,80,0,0,450
54939,230,80,160,240,160,0,870
54940,210,140,80,80,0,0,510
54941,240,160,160,160,160,0,880
54942,200,140,120,160,160,0,780
54943,220,120,40,0,0,0,380
54944,170,120,120,80,0,0,490
54945,250,60,40,80,160,0,590
54946,180,100,80,80,0,0,440
54947,210,140,80,80,160,0,670
54948,200,180,200,160,320,320,1380
54949,230,100,120,160,160,0,770
54950,190,100,120,80,160,0,650
54951,220,180,160,80,160,0,800
54952,250,120,160,160,160,0,850
54953,250,140,160,160,320,0,1030
54954,190,120,80,160,160,0,710
54955,200,120,120,80,160,0,680
54956,200,180,160,240,160,0,940
54957,160,80,80,160,320,0,800
54958,180,140,120,80,160,0,680
54959,200,120,160,80,160,0,720
54960,200,100,80,160,160,0,700
54961,190,140,120,160,160,0,770
54962,210,140,120,80,0,0,550
54963,180,80,80,80,0,0,420
54964,200,120,120,160,0,0,600
54965,180,140,160,160,320,320,1280
54966,180,140,80,80,160,0,640
54967,180,120,120,160,320,320,1220
54968,200,120,80,80,160,320,960
54969,150,120,160,160,160,0,750
54970,200,120,120,160,0,0,600
54971,230,180,120,0,0,0,530
54972,210,100,120,160,160,320,1070
54973,170,80,80,80,160,0,570
54974,200,140,120,80,0,0,540
54975,190,120,200,160,0,0,670
54976,160,100,0,0,0,0,260
54977,200,100,120,80,160,0,660
54978,180,120,160,240,160,0,860
54979,240,140,80,0,0,0,460
54980,230,140,40,0,0,0,410
54981,180,80,80,80,160,0,580
54982,180,140,120,80,160,320,1000
54983,190,120,120,160,160,0,750
54984,160,140,40,80,0,0,420
54985,210,120,160,160,160,0,810
54986,200,120,160,160,160,0,800
54987,180,140,40,80,0,0,440
54988,200,160,40,0,0,0,400
54989,200,120,120,240,320,0,1000
54990,180,160,80,0,0,0,420
54991,200,140,80,80,160,0,660
54992,190,80,80,80,0,0,430
54993,170,100,80,160,320,320,1150
54994,240,160,120,80,160,0,760
54995,210,60,80,160,160,0,670
54996,180,140,120,80,160,0,680
54997,220,100,40,0,0,0,360
54998,180,120,0,0,0,0,300
54999,210,120,120,80,0,0,530
55000,200,140,160,240,160,0,900
55001,130,80,40,0,0,0,250
55002,210,140,120,80,160,0,710
55003,190,100,160,160,0,0,610
55004,190,120,120,160,320,0,910
55005,170,80,40,80,160,0,530
55006,240,100,120,80,160,0,700
55007,200,80,120,80,160,0,640
55008,210,160,160,160,160,0,850
55009,250,180,120,160,320,0,1030
55010,220,160,120,160,320,320,1300
55011,230,200,160,160,160,0,910
55012,170,100,120,80,0,0,470
55013,220,100,160,160,160,320,1120
55014,160,100,160,160,320,0,900
55015,170,80,120,160,160,0,690
55016,180,100,120,0,0,0,400
55017,200,100,120,0,0,0,420
55018,240,160,80,0,0,0,480
55019,250,140,80,80,160,0,710
55020,200,160,200,240,320,0,1120
55021,160,100,160,160,0,0,580
55022,180,140,200,160,0,0,680
55023,180,100,120,160,160,0,720
55024,220,140,120,80,160,0,720
55025,170,100,120,80,160,0,630
55026,210,120,120,80,0,0,530
55027,230,100,120,80,160,0,690
55028,180,100,40,80,160,0,560
55029,180,120,80,80,0,0,460
55030,160,100,80,80,0,0,420
55031,210,180,200,160,160,0,910
55032,240,100,40,80,160,320,940
55033,200,80,40,80,160,0,560
55034,170,120,120,160,0,0,570
55035,190,80,40,80,160,0,550
55036,170,100,120,0,0,0,390
55037,210,140,80,0,0,0,430
55038,210,100,0,0,0,0,310
55039,170,140,200,160,160,0,830
55040,210,120,160,80,160,320,1050
55041,190,140,40,0,0,0,370
55042,220,120,80,0,0,0,420
55043,190,140,120,80,0,0,530
55044,250,120,120,160,160,0,810
55045,210,160,80,80,160,0,690
55046,230,140,120,240,320,0,1050
55047,180,120,80,160,160,320,1020
55048,130,120,120,80,160,320,930
55049,220,120,40,0,0,0,380
55050,220,180,160,80,160,0,800
55051,200,100,120,80,0,0,500
55052,210,160,120,160,320,0,970
55053,230,160,120,160,160,0,830
55054,210,160,160,160,160,0,850
55055,200,200,200,240,320,0,1160
55056,220,120,120,240,160,0,860
55057,200,160,120,0,0,0,480
55058,160,120,120,160,320,0,880
55059,150,140,80,80,160,0,610
55060,180,160,120,160,0,0,620
55061,180,80,80,80,0,0,420
55062,190,120,200,160,160,0,830
55063,190,140,120,240,320,0,1010
55064,230,160,120,80,0,0,590
55065,210,140,160,160,0,0,670
55066,180,80,40,80,160,0,540
55067,160,100,120,0,0,0,380
55068,210,80,80,80,160,320,930
55069,220,120,160,160,320,0,980
55070,200,60,0,0,0,0,260
55071,190,160,80,0,0,0,430
55072,230,120,120,80,160,0,710
55073,180,120,160,80,0,0,540
55074,200,80,120,80,160,0,640
55075,190,160,240,240,160,0,990
55076,220,140,80,160,0,0,600
55077,180,140,120,80,0,0,520
55078,180,120,80,160,320,320,1180
55079,200,160,200,80,160,0,800
55080,180,120,80,0,0,0,380
55081,220,80,80,80,160,0,620
55082,200,140,160,0,0,0,500
55083,180,100,120,160,160,0,720
55084,210,120,80,80,160,0,650
55085,210,140,120,80,160,320,1030
55086,200,160,160,160,160,0,840
55087,240,200,160,240,320,0,1160
55088,190,60,80,80,160,0,570
55089,210,120,200,160,0,0,690
55090,170,100,120,160,320,0,870
55091,200,120,120,0,0,0,440
55092,180,140,120,160,320,0,920
55093,230,100,80,160,320,320,1210
55094,210,140,200,240,160,0,950
55095,140,80,120,160,320,0,820
55096,170,120,120,240,160,0,810
55097,190,80,120,160,0,0,550
55098,230,120,80,0,0,0,430
55099,180,100,120,160,160,320,1040
55100,180,120,80,80,0,0,460
55101,240,140,120,80,160,0,740
55102,180,160,160,80,0,0,580
55103,200,120,80,80,160,0,640
55104,190,60,40,80,160,320,850
55105,210,140,120,160,160,0,790
55106,230,160,200,320,320,0,1230
55107,150,40,40,0,0,0,230
55108,160,140,80,80,160,0,620
55109,230,120,40,0,0,0,390
55110,240,140,80,80,0,0,540
55111,160,120,120,80,0,0,480
55112,200,120,80,80,160,0,640
55113,150,120,80,80,0,0,430
55114,180,80,80,160,0,0,500
55115,190,120,40,0,0,0,350
55116,170,120,40,0,0,0,330
55117,150,80,40,0,0,0,270
55118,220,140,200,240,160,0,960
55119,170,140,120,160,160,320,1070
55120,190,80,40,80,160,320,870
55121,200,120,80,80,160,0,640
55122,200,80,80,0,0,0,360
55123,180,140,80,160,320,0,880
55124,250,100,80,80,160,0,670
55125,230,100,80,160,160,0,730
55126,150,120,80,160,320,320,1150
55127,240,200,200,160,160,0,960
55128,200,100,40,80,0,0,420
55129,210,120,160,80,160,320,1050
55130,180,120,80,80,160,0,620
55131,200,120,160,0,0,0,480
55132,190,60,80,160,160,0,650
55133,180,180,240,240,320,0,1160
55134,180,120,120,160,320,320,1220
55135,180,100,80,0,0,0,360
55136,210,120,40,80,160,0,610
55137,200,160,160,80,160,0,760
55138,230,160,80,160,320,0,950
55139,220,120,120,80,0,0,540
55140,190,160,240,160,160,0,910
55141,210,160,120,0,0,0,490
55142,180,160,160,80,0,0,580
55143,180,160,80,160,320,0,900
55144,190,160,200,160,160,0,870
55145,200,140,120,80,0,0,540
55146,220,120,40,80,160,320,940
55147,210,140,80,160,160,0,750
55148,240,120,80,80,160,320,1000
55149,190,160,160,0,0,0,510
55150,210,120,160,160,160,320,1130
55151,200,120,120,0,0,0,440
55152,230,80,80,0,0,0,390
55153,160,120,0,0,0,0,280
55154,230,120,120,160,160,0,790
55155,200,120,80,0,0,0,400
55156,180,80,120,80,0,0,460
55157,190,140,40,0,0,0,370
55158,230,140,160,160,160,0,850
55159,200,140,80,160,160,0,740
55160,210,160,0,0,0,0,370
55161,210,80,80,160,0,0,530
55162,200,100,40,80,160,0,580
55163,240,160,120,160,320,320,1320
55164,130,120,200,160,160,0,770
55165,200,120,80,80,0,0,480
55166,230,140,120,0,0,0,490
55167,200,100,40,80,0,0,420
55168,190,80,40,0,0,0,310
55169,180,120,120,80,160,0,660
55170,220,160,200,240,160,0,980
55171,200,140,120,80,0,0,540
55172,230,100,120,160,160,0,770
55173,190,180,160,160,0,0,690
55174,200,100,80,80,160,320,940
55175,210,100,80,160,160,0,710
55176,200,120,80,0,0,0,400
55177,210,140,40,80,0,0,470
55178,220,140,160,160,160,0,840
55179,150,80,40,0,0,0,270
55180,170,120,80,0,0,0,370
55181,170,100,120,80,160,320,950
55182,200,140,80,80,0,0,500
55183,210,120,160,160,0,0,650
55184,230,120,80,0,0,0,430
55185,170,80,120,80,160,320,930
55186,190,140,160,80,160,0,730
55187,210,140,80,160,0,0,590
55188,210,100,40,80,160,0,590
55189,180,140,80,80,160,0,640
55190,220,120,40,80,160,0,620
55191,200,160,160,80,160,0,760
55192,180,160,40,0,0,0,380
55193,150,140,160,160,160,0,770
55194,180,120,80,80,160,0,620
55195,190,160,120,160,160,0,790
55196,150,60,80,80,160,0,530
55197,180,80,80,80,0,0,420
55198,140,80,80,80,0,0,380
55199,220,160,120,160,160,0,820
55200,190,100,120,160,160,0,730
55201,190,100,80,0,0,0,370
55202,190,160,120,80,160,0,710
55203,210,140,120,160,160,0,790
55204,190,100,40,0,0,0,330
55205,210,180,200,80,0,0,670
55206,180,100,80,0,0,0,360
55207,200,40,40,0,0,0,280
55208,190,160,120,160,320,320,1270
55209,230,140,200,0,0,0,570
55210,210,160,200,160,320,0,1050
55211,260,180,120,80,0,0,640
55212,190,120,160,160,0,0,630
55213,230,160,40,0,0,0,430
55214,180,80,40,80,160,0,540
55215,220,140,160,80,0,0,600
55216,190,140,120,80,0,0,530
55217,260,120,80,80,0,0,540
55218,190,60,80,0,0,0,330
55219,220,140,160,80,0,0,600
55220,210,100,80,80,160,0,630
55221,180,80,80,160,160,0,660
55222,180,80,80,80,0,0,420
55223,220,120,120,160,0,0,620
55224,250,180,120,80,160,0,790
55225,200,60,40,0,0,0,300
55226,210,80,80,80,160,0,610
55227,190,100,120,80,0,0,490
55228,200,80,120,160,320,320,1200
55229,170,100,80,80,160,0,590
55230,200,120,80,80,0,0,480
55231,180,80,80,80,160,0,580
55232,180,160,80,80,160,0,660
55233,220,120,80,80,160,320,980
55234,190,140,120,80,160,0,690
55235,200,140,80,80,160,0,660
55236,190,160,40,80,0,0,470
55237,170,180,160,160,160,0,830
55238,220,140,120,80,0,0,560
55239,220,160,120,80,160,0,740
55240,220,140,120,160,160,0,800
55241,200,120,80,0,0,0,400
55242,210,160,40,80,160,0,650
55243,210,160,80,80,160,320,1010
55244,160,100,120,160,0,0,540
55245,170,140,120,160,160,0,750
55246,210,80,40,80,0,0,410
55247,170,80,80,160,160,0,650
55248,190,120,120,160,160,0,750
55249,190,120,160,160,320,320,1270
55250,160,120,80,160,320,320,1160
55251,180,100,120,80,0,0,480
55252,210,120,80,80,0,0,490
55253,170,160,80,80,0,0,490
55254,210,120,120,160,160,320,1090
55255,230,100,40,0,0,0,370
55256,190,160,120,160,320,320,1270
55257,170,120,160,160,160,320,1090
55258,220,100,40,80,160,0,600
55259,200,140,80,80,0,0,500
55260,160,100,0,0,0,0,260
55261,170,120,120,80,0,0,490
55262,220,80,80,160,160,0,700
55263,150,100,120,80,160,0,610
55264,220,120,160,160,0,0,660
55265,200,80,40,0,0,0,320
55266,190,80,160,160,320,320,1230
55267,200,120,40,80,0,0,440
55268,230,120,80,160,320,320,1230
55269,170,80,80,0,0,0,330
55270,180,100,120,240,160,0,800
55271,200,160,120,0,0,0,480
55272,170,100,160,240,320,0,990
55273,190,160,160,240,320,320,1390
55274,200,160,160,80,160,0,760
55275,160,140,160,0,0,0,460
55276,170,100,120,160,160,0,710
55277,170,120,80,160,160,0,690
55278,240,140,40,0,0,0,420
55279,210,140,200,240,320,320,1430
55280,180,120,120,240,160,0,820
55281,210,160,200,240,160,0,970
55282,210,120,80,80,0,0,490
55283,170,120,120,160,320,320,1210
55284,170,120,160,160,160,0,770
55285,210,60,40,80,160,0,550
55286,140,60,80,0,0,0,280
55287,180,100,80,80,0,0,440
55288,160,120,120,80,160,0,640
55289,180,160,120,160,320,320,1260
55290,210,180,160,160,0,0,710
55291,240,140,120,80,160,0,740
55292,190,80,40,0,0,0,310
55293,170,60,80,80,160,320,870
55294,200,180,80,80,160,320,1020
55295,160,80,40,80,0,0,360
55296,200,160,200,160,320,320,1360
55297,220,160,80,80,0,0,540
55298,170,100,160,160,160,0,750
55299,180,120,160,160,160,320,1100
55300,230,160,160,160,160,320,1190
55301,220,120,160,80,0,0,580
55302,190,180,120,160,0,0,650
55303,170,60,40,80,160,0,510
55304,210,100,80,0,0,0,390
55305,200,140,160,160,160,0,820
55306,150,100,40,80,160,0,530
55307,150,140,80,80,160,0,610
55308,220,140,160,160,160,0,840
55309,170,120,80,80,0,0,450
55310,210,80,80,80,160,0,610
55311,180,80,80,80,160,320,900
55312,140,120,120,160,0,0,540
55313,200,160,120,80,0,0,560
55314,180,80,80,80,0,0,420
55315,200,80,80,160,160,0,680
55316,180,100,80,80,0,0,440
55317,170,100,80,80,160,0,590
55318,160,120,160,160,320,320,1240
55319,210,120,120,160,0,0,610
55320,180,120,40,0,0,0,340
55321,210,60,80,80,0,0,430
55322,220,100,40,0,0,0,360
55323,200,100,80,80,160,320,940
55324,220,100,120,80,160,0,680
55325,250,100,80,160,320,0,910
55326,190,100,120,160,160,0,730
55327,170,100,40,0,0,0,310
55328,190,120,120,80,160,320,990
55329,200,160,80,80,160,320,1000
55330,180,40,40,80,160,0,500
55331,170,80,120,160,160,0,690
55332,170,160,80,0,0,0,410
55333,210,60,120,160,160,0,710
55334,150,40,80,80,160,320,830
55335,230,120,40,80,160,0,630
55336,210,120,40,80,160,0,610
55337,190,160,120,80,160,320,1030
55338,210,160,200,240,320,0,1130
55339,210,140,120,160,160,0,790
55340,220,140,40,0,0,0,400
55341,230,120,80,80,0,0,510
55342,240,120,40,0,0,0,400
55343,190,160,80,80,160,0,670
55344,190,120,160,160,160,0,790
55345,190,100,80,80,160,0,610
55346,230,120,40,80,160,0,630
55347,200,140,200,160,160,0,860
55348,200,140,80,0,0,0,420
55349,220,100,80,160,320,0,880
55350,220,120,80,0,0,0,420
55351,220,100,40,0,0,0,360
55352,200,140,200,160,320,320,1340
55353,240,100,120,80,160,0,700
55354,200,80,80,160,160,0,680
55355,250,140,120,160,160,320,1150
55356,180,120,80,80,160,320,940
55357,220,120,120,80,160,0,700
55358,150,60,0,0,0,0,210
55359,180,100,80,0,0,0,360
55360,240,60,80,80,0,0,460
55361,220,140,120,80,160,0,720
55362,220,120,80,160,320,320,1220
55363,180,140,120,160,320,0,920
55364,190,100,120,80,160,0,650
55365,190,140,80,80,0,0,490
55366,200,140,160,80,160,0,740
55367,190,60,40,0,0,0,290
55368,200,80,40,80,0,0,400
55369,160,120,80,80,0,0,440
55370,220,140,80,80,160,320,1000
55371,220,80,80,80,160,0,620
55372,200,180,160,160,0,0,700
55373,230,180,80,0,0,0,490
55374,230,160,160,240,160,0,950
55375,240,140,80,0,0,0,460
55376,170,100,40,80,160,0,550
55377,200,100,80,160,160,0,700
55378,250,80,120,80,0,0,530
55379,170,80,120,80,0,0,450
55380,180,20,40,0,0,0,240
55381,200,120,80,80,0,0,480
55382,220,80,40,0,0,0,340
55383,210,80,0,0,0,0,290
55384,220,200,160,240,320,0,1140
55385,170,120,40,0,0,0,330
55386,220,160,120,80,160,0,740
55387,180,140,80,80,0,0,480
55388,210,100,160,160,160,320,1110
55389,200,100,40,80,160,0,580
55390,150,120,40,0,0,0,310
55391,150,80,120,160,320,0,830
55392,220,220,160,80,0,0,680
55393,190,140,120,80,160,0,690
55394,200,120,80,80,160,0,640
55395,170,140,80,0,0,0,390
55396,200,140,160,240,160,0,900
55397,190,100,120,80,160,0,650
55398,140,120,80,0,0,0,340
55399,210,160,160,80,160,0,770
55400,190,140,120,80,0,0,530
55401,210,160,80,80,160,0,690
55402,150,140,80,80,160,320,930
55403,210,80,80,80,0,0,450
55404,210,160,120,160,160,320,1130
55405,210,100,40,80,160,0,590
55406,200,140,160,80,0,0,580
55407,220,160,120,80,0,0,580
55408,170,80,80,0,0,0,330
55409,200,120,120,160,320,320,1240
55410,190,140,120,80,0,0,530
55411,200,140,120,80,0,0,540
55412,190,100,160,160,160,320,1090
55413,210,160,40,0,0,0,410
55414,180,140,160,160,160,320,1120
55415,190,100,40,0,0,0,330
55416,230,80,80,160,320,320,1190
55417,190,160,120,80,160,320,1030
55418,200,140,160,240,320,0,1060
55419,190,180,200,240,320,0,1130
55420,180,60,0,0,0,0,240
55421,180,140,40,80,160,0,600
55422,210,140,200,160,160,0,870
55423,200,140,160,80,160,0,740
55424,220,120,40,80,160,0,620
55425,180,120,160,160,320,0,940
55426,210,100,120,80,0,0,510
55427,230,160,40,80,0,0,510
55428,160,100,80,80,0,0,420
55429,180,120,120,240,160,0,820
55430,210,140,120,0,0,0,470
55431,170,140,120,80,0,0,510
55432,180,160,120,0,0,0,460
55433,190,60,80,80,160,0,570
55434,170,120,80,80,0,0,450
55435,190,120,120,160,0,0,590
55436,210,140,80,80,160,0,670
55437,190,100,80,0,0,0,370
55438,270,120,160,160,320,0,1030
55439,200,100,80,80,160,0,620
55440,200,100,160,160,160,0,780
55441,230,100,80,80,160,0,650
55442,140,100,80,0,0,0,320
55443,220,140,80,160,160,0,760
55444,210,100,40,80,160,0,590
55445,210,120,40,0,0,0,370
55446,190,160,120,80,160,0,710
55447,210,120,80,80,160,0,650
55448,170,60,80,80,160,0,550
55449,200,80,40,0,0,0,320
55450,210,100,80,160,160,320,1030
55451,200,160,120,80,160,0,720
55452,190,120,160,80,160,0,710
55453,200,100,40,80,160,0,580
55454,190,100,40,80,160,0,570
55455,180,100,120,160,320,0,880
55456,180,140,80,160,320,0,880
55457,180,140,160,160,160,0,800
55458,190,120,120,160,160,0,750
55459,210,100,80,80,160,0,630
55460,210,100,80,160,320,320,1190
55461,240,160,120,80,0,0,600
55462,180,160,200,240,160,0,940
55463,200,140,200,160,0,0,700
55464,160,100,80,0,0,0,340
55465,200,160,80,80,0,0,520
55466,190,120,80,80,160,0,630
55467,200,160,160,160,160,0,840
55468,200,180,80,0,0,0,460
55469,180,80,120,240,160,320,1100
55470,210,100,40,0,0,0,350
55471,240,180,200,160,320,0,1100
55472,210,100,40,80,0,0,430
55473,210,120,40,80,160,0,610
55474,180,180,120,0,0,0,480
55475,180,100,120,160,320,320,1200
55476,180,60,0,0,0,0,240
55477,190,120,120,80,160,0,670
55478,210,100,80,80,0,0,470
55479,200,120,80,80,160,0,640
55480,240,160,120,80,0,0,600
55481,200,140,120,160,0,0,620
55482,180,120,80,160,160,0,700
55483,150,140,160,240,320,0,1010
55484,170,60,0,0,0,0,230
55485,180,180,200,240,320,0,1120
55486,210,140,160,80,160,0,750
55487,200,140,40,80,0,0,460
55488,190,120,80,80,0,0,470
55489,190,100,80,160,320,0,850
55490,220,80,80,80,160,0,620
55491,180,100,120,80,160,0,640
55492,170,160,120,80,160,0,690
55493,200,80,80,0,0,0,360
55494,180,80,40,0,0,0,300
55495,180,180,120,80,0,0,560
55496,230,100,120,80,160,0,690
55497,200,180,120,160,320,320,1300
55498,240,180,120,0,0,0,540
55499,180,100,200,80,160,0,720
55500,210,180,120,240,160,0,910
55501,180,140,160,160,320,0,960
55502,200,100,80,0,0,0,380
55503,200,140,120,80,160,0,700
55504,190,100,40,0,0,0,330
55505,190,120,80,80,160,0,630
55506,220,120,0,0,0,0,340
55507,200,80,80,80,160,0,600
55508,160,80,0,0,0,0,240
55509,190,140,160,80,160,0,730
55510,200,120,80,80,0,0,480
55511,190,100,0,0,0,0,290
55512,160,120,40,0,0,0,320
55513,230,160,120,80,160,0,750
55514,180,140,40,0,0,0,360
55515,190,120,80,80,0,0,470
55516,210,100,80,80,160,0,630
55517,160,80,40,0,0,0,280
55518,180,120,160,160,320,320,1260
55519,210,140,160,80,0,0,590
55520,190,100,40,0,0,0,330
55521,210,120,120,0,0,0,450
55522,240,180,80,160,0,0,660
55523,220,160,120,160,320,320,1300
55524,210,140,120,240,320,0,1030
55525,190,120,80,0,0,0,390
55526,200,180,200,240,160,0,980
55527,210,120,120,80,160,0,690
55528,210,100,120,0,0,0,430
55529,210,100,120,160,0,0,590
55530,240,140,160,160,160,0,860
55531,210,120,120,160,160,320,1090
55532,210,140,160,80,160,0,750
55533,190,140,120,160,160,0,770
55534,210,100,120,160,160,0,750
55535,220,120,120,80,0,0,540
55536,210,80,80,160,320,0,850
55537,200,160,120,160,320,0,960
55538,160,100,120,80,0,0,460
55539,210,80,40,0,0,0,330
55540,190,60,120,160,160,0,690
55541,210,140,80,80,0,0,510
55542,210,160,200,240,160,0,970
55543,210,140,120,80,160,0,710
55544,170,120,120,80,160,0,650
55545,200,100,0,0,0,0,300
55546,170,80,80,80,0,0,410
55547,200,100,80,80,160,0,620
55548,180,120,80,80,0,0,460
55549,200,80,80,80,0,0,440
55550,240,120,120,240,320,0,1040
55551,230,180,160,160,160,0,890
55552,180,120,80,80,0,0,460
55553,210,100,40,0,0,0,350
55554,210,120,120,80,160,0,690
55555,180,100,80,0,0,0,360
55556,190,60,80,80,160,0,570
55557,190,120,120,160,160,0,750
55558,220,120,160,240,320,0,1060
55559,190,140,80,80,0,0,490
55560,240,160,200,0,0,0,600
55561,190,100,40,0,0,0,330
55562,230,160,120,0,0,0,510
55563,210,60,80,160,320,320,1150
55564,250,160,80,0,0,0,490
55565,180,100,120,160,160,320,1040
55566,190,80,0,0,0,0,270
55567,190,160,160,80,160,0,750
55568,170,160,80,80,0,0,490
55569,150,140,80,160,320,320,1170
55570,240,100,80,80,0,0,500
55571,200,60,40,80,160,320,860
55572,200,80,80,160,160,0,680
55573,220,100,0,0,0,0,320
55574,170,100,80,160,160,0,670
55575,210,140,80,80,0,0,510
55576,180,120,200,160,160,320,1140
55577,230,140,120,80,0,0,570
55578,200,140,80,80,0,0,500
55579,150,120,120,160,0,0,550
55580,240,180,40,80,0,0,540
55581,210,160,120,160,0,0,650
55582,200,100,80,160,320,0,860
55583,210,140,120,80,160,0,710
55584,220,140,40,80,0,0,480
55585,240,140,80,80,160,320,1020
55586,180,120,40,0,0,0,340
55587,220,240,200,80,0,0,740
55588,180,120,120,80,160,0,660
55589,180,180,80,80,160,0,680
55590,190,140,80,0,0,0,410
55591,220,80,80,80,0,0,460
55592,230,120,80,80,160,0,670
55593,190,100,120,80,0,0,490
55594,150,100,80,160,160,0,650
55595,210,180,160,160,0,0,710
55596,180,80,80,80,160,0,580
55597,140,80,80,0,0,0,300
55598,210,40,0,0,0,0,250
55599,160,80,80,80,0,0,400
55600,180,100,80,80,160,0,600
55601,180,120,120,160,160,0,740
55602,240,160,120,80,0,0,600
55603,200,140,80,80,0,0,500
55604,170,140,160,160,160,0,790
55605,150,100,160,80,0,0,490
55606,170,80,120,80,0,0,450
55607,190,180,160,160,320,0,1010
55608,180,140,160,80,0,0,560
55609,170,100,120,80,0,0,470
55610,180,140,80,160,320,0,880
55611,180,80,120,80,160,0,620
55612,140,100,80,80,160,0,560
55613,200,120,120,80,160,0,680
55614,190,120,120,240,320,320,1310
55615,110,100,80,80,160,0,530
55616,160,120,40,80,0,0,400
55617,220,160,120,80,160,320,1060
55618,220,160,160,160,160,0,860
55619,210,200,200,160,160,0,930
55620,150,60,120,80,160,0,570
55621,180,120,80,80,160,0,620
55622,210,120,0,0,0,0,330
55623,200,140,120,160,160,0,780
55624,240,120,80,80,0,0,520
55625,210,140,80,80,0,0,510
55626,220,140,120,0,0,0,480
55627,200,100,160,160,160,0,780
55628,200,100,120,160,0,0,580
55629,190,160,120,80,0,0,550
55630,220,60,40,80,0,0,400
55631,210,140,160,240,320,0,1070
55632,210,160,80,160,160,320,1090
55633,170,140,120,80,160,0,670
55634,150,120,80,80,160,0,590
55635,190,100,80,0,0,0,370
55636,230,160,120,80,0,0,590
55637,220,140,40,0,0,0,400
55638,190,80,80,160,320,0,830
55639,210,160,120,160,0,0,650
55640,210,100,80,0,0,0,390
55641,150,80,80,80,160,0,550
55642,200,140,40,80,160,0,620
55643,180,160,160,160,160,320,1140
55644,230,100,80,160,320,0,890
55645,180,140,120,80,160,0,680
55646,180,160,160,160,320,0,980
55647,180,120,120,160,160,320,1060
55648,190,100,80,80,160,0,610
55649,170,60,40,80,160,0,510
55650,190,140,200,0,0,0,530
55651,220,160,200,160,320,0,1060
55652,240,120,120,80,160,0,720
55653,220,220,120,0,0,0,560
55654,200,120,120,160,0,0,600
55655,230,120,80,80,160,0,670
55656,190,40,40,80,0,0,350
55657,210,120,120,80,160,320,1010
55658,190,120,160,80,160,320,1030
55659,150,80,80,0,0,0,310
55660,200,160,200,160,0,0,720
55661,200,120,80,160,320,320,1200
55662,190,100,120,80,0,0,490
55663,220,160,120,240,160,0,900
55664,190,120,120,80,0,0,510
55665,190,100,120,160,0,0,570
55666,170,100,120,80,160,0,630
55667,210,140,80,80,160,0,670
55668,180,60,40,0,0,0,280
55669,190,100,120,0,0,0,410
55670,190,140,80,0,0,0,410
55671,180,40,40,80,0,0,340
55672,240,160,40,0,0,0,440
55673,230,180,160,160,160,0,890
55674,210,180,120,80,160,0,750
55675,240,120,200,160,0,0,720
55676,200,140,80,80,160,0,660
55677,210,160,160,160,160,0,850
55678,210,100,120,0,0,0,430
55679,180,120,200,160,160,0,820
55680,180,120,120,80,160,0,660
55681,200,140,160,0,0,0,500
55682,200,120,40,80,0,0,440
55683,170,140,80,0,0,0,390
55684,220,80,80,80,0,0,460
55685,150,80,40,0,0,0,270
55686,220,140,120,80,160,320,1040
55687,200,140,160,160,160,0,820
55688,160,140,80,160,160,0,700
55689,240,140,40,80,0,0,500
55690,200,80,80,80,160,0,600
55691,210,140,120,80,0,0,550
55692,190,140,160,160,160,0,810
55693,190,120,80,80,0,0,470
55694,230,100,80,80,0,0,490
55695,240,100,120,80,160,0,700
55696,230,120,120,80,160,0,710
55697,190,120,80,160,160,0,710
55698,140,100,120,240,160,0,760
55699,210,120,160,160,160,320,1130
55700,180,120,160,240,0,0,700
55701,200,120,120,80,160,0,680
55702,210,60,80,80,0,0,430
55703,150,80,120,240,320,320,1230
55704,180,80,120,160,0,0,540
55705,230,120,80,80,160,0,670
55706,190,140,120,160,160,0,770
55707,210,160,80,0,0,0,450
55708,170,60,80,80,160,320,870
55709,220,140,200,160,160,0,880
55710,160,160,160,160,160,320,1120
55711,210,100,120,160,160,0,750
55712,230,120,40,0,0,0,390
55713,220,200,120,80,160,0,780
55714,220,100,120,80,0,0,520
55715,190,120,120,160,160,0,750
55716,230,140,80,0,0,0,450
55717,220,180,200,160,320,0,1080
55718,230,140,80,160,0,0,610
55719,190,100,80,80,160,0,610
55720,180,120,120,160,320,320,1220
55721,210,60,80,80,160,0,590
55722,150,120,80,80,160,0,590
55723,200,140,120,80,0,0,540
55724,180,80,80,80,160,320,900
55725,190,180,160,160,160,0,850
55726,230,120,80,160,320,0,910
55727,170,120,80,160,160,320,1010
55728,220,120,120,0,0,0,460
55729,190,140,120,80,160,0,690
55730,200,120,160,80,0,0,560
55731,170,100,80,0,0,0,350
55732,180,60,40,0,0,0,280
55733,190,120,40,0,0,0,350
55734,230,120,80,80,160,0,670
55735,210,100,40,0,0,0,350
55736,170,100,80,80,160,0,590
55737,200,160,80,80,160,0,680
55738,200,140,120,160,160,0,780
55739,200,80,120,0,0,0,400
55740,160,140,80,0,0,0,380
55741,190,120,120,160,160,0,750
55742,190,120,120,80,0,0,510
55743,220,140,160,0,0,0,520
55744,200,120,80,80,160,0,640
55745,170,120,120,160,160,0,730
55746,210,60,40,80,160,0,550
55747,140,100,80,0,0,0,320
55748,180,120,120,80,0,0,500
55749,220,40,40,0,0,0,300
55750,140,100,120,0,0,0,360
55751,210,140,160,80,0,0,590
55752,220,180,200,160,160,0,920
55753,180,140,40,80,160,0,600
55754,170,60,120,160,320,0,830
55755,200,180,80,80,160,0,700
55756,190,100,160,80,160,0,690
55757,150,120,120,160,160,320,1030
55758,190,100,160,240,160,0,850
55759,210,120,80,160,160,320,1050
55760,180,100,120,160,320,0,880
55761,230,80,40,0,0,0,350
55762,240,120,120,80,160,0,720
55763,170,120,160,160,160,0,770
55764,190,100,80,160,160,320,1010
55765,190,140,200,0,0,0,530
55766,180,120,120,160,320,0,900
55767,160,60,40,80,0,0,340
55768,220,140,120,160,160,0,800
55769,200,160,120,80,160,0,720
55770,200,160,80,0,0,0,440
55771,220,120,80,160,160,0,740
55772,250,160,160,160,0,0,730
55773,160,120,160,240,160,320,1160
55774,200,120,160,160,160,0,800
55775,210,100,40,0,0,0,350
55776,220,160,120,80,0,0,580
55777,190,80,80,160,0,0,510
55778,220,100,80,80,160,320,960
55779,200,100,120,0,0,0,420
55780,210,100,40,80,160,0,590
55781,210,140,120,160,160,320,1110
55782,210,140,120,160,0,0,630
55783,190,120,160,80,160,0,710
55784,240,120,80,80,0,0,520
55785,220,120,80,80,160,0,660
55786,210,140,40,80,160,320,950
55787,140,120,40,80,160,0,540
55788,210,100,160,160,160,0,790
55789,200,80,40,80,0,0,400
55790,200,100,80,80,0,0,460
55791,220,120,80,0,0,0,420
55792,190,40,40,0,0,0,270
55793,180,160,120,160,0,0,620
55794,210,140,120,160,0,0,630
55795,210,160,120,80,0,0,570
55796,220,120,80,0,0,0,420
55797,160,140,80,80,160,0,620
55798,180,100,120,160,0,0,560
55799,200,140,120,240,160,0,860
55800,190,60,40,0,0,0,290
55801,170,140,240,160,160,0,870
55802,200,180,160,80,160,320,1100
55803,200,100,40,80,160,320,900
55804,200,160,80,0,0,0,440
55805,210,140,120,0,0,0,470
55806,220,160,160,240,0,0,780
55807,250,120,80,80,160,0,690
55808,210,140,160,160,160,0,830
55809,260,140,80,0,0,0,480
55810,190,100,80,0,0,0,370
55811,170,60,80,80,160,320,870
55812,190,120,120,160,160,0,750
55813,230,120,120,80,160,0,710
55814,150,160,160,80,0,0,550
55815,240,120,120,160,0,0,640
55816,200,100,160,160,160,0,780
55817,220,180,80,80,160,0,720
55818,180,120,120,160,160,0,740
55819,200,120,120,0,0,0,440
55820,180,140,120,80,0,0,520
55821,200,160,160,160,320,320,1320
55822,220,120,120,80,160,0,700
55823,190,140,80,0,0,0,410
55824,210,80,120,80,160,0,650
55825,210,80,0,0,0,0,290
55826,170,100,200,80,0,0,550
55827,190,100,120,80,0,0,490
55828,220,180,200,160,160,320,1240
55829,240,160,160,160,160,0,880
55830,170,100,80,80,0,0,430
55831,120,80,120,160,0,0,480
55832,130,60,40,80,160,0,470
55833,170,100,80,80,0,0,430
55834,200,140,200,160,160,0,860
55835,190,180,120,160,160,0,810
55836,190,100,120,240,160,0,810
55837,210,180,120,80,160,0,750
55838,220,180,160,160,160,0,880
55839,200,100,80,80,160,0,620
55840,160,80,120,80,160,0,600
55841,220,160,120,80,0,0,580
55842,160,120,40,0,0,0,320
55843,230,140,40,0,0,0,410
55844,220,100,160,160,160,320,1120
55845,200,120,80,80,160,320,960
55846,180,140,80,80,160,0,640
55847,180,80,40,80,0,0,380
55848,200,60,40,0,0,0,300
55849,180,140,80,160,160,320,1040
55850,140,140,120,160,0,0,560
55851,210,120,160,160,160,0,810
55852,180,100,160,80,0,0,520
55853,190,100,40,80,0,0,410
55854,180,100,80,160,160,0,680
55855,180,60,80,80,160,320,880
55856,190,100,120,0,0,0,410
55857,180,120,80,160,160,0,700
55858,220,120,120,80,160,0,700
55859,180,100,120,0,0,0,400
55860,220,120,160,160,0,0,660
55861,170,80,40,0,0,0,290
55862,220,120,120,80,160,0,700
55863,190,80,120,160,320,320,1190
55864,190,160,160,160,320,0,990
55865,190,100,120,160,320,0,890
55866,200,80,80,80,160,0,600
55867,210,100,80,80,0,0,470
55868,200,100,80,80,0,0,460
55869,170,160,160,160,160,320,1130
55870,240,180,120,240,0,0,780
55871,160,100,120,240,160,0,780
55872,190,120,120,160,160,0,750
55873,200,100,40,80,0,0,420
55874,190,140,200,160,320,0,1010
55875,200,40,0,0,0,0,240
55876,150,140,120,160,320,320,1210
55877,200,160,160,240,320,0,1080
55878,220,180,80,80,0,0,560
55879,170,120,200,240,160,0,890
55880,210,180,200,80,160,0,830
55881,170,120,80,80,160,0,610
55882,180,120,160,160,160,0,780
55883,210,120,80,80,160,0,650
55884,220,140,120,80,0,0,560
55885,190,100,80,80,160,320,930
55886,210,100,40,80,0,0,430
55887,230,100,80,80,0,0,490
55888,140,80,80,160,320,0,780
55889,190,80,80,160,320,0,830
55890,190,100,80,80,160,0,610
55891,180,140,160,160,160,0,800
55892,190,100,80,80,0,0,450
55893,180,160,160,160,320,0,980
55894,170,120,40,80,160,0,570
55895,210,100,120,160,320,320,1230
55896,220,60,40,80,160,320,880
55897,190,140,160,0,0,0,490
55898,210,160,120,80,0,0,570
55899,220,200,40,80,0,0,540
55900,220,140,200,160,160,0,880
55901,180,120,120,80,0,0,500
55902,190,140,160,160,0,0,650
55903,200,140,80,80,160,0,660
55904,190,60,80,80,160,0,570
55905,210,100,80,0,0,0,390
55906,200,80,160,160,160,320,1080
55907,210,160,120,240,320,320,1370
55908,180,160,120,0,0,0,460
55909,180,80,120,160,320,320,1180
55910,170,140,160,80,160,0,710
55911,180,60,120,240,320,0,920
55912,210,200,160,160,160,0,890
55913,220,160,160,320,160,320,1340
55914,210,120,80,160,0,0,570
55915,170,80,40,0,0,0,290
55916,180,160,160,240,160,320,1220
55917,180,100,80,160,160,0,680
55918,250,160,120,240,160,0,930
55919,210,160,80,80,160,0,690
55920,180,80,40,80,160,0,540
55921,230,120,80,0,0,0,430
55922,200,200,240,0,0,0,640
55923,150,80,80,0,0,0,310
55924,180,120,80,160,160,0,700
55925,200,140,40,80,160,0,620
55926,220,140,120,160,0,0,640
55927,230,120,40,0,0,0,390
55928,250,140,160,240,320,0,1110
55929,190,120,80,80,0,0,470
55930,190,160,80,80,0,0,510
55931,220,140,160,160,320,320,1320
55932,190,100,80,160,160,320,1010
55933,200,100,120,80,160,0,660
55934,220,120,40,80,160,0,620
55935,180,160,120,160,320,320,1260
55936,190,140,80,80,160,0,650
55937,180,100,80,80,160,0,600
55938,190,140,80,0,0,0,410
55939,190,100,120,160,0,0,570
55940,210,140,120,160,320,320,1270
55941,210,140,80,160,160,0,750
55942,230,80,120,80,160,0,670
55943,190,120,80,80,0,0,470
55944,180,100,80,160,320,0,840
55945,220,180,160,0,0,0,560
55946,210,160,160,240,160,0,930
55947,230,180,120,80,160,0,770
55948,240,120,160,160,0,0,680
55949,220,80,120,80,160,320,980
55950,200,160,160,160,0,0,680
55951,220,200,200,160,160,0,940
55952,200,100,120,160,160,0,740
55953,200,140,200,240,320,320,1420
55954,200,140,120,160,160,0,780
55955,170,80,120,160,320,0,850
55956,210,120,80,80,160,0,650
55957,170,100,160,160,160,0,750
55958,230,100,80,160,160,0,730
55959,210,160,240,160,320,320,1410
55960,230,100,40,0,0,0,370
55961,160,80,40,80,160,0,520
55962,210,160,120,160,320,320,1290
55963,220,100,40,0,0,0,360
55964,220,160,40,80,0,0,500
55965,190,80,120,80,160,320,950
55966,150,140,120,240,160,0,810
55967,190,120,120,0,0,0,430
55968,170,100,80,80,0,0,430
55969,210,80,40,80,160,0,570
55970,210,80,80,80,0,0,450
55971,240,180,160,80,160,0,820
55972,200,80,80,0,0,0,360
55973,180,100,120,240,320,0,960
55974,200,140,120,240,160,0,860
55975,170,140,160,80,0,0,550
55976,220,140,160,80,0,0,600
55977,180,120,120,80,160,0,660
55978,180,140,80,0,0,0,400
55979,180,140,160,0,0,0,480
55980,220,100,40,0,0,0,360
55981,200,120,160,80,0,0,560
55982,200,140,120,80,0,0,540
55983,230,120,120,80,160,0,710
55984,220,140,120,160,160,0,800
55985,170,80,40,0,0,0,290
55986,170,40,0,0,0,0,210
55987,200,120,80,80,160,0,640
55988,220,120,80,0,0,0,420
55989,230,140,120,80,0,0,570
55990,180,80,80,80,160,0,580
55991,250,140,120,80,160,0,750
55992,200,120,40,80,160,0,600
55993,230,160,160,80,160,0,790
55994,160,120,120,80,160,0,640
55995,170,140,120,0,0,0,430
55996,220,160,120,160,320,0,980
55997,200,160,120,80,160,320,1040
55998,200,160,200,80,160,0,800
55999,190,120,120,160,160,0,750
56000,200,120,80,160,320,320,1200
56001,230,100,40,0,0,0,370
56002,180,160,120,160,0,0,620
56003,250,180,200,240,160,0,1030
56004,200,160,80,80,160,0,680
56005,190,160,200,80,160,320,1110
56006,200,160,120,80,0,0,560
56007,200,120,120,240,160,0,840
56008,210,100,120,160,160,0,750
56009,190,100,40,80,160,320,890
56010,170,60,80,80,160,0,550
56011,220,120,160,240,160,0,900
56012,160,120,120,80,160,0,640
56013,220,160,120,160,160,0,820
56014,180,120,120,160,320,0,900
56015,180,100,80,0,0,0,360
56016,220,160,120,0,0,0,500
56017,160,80,40,80,160,0,520
56018,210,80,120,80,160,320,970
56019,200,120,40,80,0,0,440
56020,220,140,120,160,160,0,800
56021,170,100,80,80,160,0,590
56022,210,100,40,0,0,0,350
56023,190,160,80,80,160,0,670
56024,180,120,40,80,160,0,580
56025,210,120,80,0,0,0,410
56026,210,80,40,0,0,0,330
56027,190,100,160,80,160,0,690
56028,190,120,120,160,160,0,750
56029,220,120,80,160,160,0,740
56030,220,120,80,80,0,0,500
56031,200,160,80,160,160,0,760
56032,160,40,0,0,0,0,200
56033,210,180,160,80,160,0,790
56034,220,140,80,160,320,320,1240
56035,200,120,120,80,160,0,680
56036,150,100,80,0,0,0,330
56037,160,80,80,160,160,0,640
56038,210,140,120,240,320,0,1030
56039,190,80,120,0,0,0,390
56040,180,80,80,80,0,0,420
56041,180,120,160,160,0,0,620
56042,210,140,120,80,160,0,710
56043,170,100,80,80,0,0,430
56044,200,120,80,80,0,0,480
56045,220,160,120,80,0,0,580
56046,160,100,80,80,160,0,580
56047,220,80,80,160,0,0,540
56048,200,180,40,80,160,0,660
56049,200,140,120,80,160,0,700
56050,170,120,120,160,0,0,570
56051,210,140,120,80,0,0,550
56052,220,80,80,80,160,0,620
56053,200,160,120,160,160,0,800
56054,180,140,40,0,0,0,360
56055,210,160,120,160,160,0,810
56056,240,200,160,80,160,0,840
56057,220,140,160,0,0,0,520
56058,220,120,120,80,160,0,700
56059,210,120,80,80,160,0,650
56060,210,140,80,0,0,0,430
56061,220,120,200,160,160,0,860
56062,200,160,80,80,0,0,520
56063,220,100,40,80,0,0,440
56064,210,140,120,80,160,0,710
56065,210,160,80,80,160,0,690
56066,210,180,120,80,160,0,750
56067,180,180,200,160,320,320,1360
56068,230,120,120,80,160,0,710
56069,160,100,120,160,160,0,700
56070,220,180,160,80,0,0,640
56071,230,140,40,0,0,0,410
56072,160,80,160,160,320,320,1200
56073,210,140,160,160,0,0,670
56074,170,100,80,160,160,0,670
56075,240,100,0,0,0,0,340
56076,190,80,0,0,0,0,270
56077,200,140,160,80,160,320,1060
56078,200,100,80,160,0,0,540
56079,200,120,80,0,0,0,400
56080,180,40,0,0,0,0,220
56081,200,140,120,160,160,0,780
56082,180,160,200,240,320,0,1100
56083,200,80,40,80,0,0,400
56084,190,100,40,80,0,0,410
56085,180,60,120,160,0,0,520
56086,200,100,40,80,0,0,420
56087,240,180,160,240,160,0,980
56088,180,100,80,0,0,0,360
56089,210,120,160,160,320,0,970
56090,180,100,120,80,0,0,480
56091,220,180,160,160,320,0,1040
56092,210,180,160,160,0,0,710
56093,200,140,160,160,160,0,820
56094,190,120,80,80,160,0,630
56095,210,140,80,0,0,0,430
56096,210,100,120,160,160,0,750
56097,230,100,120,80,160,0,690
56098,220,140,120,80,160,320,1040
56099,150,80,160,160,160,0,710
56100,170,140,160,240,0,0,710
56101,170,140,160,80,0,0,550
56102,160,120,40,80,160,0,560
56103,170,140,120,160,320,320,1230
56104,160,140,160,240,320,0,1020
56105,200,160,80,80,160,0,680
56106,180,120,120,80,160,0,660
56107,190,120,80,80,160,0,630
56108,210,120,160,240,160,0,890
56109,220,140,120,160,160,0,800
56110,220,120,80,80,160,0,660
56111,170,80,80,80,160,0,570
56112,150,100,80,0,0,0,330
56113,220,100,80,160,320,0,880
56114,240,160,120,0,0,0,520
56115,240,140,120,160,160,0,820
56116,170,120,40,80,160,0,570
56117,210,80,120,80,160,0,650
56118,200,100,40,80,160,0,580
56119,210,140,160,160,160,0,830
56120,140,80,80,160,160,0,620
56121,170,120,160,80,0,0,530
56122,190,80,80,80,160,0,590
56123,170,80,40,80,160,0,530
56124,200,140,40,80,160,320,940
56125,170,120,200,240,320,320,1370
56126,200,160,160,160,320,320,1320
56127,180,140,160,80,0,0,560
56128,180,160,200,240,160,0,940
56129,210,100,120,80,0,0,510
56130,200,140,40,80,0,0,460
56131,180,120,40,80,160,0,580
56132,240,120,120,160,0,0,640
56133,190,120,80,160,320,0,870
56134,200,100,40,80,0,0,420
56135,170,180,160,160,160,0,830
56136,200,220,120,160,320,0,1020
56137,200,100,80,160,0,0,540
56138,180,140,160,80,0,0,560
56139,210,60,80,160,160,320,990
56140,210,160,120,80,160,0,730
56141,190,120,120,80,0,0,510
56142,190,140,120,160,0,0,610
56143,210,180,120,80,0,0,590
56144,200,80,40,80,160,0,560
56145,220,120,120,80,0,0,540
56146,220,100,80,80,160,320,960
56147,150,40,80,160,320,0,750
56148,240,180,120,160,160,0,860
56149,140,100,160,240,160,0,800
56150,230,100,40,80,160,0,610
56151,190,100,160,160,160,0,770
56152,180,100,120,160,160,0,720
56153,230,80,80,80,160,0,630
56154,200,120,80,80,160,0,640
56155,180,100,120,80,160,320,960
56156,210,80,40,80,160,0,570
56157,220,80,40,80,0,0,420
56158,220,120,120,80,0,0,540
56159,160,120,120,80,160,0,640
56160,200,140,120,80,160,0,700
56161,180,140,120,160,0,0,600
56162,190,140,200,240,320,0,1090
56163,160,120,120,160,0,0,560
56164,200,140,80,160,160,0,740
56165,220,120,160,160,160,0,820
56166,130,100,120,0,0,0,350
56167,200,140,40,80,0,0,460
56168,190,140,160,0,0,0,490
56169,180,100,120,160,160,0,720
56170,230,100,120,160,0,0,610
56171,160,100,120,80,160,0,620
56172,200,80,80,80,0,0,440
56173,210,160,80,0,0,0,450
56174,200,200,160,0,0,0,560
56175,190,120,160,160,160,320,1110
56176,220,140,160,80,0,0,600
56177,190,100,160,160,320,320,1250
56178,160,140,160,160,0,0,620
56179,200,120,80,80,160,0,640
56180,210,100,40,0,0,0,350
56181,190,120,40,80,160,0,590
56182,210,120,120,80,160,0,690
56183,190,60,40,0,0,0,290
56184,210,120,40,80,160,0,610
56185,230,120,120,160,0,0,630
56186,200,140,160,160,160,0,820
56187,190,140,160,160,160,320,1130
56188,230,140,160,160,160,320,1170
56189,200,80,40,0,0,0,320
56190,190,120,120,80,160,0,670
56191,150,100,80,80,0,0,410
56192,190,100,120,80,0,0,490
56193,150,120,160,80,0,0,510
56194,160,120,120,160,0,0,560
56195,230,40,40,0,0,0,310
56196,220,140,160,240,160,0,920
56197,210,160,120,80,0,0,570
56198,180,60,120,160,160,0,680
56199,200,120,160,160,320,0,960
56200,210,80,40,80,160,0,570
56201,190,160,40,0,0,0,390
56202,200,100,80,80,160,0,620
56203,200,100,80,80,0,0,460
56204,220,80,80,80,160,320,940
56205,210,100,120,160,0,0,590
56206,220,160,200,80,160,0,820
56207,190,120,120,0,0,0,430
56208,210,140,240,80,160,0,830
56209,240,180,160,160,320,0,1060
56210,190,160,80,80,160,0,670
56211,230,140,160,80,0,0,610
56212,190,140,120,80,160,0,690
56213,190,120,160,0,0,0,470
56214,190,160,120,160,0,0,630
56215,180,140,40,80,160,320,920
56216,220,180,0,0,0,0,400
56217,210,100,120,160,160,0,750
56218,210,200,160,160,160,0,890
56219,220,60,80,0,0,0,360
56220,200,140,120,0,0,0,460
56221,180,120,80,80,160,0,620
56222,200,80,80,160,320,0,840
56223,180,120,80,0,0,0,380
56224,210,160,160,80,0,0,610
56225,210,160,120,80,160,0,730
56226,210,100,160,160,160,0,790
56227,170,120,160,0,0,0,450
56228,190,200,200,80,160,320,1150
56229,210,120,120,240,320,0,1010
56230,180,120,120,80,160,320,980
56231,200,120,80,80,160,320,960
56232,180,140,160,160,0,0,640
56233,200,80,80,160,160,0,680
56234,200,140,80,80,0,0,500
56235,210,120,80,80,160,0,650
56236,190,160,80,80,0,0,510
56237,180,100,80,80,0,0,440
56238,190,120,200,160,160,0,830
56239,200,140,40,0,0,0,380
56240,180,120,80,0,0,0,380
56241,200,140,80,80,0,0,500
56242,210,180,160,80,0,0,630
56243,210,140,120,160,160,320,1110
56244,170,100,120,80,160,0,630
56245,190,100,80,80,160,0,610
56246,220,180,200,240,160,320,1320
56247,190,160,120,80,160,0,710
56248,160,140,160,160,160,0,780
56249,210,100,80,160,160,0,710
56250,210,200,80,80,0,0,570
56251,200,60,80,160,320,320,1140
56252,200,100,80,80,0,0,460
56253,170,100,40,0,0,0,310
56254,190,80,120,240,160,320,1110
56255,220,140,80,80,160,0,680
56256,180,120,80,80,160,0,620
56257,210,160,240,160,320,320,1410
56258,160,80,80,0,0,0,320
56259,210,220,200,240,0,0,870
56260,180,80,40,80,160,320,860
56261,190,140,80,80,0,0,490
56262,230,100,80,80,0,0,490
56263,210,100,40,0,0,0,350
56264,210,120,200,240,160,0,930
56265,180,140,120,160,0,0,600
56266,240,140,80,0,0,0,460
56267,180,120,80,160,0,0,540
56268,190,180,160,80,160,320,1090
56269,160,120,120,80,160,0,640
56270,200,140,40,80,160,0,620
56271,220,140,160,160,320,0,1000
56272,190,120,80,80,160,0,630
56273,220,120,80,0,0,0,420
56274,190,140,120,160,160,320,1090
56275,140,120,120,160,160,0,700
56276,180,100,120,80,0,0,480
56277,200,140,120,160,320,0,940
56278,220,140,40,80,160,0,640
56279,180,140,160,160,160,0,800
56280,210,80,80,0,0,0,370
56281,200,120,120,160,160,0,760
56282,180,140,120,160,160,0,760
56283,210,140,80,80,160,0,670
56284,160,80,40,80,160,0,520
56285,190,120,0,0,0,0,310
56286,200,140,120,80,0,0,540
56287,230,160,40,80,160,0,670
56288,160,120,80,80,0,0,440
56289,170,100,80,80,160,0,590
56290,200,140,120,160,160,0,780
56291,190,160,40,80,0,0,470
56292,210,180,200,80,0,0,670
56293,230,100,120,0,0,0,450
56294,220,100,80,80,0,0,480
56295,180,100,40,80,160,0,560
56296,190,140,80,160,160,0,730
56297,140,60,0,0,0,0,200
56298,150,100,120,160,160,320,1010
56299,230,180,200,80,160,0,850
56300,230,160,160,80,0,0,630
56301,180,40,80,80,160,320,860
56302,210,120,120,160,160,0,770
56303,130,160,80,80,0,0,450
56304,200,100,40,0,0,0,340
56305,170,100,40,0,0,0,310
56306,180,140,80,80,160,0,640
56307,210,160,200,0,0,0,570
56308,180,160,120,80,0,0,540
56309,220,120,120,160,160,0,780
56310,210,140,120,160,160,0,790
56311,210,120,120,80,0,0,530
56312,150,120,0,0,0,0,270
56313,220,100,40,80,0,0,440
56314,190,60,120,240,320,0,930
56315,210,120,120,160,320,320,1250
56316,180,140,120,0,0,0,440
56317,200,160,160,160,0,0,680
56318,180,100,40,80,160,320,880
56319,200,120,40,80,160,0,600
56320,160,100,80,80,0,0,420
56321,170,120,160,160,160,0,770
56322,170,80,120,0,0,0,370
56323,220,120,120,160,320,320,1260
56324,200,100,120,240,160,0,820
56325,170,120,120,160,160,0,730
56326,170,160,80,160,160,0,730
56327,230,140,40,0,0,0,410
56328,200,80,120,0,0,0,400
56329,190,120,120,80,160,0,670
56330,210,80,80,0,0,0,370
56331,190,140,80,80,160,320,970
56332,140,80,80,80,0,0,380
56333,240,120,160,240,160,0,920
56334,180,120,120,80,160,0,660
56335,160,140,120,80,160,0,660
56336,190,200,160,160,0,0,710
56337,240,200,200,0,0,0,640
56338,170,120,120,240,320,320,1290
56339,180,60,0,0,0,0,240
56340,190,100,160,160,0,0,610
56341,170,100,120,80,160,0,630
56342,240,180,120,80,0,0,620
56343,180,40,40,80,160,0,500
56344,150,100,40,80,160,0,530
56345,190,160,120,80,160,0,710
56346,220,140,160,160,160,0,840
56347,190,80,40,80,160,0,550
56348,180,60,80,0,0,0,320
56349,190,120,80,80,160,0,630
56350,180,120,120,80,160,0,660
56351,220,120,0,0,0,0,340
56352,230,100,160,160,160,320,1130
56353,160,140,80,80,160,0,620
56354,190,80,80,80,0,0,430
56355,220,160,80,0,0,0,460
56356,180,160,160,160,320,0,980
56357,230,120,120,80,0,0,550
56358,210,100,40,0,0,0,350
56359,190,140,120,240,160,0,850
56360,160,100,120,0,0,0,380
56361,200,100,80,80,160,0,620
56362,180,80,80,160,320,0,820
56363,170,120,160,80,160,320,1010
56364,190,100,80,160,160,0,690
56365,170,80,120,240,160,0,770
56366,170,80,120,160,160,0,690
56367,160,80,80,80,160,0,560
56368,200,160,120,160,0,0,640
56369,200,140,200,240,320,320,1420
56370,220,80,120,0,0,0,420
56371,180,140,160,80,0,0,560
56372,180,80,80,80,160,0,580
56373,150,120,120,0,0,0,390
56374,180,100,80,80,160,320,920
56375,160,120,120,80,0,0,480
56376,170,60,40,0,0,0,270
56377,220,140,120,160,160,320,1120
56378,180,100,120,80,160,0,640
56379,150,100,160,160,160,0,730
56380,220,120,40,80,0,0,460
56381,210,180,120,240,320,320,1390
56382,200,180,40,80,160,0,660
56383,200,120,120,80,0,0,520
56384,160,140,120,80,160,0,660
56385,240,120,160,160,160,0,840
56386,230,120,120,160,160,320,1110
56387,180,160,40,0,0,0,380
56388,190,140,200,160,320,0,1010
56389,160,120,80,160,160,0,680
56390,170,100,120,80,0,0,470
56391,190,60,40,0,0,0,290
56392,150,120,40,0,0,0,310
56393,200,80,40,0,0,0,320
56394,190,120,40,80,160,0,590
56395,180,120,120,240,320,0,980
56396,170,120,40,0,0,0,330
56397,190,160,160,160,320,0,990
56398,200,160,80,80,160,0,680
56399,230,160,80,0,0,0,470
56400,200,120,120,160,160,320,1080
56401,200,120,40,0,0,0,360
56402,220,80,40,80,0,0,420
56403,240,120,160,240,320,0,1080
56404,200,100,40,80,0,0,420
56405,210,140,120,80,0,0,550
56406,210,60,40,80,160,320,870
56407,170,80,40,80,0,0,370
56408,190,100,160,160,0,0,610
56409,190,100,160,80,0,0,530
56410,170,160,160,160,0,0,650
56411,200,80,120,80,0,0,480
56412,180,120,80,80,0,0,460
56413,250,120,120,160,160,0,810
56414,220,120,120,160,160,0,780
56415,220,140,120,160,0,0,640
56416,210,80,120,80,160,0,650
56417,170,60,120,80,160,0,590
56418,210,140,160,160,0,0,670
56419,170,100,120,240,160,0,790
56420,230,140,200,240,0,0,810
56421,180,120,160,80,160,0,700
56422,190,160,80,0,0,0,430
56423,180,120,120,80,0,0,500
56424,220,180,160,80,160,320,1120
56425,200,100,160,80,160,0,700
56426,220,140,80,80,0,0,520
56427,230,140,120,80,160,0,730
56428,190,160,160,160,160,320,1150
56429,180,120,80,80,0,0,460
56430,220,140,200,240,320,0,1120
56431,210,180,80,80,0,0,550
56432,150,60,120,160,160,0,650
56433,220,140,120,160,160,0,800
56434,220,120,160,160,320,0,980
56435,200,140,160,80,160,0,740
56436,170,100,0,0,0,0,270
56437,200,200,120,80,0,0,600
56438,170,100,120,80,160,0,630
56439,220,160,160,160,0,0,700
56440,200,160,120,80,160,0,720
56441,210,140,120,80,160,0,710
56442,190,60,40,0,0,0,290
56443,220,140,120,160,160,320,1120
56444,180,140,80,0,0,0,400
56445,180,120,120,160,160,0,740
56446,180,120,120,80,160,0,660
56447,210,120,80,0,0,0,410
56448,190,140,120,240,160,0,850
56449,140,100,120,160,160,0,680
56450,190,120,120,80,0,0,510
56451,210,80,80,160,0,0,530
56452,230,100,80,160,320,0,890
56453,220,180,200,160,160,0,920
56454,200,120,120,80,0,0,520
56455,200,60,80,80,160,0,580
56456,200,120,120,0,0,0,440
56457,200,140,160,160,0,0,660
56458,180,120,160,0,0,0,460
56459,210,160,80,160,160,0,770
56460,200,160,80,160,160,0,760
56461,210,140,120,80,160,320,1030
56462,200,160,160,160,160,0,840
56463,140,120,40,80,0,0,380
56464,200,140,120,160,160,0,780
56465,180,120,80,0,0,0,380
56466,180,120,80,160,0,0,540
56467,170,120,120,160,0,0,570
56468,220,240,200,240,320,0,1220
56469,160,120,120,0,0,0,400
56470,200,80,120,80,160,0,640
56471,200,120,160,80,0,0,560
56472,180,100,80,160,160,320,1000
56473,220,140,160,160,320,0,1000
56474,170,60,80,80,160,320,870
56475,160,120,80,80,0,0,440
56476,260,180,80,80,0,0,600
56477,160,140,80,80,160,0,620
56478,220,160,80,0,0,0,460
56479,210,140,160,160,0,0,670
56480,210,100,40,80,160,0,590
56481,220,180,160,80,160,320,1120
56482,180,140,200,240,160,320,1240
56483,190,140,160,160,160,0,810
56484,190,120,80,0,0,0,390
56485,180,160,80,160,320,0,900
56486,220,120,120,80,160,0,700
56487,200,120,120,240,320,320,1320
56488,180,80,80,80,160,0,580
56489,200,120,120,80,0,0,520
56490,190,120,200,80,0,0,590
56491,200,160,120,80,0,0,560
56492,170,100,160,160,160,320,1070
56493,250,140,40,80,160,0,670
56494,160,120,160,80,0,0,520
56495,220,160,160,160,160,320,1180
56496,210,120,120,80,160,0,690
56497,220,80,120,0,0,0,420
56498,180,140,160,80,160,0,720
56499,180,100,120,160,160,320,1040
56500,200,120,120,160,160,0,760
56501,200,140,120,240,160,0,860
56502,160,160,200,160,0,0,680
56503,200,180,200,160,320,320,1380
56504,170,120,40,0,0,0,330
56505,180,120,80,80,0,0,460
56506,180,80,80,80,160,0,580
56507,210,80,40,0,0,0,330
56508,190,140,80,0,0,0,410
56509,190,120,80,80,0,0,470
56510,240,160,120,160,320,0,1000
56511,230,120,80,160,160,0,750
56512,190,140,160,160,160,0,810
56513,210,160,40,80,160,0,650
56514,240,140,160,160,0,0,700
56515,240,140,120,80,0,0,580
56516,180,100,40,80,0,0,400
56517,200,100,80,80,160,0,620
56518,200,120,80,80,0,0,480
56519,190,60,80,80,0,0,410
56520,180,160,160,0,0,0,500
56521,170,100,80,160,320,320,1150
56522,200,100,0,0,0,0,300
56523,160,120,120,160,160,0,720
56524,220,160,80,80,160,0,700
56525,220,140,120,80,0,0,560
56526,210,100,40,0,0,0,350
56527,190,80,80,160,160,0,670
56528,220,100,120,80,0,0,520
56529,180,80,120,0,0,0,380
56530,230,140,200,240,320,0,1130
56531,230,180,80,80,160,0,730
56532,180,100,80,0,0,0,360
56533,180,140,80,80,160,0,640
56534,200,100,120,160,0,0,580
56535,190,140,120,80,0,0,530
56536,180,200,240,160,160,0,940
56537,180,80,80,0,0,0,340
56538,210,180,120,80,0,0,590
56539,180,60,80,80,160,0,560
56540,220,100,80,80,0,0,480
56541,180,40,80,80,0,0,380
56542,200,160,160,80,0,0,600
56543,210,140,120,240,320,0,1030
56544,170,120,80,80,160,0,610
56545,160,140,160,160,160,0,780
56546,210,140,120,80,0,0,550
56547,200,60,40,0,0,0,300
56548,200,100,80,80,160,320,940
56549,150,60,40,80,160,0,490
56550,200,120,160,80,160,320,1040
56551,150,100,120,80,0,0,450
56552,230,120,160,80,160,0,750
56553,210,160,160,80,160,0,770
56554,190,140,40,0,0,0,370
56555,200,120,120,80,0,0,520
56556,190,80,40,80,160,320,870
56557,210,160,120,80,0,0,570
56558,210,80,160,160,160,0,770
56559,220,140,120,160,320,320,1280
56560,170,60,80,160,0,0,470
56561,170,120,80,0,0,0,370
56562,180,160,120,160,160,320,1100
56563,190,100,80,160,320,320,1170
56564,170,140,120,0,0,0,430
56565,180,100,80,0,0,0,360
56566,170,120,80,80,160,0,610
56567,250,160,160,80,160,0,810
56568,200,140,80,0,0,0,420
56569,190,60,0,0,0,0,250
56570,180,100,80,0,0,0,360
56571,210,220,160,160,320,0,1070
56572,170,80,80,0,0,0,330
56573,190,160,80,0,0,0,430
56574,190,120,80,0,0,0,390
56575,180,120,120,240,160,0,820
56576,230,120,80,160,320,0,910
56577,210,100,80,0,0,0,390
56578,180,120,120,160,160,0,740
56579,200,80,120,80,160,0,640
56580,230,140,80,80,160,0,690
56581,190,120,120,0,0,0,430
56582,190,60,80,160,160,0,650
56583,220,140,120,160,0,0,640
56584,190,120,80,80,160,0,630
56585,210,180,160,80,0,0,630
56586,160,120,40,80,0,0,400
56587,210,80,40,80,0,0,410
56588,180,80,80,0,0,0,340
56589,220,180,40,0,0,0,440
56590,180,100,120,80,0,0,480
56591,210,180,160,80,0,0,630
56592,240,120,120,160,320,0,960
56593,210,80,80,80,160,320,930
56594,180,80,80,0,0,0,340
56595,210,100,0,0,0,0,310
56596,220,160,200,160,160,0,900
56597,190,120,80,0,0,0,390
56598,190,140,80,0,0,0,410
56599,220,100,80,160,320,0,880
56600,230,160,120,160,160,0,830
56601,190,100,40,80,160,0,570
56602,190,160,120,160,160,0,790
56603,190,120,80,80,0,0,470
56604,210,160,120,160,160,0,810
56605,220,140,160,160,0,0,680
56606,170,60,0,0,0,0,230
56607,210,140,80,80,0,0,510
56608,170,140,120,240,160,0,830
56609,220,100,120,160,160,320,1080
56610,180,120,160,80,160,0,700
56611,200,100,40,0,0,0,340
56612,200,80,80,80,160,0,600
56613,190,120,160,160,160,0,790
56614,200,80,40,0,0,0,320
56615,190,100,120,240,320,320,1290
56616,190,140,80,160,160,0,730
56617,180,80,40,80,160,320,860
56618,200,140,160,80,160,0,740
56619,190,140,80,160,0,0,570
56620,180,100,80,160,320,0,840
56621,180,40,0,0,0,0,220
56622,260,180,120,80,0,0,640
56623,180,80,80,80,160,0,580
56624,180,80,80,160,320,320,1140
56625,220,140,120,240,320,0,1040
56626,240,160,120,160,160,0,840
56627,210,120,120,160,160,0,770
56628,200,120,160,160,320,320,1280
56629,210,100,80,160,320,0,870
56630,190,120,0,0,0,0,310
56631,230,120,120,160,320,0,950
56632,180,140,160,80,160,0,720
56633,200,100,80,80,160,0,620
56634,220,180,240,320,320,0,1280
56635,230,160,120,240,320,0,1070
56636,180,100,80,0,0,0,360
56637,220,120,120,160,160,0,780
56638,180,80,40,0,0,0,300
56639,180,100,120,80,160,0,640
56640,180,140,80,80,0,0,480
56641,240,140,160,240,320,320,1420
56642,210,100,120,160,160,0,750
56643,190,160,240,240,160,0,990
56644,240,120,120,80,0,0,560
56645,200,120,0,0,0,0,320
56646,230,200,200,160,160,320,1270
56647,200,140,80,80,160,0,660
56648,180,160,120,80,0,0,540
56649,190,180,160,80,160,0,770
56650,180,160,160,160,160,0,820
56651,180,160,120,240,160,0,860
56652,230,200,40,0,0,0,470
56653,140,80,40,80,160,0,500
56654,210,100,80,0,0,0,390
56655,210,120,80,80,160,0,650
56656,180,60,80,80,160,320,880
56657,190,100,120,160,160,0,730
56658,220,120,120,160,160,0,780
56659,190,140,80,80,0,0,490
56660,190,120,40,0,0,0,350
56661,150,100,80,0,0,0,330
56662,190,200,120,0,0,0,510
56663,210,140,160,80,160,0,750
56664,230,120,80,0,0,0,430
56665,230,80,40,80,160,0,590
56666,190,140,120,80,0,0,530
56667,150,100,80,80,160,0,570
56668,200,100,80,80,160,0,620
56669,230,160,160,160,320,320,1350
56670,200,100,80,80,160,0,620
56671,190,120,120,80,160,0,670
56672,200,160,160,80,160,0,760
56673,190,140,120,80,0,0,530
56674,190,80,40,0,0,0,310
56675,230,60,80,160,0,0,530
56676,210,180,120,240,0,0,750
56677,210,100,80,80,160,0,630
56678,180,140,160,160,320,320,1280
56679,170,80,80,80,160,0,570
56680,170,80,120,160,160,320,1010
56681,210,120,0,0,0,0,330
56682,230,120,80,160,160,0,750
56683,190,100,120,80,160,0,650
56684,250,120,40,80,160,0,650
56685,200,140,120,80,0,0,540
56686,190,80,120,80,160,0,630
56687,250,160,80,0,0,0,490
56688,200,120,80,0,0,0,400
56689,160,180,200,240,160,0,940
56690,200,100,120,0,0,0,420
56691,220,200,120,0,0,0,540
56692,210,100,80,160,0,0,550
56693,200,160,160,0,0,0,520
56694,160,120,120,80,0,0,480
56695,180,140,120,80,0,0,520
56696,230,160,120,160,160,0,830
56697,200,100,40,0,0,0,340
56698,210,160,120,80,0,0,570
56699,200,120,40,0,0,0,360
56700,220,60,0,0,0,0,280
56701,220,140,120,160,160,0,800
56702,200,120,120,160,160,0,760
56703,220,120,160,160,0,0,660
56704,190,100,120,160,160,0,730
56705,190,100,120,160,0,0,570
56706,180,140,160,240,0,0,720
56707,180,180,80,80,160,0,680
56708,200,120,80,0,0,0,400
56709,200,120,160,240,0,0,720
56710,190,140,80,0,0,0,410
56711,170,80,80,80,0,0,410
56712,190,100,80,0,0,0,370
56713,170,140,80,0,0,0,390
56714,200,180,120,80,160,0,740
56715,190,100,40,0,0,0,330
56716,180,160,120,160,160,0,780
56717,200,120,120,160,320,0,920
56718,130,60,80,80,160,320,830
56719,190,100,120,80,160,0,650
56720,170,140,200,160,160,0,830
56721,210,140,80,160,0,0,590
56722,220,160,200,80,0,0,660
56723,230,140,40,80,160,0,650
56724,230,140,80,80,160,0,690
56725,210,140,120,80,160,0,710
56726,220,120,200,160,160,0,860
56727,180,120,80,80,160,0,620
56728,230,180,160,80,160,0,810
56729,180,100,120,80,0,0,480
56730,170,120,120,160,0,0,570
56731,180,100,160,80,0,0,520
56732,170,220,200,80,0,0,670
56733,210,100,80,0,0,0,390
56734,180,100,40,80,0,0,400
56735,220,100,80,80,0,0,480
56736,200,160,160,80,0,0,600
56737,210,80,40,80,0,0,410
56738,240,140,160,160,160,0,860
56739,200,120,120,80,160,0,680
56740,240,220,200,240,320,0,1220
56741,260,160,200,80,160,0,860
56742,180,100,40,80,160,320,880
56743,230,140,80,80,160,0,690
56744,190,140,120,80,160,0,690
56745,160,120,120,80,160,0,640
56746,180,140,160,160,160,0,800
56747,230,160,120,160,160,0,830
56748,180,120,120,80,0,0,500
56749,230,160,80,160,160,0,790
56750,190,160,120,80,0,0,550
56751,180,160,200,240,160,0,940
56752,180,120,120,80,0,0,500
56753,210,140,160,160,160,0,830
56754,180,120,120,0,0,0,420
56755,230,160,120,0,0,0,510
56756,160,120,120,160,320,320,1200
56757,230,140,80,0,0,0,450
56758,210,160,120,160,320,0,970
56759,220,80,80,80,160,0,620
56760,150,100,120,240,320,320,1250
56761,210,80,80,80,160,0,610
56762,170,100,120,160,160,0,710
56763,200,80,40,0,0,0,320
56764,190,100,40,80,160,320,890
56765,180,120,80,80,160,0,620
56766,190,100,80,0,0,0,370
56767,220,120,80,0,0,0,420
56768,170,80,80,80,160,0,570
56769,210,100,120,160,320,0,910
56770,200,120,160,160,160,0,800
56771,150,80,80,160,160,0,630
56772,160,100,0,0,0,0,260
56773,220,140,160,160,160,320,1160
56774,190,120,120,80,160,0,670
56775,240,100,120,160,0,0,620
56776,190,80,80,80,160,0,590
56777,210,120,120,160,160,0,770
56778,220,140,160,160,320,320,1320
56779,210,100,80,80,160,0,630
56780,220,140,80,0,0,0,440
56781,210,140,80,80,160,0,670
56782,210,160,160,160,160,0,850
56783,190,60,40,0,0,0,290
56784,170,100,0,0,0,0,270
56785,210,180,160,160,160,0,870
56786,150,100,120,240,160,0,770
56787,220,140,160,80,0,0,600
56788,210,120,120,80,160,0,690
56789,190,180,200,80,0,0,650
56790,190,220,80,80,160,0,730
56791,180,140,160,80,0,0,560
56792,180,180,160,160,320,320,1320
56793,210,120,40,80,160,0,610
56794,200,100,40,80,0,0,420
56795,200,160,120,80,160,0,720
56796,220,100,80,160,0,0,560
56797,220,140,200,240,320,320,1440
56798,210,80,160,160,160,0,770
56799,210,180,160,80,0,0,630
56800,220,120,120,160,0,0,620
56801,180,80,80,0,0,0,340
56802,210,80,80,80,0,0,450
56803,180,100,80,80,160,0,600
56804,170,120,120,240,320,320,1290
56805,250,160,160,160,160,0,890
56806,160,60,80,80,160,0,540
56807,200,100,40,0,0,0,340
56808,180,100,120,160,160,0,720
56809,230,140,80,0,0,0,450
56810,160,80,40,80,0,0,360
56811,190,200,200,240,160,320,1310
56812,210,140,120,0,0,0,470
56813,220,120,0,0,0,0,340
56814,170,140,160,0,0,0,470
56815,190,180,160,160,160,0,850
56816,170,140,80,80,160,320,950
56817,200,100,120,160,320,0,900
56818,160,80,0,0,0,0,240
56819,160,100,120,80,160,0,620
56820,190,100,80,0,0,0,370
56821,200,140,80,80,160,320,980
56822,190,140,80,160,320,0,890
56823,220,160,120,80,160,320,1060
56824,230,120,80,80,0,0,510
56825,190,140,80,0,0,0,410
56826,180,140,120,240,320,0,1000
56827,230,140,120,160,160,0,810
56828,210,140,120,80,0,0,550
56829,200,140,0,0,0,0,340
56830,200,140,160,160,160,0,820
56831,220,100,120,160,0,0,600
56832,240,180,200,160,160,0,940
56833,240,180,80,0,0,0,500
56834,190,140,80,0,0,0,410
56835,190,160,120,80,160,0,710
56836,180,120,120,160,160,0,740
56837,220,120,160,80,0,0,580
56838,250,140,80,0,0,0,470
56839,200,140,160,160,160,320,1140
56840,210,180,120,160,320,320,1310
56841,190,160,160,160,160,0,830
56842,190,140,0,0,0,0,330
56843,240,140,40,0,0,0,420
56844,200,120,80,80,160,320,960
56845,180,100,0,0,0,0,280
56846,240,120,120,240,320,0,1040
56847,230,140,80,160,160,0,770
56848,200,80,40,0,0,0,320
56849,170,60,40,80,0,0,350
56850,200,140,120,80,160,0,700
56851,220,120,80,80,160,0,660
56852,210,120,160,160,320,0,970
56853,210,100,80,160,160,0,710
56854,190,120,160,80,160,0,710
56855,210,140,80,80,160,0,670
56856,180,160,160,160,160,0,820
56857,200,80,120,160,0,0,560
56858,170,100,160,160,160,0,750
56859,170,100,80,160,320,0,830
56860,190,100,80,0,0,0,370
56861,210,160,120,160,160,320,1130
56862,180,100,40,80,0,0,400
56863,200,140,120,80,160,0,700
56864,170,100,120,160,320,0,870
56865,210,100,80,80,0,0,470
56866,140,60,40,80,160,0,480
56867,160,80,40,0,0,0,280
56868,200,100,80,160,320,0,860
56869,190,140,160,160,320,0,970
56870,230,140,120,0,0,0,490
56871,210,80,0,0,0,0,290
56872,210,40,40,0,0,0,290
56873,210,80,80,80,0,0,450
56874,230,160,160,160,160,0,870
56875,200,100,40,0,0,0,340
56876,220,100,0,0,0,0,320
56877,180,140,80,80,0,0,480
56878,260,80,160,80,160,0,740
56879,230,140,120,160,320,0,970
56880,200,100,40,0,0,0,340
56881,170,100,120,80,160,0,630
56882,200,160,40,80,160,0,640
56883,170,120,160,160,160,0,770
56884,210,120,160,160,0,0,650
56885,200,160,200,80,0,0,640
56886,200,40,40,80,160,0,520
56887,230,180,200,240,0,0,850
56888,220,140,160,160,320,0,1000
56889,230,180,160,160,160,0,890
56890,170,120,80,0,0,0,370
56891,190,40,80,160,160,0,630
56892,210,40,0,0,0,0,250
56893,170,100,40,80,160,0,550
56894,160,80,80,80,160,0,560
56895,210,140,120,0,0,0,470
56896,140,40,40,80,160,0,460
56897,170,120,80,80,0,0,450
56898,190,120,120,80,0,0,510
56899,240,120,40,80,160,0,640
56900,210,100,80,80,160,320,950
56901,230,100,120,80,160,0,690
56902,210,80,80,80,0,0,450
56903,170,80,80,80,0,0,410
56904,230,160,40,80,160,0,670
56905,140,160,160,80,0,0,540
56906,140,100,120,160,160,0,680
56907,200,100,0,0,0,0,300
56908,220,120,120,80,160,0,700
56909,200,160,120,160,320,320,1280
56910,190,100,120,80,160,0,650
56911,130,140,200,240,160,0,870
56912,200,140,200,160,160,0,860
56913,200,120,200,80,0,0,600
56914,230,120,80,80,0,0,510
56915,210,100,0,0,0,0,310
56916,180,120,120,80,0,0,500
56917,200,120,120,80,160,0,680
56918,140,100,80,80,0,0,400
56919,210,80,160,240,0,0,690
56920,200,140,160,240,0,0,740
56921,190,140,80,80,160,0,650
56922,200,100,80,80,0,0,460
56923,180,160,160,160,160,0,820
56924,190,140,80,80,0,0,490
56925,190,200,160,160,0,0,710
56926,190,140,160,240,160,0,890
56927,170,140,120,160,160,0,750
56928,200,100,120,160,160,0,740
56929,160,160,160,160,160,0,800
56930,210,100,120,160,160,320,1070
56931,230,160,160,160,0,0,710
56932,200,140,160,80,0,0,580
56933,190,140,160,240,320,320,1370
56934,230,160,120,80,0,0,590
56935,230,120,160,240,320,0,1070
56936,190,120,120,240,0,0,670
56937,140,60,80,80,160,0,520
56938,220,100,120,160,0,0,600
56939,150,100,160,80,160,0,650
56940,200,120,120,160,160,0,760
56941,190,120,80,160,320,0,870
56942,200,140,160,160,320,0,980
56943,210,140,160,160,160,320,1150
56944,210,80,120,160,320,0,890
56945,200,160,40,0,0,0,400
56946,180,180,160,80,0,0,600
56947,210,200,80,80,0,0,570
56948,150,100,80,0,0,0,330
56949,220,140,120,160,160,0,800
56950,210,140,160,240,320,0,1070
56951,210,120,40,80,160,0,610
56952,200,120,160,240,0,0,720
56953,230,60,80,0,0,0,370
56954,170,100,120,160,0,0,550
56955,250,180,120,0,0,0,550
56956,210,140,160,160,0,0,670
56957,250,220,120,160,160,0,910
56958,220,120,120,160,160,0,780
56959,210,160,80,160,160,0,770
56960,200,180,80,0,0,0,460
56961,180,80,40,80,160,0,540
56962,210,140,120,80,160,0,710
56963,220,160,120,160,0,0,660
56964,180,100,120,0,0,0,400
56965,210,120,40,80,0,0,450
56966,200,120,120,80,0,0,520
56967,170,80,80,0,0,0,330
56968,170,120,120,160,160,0,730
56969,200,120,80,80,160,320,960
56970,190,80,120,80,160,0,630
56971,200,120,160,160,160,320,1120
56972,180,140,240,160,0,0,720
56973,240,140,160,80,160,0,780
56974,190,80,80,160,160,0,670
56975,220,100,80,80,160,0,640
56976,220,100,120,160,160,0,760
56977,200,120,120,160,160,0,760
56978,210,120,80,80,160,0,650
56979,220,100,80,80,160,0,640
56980,210,180,120,80,0,0,590
56981,210,100,80,80,160,0,630
56982,170,120,40,0,0,0,330
56983,220,120,120,160,320,0,940
56984,200,60,80,80,160,0,580
56985,230,120,40,0,0,0,390
56986,220,120,40,80,160,0,620
56987,200,160,160,80,160,0,760
56988,200,120,120,240,320,320,1320
56989,190,180,160,160,160,0,850
56990,200,120,80,80,160,0,640
56991,150,120,80,0,0,0,350
56992,200,140,120,80,0,0,540
56993,180,140,80,80,160,0,640
56994,170,120,120,160,160,0,730
56995,200,180,200,80,0,0,660
56996,200,100,80,80,160,0,620
56997,210,200,200,160,160,0,930
56998,210,120,160,80,160,320,1050
56999,190,100,80,0,0,0,370
57000,180,100,40,80,160,0,560
57001,210,140,160,80,0,0,590
57002,170,80,40,80,160,0,530
57003,160,120,0,0,0,0,280
57004,180,100,80,80,0,0,440
57005,160,180,120,160,320,320,1260
57006,230,200,160,160,160,0,910
57007,260,60,40,80,160,320,920
57008,200,200,120,160,160,0,840
57009,170,140,120,240,0,0,670
57010,190,140,80,160,0,0,570
57011,200,120,120,160,160,0,760
57012,180,120,80,0,0,0,380
57013,190,100,80,80,0,0,450
57014,210,160,40,0,0,0,410
57015,220,140,160,160,0,0,680
57016,210,80,120,80,160,0,650
57017,230,160,200,160,320,0,1070
57018,230,140,120,80,160,0,730
57019,200,140,160,80,0,0,580
57020,240,120,160,240,0,0,760
57021,190,100,120,80,0,0,490
57022,200,160,200,0,0,0,560
57023,230,80,80,160,160,0,710
57024,190,100,80,80,160,0,610
57025,210,80,80,160,0,0,530
57026,180,100,160,160,160,0,760
57027,220,120,120,80,0,0,540
57028,220,140,120,0,0,0,480
57029,200,100,80,0,0,0,380
57030,220,160,200,240,320,320,1460
57031,170,100,80,160,160,0,670
57032,220,160,120,160,160,0,820
57033,220,200,120,0,0,0,540
57034,250,80,80,0,0,0,410
57035,190,140,160,160,160,0,810
57036,200,80,80,160,160,0,680
57037,200,160,200,160,160,0,880
57038,200,140,120,80,160,320,1020
57039,230,140,160,80,0,0,610
57040,200,100,120,160,160,0,740
57041,170,140,120,160,320,320,1230
57042,210,180,200,160,320,0,1070
57043,170,120,80,80,160,0,610
57044,220,120,80,160,320,0,900
57045,210,140,40,80,160,0,630
57046,190,140,120,80,160,0,690
57047,200,120,120,80,0,0,520
57048,200,140,120,80,160,0,700
57049,200,120,160,160,0,0,640
57050,210,140,120,80,0,0,550
57051,220,120,160,80,0,0,580
57052,210,120,80,80,0,0,490
57053,190,100,80,80,160,0,610
57054,180,100,40,0,0,0,320
57055,220,180,160,160,160,0,880
57056,230,160,80,160,160,0,790
57057,200,120,40,80,160,0,600
57058,170,100,200,240,160,0,870
57059,170,120,120,160,160,320,1050
57060,160,80,80,80,160,0,560
57061,160,80,80,0,0,0,320
57062,200,60,40,0,0,0,300
57063,170,140,40,0,0,0,350
57064,210,120,80,0,0,0,410
57065,170,160,120,0,0,0,450
57066,150,80,120,240,320,0,910
57067,210,180,80,0,0,0,470
57068,230,120,80,80,0,0,510
57069,160,80,80,160,0,0,480
57070,160,80,120,160,320,320,1160
57071,210,160,160,240,160,0,930
57072,230,160,120,0,0,0,510
57073,200,60,80,160,160,0,660
57074,220,160,120,160,160,320,1140
57075,200,100,160,240,160,0,860
57076,180,60,40,80,160,0,520
57077,150,100,120,160,0,0,530
57078,180,60,40,0,0,0,280
57079,180,160,80,160,160,0,740
57080,180,120,160,160,320,320,1260
57081,210,180,160,80,160,0,790
57082,200,120,120,80,160,320,1000
57083,180,60,80,80,160,0,560
57084,200,160,80,0,0,0,440
57085,190,60,0,0,0,0,250
57086,170,120,160,160,320,0,930
57087,210,140,120,80,160,0,710
57088,220,60,80,0,0,0,360
57089,170,160,200,160,160,320,1170
57090,170,100,80,80,0,0,430
57091,200,140,120,0,0,0,460
57092,220,140,160,160,160,320,1160
57093,180,120,200,240,160,320,1220
57094,160,80,80,80,0,0,400
57095,190,140,160,160,160,0,810
57096,180,160,40,80,0,0,460
57097,180,100,120,80,160,0,640
57098,220,100,40,0,0,0,360
57099,220,120,80,80,160,0,660
57100,180,80,40,80,0,0,380
57101,160,160,120,80,160,320,1000
57102,190,100,80,80,160,0,610
57103,210,60,40,80,160,320,870
57104,230,80,120,80,160,0,670
57105,230,140,120,80,160,0,730
57106,200,120,160,160,160,0,800
57107,160,140,80,160,0,0,540
57108,200,160,80,0,0,0,440
57109,170,100,160,160,160,0,750
57110,160,140,80,160,160,0,700
57111,210,180,120,160,160,320,1150
57112,200,80,120,80,160,0,640
57113,210,100,80,80,160,0,630
57114,180,80,0,0,0,0,260
57115,230,160,160,240,320,0,1110
57116,190,140,200,160,160,0,850
57117,220,100,80,160,0,0,560
57118,190,120,120,80,0,0,510
57119,170,180,200,240,160,320,1270
57120,230,120,160,160,320,320,1310
57121,190,140,80,80,0,0,490
57122,180,160,80,80,160,0,660
57123,220,140,160,160,320,0,1000
57124,180,100,80,0,0,0,360
57125,190,120,80,80,0,0,470
57126,160,80,40,80,0,0,360
57127,230,160,160,80,0,0,630
57128,200,120,120,80,160,0,680
57129,160,100,120,160,160,0,700
57130,230,120,120,160,320,320,1270
57131,220,80,0,0,0,0,300
57132,190,160,120,0,0,0,470
57133,180,100,80,80,160,320,920
57134,200,140,40,0,0,0,380
57135,190,120,120,80,160,0,670
57136,160,120,120,80,160,0,640
57137,220,100,40,0,0,0,360
57138,150,80,160,240,160,0,790
57139,180,100,120,240,160,0,800
57140,150,100,160,160,160,0,730
57141,190,120,80,80,160,0,630
57142,200,160,40,80,0,0,480
57143,180,140,160,80,160,0,720
57144,220,80,80,0,0,0,380
57145,260,160,120,80,160,0,780
57146,210,60,80,0,0,0,350
57147,180,60,80,160,320,0,800
57148,190,60,40,80,160,0,530
57149,170,100,80,80,160,0,590
57150,170,80,40,80,160,0,530
57151,210,120,160,160,160,0,810
57152,220,140,120,240,320,320,1360
57153,190,100,160,160,160,320,1090
57154,190,80,40,80,160,0,550
57155,190,100,80,0,0,0,370
57156,220,160,160,80,160,0,780
57157,190,160,160,240,160,320,1230
57158,210,160,160,80,0,0,610
57159,220,140,120,160,160,0,800
57160,160,80,80,160,0,0,480
57161,190,140,80,160,160,0,730
57162,160,100,80,80,0,0,420
57163,210,60,40,80,160,0,550
57164,200,80,120,80,160,0,640
57165,200,120,80,80,160,0,640
57166,260,240,160,160,160,0,980
57167,170,100,120,80,0,0,470
57168,190,120,120,160,320,0,910
57169,180,100,40,0,0,0,320
57170,190,140,40,80,160,0,610
57171,200,140,160,80,160,0,740
57172,180,80,80,80,160,0,580
57173,170,140,80,80,160,0,630
57174,200,120,120,160,160,0,760
57175,220,120,80,0,0,0,420
57176,140,100,40,80,0,0,360
57177,210,180,120,80,160,0,750
57178,190,160,160,240,160,0,910
57179,190,140,120,160,320,320,1250
57180,200,160,80,80,160,0,680
57181,160,100,160,160,320,0,900
57182,200,140,120,80,0,0,540
57183,200,140,160,80,160,0,740
57184,200,100,40,0,0,0,340
57185,240,80,80,80,0,0,480
57186,180,100,40,80,160,320,880
57187,190,100,40,0,0,0,330
57188,180,160,120,80,160,320,1020
57189,170,120,80,80,0,0,450
57190,210,160,160,80,0,0,610
57191,240,160,160,0,0,0,560
57192,190,140,120,80,0,0,530
57193,170,120,200,160,0,0,650
57194,190,160,160,80,160,0,750
57195,230,180,80,0,0,0,490
57196,200,120,120,0,0,0,440
57197,220,160,40,80,160,320,980
57198,200,120,0,0,0,0,320
57199,230,100,160,160,0,0,650
57200,220,120,80,80,160,0,660
57201,180,120,0,0,0,0,300
57202,170,100,40,80,160,320,870
57203,190,120,80,80,0,0,470
57204,180,120,80,80,160,320,940
57205,180,140,120,80,160,0,680
57206,200,120,120,160,160,320,1080
57207,210,100,80,80,0,0,470
57208,160,120,160,160,0,0,600
57209,210,160,200,160,160,0,890
57210,200,120,160,160,160,320,1120
57211,190,120,40,80,0,0,430
57212,230,120,120,160,320,0,950
57213,200,140,80,160,160,0,740
57214,240,160,80,80,0,0,560
57215,150,100,40,0,0,0,290
57216,190,140,160,80,160,320,1050
57217,180,200,120,80,160,320,1060
57218,180,160,120,80,0,0,540
57219,220,160,160,80,0,0,620
57220,170,100,160,80,0,0,510
57221,190,140,160,80,160,0,730
57222,120,80,80,160,320,0,760
57223,180,80,40,80,0,0,380
57224,210,200,200,160,160,0,930
57225,240,160,80,80,0,0,560
57226,220,200,160,80,160,0,820
57227,250,80,120,160,320,320,1250
57228,150,120,160,160,160,0,750
57229,170,140,160,240,160,0,870
57230,170,100,80,160,320,0,830
57231,200,80,40,0,0,0,320
57232,210,140,80,80,160,320,990
57233,200,140,80,80,160,0,660
57234,210,120,80,0,0,0,410
57235,210,160,120,80,160,0,730
57236,240,120,80,80,0,0,520
57237,200,140,120,80,0,0,540
57238,230,120,120,0,0,0,470
57239,200,180,120,160,160,0,820
57240,210,140,40,0,0,0,390
57241,200,140,160,160,160,0,820
57242,220,200,200,80,160,0,860
57243,230,140,80,80,0,0,530
57244,150,120,80,80,160,0,590
57245,230,140,120,80,160,0,730
57246,210,120,120,80,0,0,530
57247,210,140,80,160,160,0,750
57248,150,100,120,160,160,320,1010
57249,190,200,160,240,320,0,1110
57250,200,200,200,80,0,0,680
57251,180,120,120,80,160,320,980
57252,190,120,120,160,0,0,590
57253,210,160,120,160,320,0,970
57254,220,140,40,80,160,0,640
57255,220,100,40,0,0,0,360
57256,200,120,80,80,0,0,480
57257,190,120,80,160,160,0,710
57258,200,120,160,160,160,0,800
57259,220,120,80,160,320,0,900
57260,210,100,80,80,160,0,630
57261,190,120,160,240,320,320,1350
57262,180,100,120,160,160,0,720
57263,220,120,80,80,160,0,660
57264,250,140,120,240,160,0,910
57265,190,120,160,0,0,0,470
57266,190,100,40,80,0,0,410
57267,220,160,120,80,160,0,740
57268,200,100,40,0,0,0,340
57269,210,80,120,80,0,0,490
57270,190,140,120,80,160,0,690
57271,210,140,80,80,160,0,670
57272,240,120,160,80,0,0,600
57273,140,80,40,0,0,0,260
57274,210,140,120,160,160,0,790
57275,210,200,80,80,160,320,1050
57276,240,100,160,160,320,320,1300
57277,150,160,160,160,0,0,630
57278,200,140,160,160,160,0,820
57279,190,160,160,160,160,0,830
57280,160,80,80,160,320,320,1120
57281,210,140,80,80,160,0,670
57282,220,160,120,160,160,0,820
57283,210,100,80,0,0,0,390
57284,180,160,240,160,160,0,900
57285,200,60,80,80,0,0,420
57286,210,140,120,0,0,0,470
57287,180,100,120,160,320,0,880
57288,190,160,200,160,160,0,870
57289,210,100,40,80,0,0,430
57290,210,140,80,0,0,0,430
57291,180,160,200,160,320,0,1020
57292,200,140,160,80,160,0,740
57293,180,120,120,80,160,0,660
57294,180,120,80,80,0,0,460
57295,200,140,120,0,0,0,460
57296,170,120,120,80,0,0,490
57297,180,120,80,160,0,0,540
57298,230,140,0,0,0,0,370
57299,190,100,80,0,0,0,370
57300,180,100,120,80,160,0,640
57301,180,80,80,80,160,320,900
57302,170,80,40,0,0,0,290
57303,170,100,80,160,160,0,670
57304,170,100,80,80,160,0,590
57305,170,140,120,0,0,0,430
57306,190,100,120,160,0,0,570
57307,160,140,80,80,0,0,460
57308,200,140,200,240,320,320,1420
57309,200,140,80,160,160,0,740
57310,190,120,120,80,0,0,510
57311,180,100,80,80,160,320,920
57312,160,180,200,160,160,0,860
57313,200,140,40,0,0,0,380
57314,210,120,80,160,320,320,1210
57315,210,160,120,160,160,0,810
57316,190,100,120,160,0,0,570
57317,190,120,40,0,0,0,350
57318,210,120,80,0,0,0,410
57319,200,160,80,80,160,0,680
57320,190,140,160,240,160,0,890
57321,200,140,120,0,0,0,460
57322,210,60,40,0,0,0,310
57323,150,140,40,80,0,0,410
57324,200,120,160,240,320,0,1040
57325,180,160,120,160,0,0,620
57326,160,100,40,0,0,0,300
57327,220,100,80,80,160,0,640
57328,200,160,40,0,0,0,400
57329,160,120,160,80,0,0,520
57330,200,80,120,160,320,0,880
57331,230,100,80,80,0,0,490
57332,200,80,40,80,0,0,400
57333,200,100,120,80,0,0,500
57334,200,140,120,80,160,0,700
57335,210,140,200,80,0,0,630
57336,200,60,0,0,0,0,260
57337,180,100,160,0,0,0,440
57338,190,140,120,160,160,320,1090
57339,200,80,160,240,320,0,1000
57340,250,100,40,0,0,0,390
57341,210,140,120,160,0,0,630
57342,200,180,200,80,160,0,820
57343,220,140,80,80,0,0,520
57344,190,120,80,80,0,0,470
57345,260,180,120,80,160,0,800
57346,210,100,120,80,160,0,670
57347,190,120,120,240,320,320,1310
57348,130,100,120,160,160,0,670
57349,180,100,80,80,0,0,440
57350,200,120,80,0,0,0,400
57351,160,80,80,160,160,320,960
57352,190,140,80,0,0,0,410
57353,210,100,120,240,320,0,990
57354,200,140,80,0,0,0,420
57355,180,140,40,0,0,0,360
57356,210,100,80,160,160,0,710
57357,260,100,120,160,160,0,800
57358,180,40,40,0,0,0,260
57359,200,100,80,80,0,0,460
57360,190,140,120,80,0,0,530
57361,230,140,120,0,0,0,490
57362,180,100,40,80,160,0,560
57363,200,120,160,160,320,320,1280
57364,170,80,80,0,0,0,330
57365,210,140,80,0,0,0,430
57366,180,120,120,160,160,0,740
57367,200,140,120,80,0,0,540
57368,220,140,120,160,160,0,800
57369,210,140,120,80,160,0,710
57370,240,180,200,160,320,320,1420
57371,200,120,80,0,0,0,400
57372,200,140,160,160,160,0,820
57373,190,100,80,80,0,0,450
57374,200,120,120,160,320,320,1240
57375,200,80,40,0,0,0,320
57376,200,160,120,240,160,0,880
57377,210,100,120,80,160,320,990
57378,160,80,80,80,0,0,400
57379,200,140,120,160,160,0,780
57380,170,120,40,80,160,0,570
57381,180,120,120,80,0,0,500
57382,190,160,80,80,160,0,670
57383,180,140,160,80,0,0,560
57384,190,100,40,0,0,0,330
57385,200,120,80,80,160,320,960
57386,230,80,120,160,160,320,1070
57387,200,140,200,0,0,0,540
57388,220,180,160,160,320,0,1040
57389,240,160,80,160,160,0,800
57390,190,100,40,80,160,0,570
57391,200,160,160,160,160,320,1160
57392,190,180,80,0,0,0,450
57393,220,100,120,160,0,0,600
57394,170,80,40,80,160,0,530
57395,180,100,80,160,160,0,680
57396,200,100,40,80,160,320,900
57397,200,120,200,160,160,0,840
57398,210,160,80,0,0,0,450
57399,210,160,200,160,0,0,730
57400,210,120,120,80,160,0,690
57401,190,60,80,80,0,0,410
57402,220,160,160,0,0,0,540
57403,160,80,40,80,0,0,360
57404,240,160,80,80,160,320,1040
57405,180,100,120,240,160,0,800
57406,210,120,80,80,0,0,490
57407,260,160,120,80,160,0,780
57408,170,80,80,80,0,0,410
57409,230,160,80,160,0,0,630
57410,170,100,80,80,160,0,590
57411,170,140,80,80,160,0,630
57412,160,80,40,80,160,0,520
57413,210,200,120,80,160,0,770
57414,190,100,120,0,0,0,410
57415,200,140,120,80,160,0,700
57416,170,120,160,240,160,0,850
57417,180,120,80,160,320,0,860
57418,200,140,160,80,0,0,580
57419,180,80,80,80,160,0,580
57420,200,140,120,160,0,0,620
57421,210,40,40,0,0,0,290
57422,220,160,40,80,160,0,660
57423,170,120,160,0,0,0,450
57424,160,160,40,80,0,0,440
57425,170,100,120,80,0,0,470
57426,180,140,80,80,0,0,480
57427,200,100,120,80,0,0,500
57428,200,120,120,80,160,0,680
57429,230,120,120,160,0,0,630
57430,180,140,160,160,320,320,1280
57431,190,100,40,80,160,0,570
57432,210,100,40,80,160,0,590
57433,220,120,120,80,160,0,700
57434,190,80,120,160,320,320,1190
57435,200,140,120,80,160,0,700
57436,240,100,120,0,0,0,460
57437,190,80,120,80,160,0,630
57438,210,120,40,0,0,0,370
57439,220,200,200,160,0,0,780
57440,200,140,160,160,160,0,820
57441,170,60,0,0,0,0,230
57442,180,120,80,80,0,0,460
57443,190,100,120,80,160,0,650
57444,230,60,80,80,160,0,610
57445,180,100,40,80,160,0,560
57446,190,120,120,160,0,0,590
57447,200,160,120,160,320,320,1280
57448,160,80,160,160,0,0,560
57449,230,100,40,80,160,0,610
57450,170,80,120,160,320,0,850
57451,200,100,40,0,0,0,340
57452,250,180,200,160,0,0,790
57453,180,80,80,80,160,0,580
57454,180,80,120,160,320,0,860
57455,230,140,80,80,160,0,690
57456,220,180,160,160,160,320,1200
57457,190,80,80,80,160,0,590
57458,210,140,80,80,0,0,510
57459,190,100,40,80,160,0,570
57460,190,160,80,80,160,0,670
57461,160,120,40,80,0,0,400
57462,230,120,80,0,0,0,430
57463,180,120,120,160,160,0,740
57464,180,100,120,160,160,320,1040
57465,200,80,40,0,0,0,320
57466,220,140,120,160,160,0,800
57467,230,140,120,80,160,320,1050
57468,200,200,160,0,0,0,560
57469,210,100,80,160,320,0,870
57470,200,180,160,160,160,0,860
57471,170,160,240,0,0,0,570
57472,210,160,40,80,0,0,490
57473,200,100,80,80,0,0,460
57474,190,120,160,160,0,0,630
57475,220,120,120,240,320,0,1020
57476,190,140,120,160,320,320,1250
57477,210,120,80,0,0,0,410
57478,200,100,40,80,160,320,900
57479,230,180,200,80,0,0,690
57480,220,120,80,80,160,0,660
57481,180,100,80,80,160,0,600
57482,210,140,120,0,0,0,470
57483,220,200,200,240,320,320,1500
57484,150,100,80,0,0,0,330
57485,230,160,200,80,160,0,830
57486,210,180,120,160,160,0,830
57487,190,100,40,80,160,0,570
57488,190,100,80,160,320,0,850
57489,160,100,80,80,0,0,420
57490,170,140,160,160,160,0,790
57491,160,100,80,80,160,0,580
57492,160,120,80,80,0,0,440
57493,210,100,40,80,160,320,910
57494,200,100,120,80,160,0,660
57495,200,140,200,240,320,0,1100
57496,150,140,120,80,160,0,650
57497,140,100,40,80,0,0,360
57498,190,160,160,160,160,0,830
57499,190,100,80,0,0,0,370
57500,190,140,120,0,0,0,450
57501,190,100,160,160,0,0,610
57502,120,100,120,80,160,0,580
57503,150,100,120,80,160,0,610
57504,190,180,160,160,0,0,690
57505,180,140,120,80,0,0,520
57506,230,100,120,80,0,0,530
57507,160,80,80,0,0,0,320
57508,190,160,160,80,160,0,750
57509,190,160,160,80,160,0,750
57510,190,100,120,160,160,0,730
57511,200,140,40,80,0,0,460
57512,190,100,120,160,160,0,730
57513,190,120,200,80,160,0,750
57514,240,140,160,160,160,320,1180
57515,220,160,120,0,0,0,500
57516,190,100,80,80,160,0,610
57517,250,140,120,0,0,0,510
57518,160,100,0,0,0,0,260
57519,250,120,40,0,0,0,410
57520,200,100,80,80,0,0,460
57521,230,120,40,0,0,0,390
57522,140,120,160,160,0,0,580
57523,220,160,120,80,0,0,580
57524,210,160,200,80,160,0,810
57525,190,120,80,160,0,0,550
57526,220,140,80,80,160,320,1000
57527,190,140,120,80,0,0,530
57528,170,120,120,80,0,0,490
57529,190,140,120,160,160,0,770
57530,210,140,80,80,160,0,670
57531,210,140,120,0,0,0,470
57532,200,160,120,80,160,0,720
57533,210,160,160,160,0,0,690
57534,170,120,40,0,0,0,330
57535,200,80,80,80,160,0,600
57536,200,160,160,80,0,0,600
57537,190,60,80,80,160,0,570
57538,170,80,80,80,0,0,410
57539,190,80,120,80,160,320,950
57540,190,80,120,240,160,0,790
57541,180,120,160,80,0,0,540
57542,180,120,80,0,0,0,380
57543,190,120,80,160,160,0,710
57544,210,160,120,80,0,0,570
57545,200,160,120,160,160,320,1120
57546,200,180,80,160,160,0,780
57547,220,120,120,160,160,0,780
57548,210,220,160,160,160,0,910
57549,190,140,160,240,160,0,890
57550,170,100,160,160,160,0,750
57551,190,100,120,160,320,320,1210
57552,190,60,120,80,0,0,450
57553,200,120,160,240,160,0,880
57554,170,80,40,80,0,0,370
57555,180,100,80,80,0,0,440
57556,190,140,120,80,0,0,530
57557,180,100,120,160,320,320,1200
57558,170,120,160,160,160,320,1090
57559,220,140,120,80,0,0,560
57560,210,100,80,160,160,0,710
57561,220,120,80,80,0,0,500
57562,190,140,80,80,160,0,650
57563,180,60,80,80,160,0,560
57564,220,100,80,80,160,0,640
57565,230,180,120,160,320,320,1330
57566,220,100,120,0,0,0,440
57567,210,100,80,160,160,0,710
57568,180,140,80,80,0,0,480
57569,200,120,120,80,0,0,520
57570,170,140,120,80,0,0,510
57571,150,140,80,80,0,0,450
57572,200,80,120,80,0,0,480
57573,180,160,80,160,160,0,740
57574,200,100,40,80,160,320,900
57575,180,100,120,0,0,0,400
57576,150,140,120,80,160,0,650
57577,240,160,120,80,160,320,1080
57578,180,100,80,0,0,0,360
57579,170,160,200,160,160,0,850
57580,220,120,200,160,0,0,700
57581,170,160,160,160,320,0,970
57582,200,140,80,0,0,0,420
57583,200,100,120,160,160,0,740
57584,200,80,40,80,0,0,400
57585,170,40,0,0,0,0,210
57586,230,120,80,0,0,0,430
57587,170,80,0,0,0,0,250
57588,220,180,80,80,0,0,560
57589,220,120,120,160,160,0,780
57590,170,100,80,160,320,0,830
57591,170,80,120,160,320,0,850
57592,220,100,40,0,0,0,360
57593,200,120,120,80,0,0,520
57594,190,100,80,160,160,0,690
57595,130,140,160,160,160,320,1070
57596,190,140,160,160,160,0,810
57597,190,60,80,80,160,0,570
57598,230,180,120,160,160,0,850
57599,200,100,80,80,160,0,620
57600,200,40,80,160,160,320,960
57601,200,140,120,0,0,0,460
57602,190,120,120,80,160,0,670
57603,160,120,80,80,0,0,440
57604,210,140,80,80,160,320,990
57605,180,100,80,80,160,0,600
57606,190,100,0,0,0,0,290
57607,240,100,80,80,160,0,660
57608,210,140,120,160,160,0,790
57609,200,80,80,80,0,0,440
57610,160,100,80,80,160,320,900
57611,200,80,80,80,160,320,920
57612,250,100,80,0,0,0,430
57613,170,120,40,0,0,0,330
57614,190,140,120,160,320,0,930
57615,180,120,40,0,0,0,340
57616,180,120,120,0,0,0,420
57617,190,100,80,80,160,0,610
57618,240,180,120,80,160,0,780
57619,190,140,200,160,0,0,690
57620,190,80,120,0,0,0,390
57621,200,120,80,160,0,0,560
57622,220,140,40,0,0,0,400
57623,160,60,80,80,0,0,380
57624,190,160,120,160,160,0,790
57625,190,120,120,160,0,0,590
57626,160,40,40,80,0,0,320
57627,240,200,200,80,160,320,1200
57628,230,200,120,80,160,0,790
57629,150,60,80,160,0,0,450
57630,210,140,120,0,0,0,470
57631,220,100,120,160,160,0,760
57632,210,140,120,160,320,320,1270
57633,210,140,40,80,0,0,470
57634,180,80,80,0,0,0,340
57635,150,80,80,0,0,0,310
57636,220,140,120,160,320,0,960
57637,210,160,80,0,0,0,450
57638,210,120,40,80,0,0,450
57639,210,140,120,80,0,0,550
57640,180,100,160,240,160,0,840
57641,200,100,80,160,0,0,540
57642,200,120,120,160,0,0,600
57643,210,180,80,80,0,0,550
57644,220,120,80,160,160,0,740
57645,240,140,80,80,0,0,540
57646,170,140,160,160,160,0,790
57647,150,140,40,80,0,0,410
57648,200,100,80,80,0,0,460
57649,170,100,80,160,160,0,670
57650,170,120,120,80,0,0,490
57651,170,100,160,160,0,0,590
57652,220,160,120,80,160,0,740
57653,170,140,120,160,320,0,910
57654,200,140,160,160,160,0,820
57655,200,80,40,0,0,0,320
57656,200,120,80,80,0,0,480
57657,200,120,160,240,320,0,1040
57658,190,80,40,0,0,0,310
57659,200,120,80,80,0,0,480
57660,200,160,160,0,0,0,520
57661,160,100,80,80,160,0,580
57662,190,80,120,160,160,0,710
57663,210,140,80,80,160,0,670
57664,190,120,160,160,160,0,790
57665,170,140,80,80,160,0,630
57666,180,80,80,0,0,0,340
57667,210,120,120,80,0,0,530
57668,220,180,120,160,160,320,1160
57669,180,80,40,80,0,0,380
57670,170,100,160,80,160,0,670
57671,140,100,120,160,160,0,680
57672,220,120,160,80,160,0,740
57673,150,80,80,80,160,0,550
57674,180,140,120,80,0,0,520
57675,150,120,120,80,0,0,470
57676,150,100,120,0,0,0,370
57677,210,140,160,80,160,0,750
57678,180,80,120,160,160,320,1020
57679,160,100,40,0,0,0,300
57680,210,120,120,160,0,0,610
57681,230,180,160,80,160,0,810
57682,230,80,120,240,160,0,830
57683,210,80,80,160,160,0,690
57684,190,180,120,160,160,0,810
57685,200,100,120,160,160,0,740
57686,180,140,120,0,0,0,440
57687,240,160,120,160,320,0,1000
57688,190,80,80,160,160,0,670
57689,220,140,160,240,320,0,1080
57690,170,120,160,240,320,320,1330
57691,230,160,120,80,0,0,590
57692,210,180,120,160,160,0,830
57693,210,140,200,80,0,0,630
57694,180,160,80,80,0,0,500
57695,220,160,160,80,0,0,620
57696,220,60,40,80,160,0,560
57697,210,100,120,80,160,320,990
57698,180,80,80,80,160,0,580
57699,170,200,160,80,0,0,610
57700,200,120,120,80,160,0,680
57701,240,140,160,240,0,0,780
57702,230,120,80,80,0,0,510
57703,220,120,160,240,160,0,900
57704,220,120,80,0,0,0,420
57705,200,140,80,80,160,0,660
57706,210,160,120,80,160,0,730
57707,190,100,120,160,160,320,1050
57708,220,100,80,80,0,0,480
57709,170,120,120,80,160,0,650
57710,200,100,80,80,0,0,460
57711,180,140,120,80,0,0,520
57712,220,100,120,80,160,0,680
57713,250,180,200,160,160,320,1270
57714,200,140,80,80,0,0,500
57715,210,160,160,240,320,320,1410
57716,200,120,80,80,160,320,960
57717,160,140,200,160,160,0,820
57718,230,140,80,80,160,0,690
57719,200,80,40,80,160,0,560
57720,190,140,120,160,320,0,930
57721,230,200,120,80,0,0,630
57722,170,60,80,0,0,0,310
57723,200,140,0,0,0,0,340
57724,220,160,160,80,0,0,620
57725,210,160,240,160,160,0,930
57726,180,140,120,80,160,0,680
57727,190,120,120,80,160,0,670
57728,180,100,120,80,160,0,640
57729,190,120,120,80,0,0,510
57730,220,140,160,80,160,320,1080
57731,190,120,120,160,320,0,910
57732,190,120,120,0,0,0,430
57733,200,140,160,160,160,0,820
57734,240,180,200,160,160,0,940
57735,170,140,160,80,0,0,550
57736,160,120,120,80,0,0,480
57737,190,140,80,0,0,0,410
57738,210,160,120,0,0,0,490
57739,200,120,120,240,160,0,840
57740,210,80,40,0,0,0,330
57741,170,60,80,80,0,0,390
57742,210,120,200,80,160,0,770
57743,170,100,120,0,0,0,390
57744,240,140,160,160,160,0,860
57745,200,120,160,160,160,320,1120
57746,210,120,160,160,160,0,810
57747,200,120,120,0,0,0,440
57748,170,80,40,80,160,0,530
57749,200,160,160,80,0,0,600
57750,200,180,160,160,160,0,860
57751,180,180,80,0,0,0,440
57752,150,120,40,0,0,0,310
57753,220,160,160,160,320,0,1020
57754,190,80,80,0,0,0,350
57755,140,80,80,0,0,0,300
57756,200,100,0,0,0,0,300
57757,200,120,160,80,160,320,1040
57758,190,100,160,160,160,0,770
57759,210,120,120,160,160,0,770
57760,190,100,120,80,160,0,650
57761,180,160,120,80,160,0,700
57762,200,160,160,160,160,0,840
57763,200,80,80,0,0,0,360
57764,240,180,160,80,160,0,820
57765,170,100,0,0,0,0,270
57766,180,160,120,80,160,0,700
57767,220,160,80,80,160,0,700
57768,200,120,40,0,0,0,360
57769,230,100,160,160,160,0,810
57770,210,180,80,80,160,0,710
57771,210,120,160,160,160,0,810
57772,230,140,80,80,160,0,690
57773,190,160,200,160,160,0,870
57774,180,140,120,80,0,0,520
57775,210,140,40,80,0,0,470
57776,170,120,80,160,320,0,850
57777,230,140,160,80,0,0,610
57778,190,140,80,0,0,0,410
57779,250,140,160,160,0,0,710
57780,180,140,80,0,0,0,400
57781,180,40,40,80,160,0,500
57782,170,100,120,0,0,0,390
57783,200,160,120,240,320,0,1040
57784,190,140,200,160,160,0,850
57785,190,100,80,80,160,0,610
57786,190,80,40,0,0,0,310
57787,200,120,40,0,0,0,360
57788,160,100,40,0,0,0,300
57789,200,180,120,0,0,0,500
57790,220,100,80,160,160,0,720
57791,230,140,160,160,160,0,850
57792,200,160,120,80,0,0,560
57793,150,100,40,80,160,0,530
57794,170,100,0,0,0,0,270
57795,170,100,80,80,0,0,430
57796,230,160,80,0,0,0,470
57797,190,120,120,80,160,0,670
57798,170,120,120,160,160,0,730
57799,180,180,120,80,160,0,720
57800,210,180,80,0,0,0,470
57801,210,120,120,160,160,0,770
57802,240,100,40,0,0,0,380
57803,180,140,120,80,0,0,520
57804,170,80,80,160,320,0,810
57805,220,120,120,240,160,0,860
57806,190,140,160,160,160,0,810
57807,200,80,40,80,160,0,560
57808,210,100,80,80,160,0,630
57809,210,160,200,240,160,0,970
57810,230,100,80,160,160,320,1050
57811,170,120,120,160,320,320,1210
57812,200,140,160,160,320,0,980
57813,170,120,120,160,160,0,730
57814,170,100,80,160,160,0,670
57815,190,100,40,80,0,0,410
57816,180,100,160,160,160,0,760
57817,220,140,80,80,160,0,680
57818,210,100,40,0,0,0,350
57819,200,140,160,80,160,0,740
57820,210,140,80,80,160,0,670
57821,180,160,80,80,160,0,660
57822,180,120,40,0,0,0,340
57823,200,120,40,80,160,0,600
57824,210,120,40,0,0,0,370
57825,200,120,40,0,0,0,360
57826,240,140,40,80,160,0,660
57827,230,100,80,0,0,0,410
57828,230,120,80,80,160,0,670
57829,230,140,80,0,0,0,450
57830,160,100,80,80,0,0,420
57831,230,180,80,0,0,0,490
57832,210,140,80,80,0,0,510
57833,190,120,120,0,0,0,430
57834,240,160,200,240,320,0,1160
57835,170,100,120,240,320,0,950
57836,190,140,160,160,160,0,810
57837,200,100,120,160,320,320,1220
57838,220,100,160,160,160,0,800
57839,160,100,80,80,160,0,580
57840,200,100,120,80,160,0,660
57841,220,140,80,0,0,0,440
57842,220,120,80,80,0,0,500
57843,220,120,80,80,160,0,660
57844,180,140,160,240,160,320,1200
57845,150,120,80,0,0,0,350
57846,150,120,120,160,320,0,870
57847,190,160,160,0,0,0,510
57848,190,80,120,80,160,0,630
57849,220,100,80,0,0,0,400
57850,220,160,160,240,320,0,1100
57851,200,100,0,0,0,0,300
57852,180,120,120,160,0,0,580
57853,180,180,120,240,320,0,1040
57854,220,160,80,160,160,0,780
57855,160,120,160,240,160,0,840
57856,170,120,120,160,160,0,730
57857,190,120,120,80,160,0,670
57858,160,100,40,80,160,0,540
57859,180,140,120,80,0,0,520
57860,210,200,120,80,160,0,770
57861,190,120,120,160,160,0,750
57862,210,120,80,80,0,0,490
57863,200,140,80,80,160,0,660
57864,200,80,80,80,160,0,600
57865,230,200,160,240,320,0,1150
57866,180,140,120,160,160,0,760
57867,190,120,80,80,0,0,470
57868,210,160,120,240,160,0,890
57869,200,80,40,80,160,0,560
57870,220,160,120,160,160,0,820
57871,230,120,160,240,320,0,1070
57872,220,120,120,80,160,0,700
57873,150,140,200,160,320,0,970
57874,210,140,160,240,320,0,1070
57875,190,100,80,80,160,0,610
57876,160,120,80,160,320,0,840
57877,210,180,160,160,160,320,1190
57878,180,160,160,160,320,0,980
57879,180,100,120,0,0,0,400
57880,160,120,160,160,160,0,760
57881,200,140,160,160,0,0,660
57882,200,160,80,80,0,0,520
57883,180,100,120,80,160,0,640
57884,170,100,80,80,160,0,590
57885,190,100,80,160,320,0,850
57886,150,120,80,80,160,320,910
57887,190,60,120,240,160,0,770
57888,190,180,80,0,0,0,450
57889,190,140,80,80,160,0,650
57890,160,100,120,160,0,0,540
57891,220,120,40,80,160,0,620
57892,200,160,120,0,0,0,480
57893,210,120,120,80,160,0,690
57894,200,160,40,80,160,0,640
57895,120,40,80,160,320,0,720
57896,200,180,80,0,0,0,460
57897,210,160,120,80,160,0,730
57898,240,100,80,80,160,0,660
57899,190,120,160,160,320,0,950
57900,210,160,120,80,160,320,1050
57901,230,100,160,160,160,0,810
57902,200,120,120,80,160,320,1000
57903,150,120,160,80,160,0,670
57904,160,120,120,80,160,0,640
57905,200,160,40,80,160,0,640
57906,180,80,40,80,160,0,540
57907,160,80,120,80,0,0,440
57908,230,160,80,0,0,0,470
57909,210,120,80,0,0,0,410
57910,220,160,160,160,0,0,700
57911,160,60,80,160,160,0,620
57912,190,100,160,80,0,0,530
57913,230,100,200,160,0,0,690
57914,200,60,80,160,320,320,1140
57915,180,160,80,80,160,0,660
57916,170,60,80,80,0,0,390
57917,170,100,40,80,160,0,550
57918,210,100,80,80,0,0,470
57919,210,180,160,160,160,0,870
57920,230,180,120,80,160,0,770
57921,210,160,200,80,160,0,810
57922,200,120,120,160,160,320,1080
57923,220,80,120,160,0,0,580
57924,200,140,120,160,320,0,940
57925,190,120,160,80,160,0,710
57926,200,120,120,80,0,0,520
57927,200,120,120,240,160,320,1160
57928,210,180,80,160,160,0,790
57929,240,160,80,80,0,0,560
57930,180,100,120,160,160,0,720
57931,200,100,160,160,160,0,780
57932,210,100,0,0,0,0,310
57933,220,200,40,0,0,0,460
57934,190,120,120,80,160,0,670
57935,180,100,80,80,160,0,600
57936,180,140,120,80,160,0,680
57937,230,160,120,80,0,0,590
57938,170,120,40,80,160,0,570
57939,190,140,160,0,0,0,490
57940,210,100,160,160,0,0,630
57941,210,120,80,160,160,0,730
57942,200,140,40,80,160,320,940
57943,190,160,200,160,160,0,870
57944,200,100,120,160,320,0,900
57945,190,100,80,160,320,320,1170
57946,190,100,120,80,0,0,490
57947,200,120,120,80,0,0,520
57948,190,160,200,80,160,320,1110
57949,200,120,120,160,320,0,920
57950,210,120,120,80,0,0,530
57951,230,160,160,80,0,0,630
57952,220,180,120,0,0,0,520
57953,210,120,120,80,0,0,530
57954,160,60,80,0,0,0,300
57955,240,120,80,160,160,0,760
57956,240,120,80,80,160,0,680
57957,150,100,160,240,0,0,650
57958,200,80,80,80,0,0,440
57959,190,100,120,80,160,0,650
57960,160,80,120,160,160,0,680
57961,190,100,80,160,320,320,1170
57962,160,80,80,0,0,0,320
57963,240,140,80,0,0,0,460
57964,230,100,40,0,0,0,370
57965,210,140,120,240,0,0,710
57966,240,200,160,160,320,0,1080
57967,160,100,120,160,0,0,540
57968,160,140,80,80,160,0,620
57969,220,160,120,160,320,0,980
57970,210,80,40,0,0,0,330
57971,250,140,80,80,160,320,1030
57972,230,240,240,80,0,0,790
57973,200,100,80,160,320,0,860
57974,170,80,120,240,160,0,770
57975,220,120,160,240,320,0,1060
57976,190,100,160,160,320,320,1250
57977,190,140,160,160,160,0,810
57978,240,100,80,0,0,0,420
57979,190,120,120,80,160,320,990
57980,200,80,40,0,0,0,320
57981,210,140,80,0,0,0,430
57982,210,180,40,0,0,0,430
57983,160,160,80,80,160,0,640
57984,140,80,80,160,320,0,780
57985,160,80,120,80,160,0,600
57986,210,140,40,0,0,0,390
57987,210,120,80,80,160,0,650
57988,180,100,80,80,0,0,440
57989,210,80,80,160,320,320,1170
57990,160,120,160,160,160,0,760
57991,180,100,40,0,0,0,320
57992,210,140,80,80,160,0,670
57993,160,60,0,0,0,0,220
57994,170,160,200,0,0,0,530
57995,200,100,120,80,0,0,500
57996,180,140,40,0,0,0,360
57997,210,140,120,160,0,0,630
57998,120,100,80,80,160,320,860
57999,240,120,40,0,0,0,400
58000,210,140,120,240,160,0,870
58001,200,80,120,0,0,0,400
58002,150,60,40,80,160,0,490
58003,220,120,80,80,0,0,500
58004,160,100,40,80,0,0,380
58005,190,80,40,80,160,0,550
58006,210,140,80,80,160,0,670
58007,150,100,160,160,160,0,730
58008,230,160,160,80,160,0,790
58009,230,140,80,160,160,0,770
58010,230,180,120,80,0,0,610
58011,230,160,40,80,0,0,510
58012,190,120,200,160,320,0,990
58013,180,80,120,160,320,0,860
58014,200,120,40,80,160,320,920
58015,180,100,80,160,320,320,1160
58016,180,140,120,80,0,0,520
58017,220,120,120,80,160,0,700
58018,210,160,160,80,0,0,610
58019,180,140,80,80,160,0,640
58020,150,160,160,80,160,0,710
58021,210,140,120,80,160,0,710
58022,170,140,40,0,0,0,350
58023,170,60,40,80,0,0,350
58024,220,120,120,0,0,0,460
58025,190,100,120,0,0,0,410
58026,190,80,80,80,160,0,590
58027,170,80,120,240,160,0,770
58028,210,160,80,160,160,0,770
58029,220,100,120,0,0,0,440
58030,230,80,80,80,0,0,470
58031,200,160,80,80,0,0,520
58032,150,120,80,80,160,0,590
58033,200,100,160,80,0,0,540
58034,210,100,120,160,0,0,590
58035,200,120,160,80,160,0,720
58036,160,140,80,0,0,0,380
58037,200,180,120,160,0,0,660
58038,180,120,120,160,320,0,900
58039,190,100,80,0,0,0,370
58040,220,100,0,0,0,0,320
58041,170,100,120,80,0,0,470
58042,200,100,120,160,320,0,900
58043,170,100,40,80,160,0,550
58044,210,100,80,160,320,0,870
58045,220,120,160,160,160,0,820
58046,190,100,80,80,0,0,450
58047,180,140,160,160,160,0,800
58048,210,60,40,80,160,0,550
58049,190,120,120,0,0,0,430
58050,130,140,120,0,0,0,390
58051,200,120,80,160,160,0,720
58052,180,120,40,80,0,0,420
58053,200,100,80,160,160,320,1020
58054,230,200,160,80,160,0,830
58055,150,140,160,160,160,0,770
58056,150,120,80,80,160,0,590
58057,230,80,80,80,0,0,470
58058,210,140,160,240,160,0,910
58059,220,140,160,80,160,0,760
58060,220,160,120,80,160,0,740
58061,200,140,120,160,160,0,780
58062,230,140,40,80,160,0,650
58063,200,120,80,0,0,0,400
58064,190,100,120,0,0,0,410
58065,220,100,160,160,0,0,640
58066,170,100,120,80,0,0,470
58067,180,100,80,160,160,0,680
58068,190,160,160,160,160,0,830
58069,220,140,120,80,160,0,720
58070,210,140,40,0,0,0,390
58071,230,140,120,80,160,0,730
58072,180,120,0,0,0,0,300
58073,180,100,120,240,320,0,960
58074,210,100,120,80,160,320,990
58075,220,100,160,160,320,0,960
58076,220,100,120,160,160,320,1080
58077,250,220,120,160,0,0,750
58078,170,120,160,80,0,0,530
58079,140,100,160,80,160,0,640
58080,180,180,80,80,0,0,520
58081,220,120,40,0,0,0,380
58082,200,140,120,160,320,320,1260
58083,210,160,80,160,320,320,1250
58084,180,120,120,160,320,0,900
58085,180,120,120,160,320,0,900
58086,180,80,80,80,160,0,580
58087,160,180,80,80,0,0,500
58088,180,60,40,0,0,0,280
58089,210,160,160,80,0,0,610
58090,180,80,120,80,160,0,620
58091,210,120,120,160,160,0,770
58092,210,120,80,80,160,0,650
58093,210,160,160,160,0,0,690
58094,200,140,80,0,0,0,420
58095,200,100,80,80,160,0,620
58096,200,120,120,80,0,0,520
58097,240,100,80,160,160,0,740
58098,160,80,80,0,0,0,320
58099,200,180,160,80,0,0,620
58100,210,120,40,80,160,320,930
58101,190,140,200,240,320,0,1090
58102,200,80,80,80,0,0,440
58103,210,120,120,160,160,0,770
58104,210,120,120,160,160,0,770
58105,220,120,160,240,160,0,900
58106,180,80,40,80,160,0,540
58107,220,160,200,80,160,320,1140
58108,190,140,160,160,160,0,810
58109,230,120,120,80,160,0,710
58110,200,180,120,0,0,0,500
58111,150,100,160,160,0,0,570
58112,160,80,80,0,0,0,320
58113,200,180,160,160,0,0,700
58114,240,200,120,160,160,0,880
58115,240,120,120,160,160,0,800
58116,240,100,0,0,0,0,340
58117,210,140,120,0,0,0,470
58118,230,180,160,240,320,0,1130
58119,240,80,80,160,160,0,720
58120,190,120,80,0,0,0,390
58121,190,100,80,80,160,0,610
58122,200,160,160,160,160,0,840
58123,260,180,120,80,160,0,800
58124,190,160,120,80,160,0,710
58125,210,140,80,0,0,0,430
58126,190,120,80,0,0,0,390
58127,150,120,80,160,160,320,990
58128,200,120,200,240,0,0,760
58129,220,140,80,80,160,0,680
58130,220,100,80,80,0,0,480
58131,200,120,120,80,0,0,520
58132,240,180,240,240,160,0,1060
58133,200,180,160,160,0,0,700
58134,200,100,80,160,160,0,700
58135,220,140,160,80,160,320,1080
58136,150,140,80,80,160,0,610
58137,220,100,120,240,0,0,680
58138,190,180,80,160,0,0,610
58139,180,140,120,80,160,0,680
58140,200,120,120,160,160,320,1080
58141,190,100,80,80,160,0,610
58142,220,80,80,160,160,0,700
58143,150,140,160,160,160,320,1090
58144,180,140,80,160,0,0,560
58145,160,100,80,80,160,0,580
58146,200,120,80,80,0,0,480
58147,150,100,40,0,0,0,290
58148,180,120,120,240,160,0,820
58149,170,80,80,80,0,0,410
58150,180,160,80,80,160,0,660
58151,200,80,80,160,320,0,840
58152,220,100,80,80,160,0,640
58153,190,140,160,80,160,0,730
58154,210,140,80,0,0,0,430
58155,190,120,160,160,160,0,790
58156,170,100,80,160,160,0,670
58157,230,180,120,160,160,0,850
58158,190,100,80,0,0,0,370
58159,240,180,160,160,320,0,1060
58160,230,140,80,80,0,0,530
58161,220,120,120,80,160,320,1020
58162,230,120,120,80,0,0,550
58163,220,140,40,0,0,0,400
58164,190,160,160,160,0,0,670
58165,190,120,40,80,160,0,590
58166,210,120,80,80,160,0,650
58167,190,140,40,80,160,0,610
58168,190,180,200,160,320,320,1370
58169,200,140,160,240,160,0,900
58170,230,140,80,80,160,0,690
58171,250,140,200,80,0,0,670
58172,220,100,120,160,0,0,600
58173,200,80,40,80,160,320,880
58174,200,100,120,160,160,0,740
58175,180,140,0,0,0,0,320
58176,190,120,80,80,160,0,630
58177,190,200,200,160,160,0,910
58178,180,100,120,160,160,0,720
58179,190,120,80,0,0,0,390
58180,130,100,40,0,0,0,270
58181,230,100,120,0,0,0,450
58182,220,160,160,80,0,0,620
58183,220,160,80,80,0,0,540
58184,200,160,160,160,160,0,840
58185,210,200,200,240,0,0,850
58186,200,120,80,80,160,0,640
58187,170,120,80,80,160,0,610
58188,200,140,160,80,160,0,740
58189,230,180,40,80,0,0,530
58190,160,80,160,160,320,0,880
58191,160,80,120,80,160,0,600
58192,200,140,40,80,160,0,620
58193,180,100,40,0,0,0,320
58194,210,100,80,80,160,0,630
58195,160,120,120,80,160,320,960
58196,210,120,120,80,160,320,1010
58197,200,100,80,80,160,0,620
58198,210,140,120,160,320,320,1270
58199,170,100,200,160,160,0,790
58200,140,60,80,160,320,0,760
58201,190,100,120,240,320,0,970
58202,190,100,80,160,160,0,690
58203,200,180,40,0,0,0,420
58204,180,80,120,160,0,0,540
58205,210,100,80,80,0,0,470
58206,200,120,120,80,160,0,680
58207,220,80,40,0,0,0,340
58208,190,140,120,240,320,0,1010
58209,190,100,40,80,160,0,570
58210,210,100,120,160,320,0,910
58211,170,160,160,240,0,0,730
58212,220,100,80,80,160,0,640
58213,230,120,80,0,0,0,430
58214,190,140,120,160,320,320,1250
58215,250,100,120,160,0,0,630
58216,180,80,80,80,0,0,420
58217,210,160,160,160,0,0,690
58218,200,140,120,0,0,0,460
58219,170,100,120,0,0,0,390
58220,190,80,120,160,160,0,710
58221,210,140,40,0,0,0,390
58222,180,100,80,80,160,320,920
58223,190,80,80,160,320,320,1150
58224,170,100,120,80,0,0,470
58225,230,120,80,0,0,0,430
58226,200,140,80,0,0,0,420
58227,220,120,200,240,320,0,1100
58228,200,100,120,160,160,0,740
58229,220,120,200,160,160,0,860
58230,210,120,80,80,160,0,650
58231,260,180,120,160,160,0,880
58232,220,140,80,0,0,0,440
58233,170,120,120,80,0,0,490
58234,210,100,120,160,160,0,750
58235,190,80,80,80,0,0,430
58236,230,160,160,240,160,0,950
58237,150,60,80,160,320,0,770
58238,180,100,80,160,160,0,680
58239,220,140,80,160,160,0,760
58240,150,100,40,80,160,0,530
58241,170,100,80,80,0,0,430
58242,210,200,120,240,320,320,1410
58243,210,140,80,80,160,0,670
58244,200,100,80,80,0,0,460
58245,220,80,120,160,160,0,740
58246,190,140,120,160,0,0,610
58247,210,120,120,160,160,0,770
58248,210,160,40,0,0,0,410
58249,180,100,0,0,0,0,280
58250,190,100,40,0,0,0,330
58251,230,140,160,160,160,0,850
58252,200,140,80,0,0,0,420
58253,190,140,80,0,0,0,410
58254,190,140,120,160,320,320,1250
58255,230,160,120,160,160,320,1150
58256,210,120,120,240,320,0,1010
58257,220,200,200,240,160,320,1340
58258,200,140,120,160,160,0,780
58259,140,100,80,80,160,0,560
58260,200,100,0,0,0,0,300
58261,190,180,120,80,160,0,730
58262,220,140,120,80,160,320,1040
58263,190,120,160,80,0,0,550
58264,210,160,120,160,320,320,1290
58265,160,80,40,80,0,0,360
58266,170,120,160,80,0,0,530
58267,140,140,160,80,160,320,1000
58268,200,120,120,80,0,0,520
58269,210,100,40,0,0,0,350
58270,170,80,80,160,320,0,810
58271,200,120,120,80,160,0,680
58272,190,120,80,160,320,0,870
58273,240,100,80,0,0,0,420
58274,180,80,80,160,320,0,820
58275,150,100,120,240,320,320,1250
58276,170,120,120,80,160,0,650
58277,210,80,40,80,160,0,570
58278,200,120,80,80,0,0,480
58279,230,140,80,80,160,0,690
58280,200,120,120,80,0,0,520
58281,200,120,80,80,160,0,640
58282,200,180,160,80,160,0,780
58283,210,100,40,0,0,0,350
58284,190,120,120,80,0,0,510
58285,220,160,160,160,160,0,860
58286,170,100,120,160,160,0,710
58287,190,160,120,80,160,0,710
58288,220,160,160,80,0,0,620
58289,140,60,40,80,0,0,320
58290,210,120,160,80,0,0,570
58291,190,160,160,160,320,0,990
58292,210,120,160,160,0,0,650
58293,190,160,200,240,160,0,950
58294,210,80,80,160,160,0,690
58295,170,140,40,80,160,0,590
58296,170,100,40,80,160,0,550
58297,200,80,40,80,160,0,560
58298,140,40,40,80,160,0,460
58299,170,100,40,80,160,0,550
58300,200,140,40,0,0,0,380
58301,220,120,200,0,0,0,540
58302,220,100,40,80,160,0,600
58303,210,160,120,80,160,0,730
58304,180,120,120,80,160,0,660
58305,170,100,120,0,0,0,390
58306,190,80,120,160,0,0,550
58307,200,140,40,80,0,0,460
58308,210,160,160,0,0,0,530
58309,200,140,120,80,160,0,700
58310,230,120,80,0,0,0,430
58311,180,80,80,160,320,0,820
58312,220,140,160,160,0,0,680
58313,210,80,80,80,0,0,450
58314,180,140,80,160,320,0,880
58315,250,120,80,0,0,0,450
58316,190,180,80,0,0,0,450
58317,230,180,200,160,160,0,930
58318,220,140,40,80,160,0,640
58319,210,180,160,160,320,0,1030
58320,190,80,80,80,160,0,590
58321,170,60,40,80,160,0,510
58322,200,160,120,0,0,0,480
58323,160,120,160,80,160,0,680
58324,200,60,80,160,160,0,660
58325,180,40,80,80,0,0,380
58326,160,100,120,80,160,0,620
58327,160,100,80,0,0,0,340
58328,200,160,160,0,0,0,520
58329,210,120,160,160,160,0,810
58330,230,40,80,160,160,0,670
58331,180,80,80,160,160,0,660
58332,190,120,40,80,160,0,590
58333,230,120,120,80,0,0,550
58334,180,120,80,80,0,0,460
58335,220,140,40,80,0,0,480
58336,170,140,120,160,160,0,750
58337,170,140,120,160,160,0,750
58338,200,180,160,80,160,320,1100
58339,230,80,40,80,0,0,430
58340,160,140,120,0,0,0,420
58341,200,100,0,0,0,0,300
58342,190,160,200,160,160,0,870
58343,200,140,160,80,160,0,740
58344,230,140,160,0,0,0,530
58345,170,100,120,80,0,0,470
58346,190,180,120,160,160,0,810
58347,220,160,160,160,160,0,860
58348,230,140,40,80,0,0,490
58349,220,120,80,160,320,0,900
58350,230,180,160,80,0,0,650
58351,160,120,120,80,0,0,480
58352,200,160,160,160,0,0,680
58353,170,120,160,0,0,0,450
58354,190,120,80,160,160,0,710
58355,180,160,40,80,0,0,460
58356,180,180,160,160,0,0,680
58357,190,160,160,80,160,0,750
58358,190,120,120,160,160,0,750
58359,210,140,160,160,0,0,670
58360,180,120,80,0,0,0,380
58361,180,120,80,80,0,0,460
58362,210,120,80,80,160,0,650
58363,180,120,80,160,320,0,860
58364,200,60,0,0,0,0,260
58365,190,80,40,0,0,0,310
58366,170,100,120,160,160,0,710
58367,240,80,80,80,160,0,640
58368,180,140,120,80,0,0,520
58369,200,180,160,80,160,320,1100
58370,200,120,80,0,0,0,400
58371,190,80,160,80,160,0,670
58372,210,140,120,80,160,0,710
58373,240,100,80,80,0,0,500
58374,170,80,0,0,0,0,250
58375,190,140,200,240,0,0,770
58376,200,160,80,160,160,0,760
58377,170,40,80,0,0,0,290
58378,220,80,80,80,160,0,620
58379,190,140,120,80,160,0,690
58380,210,160,80,80,160,0,690
58381,220,160,120,80,160,0,740
58382,160,100,120,80,0,0,460
58383,210,100,120,240,0,0,670
58384,180,100,80,0,0,0,360
58385,190,160,120,80,160,320,1030
58386,170,120,160,160,0,0,610
58387,160,80,80,160,160,0,640
58388,160,120,120,160,320,320,1200
58389,190,160,120,80,160,0,710
58390,170,100,40,0,0,0,310
58391,180,40,80,160,160,0,620
58392,120,80,80,160,160,0,600
58393,190,120,80,0,0,0,390
58394,200,180,200,240,320,0,1140
58395,230,180,200,80,0,0,690
58396,200,140,120,80,0,0,540
58397,200,100,160,240,320,320,1340
58398,190,140,80,0,0,0,410
58399,220,120,40,80,160,0,620
58400,180,160,80,80,160,0,660
58401,170,140,160,160,0,0,630
58402,160,120,160,160,160,0,760
58403,210,160,120,80,0,0,570
58404,250,100,80,80,160,0,670
58405,170,140,120,80,160,0,670
58406,170,140,120,0,0,0,430
58407,200,120,160,160,320,320,1280
58408,210,140,120,80,0,0,550
58409,220,80,80,160,320,0,860
58410,170,100,160,160,320,320,1230
58411,210,180,120,160,160,0,830
58412,200,120,120,160,160,0,760
58413,190,120,120,160,0,0,590
58414,190,120,120,80,0,0,510
58415,210,120,40,0,0,0,370
58416,220,140,80,80,160,0,680
58417,190,120,120,160,160,320,1070
58418,210,120,120,80,160,320,1010
58419,220,100,80,0,0,0,400
58420,160,80,40,0,0,0,280
58421,210,80,160,160,160,0,770
58422,170,100,80,160,160,0,670
58423,180,100,40,80,0,0,400
58424,170,180,160,160,160,0,830
58425,210,160,40,0,0,0,410
58426,200,140,120,80,160,0,700
58427,210,120,80,0,0,0,410
58428,160,60,80,80,160,320,860
58429,220,80,0,0,0,0,300
58430,240,80,120,160,320,320,1240
58431,200,120,40,80,160,320,920
58432,170,60,80,80,160,0,550
58433,180,120,120,160,160,0,740
58434,230,80,160,80,0,0,550
58435,240,200,200,0,0,0,640
58436,190,100,80,80,160,0,610
58437,230,160,160,240,320,0,1110
58438,190,120,120,240,320,320,1310
58439,200,140,120,80,160,0,700
58440,200,120,200,160,0,0,680
58441,180,180,160,160,160,0,840
58442,210,160,80,160,160,0,770
58443,220,160,200,160,160,0,900
58444,200,120,160,160,320,0,960
58445,200,120,40,0,0,0,360
58446,180,80,40,0,0,0,300
58447,210,100,40,80,0,0,430
58448,200,100,80,80,160,0,620
58449,220,120,40,80,0,0,460
58450,210,80,80,160,320,320,1170
58451,210,120,80,160,320,320,1210
58452,190,80,80,80,160,0,590
58453,170,80,80,80,160,320,890
58454,220,180,120,80,160,320,1080
58455,190,160,40,80,0,0,470
58456,160,120,160,160,160,0,760
58457,180,60,120,160,320,0,840
58458,200,80,80,80,0,0,440
58459,170,80,0,0,0,0,250
58460,200,120,80,80,0,0,480
58461,180,100,120,160,0,0,560
58462,180,100,40,80,0,0,400
58463,180,100,80,0,0,0,360
58464,170,100,40,0,0,0,310
58465,180,120,40,80,0,0,420
58466,190,100,160,80,160,0,690
58467,200,120,80,80,0,0,480
58468,230,120,200,160,320,0,1030
58469,200,160,120,160,320,0,960
58470,200,140,80,80,160,0,660
58471,160,100,80,80,0,0,420
58472,200,100,80,0,0,0,380
58473,180,80,120,80,0,0,460
58474,200,140,120,160,0,0,620
58475,210,120,120,80,160,320,1010
58476,160,60,0,0,0,0,220
58477,200,140,80,80,160,0,660
58478,170,60,80,80,160,0,550
58479,200,160,120,0,0,0,480
58480,200,160,80,80,160,0,680
58481,150,120,80,80,0,0,430
58482,210,60,40,80,0,0,390
58483,180,120,80,80,0,0,460
58484,170,100,120,80,0,0,470
58485,170,80,120,80,160,0,610
58486,190,120,0,0,0,0,310
58487,180,100,120,160,160,0,720
58488,190,60,80,160,160,0,650
58489,200,160,80,160,160,0,760
58490,220,180,120,160,160,0,840
58491,190,160,160,160,0,0,670
58492,160,120,120,160,160,0,720
58493,160,140,160,160,160,0,780
58494,210,80,80,80,0,0,450
58495,190,140,120,80,160,0,690
58496,200,100,120,240,160,320,1140
58497,190,100,120,0,0,0,410
58498,190,100,120,80,160,0,650
58499,170,160,200,160,320,320,1330
58500,190,140,120,0,0,0,450
58501,180,140,120,80,0,0,520
58502,190,100,120,160,320,320,1210
58503,230,120,160,0,0,0,510
58504,230,200,160,160,160,0,910
58505,200,140,120,160,160,0,780
58506,210,140,120,160,320,0,950
58507,170,100,120,160,160,0,710
58508,200,100,120,160,320,0,900
58509,220,80,80,160,160,0,700
58510,200,100,40,80,160,320,900
58511,230,160,120,80,0,0,590
58512,240,160,160,80,160,0,800
58513,220,140,160,160,320,0,1000
58514,200,120,80,80,0,0,480
58515,170,100,40,0,0,0,310
58516,170,100,120,160,160,320,1030
58517,210,120,40,80,160,0,610
58518,160,100,120,160,160,0,700
58519,170,120,80,80,160,0,610
58520,200,160,120,160,0,0,640
58521,210,120,160,160,160,0,810
58522,190,80,80,0,0,0,350
58523,190,100,120,80,160,0,650
58524,210,100,160,80,160,0,710
58525,220,140,120,80,160,0,720
58526,190,140,80,80,160,0,650
58527,180,160,80,0,0,0,420
58528,150,80,80,80,160,320,870
58529,210,180,160,160,160,0,870
58530,220,140,120,80,0,0,560
58531,220,80,40,80,160,0,580
58532,210,140,120,0,0,0,470
58533,210,120,120,80,160,0,690
58534,150,100,120,240,160,0,770
58535,160,80,120,80,0,0,440
58536,200,160,80,80,160,0,680
58537,150,120,120,80,160,0,630
58538,180,100,80,80,0,0,440
58539,180,100,40,80,160,0,560
58540,210,140,120,160,320,0,950
58541,150,140,80,160,160,0,690
58542,220,100,80,80,160,320,960
58543,180,80,120,160,0,0,540
58544,210,140,80,0,0,0,430
58545,170,120,200,160,160,0,810
58546,200,120,120,80,0,0,520
58547,210,140,120,160,160,0,790
58548,190,40,0,0,0,0,230
58549,210,80,40,80,0,0,410
58550,210,120,120,80,0,0,530
58551,150,80,80,160,0,0,470
58552,190,120,40,0,0,0,350
58553,220,180,160,0,0,0,560
58554,200,140,160,160,160,0,820
58555,200,100,80,160,160,0,700
58556,180,80,40,80,160,320,860
58557,200,100,120,80,160,0,660
58558,160,80,80,80,160,320,880
58559,210,180,160,0,0,0,550
58560,230,120,40,0,0,0,390
58561,160,100,80,80,160,0,580
58562,160,100,40,80,160,0,540
58563,180,160,120,160,320,0,940
58564,200,140,120,0,0,0,460
58565,160,100,80,80,160,0,580
58566,210,100,160,160,160,0,790
58567,190,60,40,80,0,0,370
58568,170,140,160,160,320,320,1270
58569,200,140,160,160,160,320,1140
58570,200,120,80,160,160,0,720
58571,140,120,120,80,160,0,620
58572,210,140,80,0,0,0,430
58573,180,140,120,160,320,0,920
58574,220,140,120,160,160,0,800
58575,200,120,120,160,160,0,760
58576,200,40,40,80,160,0,520
58577,170,120,120,0,0,0,410
58578,210,120,40,80,160,320,930
58579,210,60,80,160,160,0,670
58580,180,140,120,160,160,320,1080
58581,190,120,120,80,0,0,510
58582,220,120,120,160,160,0,780
58583,240,100,80,80,160,0,660
58584,200,140,160,160,0,0,660
58585,200,120,80,80,0,0,480
58586,170,120,120,80,160,320,970
58587,170,120,80,0,0,0,370
58588,180,80,80,160,160,0,660
58589,210,120,80,80,0,0,490
58590,240,100,80,160,160,0,740
58591,210,100,120,0,0,0,430
58592,190,120,120,80,160,0,670
58593,200,140,120,80,160,0,700
58594,180,140,200,80,160,0,760
58595,200,140,40,80,0,0,460
58596,210,140,80,160,160,0,750
58597,220,160,120,80,0,0,580
58598,200,120,160,160,320,320,1280
58599,170,120,120,0,0,0,410
58600,240,160,160,160,160,0,880
58601,160,80,40,80,160,320,840
58602,220,160,160,240,320,0,1100
58603,150,100,80,0,0,0,330
58604,190,120,80,80,0,0,470
58605,200,160,160,160,160,0,840
58606,200,60,80,80,0,0,420
58607,200,140,80,80,0,0,500
58608,180,160,160,160,0,0,660
58609,170,80,80,80,160,0,570
58610,220,180,120,80,0,0,600
58611,200,160,80,160,160,0,760
58612,160,120,160,80,160,320,1000
58613,200,80,40,0,0,0,320
58614,190,140,160,160,160,0,810
58615,190,140,120,80,0,0,530
58616,170,80,40,0,0,0,290
58617,240,120,160,160,0,0,680
58618,190,100,80,160,0,0,530
58619,220,180,200,80,0,0,680
58620,200,120,200,80,0,0,600
58621,210,120,80,160,320,0,890
58622,220,180,40,80,160,320,1000
58623,240,100,120,160,320,0,940
58624,190,100,40,0,0,0,330
58625,170,120,120,160,160,320,1050
58626,210,120,120,240,320,0,1010
58627,200,140,80,80,160,0,660
58628,210,160,80,80,160,0,690
58629,200,100,80,160,160,0,700
58630,200,100,80,0,0,0,380
58631,210,140,160,80,160,320,1070
58632,220,140,120,80,160,0,720
58633,210,40,40,80,160,320,850
58634,230,160,160,160,320,0,1030
58635,230,140,200,160,160,0,890
58636,200,80,40,0,0,0,320
58637,220,100,80,80,0,0,480
58638,180,100,80,80,0,0,440
58639,200,100,80,80,0,0,460
58640,190,120,120,160,320,0,910
58641,210,140,120,160,160,0,790
58642,220,140,80,80,160,0,680
58643,170,80,80,160,320,320,1130
58644,190,120,120,0,0,0,430
58645,180,160,160,160,160,320,1140
58646,180,100,40,0,0,0,320
58647,180,100,40,0,0,0,320
58648,160,120,40,80,160,0,560
58649,220,100,40,0,0,0,360
58650,200,140,120,160,160,0,780
58651,220,180,80,0,0,0,480
58652,220,120,120,80,160,0,700
58653,210,120,120,240,160,0,850
58654,210,120,80,0,0,0,410
58655,200,160,120,0,0,0,480
58656,170,80,120,0,0,0,370
58657,180,80,40,80,0,0,380
58658,200,160,120,80,0,0,560
58659,190,120,40,0,0,0,350
58660,200,120,200,0,0,0,520
58661,170,100,40,80,0,0,390
58662,210,100,40,80,0,0,430
58663,210,120,120,160,160,0,770
58664,170,100,120,80,160,0,630
58665,260,100,0,0,0,0,360
58666,180,140,80,80,0,0,480
58667,180,80,80,80,160,0,580
58668,190,80,120,80,0,0,470
58669,180,140,80,80,0,0,480
58670,180,80,80,0,0,0,340
58671,240,160,120,160,160,0,840
58672,180,80,80,160,320,0,820
58673,200,120,0,0,0,0,320
58674,210,120,120,160,160,0,770
58675,170,80,120,240,320,320,1250
58676,190,80,160,80,160,0,670
58677,180,120,120,160,160,0,740
58678,230,200,40,80,160,0,710
58679,190,80,40,0,0,0,310
58680,170,60,40,80,160,0,510
58681,210,120,120,160,0,0,610
58682,190,80,80,80,160,0,590
58683,180,100,120,160,160,0,720
58684,240,120,120,160,160,320,1120
58685,220,140,160,240,320,0,1080
58686,200,120,40,0,0,0,360
58687,130,80,40,0,0,0,250
58688,160,120,160,160,160,0,760
58689,180,100,120,160,160,320,1040
58690,190,100,40,80,160,320,890
58691,160,80,80,0,0,0,320
58692,150,120,120,80,160,0,630
58693,180,140,80,80,0,0,480
58694,180,160,40,80,160,0,620
58695,220,120,160,160,160,0,820
58696,210,160,120,80,160,320,1050
58697,200,80,0,0,0,0,280
58698,160,120,120,80,160,320,960
58699,240,80,40,80,160,0,600
58700,200,120,120,80,160,0,680
58701,210,100,120,160,320,0,910
58702,170,140,80,0,0,0,390
58703,190,80,40,80,160,0,550
58704,200,160,80,80,160,0,680
58705,180,80,80,80,0,0,420
58706,240,160,120,160,0,0,680
58707,220,100,80,160,320,0,880
58708,200,120,80,0,0,0,400
58709,190,100,80,0,0,0,370
58710,220,140,120,80,0,0,560
58711,140,120,160,160,320,0,900
58712,210,160,120,80,0,0,570
58713,230,100,80,0,0,0,410
58714,170,100,80,80,0,0,430
58715,230,120,120,80,0,0,550
58716,240,120,40,80,160,320,960
58717,160,80,40,80,160,0,520
58718,230,160,120,0,0,0,510
58719,150,80,80,160,160,0,630
58720,200,180,80,80,0,0,540
58721,200,80,120,80,160,320,960
58722,160,180,160,0,0,0,500
58723,200,120,80,80,160,0,640
58724,220,140,40,0,0,0,400
58725,210,100,120,80,0,0,510
58726,220,160,200,160,160,0,900
58727,180,100,80,160,160,320,1000
58728,230,80,80,80,0,0,470
58729,180,100,80,160,0,0,520
58730,220,160,160,160,160,0,860
58731,140,140,80,80,160,0,600
58732,180,80,120,160,160,0,700
58733,220,120,200,160,160,320,1180
58734,200,140,80,0,0,0,420
58735,200,160,160,160,0,0,680
58736,240,100,120,0,0,0,460
58737,150,80,80,80,160,0,550
58738,200,140,120,80,160,0,700
58739,230,180,120,160,0,0,690
58740,160,120,120,80,160,0,640
58741,250,160,160,160,0,0,730
58742,200,180,200,160,320,320,1380
58743,200,160,160,240,320,0,1080
58744,200,180,200,160,320,0,1060
58745,190,160,160,80,0,0,590
58746,220,100,80,80,160,0,640
58747,200,120,40,0,0,0,360
58748,200,120,120,240,320,0,1000
58749,180,140,160,80,160,0,720
58750,180,100,80,160,160,0,680
58751,220,180,160,160,320,0,1040
58752,190,120,120,160,320,0,910
58753,230,120,80,160,0,0,590
58754,200,120,160,160,0,0,640
58755,200,100,80,160,320,320,1180
58756,150,100,80,160,0,0,490
58757,210,140,160,160,320,0,990
58758,210,140,160,160,320,0,990
58759,180,140,80,160,320,0,880
58760,190,60,120,160,160,0,690
58761,210,100,120,80,160,0,670
58762,180,100,80,80,160,0,600
58763,190,160,120,80,160,0,710
58764,170,60,80,80,160,320,870
58765,200,160,160,160,160,0,840
58766,150,80,40,80,160,0,510
58767,180,120,40,80,160,0,580
58768,180,140,200,160,0,0,680
58769,200,160,160,0,0,0,520
58770,160,120,160,240,320,0,1000
58771,220,160,120,80,160,320,1060
58772,210,140,120,80,0,0,550
58773,160,140,160,160,160,0,780
58774,190,180,160,0,0,0,530
58775,210,140,80,160,320,0,910
58776,200,160,200,240,320,0,1120
58777,230,140,40,0,0,0,410
58778,220,180,200,80,0,0,680
58779,190,120,160,80,160,0,710
58780,160,80,120,80,0,0,440
58781,250,120,80,0,0,0,450
58782,220,180,160,240,320,320,1440
58783,210,100,120,80,160,0,670
58784,200,120,80,160,320,0,880
58785,220,140,80,160,160,0,760
58786,170,100,80,80,160,0,590
58787,240,100,80,0,0,0,420
58788,180,60,40,80,160,320,840
58789,220,100,80,160,160,0,720
58790,160,140,80,0,0,0,380
58791,140,100,120,80,160,0,600
58792,200,160,80,80,160,0,680
58793,190,120,120,0,0,0,430
58794,200,80,120,0,0,0,400
58795,120,60,80,160,160,320,900
58796,200,120,120,160,320,0,920
58797,240,160,40,80,0,0,520
58798,200,60,0,0,0,0,260
58799,190,100,80,160,160,320,1010
58800,190,100,120,80,160,0,650
58801,240,100,120,160,0,0,620
58802,230,160,160,160,160,0,870
58803,210,120,80,80,0,0,490
58804,190,120,160,0,0,0,470
58805,180,120,80,0,0,0,380
58806,180,120,120,160,320,0,900
58807,220,100,120,80,160,0,680
58808,170,80,80,80,160,320,890
58809,160,160,120,160,160,0,760
58810,160,40,40,0,0,0,240
58811,190,80,120,160,0,0,550
58812,190,120,160,160,160,0,790
58813,190,80,80,0,0,0,350
58814,200,160,120,160,160,0,800
58815,250,140,160,160,0,0,710
58816,190,120,120,160,320,0,910
58817,210,120,120,0,0,0,450
58818,170,100,200,80,0,0,550
58819,160,140,120,0,0,0,420
58820,200,60,80,80,160,0,580
58821,230,180,80,160,160,0,810
58822,200,120,40,80,0,0,440
58823,180,120,120,160,160,0,740
58824,200,140,160,160,320,320,1300
58825,180,100,160,160,320,0,920
58826,210,100,40,80,160,0,590
58827,200,160,120,160,160,0,800
58828,140,140,80,80,0,0,440
58829,180,120,160,240,160,0,860
58830,180,120,40,0,0,0,340
58831,200,20,40,80,160,0,500
58832,180,100,80,80,160,0,600
58833,190,120,160,240,160,320,1190
58834,160,100,120,80,160,320,940
58835,180,140,160,160,160,0,800
58836,200,120,200,160,160,320,1160
58837,200,120,120,80,160,0,680
58838,140,120,120,80,160,0,620
58839,210,120,80,80,0,0,490
58840,190,100,120,80,160,0,650
58841,170,140,80,80,160,320,950
58842,190,140,120,0,0,0,450
58843,230,140,80,0,0,0,450
58844,200,120,80,80,160,0,640
58845,160,100,120,160,160,0,700
58846,190,120,80,80,160,0,630
58847,220,100,160,80,160,320,1040
58848,210,140,0,0,0,0,350
58849,190,80,120,80,160,0,630
58850,190,120,0,0,0,0,310
58851,180,100,80,160,320,320,1160
58852,190,120,120,0,0,0,430
58853,220,120,120,80,160,0,700
58854,190,80,40,0,0,0,310
58855,170,120,120,80,0,0,490
58856,180,140,120,80,160,0,680
58857,210,140,120,80,0,0,550
58858,170,120,40,80,0,0,410
58859,240,120,40,0,0,0,400
58860,160,40,40,80,0,0,320
58861,190,120,120,160,320,0,910
58862,180,120,120,160,160,0,740
58863,190,140,40,80,0,0,450
58864,190,120,40,0,0,0,350
58865,190,160,120,0,0,0,470
58866,210,140,160,80,160,0,750
58867,190,80,0,0,0,0,270
58868,190,80,40,80,160,0,550
58869,210,160,120,80,160,0,730
58870,180,80,80,80,160,0,580
58871,190,80,80,80,0,0,430
58872,240,180,160,160,0,0,740
58873,200,120,120,0,0,0,440
58874,190,160,80,160,160,0,750
58875,180,120,120,80,160,320,980
58876,210,160,80,80,160,0,690
58877,150,140,120,160,0,0,570
58878,190,120,160,160,160,0,790
58879,190,180,80,80,160,0,690
58880,210,100,120,160,160,0,750
58881,180,140,160,240,320,320,1360
58882,170,100,80,80,160,0,590
58883,220,120,40,80,0,0,460
58884,190,180,80,0,0,0,450
58885,210,120,80,160,320,0,890
58886,210,120,160,240,160,0,890
58887,220,120,160,160,160,320,1140
58888,210,80,0,0,0,0,290
58889,220,100,120,160,320,320,1240
58890,200,140,80,80,160,320,980
58891,190,100,160,80,160,0,690
58892,190,160,200,160,320,0,1030
58893,160,60,40,0,0,0,260
58894,190,140,120,160,160,0,770
58895,170,160,120,240,320,0,1010
58896,240,160,80,80,160,320,1040
58897,180,120,120,80,160,0,660
58898,210,60,40,80,160,320,870
58899,170,100,120,80,0,0,470
58900,220,120,160,0,0,0,500
58901,180,120,40,0,0,0,340
58902,210,100,160,240,160,0,870
58903,190,160,80,80,0,0,510
58904,190,120,120,160,0,0,590
58905,180,100,120,160,0,0,560
58906,210,140,120,80,160,0,710
58907,250,180,120,80,160,0,790
58908,170,100,0,0,0,0,270
58909,230,180,120,160,160,0,850
58910,160,80,80,160,320,0,800
58911,200,140,80,0,0,0,420
58912,200,160,120,160,160,320,1120
58913,180,140,120,80,0,0,520
58914,210,200,160,240,320,0,1130
58915,230,160,200,160,160,0,910
58916,200,120,120,160,160,0,760
58917,210,140,80,80,160,0,670
58918,200,160,80,0,0,0,440
58919,200,160,160,160,320,320,1320
58920,200,140,160,160,320,320,1300
58921,200,120,120,160,160,0,760
58922,200,120,120,160,160,0,760
58923,190,140,160,0,0,0,490
58924,200,120,160,160,160,0,800
58925,210,120,80,160,160,0,730
58926,210,100,80,80,160,0,630
58927,180,80,120,80,160,0,620
58928,220,120,80,0,0,0,420
58929,140,120,160,80,160,0,660
58930,200,160,160,160,0,0,680
58931,210,120,80,80,160,0,650
58932,200,120,80,80,160,0,640
58933,200,160,120,80,160,0,720
58934,190,140,120,160,320,0,930
58935,240,120,120,80,0,0,560
58936,230,120,40,80,160,0,630
58937,200,100,120,240,320,0,980
58938,190,140,40,80,0,0,450
58939,200,120,80,160,0,0,560
58940,190,120,120,80,160,0,670
58941,180,120,160,80,160,0,700
58942,170,80,80,0,0,0,330
58943,190,80,120,160,160,0,710
58944,210,120,120,80,0,0,530
58945,210,80,80,80,0,0,450
58946,230,160,120,80,0,0,590
58947,160,100,120,0,0,0,380
58948,170,120,120,160,320,0,890
58949,180,140,120,160,160,0,760
58950,200,80,120,240,160,0,800
58951,230,180,120,80,0,0,610
58952,200,140,160,80,160,0,740
58953,200,140,200,240,0,0,780
58954,190,100,160,160,160,0,770
58955,200,120,160,80,160,0,720
58956,190,120,120,80,160,0,670
58957,170,60,80,160,320,0,790
58958,140,100,160,80,160,0,640
58959,230,100,120,80,160,0,690
58960,190,120,80,160,320,0,870
58961,180,140,200,80,0,0,600
58962,210,120,80,80,0,0,490
58963,210,100,120,160,160,0,750
58964,170,120,40,80,160,0,570
58965,220,120,120,80,160,0,700
58966,210,180,160,160,320,0,1030
58967,190,120,80,80,160,0,630
58968,170,140,200,160,160,0,830
58969,160,160,160,160,160,0,800
58970,220,60,80,80,160,0,600
58971,190,120,160,0,0,0,470
58972,170,140,120,80,0,0,510
58973,170,80,120,80,0,0,450
58974,200,120,40,80,160,0,600
58975,200,120,80,80,160,320,960
58976,150,140,120,80,0,0,490
58977,180,160,160,0,0,0,500
58978,210,120,120,160,160,0,770
58979,220,140,0,0,0,0,360
58980,160,140,80,0,0,0,380
58981,190,100,80,80,0,0,450
58982,180,120,80,160,160,0,700
58983,210,120,40,0,0,0,370
58984,190,100,160,0,0,0,450
58985,200,160,120,80,0,0,560
58986,220,80,120,0,0,0,420
58987,230,120,160,160,160,0,830
58988,210,160,120,80,160,0,730
58989,230,160,120,80,160,0,750
58990,210,100,80,160,320,0,870
58991,210,120,120,80,160,0,690
58992,240,120,80,80,160,0,680
58993,150,120,80,80,0,0,430
58994,210,80,80,160,160,320,1010
58995,170,140,80,0,0,0,390
58996,160,120,120,80,160,0,640
58997,160,160,160,240,160,0,880
58998,230,200,160,80,160,0,830
58999,200,100,160,240,320,0,1020
59000,210,120,120,160,160,0,770
59001,180,160,120,80,0,0,540
59002,170,120,160,160,160,320,1090
59003,160,100,80,80,160,0,580
59004,200,60,80,80,160,0,580
59005,200,160,120,160,320,320,1280
59006,180,120,80,80,160,320,940
59007,230,140,40,0,0,0,410
59008,210,120,120,80,0,0,530
59009,190,100,120,160,160,0,730
59010,220,100,40,80,0,0,440
59011,220,80,40,80,160,320,900
59012,200,140,80,160,160,0,740
59013,200,140,160,160,160,0,820
59014,200,120,40,80,0,0,440
59015,200,120,120,160,160,0,760
59016,210,120,80,80,160,0,650
59017,180,60,120,80,160,0,600
59018,210,160,40,80,160,0,650
59019,170,100,160,160,160,0,750
59020,190,100,40,0,0,0,330
59021,170,120,80,80,0,0,450
59022,200,140,160,160,160,0,820
59023,200,140,120,160,160,0,780
59024,180,100,120,160,160,0,720
59025,190,120,200,160,0,0,670
59026,190,120,120,80,160,0,670
59027,200,120,120,80,160,0,680
59028,200,140,40,0,0,0,380
59029,180,100,80,80,160,320,920
59030,200,140,80,80,0,0,500
59031,220,120,120,80,160,0,700
59032,220,200,80,160,160,0,820
59033,210,80,40,80,160,0,570
59034,200,120,80,80,0,0,480
59035,200,140,200,80,160,0,780
59036,210,120,40,80,160,0,610
59037,230,120,160,160,160,320,1150
59038,230,120,80,160,160,0,750
59039,210,160,120,160,160,0,810
59040,200,80,80,0,0,0,360
59041,150,100,120,160,160,0,690
59042,190,120,160,80,160,0,710
59043,220,100,40,0,0,0,360
59044,190,140,160,160,160,320,1130
59045,180,100,80,0,0,0,360
59046,180,120,120,160,0,0,580
59047,200,100,120,160,320,0,900
59048,220,140,120,80,160,320,1040
59049,190,160,120,160,320,320,1270
59050,210,180,80,160,160,320,1110
59051,200,120,200,160,160,0,840
59052,180,100,80,80,160,0,600
59053,200,180,200,160,320,320,1380
59054,200,100,0,0,0,0,300
59055,170,80,80,80,0,0,410
59056,180,160,80,80,160,0,660
59057,230,180,120,160,320,320,1330
59058,170,80,80,0,0,0,330
59059,240,120,40,80,0,0,480
59060,210,160,160,160,320,0,1010
59061,230,160,160,160,320,0,1030
59062,200,60,40,80,160,0,540
59063,220,100,40,0,0,0,360
59064,190,100,120,0,0,0,410
59065,200,180,120,80,160,0,740
59066,170,100,120,80,0,0,470
59067,220,140,200,160,0,0,720
59068,170,40,40,0,0,0,250
59069,220,100,120,160,160,0,760
59070,190,160,160,160,0,0,670
59071,240,180,160,0,0,0,580
59072,180,120,120,80,0,0,500
59073,190,140,120,80,160,320,1010
59074,200,100,80,80,0,0,460
59075,210,120,40,80,160,0,610
59076,210,100,40,0,0,0,350
59077,210,120,80,80,160,0,650
59078,190,180,40,80,0,0,490
59079,190,100,160,160,320,320,1250
59080,230,140,120,160,160,0,810
59081,190,120,40,80,0,0,430
59082,190,140,80,80,160,0,650
59083,180,40,40,0,0,0,260
59084,180,120,80,80,160,0,620
59085,200,120,120,80,160,0,680
59086,220,140,80,80,0,0,520
59087,200,60,80,80,160,0,580
59088,190,120,160,160,160,0,790
59089,220,120,40,0,0,0,380
59090,230,120,120,80,160,0,710
59091,200,120,120,160,0,0,600
59092,190,180,200,160,160,0,890
59093,220,80,40,80,0,0,420
59094,220,100,80,80,160,0,640
59095,190,160,160,80,160,0,750
59096,150,100,120,80,160,0,610
59097,220,120,120,160,0,0,620
59098,200,120,80,80,0,0,480
59099,190,120,160,80,0,0,550
59100,210,120,120,80,0,0,530
59101,220,200,160,160,160,0,900
59102,240,100,160,160,160,0,820
59103,220,160,200,240,0,0,820
59104,180,120,120,160,320,320,1220
59105,250,100,80,160,160,0,750
59106,230,160,160,160,0,0,710
59107,200,120,80,0,0,0,400
59108,190,100,0,0,0,0,290
59109,220,160,160,240,320,0,1100
59110,230,200,80,160,0,0,670
59111,170,140,80,160,160,0,710
59112,200,160,160,160,160,320,1160
59113,160,80,40,80,0,0,360
59114,160,60,40,80,160,0,500
59115,190,100,40,80,160,0,570
59116,190,120,40,0,0,0,350
59117,220,160,120,240,160,0,900
59118,220,120,80,80,0,0,500
59119,210,120,120,160,320,0,930
59120,210,60,120,160,160,0,710
59121,230,100,40,0,0,0,370
59122,200,120,80,160,160,320,1040
59123,180,180,200,80,0,0,640
59124,160,80,80,80,0,0,400
59125,230,140,120,80,160,320,1050
59126,200,120,80,0,0,0,400
59127,170,100,120,0,0,0,390
59128,190,160,160,160,320,0,990
59129,210,100,120,160,160,0,750
59130,190,100,160,80,0,0,530
59131,190,120,120,160,320,0,910
59132,180,100,200,160,320,0,960
59133,230,140,120,160,320,320,1290
59134,220,180,160,80,0,0,640
59135,150,100,120,160,160,0,690
59136,240,140,120,80,0,0,580
59137,200,140,120,80,160,0,700
59138,180,100,80,80,0,0,440
59139,210,160,40,80,0,0,490
59140,210,120,120,160,0,0,610
59141,210,140,0,0,0,0,350
59142,190,140,160,80,160,0,730
59143,170,60,80,80,0,0,390
59144,220,120,80,160,320,0,900
59145,190,100,80,80,0,0,450
59146,220,160,120,160,320,0,980
59147,210,140,120,80,0,0,550
59148,200,100,80,80,0,0,460
59149,210,80,80,80,160,0,610
59150,220,160,120,160,160,0,820
59151,210,120,80,80,0,0,490
59152,190,140,160,240,160,0,890
59153,180,100,120,80,0,0,480
59154,190,120,40,0,0,0,350
59155,220,140,120,80,160,0,720
59156,180,60,80,80,160,0,560
59157,200,60,80,80,0,0,420
59158,210,180,120,80,160,0,750
59159,200,100,80,160,160,0,700
59160,240,140,120,160,160,0,820
59161,160,80,40,0,0,0,280
59162,200,120,40,80,160,0,600
59163,230,180,120,240,320,0,1090
59164,160,120,120,80,160,320,960
59165,180,160,80,80,160,0,660
59166,160,120,40,0,0,0,320
59167,200,140,120,160,0,0,620
59168,140,60,80,160,160,0,600
59169,170,140,160,160,320,0,950
59170,150,100,120,160,160,0,690
59171,220,120,120,160,0,0,620
59172,230,140,160,0,0,0,530
59173,150,40,40,80,160,0,470
59174,170,120,80,0,0,0,370
59175,200,100,80,0,0,0,380
59176,210,160,120,80,0,0,570
59177,170,80,80,0,0,0,330
59178,180,180,160,240,160,0,920
59179,170,120,120,160,160,320,1050
59180,150,80,40,80,0,0,350
59181,190,80,80,0,0,0,350
59182,180,100,120,80,0,0,480
59183,180,140,120,240,320,0,1000
59184,150,100,160,160,160,0,730
59185,220,100,120,160,160,0,760
59186,190,100,120,80,0,0,490
59187,190,140,80,160,0,0,570
59188,210,180,120,80,160,0,750
59189,230,140,120,240,320,320,1370
59190,180,140,160,160,0,0,640
59191,190,100,120,0,0,0,410
59192,200,100,120,160,160,0,740
59193,200,120,80,80,0,0,480
59194,180,160,120,80,160,0,700
59195,180,120,120,240,320,0,980
59196,240,140,120,160,320,320,1300
59197,210,100,120,80,0,0,510
59198,200,140,160,80,160,0,740
59199,190,140,40,0,0,0,370
59200,220,140,120,160,160,0,800
59201,160,120,160,160,0,0,600
59202,160,100,40,0,0,0,300
59203,200,80,120,80,0,0,480
59204,210,120,80,80,160,0,650
59205,180,120,120,240,160,0,820
59206,180,140,200,160,160,0,840
59207,200,100,40,0,0,0,340
59208,220,100,120,160,160,320,1080
59209,200,140,120,160,160,320,1100
59210,180,120,80,160,0,0,540
59211,180,140,120,160,0,0,600
59212,230,200,160,160,0,0,750
59213,160,140,80,80,0,0,460
59214,170,120,120,160,160,0,730
59215,180,100,40,0,0,0,320
59216,180,60,80,80,0,0,400
59217,220,80,80,0,0,0,380
59218,150,120,160,160,320,320,1230
59219,200,120,80,0,0,0,400
59220,200,140,160,80,160,0,740
59221,160,140,160,240,160,320,1180
59222,120,100,160,80,0,0,460
59223,180,120,120,80,160,0,660
59224,190,80,120,160,160,0,710
59225,220,140,160,240,160,0,920
59226,170,120,80,80,0,0,450
59227,180,140,80,160,320,320,1200
59228,170,160,40,80,0,0,450
59229,180,80,80,160,0,0,500
59230,190,100,40,0,0,0,330
59231,190,100,160,80,160,0,690
59232,190,100,80,160,160,0,690
59233,180,140,120,80,160,0,680
59234,200,100,120,240,160,0,820
59235,180,100,80,80,160,0,600
59236,180,100,80,80,160,320,920
59237,220,140,40,0,0,0,400
59238,250,160,160,160,320,320,1370
59239,240,120,80,80,160,0,680
59240,170,80,80,80,160,0,570
59241,180,80,80,80,160,0,580
59242,220,100,80,80,0,0,480
59243,190,120,40,0,0,0,350
59244,200,180,80,80,0,0,540
59245,150,80,120,80,0,0,430
59246,190,180,160,80,160,0,770
59247,190,40,80,0,0,0,310
59248,230,140,40,80,0,0,490
59249,160,160,160,0,0,0,480
59250,210,180,160,240,320,0,1110
59251,180,80,80,80,160,0,580
59252,210,120,120,160,320,0,930
59253,240,160,120,80,0,0,600
59254,190,120,80,0,0,0,390
59255,220,120,40,80,0,0,460
59256,180,100,80,160,0,0,520
59257,180,140,160,160,320,0,960
59258,220,100,120,160,0,0,600
59259,180,120,40,0,0,0,340
59260,180,80,120,80,160,0,620
59261,140,120,120,80,160,0,620
59262,200,80,40,80,160,0,560
59263,220,120,80,160,160,0,740
59264,200,160,160,160,320,320,1320
59265,170,80,40,80,160,0,530
59266,170,100,120,160,320,0,870
59267,210,80,120,160,0,0,570
59268,210,100,40,80,160,0,590
59269,180,160,80,80,160,0,660
59270,200,120,160,160,320,320,1280
59271,170,100,120,80,160,0,630
59272,160,140,120,80,160,0,660
59273,240,100,160,80,160,0,740
59274,160,80,80,80,0,0,400
59275,220,160,200,160,0,0,740
59276,250,140,80,0,0,0,470
59277,160,120,120,80,0,0,480
59278,220,120,80,0,0,0,420
59279,210,80,0,0,0,0,290
59280,210,160,160,160,320,0,1010
59281,220,140,0,0,0,0,360
59282,180,100,80,160,320,0,840
59283,210,120,120,80,0,0,530
59284,220,180,280,80,0,0,760
59285,170,120,80,80,0,0,450
59286,140,120,120,80,0,0,460
59287,200,40,80,0,0,0,320
59288,200,120,120,80,160,0,680
59289,220,160,80,160,160,0,780
59290,200,60,40,80,0,0,380
59291,200,100,40,80,160,0,580
59292,230,80,160,80,0,0,550
59293,200,120,80,160,320,0,880
59294,240,180,120,80,160,0,780
59295,200,40,80,80,160,0,560
59296,180,100,40,80,160,0,560
59297,230,120,160,80,160,320,1070
59298,170,160,80,160,160,320,1050
59299,200,120,80,160,160,0,720
59300,190,120,120,80,0,0,510
59301,160,100,160,240,160,0,820
59302,170,100,80,80,160,0,590
59303,120,80,40,80,160,0,480
59304,180,180,120,160,160,320,1120
59305,140,80,120,160,160,0,660
59306,210,100,80,80,0,0,470
59307,190,100,160,0,0,0,450
59308,170,100,80,0,0,0,350
59309,170,100,120,160,160,320,1030
59310,200,120,160,240,320,0,1040
59311,220,120,120,160,160,0,780
59312,200,160,120,80,0,0,560
59313,190,180,160,0,0,0,530
59314,190,100,80,80,160,0,610
59315,230,100,120,80,160,320,1010
59316,200,100,120,160,0,0,580
59317,240,100,40,0,0,0,380
59318,170,120,120,160,160,0,730
59319,250,160,120,80,160,0,770
59320,170,100,120,160,160,0,710
59321,190,100,80,80,160,320,930
59322,190,160,160,80,160,0,750
59323,200,160,120,240,320,0,1040
59324,210,140,160,160,0,0,670
59325,210,120,120,160,0,0,610
59326,200,100,80,0,0,0,380
59327,180,80,0,0,0,0,260
59328,170,100,0,0,0,0,270
59329,210,100,80,80,160,0,630
59330,220,180,80,80,0,0,560
59331,220,160,80,80,0,0,540
59332,230,140,40,80,160,320,970
59333,160,100,120,240,160,0,780
59334,190,100,80,0,0,0,370
59335,200,160,80,0,0,0,440
59336,220,160,200,240,160,0,980
59337,150,40,40,80,160,0,470
59338,180,120,120,80,160,0,660
59339,180,140,120,80,160,320,1000
59340,190,140,160,240,160,0,890
59341,210,120,160,240,320,320,1370
59342,170,140,120,0,0,0,430
59343,210,60,120,160,160,0,710
59344,240,140,120,160,160,0,820
59345,210,160,160,240,160,0,930
59346,200,80,160,80,0,0,520
59347,180,80,40,80,0,0,380
59348,190,100,80,80,160,0,610
59349,200,120,120,160,160,320,1080
59350,220,160,40,80,160,320,980
59351,200,160,120,80,0,0,560
59352,200,120,120,80,0,0,520
59353,210,60,40,80,160,0,550
59354,160,140,160,160,160,0,780
59355,240,160,120,80,160,0,760
59356,220,180,120,0,0,0,520
59357,180,160,120,160,0,0,620
59358,190,140,80,0,0,0,410
59359,210,140,80,160,320,0,910
59360,190,180,160,160,0,0,690
59361,220,100,120,160,160,320,1080
59362,170,220,200,80,0,0,670
59363,230,80,0,0,0,0,310
59364,220,100,40,80,160,0,600
59365,190,80,80,160,0,0,510
59366,170,140,200,240,320,0,1070
59367,170,120,40,80,160,0,570
59368,210,100,80,0,0,0,390
59369,210,80,40,0,0,0,330
59370,140,100,80,80,0,0,400
59371,170,160,120,0,0,0,450
59372,220,140,80,80,0,0,520
59373,210,100,80,80,160,0,630
59374,220,140,80,0,0,0,440
59375,190,160,200,160,160,0,870
59376,190,120,200,80,160,0,750
59377,200,160,160,80,160,0,760
59378,260,160,200,160,320,0,1100
59379,210,160,160,0,0,0,530
59380,200,120,120,240,160,0,840
59381,150,100,120,160,0,0,530
59382,190,120,120,160,160,0,750
59383,180,80,40,0,0,0,300
59384,170,160,120,160,320,0,930
59385,150,100,80,160,160,0,650
59386,200,140,120,160,0,0,620
59387,210,100,80,80,160,0,630
59388,270,160,160,240,320,0,1150
59389,200,100,80,80,160,320,940
59390,190,100,160,80,0,0,530
59391,240,140,80,80,160,0,700
59392,220,140,160,80,160,0,760
59393,170,140,120,160,0,0,590
59394,190,100,80,160,160,0,690
59395,240,100,40,80,0,0,460
59396,230,120,80,80,0,0,510
59397,170,120,120,80,0,0,490
59398,210,100,120,160,0,0,590
59399,210,60,40,0,0,0,310
59400,150,80,80,160,160,0,630
59401,210,160,200,160,160,0,890
59402,190,100,40,0,0,0,330
59403,140,100,40,0,0,0,280
59404,200,100,120,160,160,0,740
59405,170,140,120,80,0,0,510
59406,200,180,200,160,320,0,1060
59407,190,140,40,0,0,0,370
59408,200,120,160,160,160,0,800
59409,200,100,120,80,160,0,660
59410,200,100,120,160,320,0,900
59411,230,180,120,160,160,0,850
59412,170,120,120,160,0,0,570
59413,210,120,120,80,160,0,690
59414,190,120,80,0,0,0,390
59415,200,100,40,80,160,0,580
59416,210,120,120,80,0,0,530
59417,260,140,120,160,320,0,1000
59418,220,100,120,160,160,0,760
59419,190,120,120,160,0,0,590
59420,180,140,120,80,160,0,680
59421,240,120,80,160,160,0,760
59422,170,120,120,80,160,0,650
59423,240,140,200,240,160,320,1300
59424,190,180,120,80,0,0,570
59425,210,120,120,160,320,0,930
59426,180,100,80,160,160,0,680
59427,160,80,80,80,0,0,400
59428,190,180,200,80,0,0,650
59429,170,120,40,0,0,0,330
59430,200,100,80,80,0,0,460
59431,200,140,40,0,0,0,380
59432,190,100,80,80,160,0,610
59433,230,140,80,80,0,0,530
59434,190,100,160,240,320,0,1010
59435,230,80,80,160,160,0,710
59436,220,100,40,80,160,0,600
59437,180,140,160,240,320,320,1360
59438,180,140,200,80,0,0,600
59439,200,160,120,160,160,0,800
59440,180,140,120,80,160,0,680
59441,200,200,160,160,160,0,880
59442,220,160,240,240,160,0,1020
59443,200,80,40,0,0,0,320
59444,130,120,160,160,320,0,890
59445,190,140,80,80,160,0,650
59446,210,160,200,240,160,0,970
59447,210,120,160,240,320,0,1050
59448,190,140,160,240,160,0,890
59449,230,120,40,0,0,0,390
59450,200,60,80,160,160,0,660
59451,210,140,120,160,160,0,790
59452,190,100,40,80,0,0,410
59453,190,120,120,160,160,0,750
59454,250,160,200,160,0,0,770
59455,210,80,0,0,0,0,290
59456,240,120,80,80,160,0,680
59457,260,80,40,0,0,0,380
59458,130,80,120,160,0,0,490
59459,170,140,160,160,0,0,630
59460,220,160,120,80,0,0,580
59461,220,120,120,160,320,320,1260
59462,210,160,120,80,160,320,1050
59463,210,80,40,0,0,0,330
59464,170,120,120,80,160,0,650
59465,210,120,80,160,0,0,570
59466,220,160,160,240,160,0,940
59467,220,140,120,160,160,0,800
59468,220,160,120,80,160,0,740
59469,180,140,80,80,160,320,960
59470,180,80,120,160,160,0,700
59471,190,160,120,80,0,0,550
59472,230,100,120,240,320,0,1010
59473,200,140,80,0,0,0,420
59474,210,100,40,80,160,0,590
59475,180,100,80,160,0,0,520
59476,210,120,120,80,160,320,1010
59477,160,80,80,80,160,0,560
59478,170,80,120,160,320,0,850
59479,180,140,120,160,320,0,920
59480,190,160,160,80,160,0,750
59481,190,140,160,240,320,0,1050
59482,170,100,80,80,160,0,590
59483,210,100,120,160,320,320,1230
59484,190,120,160,160,160,0,790
59485,170,100,200,80,160,320,1030
59486,190,100,120,80,160,0,650
59487,210,120,120,80,0,0,530
59488,210,120,120,80,160,0,690
59489,210,200,200,80,0,0,690
59490,220,100,80,160,160,0,720
59491,240,120,120,160,320,0,960
59492,240,140,80,80,160,0,700
59493,180,160,120,240,160,0,860
59494,160,80,80,80,160,0,560
59495,230,120,80,80,160,0,670
59496,190,80,0,0,0,0,270
59497,240,120,80,0,0,0,440
59498,190,140,120,80,0,0,530
59499,170,100,200,80,160,0,710
59500,160,140,160,160,160,0,780
59501,190,80,80,80,160,0,590
59502,200,160,120,160,0,0,640
59503,240,160,120,80,160,0,760
59504,180,120,80,0,0,0,380
59505,170,120,120,160,160,0,730
59506,190,60,80,80,160,320,890
59507,180,120,120,80,0,0,500
59508,190,140,120,80,160,320,1010
59509,170,100,40,80,160,0,550
59510,240,180,120,80,160,320,1100
59511,220,140,80,160,0,0,600
59512,200,100,120,240,160,0,820
59513,160,120,80,0,0,0,360
59514,240,120,120,80,160,0,720
59515,200,140,160,240,320,0,1060
59516,170,140,120,160,160,320,1070
59517,210,140,200,80,0,0,630
59518,220,100,40,0,0,0,360
59519,170,100,120,80,160,320,950
59520,180,80,80,80,0,0,420
59521,210,140,80,80,0,0,510
59522,200,120,160,240,320,0,1040
59523,200,120,120,80,160,0,680
59524,210,100,80,0,0,0,390
59525,230,120,80,80,160,0,670
59526,200,80,80,80,160,0,600
59527,180,140,80,80,160,0,640
59528,180,140,120,80,160,0,680
59529,240,140,120,80,0,0,580
59530,200,120,160,160,0,0,640
59531,180,120,80,80,0,0,460
59532,200,100,160,160,160,0,780
59533,180,80,120,80,0,0,460
59534,190,100,0,0,0,0,290
59535,190,100,80,80,0,0,450
59536,180,120,120,160,160,0,740
59537,220,140,160,80,0,0,600
59538,210,120,160,240,320,0,1050
59539,170,140,120,80,160,0,670
59540,220,100,80,0,0,0,400
59541,240,100,80,80,0,0,500
59542,210,180,160,80,160,0,790
59543,170,180,200,80,0,0,630
59544,200,140,80,0,0,0,420
59545,170,180,240,160,0,0,750
59546,230,120,80,80,0,0,510
59547,200,100,120,160,160,0,740
59548,180,140,160,160,160,320,1120
59549,180,160,120,80,160,0,700
59550,190,120,120,0,0,0,430
59551,170,140,120,80,0,0,510
59552,180,140,120,80,0,0,520
59553,230,80,80,160,160,320,1030
59554,220,120,120,80,0,0,540
59555,200,120,80,160,160,0,720
59556,180,80,120,160,320,0,860
59557,220,120,120,240,320,0,1020
59558,200,140,120,160,160,320,1100
59559,170,80,80,80,160,0,570
59560,220,140,80,80,0,0,520
59561,180,140,80,80,0,0,480
59562,180,120,120,80,0,0,500
59563,190,60,40,0,0,0,290
59564,180,80,40,0,0,0,300
59565,200,140,80,80,0,0,500
59566,230,140,80,160,0,0,610
59567,190,100,40,0,0,0,330
59568,230,180,120,160,0,0,690
59569,220,160,160,80,0,0,620
59570,180,160,120,80,0,0,540
59571,150,120,120,80,160,0,630
59572,230,160,120,80,0,0,590
59573,190,100,80,80,160,0,610
59574,180,120,120,80,0,0,500
59575,170,160,160,160,320,0,970
59576,220,140,80,80,160,0,680
59577,200,120,40,80,160,320,920
59578,190,160,80,80,160,320,990
59579,170,140,160,80,160,0,710
59580,230,100,80,160,160,0,730
59581,190,100,40,0,0,0,330
59582,210,140,120,80,160,0,710
59583,210,120,120,80,160,0,690
59584,270,140,160,160,160,0,890
59585,210,180,80,0,0,0,470
59586,200,140,40,80,160,0,620
59587,180,120,120,80,0,0,500
59588,170,80,40,80,160,320,850
59589,180,80,40,80,160,320,860
59590,190,160,240,160,0,0,750
59591,170,120,40,0,0,0,330
59592,170,60,40,80,160,0,510
59593,210,60,80,80,0,0,430
59594,160,80,120,80,160,0,600
59595,190,160,80,80,160,320,990
59596,140,120,200,240,160,0,860
59597,170,80,80,80,0,0,410
59598,210,180,80,160,320,0,950
59599,150,160,120,80,160,0,670
59600,220,80,120,80,160,0,660
59601,180,120,80,160,0,0,540
59602,160,100,80,160,160,0,660
59603,200,60,80,160,320,320,1140
59604,210,120,120,0,0,0,450
59605,220,80,120,160,320,320,1220
59606,170,140,80,160,0,0,550
59607,190,100,80,80,160,0,610
59608,200,120,120,160,320,0,920
59609,190,100,40,80,160,0,570
59610,220,160,120,160,160,0,820
59611,230,140,160,160,160,0,850
59612,230,140,80,80,160,0,690
59613,220,140,40,0,0,0,400
59614,210,40,80,80,0,0,410
59615,220,160,40,0,0,0,420
59616,190,160,200,240,320,320,1430
59617,200,160,120,0,0,0,480
59618,200,120,120,160,320,320,1240
59619,210,140,80,80,0,0,510
59620,190,100,40,80,160,0,570
59621,220,140,120,80,0,0,560
59622,220,80,80,80,0,0,460
59623,210,120,80,160,320,320,1210
59624,200,140,120,0,0,0,460
59625,210,160,120,160,160,0,810
59626,230,140,120,0,0,0,490
59627,200,100,80,0,0,0,380
59628,170,160,160,160,0,0,650
59629,210,80,80,80,160,0,610
59630,200,160,160,160,160,0,840
59631,220,120,120,80,0,0,540
59632,200,80,160,160,160,320,1080
59633,190,140,120,80,160,320,1010
59634,230,120,80,160,160,320,1070
59635,200,100,40,0,0,0,340
59636,210,120,80,160,160,0,730
59637,190,140,240,240,160,0,970
59638,220,120,120,160,160,0,780
59639,170,120,80,160,160,0,690
59640,180,160,120,160,160,320,1100
59641,230,140,120,160,320,0,970
59642,210,120,80,0,0,0,410
59643,180,60,80,80,160,320,880
59644,180,160,160,160,320,0,980
59645,220,180,160,0,0,0,560
59646,220,180,80,0,0,0,480
59647,220,120,160,160,160,0,820
59648,230,180,200,80,0,0,690
59649,210,160,200,160,160,0,890
59650,170,160,120,160,0,0,610
59651,210,100,80,160,0,0,550
59652,180,120,120,0,0,0,420
59653,220,100,40,80,0,0,440
59654,190,140,80,80,160,320,970
59655,160,120,80,80,160,0,600
59656,180,80,120,0,0,0,380
59657,200,100,80,80,0,0,460
59658,210,140,120,160,160,320,1110
59659,220,100,120,80,160,0,680
59660,160,100,80,0,0,0,340
59661,220,140,80,0,0,0,440
59662,140,60,40,0,0,0,240
59663,190,140,120,80,0,0,530
59664,180,120,120,80,0,0,500
59665,150,100,40,0,0,0,290
59666,210,140,160,160,160,320,1150
59667,200,100,120,80,160,0,660
59668,230,160,120,160,160,0,830
59669,220,100,120,160,320,320,1240
59670,180,100,120,0,0,0,400
59671,210,120,40,80,160,0,610
59672,190,120,120,80,160,0,670
59673,220,180,120,160,160,0,840
59674,190,120,160,240,320,0,1030
59675,210,100,120,160,160,0,750
59676,220,100,120,160,320,320,1240
59677,200,140,40,0,0,0,380
59678,220,160,120,160,160,0,820
59679,160,100,40,0,0,0,300
59680,210,120,200,80,0,0,610
59681,220,160,120,80,160,0,740
59682,190,180,200,240,160,320,1290
59683,200,100,80,80,0,0,460
59684,220,100,120,80,0,0,520
59685,160,20,0,0,0,0,180
59686,230,120,120,160,320,0,950
59687,200,120,120,80,0,0,520
59688,150,60,80,160,320,320,1090
59689,210,140,160,240,320,320,1390
59690,230,140,160,80,160,320,1090
59691,190,140,160,80,0,0,570
59692,200,100,80,80,160,0,620
59693,160,100,120,80,160,0,620
59694,230,120,80,80,160,0,670
59695,160,100,120,0,0,0,380
59696,230,100,120,160,160,0,770
59697,220,80,80,80,160,0,620
59698,170,100,80,0,0,0,350
59699,230,100,120,80,160,0,690
59700,210,120,120,80,0,0,530
59701,230,120,80,160,320,0,910
59702,210,100,120,80,0,0,510
59703,200,100,80,0,0,0,380
59704,200,120,120,0,0,0,440
59705,210,160,120,80,160,0,730
59706,200,120,120,0,0,0,440
59707,220,120,120,160,160,0,780
59708,180,100,160,240,320,0,1000
59709,190,80,40,80,160,0,550
59710,190,180,40,0,0,0,410
59711,140,120,120,160,160,0,700
59712,190,100,40,80,160,0,570
59713,220,120,120,0,0,0,460
59714,240,160,80,160,320,0,960
59715,160,80,80,160,320,320,1120
59716,180,100,80,160,0,0,520
59717,210,180,120,80,160,320,1070
59718,200,140,80,80,0,0,500
59719,210,120,120,80,0,0,530
59720,190,160,80,80,160,0,670
59721,200,140,80,80,160,0,660
59722,180,160,120,80,0,0,540
59723,180,120,80,80,160,0,620
59724,200,100,120,80,160,0,660
59725,200,200,120,80,160,0,760
59726,170,80,80,0,0,0,330
59727,170,80,120,80,160,0,610
59728,130,80,120,160,320,0,810
59729,240,160,160,80,160,320,1120
59730,200,80,40,0,0,0,320
59731,190,100,80,160,160,0,690
59732,200,80,80,160,160,0,680
59733,130,60,80,80,0,0,350
59734,190,40,40,0,0,0,270
59735,210,120,120,80,0,0,530
59736,210,100,40,80,0,0,430
59737,180,60,80,80,160,0,560
59738,180,100,120,80,160,0,640
59739,230,180,160,240,160,0,970
59740,200,140,80,80,160,0,660
59741,200,180,160,80,0,0,620
59742,190,160,120,160,160,0,790
59743,210,160,120,80,160,0,730
59744,180,120,120,160,160,0,740
59745,190,100,40,0,0,0,330
59746,230,160,160,240,320,320,1430
59747,190,200,120,0,0,0,510
59748,220,140,160,160,0,0,680
59749,190,100,120,160,320,0,890
59750,170,160,40,80,0,0,450
59751,150,100,120,160,160,0,690
59752,180,120,80,80,160,0,620
59753,200,120,120,80,160,320,1000
59754,170,140,120,160,320,0,910
59755,190,120,80,80,0,0,470
59756,220,140,40,80,160,0,640
59757,210,80,80,0,0,0,370
59758,140,80,80,160,160,0,620
59759,170,80,0,0,0,0,250
59760,190,140,80,80,160,0,650
59761,160,80,40,80,160,0,520
59762,210,120,120,80,160,0,690
59763,160,100,120,0,0,0,380
59764,190,140,120,80,160,0,690
59765,180,80,0,0,0,0,260
59766,240,100,40,80,160,0,620
59767,200,180,80,80,160,0,700
59768,170,140,160,240,320,0,1030
59769,160,140,120,160,160,0,740
59770,200,120,120,160,160,0,760
59771,190,120,80,160,160,0,710
59772,230,140,120,80,160,0,730
59773,190,140,120,80,160,0,690
59774,200,120,80,160,160,0,720
59775,150,180,120,80,0,0,530
59776,190,120,120,160,160,0,750
59777,190,100,80,160,320,0,850
59778,220,120,120,80,160,0,700
59779,180,120,120,160,160,0,740
59780,170,100,200,0,0,0,470
59781,230,120,40,80,160,320,950
59782,200,160,160,80,0,0,600
59783,200,120,200,80,160,0,760
59784,210,80,80,80,160,0,610
59785,210,100,120,160,160,0,750
59786,240,80,40,80,0,0,440
59787,180,100,80,0,0,0,360
59788,150,120,80,160,160,0,670
59789,230,160,120,80,160,0,750
59790,220,140,80,0,0,0,440
59791,220,80,0,0,0,0,300
59792,170,120,120,80,0,0,490
59793,200,100,120,80,0,0,500
59794,140,80,40,80,0,0,340
59795,210,160,80,0,0,0,450
59796,210,80,40,80,160,0,570
59797,250,140,80,80,160,0,710
59798,170,80,120,160,160,0,690
59799,200,120,80,160,160,0,720
59800,200,200,160,240,160,0,960
59801,170,120,80,160,160,0,690
59802,230,180,200,160,160,0,930
59803,230,120,80,80,160,0,670
59804,210,140,160,160,320,320,1310
59805,210,120,160,80,160,0,730
59806,200,160,240,160,320,0,1080
59807,200,80,40,0,0,0,320
59808,220,140,80,80,0,0,520
59809,210,120,160,80,160,0,730
59810,220,180,120,80,160,320,1080
59811,170,140,0,0,0,0,310
59812,210,100,80,160,160,0,710
59813,220,140,160,160,320,320,1320
59814,220,100,80,160,0,0,560
59815,180,100,160,240,320,0,1000
59816,210,120,80,160,160,0,730
59817,210,120,160,160,160,0,810
59818,240,120,160,160,160,0,840
59819,180,60,120,80,160,320,920
59820,200,140,120,160,160,0,780
59821,200,100,40,80,160,0,580
59822,190,120,120,80,160,320,990
59823,200,120,160,160,160,0,800
59824,170,80,120,80,0,0,450
59825,190,120,120,80,0,0,510
59826,180,120,80,80,160,0,620
59827,190,120,120,0,0,0,430
59828,180,40,80,160,160,320,940
59829,230,80,80,160,160,0,710
59830,220,120,160,80,0,0,580
59831,210,140,120,160,160,0,790
59832,170,140,120,0,0,0,430
59833,190,120,120,80,160,0,670
59834,160,80,80,160,320,0,800
59835,200,140,40,0,0,0,380
59836,220,80,120,240,160,0,820
59837,220,180,120,160,160,0,840
59838,220,140,80,80,0,0,520
59839,200,100,40,0,0,0,340
59840,210,180,200,80,0,0,670
59841,170,100,120,160,320,0,870
59842,200,140,40,0,0,0,380
59843,180,120,80,160,160,0,700
59844,240,140,40,80,0,0,500
59845,220,140,200,240,160,320,1280
59846,170,120,120,80,160,0,650
59847,140,140,120,160,160,320,1040
59848,190,140,80,80,0,0,490
59849,170,160,160,240,160,0,890
59850,160,100,120,160,160,0,700
59851,170,120,120,80,160,0,650
59852,150,60,80,80,0,0,370
59853,180,120,200,80,160,0,740
59854,180,120,160,240,320,0,1020
59855,160,120,120,160,160,0,720
59856,200,60,40,80,0,0,380
59857,190,100,120,160,160,0,730
59858,230,100,80,80,0,0,490
59859,190,180,160,160,0,0,690
59860,200,100,40,80,160,0,580
59861,240,160,160,160,0,0,720
59862,200,140,40,0,0,0,380
59863,210,200,80,160,160,0,810
59864,210,160,80,0,0,0,450
59865,160,120,120,0,0,0,400
59866,200,120,120,80,160,0,680
59867,200,140,160,80,0,0,580
59868,180,120,160,240,160,0,860
59869,180,160,200,240,160,320,1260
59870,190,100,80,160,320,0,850
59871,210,120,120,160,0,0,610
59872,170,100,120,160,320,0,870
59873,170,100,120,80,160,0,630
59874,170,80,80,160,160,0,650
59875,180,120,80,80,160,0,620
59876,220,160,80,80,160,0,700
59877,190,100,160,240,320,320,1330
59878,200,200,200,160,160,320,1240
59879,230,100,40,80,160,320,930
59880,200,120,160,240,160,0,880
59881,200,180,120,160,0,0,660
59882,200,100,120,80,160,0,660
59883,210,100,120,80,160,0,670
59884,210,160,40,80,160,0,650
59885,240,140,80,80,160,0,700
59886,180,100,80,80,160,0,600
59887,210,80,40,80,160,0,570
59888,190,120,120,160,320,0,910
59889,200,140,200,80,0,0,620
59890,220,80,40,80,160,0,580
59891,220,180,120,160,160,0,840
59892,210,120,80,80,160,0,650
59893,160,60,40,0,0,0,260
59894,230,100,120,160,320,0,930
59895,240,140,40,80,160,320,980
59896,160,120,120,160,0,0,560
59897,210,80,120,160,160,0,730
59898,180,120,120,80,0,0,500
59899,210,140,120,80,160,0,710
59900,220,80,80,160,160,0,700
59901,200,100,120,0,0,0,420
59902,260,160,40,80,160,0,700
59903,210,100,160,160,160,0,790
59904,190,120,80,80,0,0,470
59905,210,120,80,80,160,320,970
59906,250,140,160,160,160,0,870
59907,160,160,40,0,0,0,360
59908,240,120,80,80,160,0,680
59909,160,160,120,80,160,0,680
59910,220,100,80,80,160,0,640
59911,200,100,120,80,160,0,660
59912,210,160,120,0,0,0,490
59913,220,160,120,80,0,0,580
59914,180,80,120,0,0,0,380
59915,180,60,40,80,160,320,840
59916,180,140,200,240,320,320,1400
59917,200,120,160,160,320,320,1280
59918,160,120,160,160,160,0,760
59919,280,140,80,80,0,0,580
59920,230,140,120,80,160,0,730
59921,160,100,80,0,0,0,340
59922,220,120,80,80,160,0,660
59923,190,80,80,160,160,0,670
59924,210,160,160,80,0,0,610
59925,220,160,120,0,0,0,500
59926,170,40,40,80,160,0,490
59927,190,160,120,80,0,0,550
59928,220,140,120,160,320,0,960
59929,230,160,160,0,0,0,550
59930,180,120,80,80,160,0,620
59931,160,80,120,240,320,0,920
59932,210,180,120,0,0,0,510
59933,210,120,120,160,0,0,610
59934,190,180,160,80,160,0,770
59935,190,160,80,0,0,0,430
59936,200,100,160,160,0,0,620
59937,210,160,80,80,160,0,690
59938,210,120,80,80,0,0,490
59939,180,100,200,160,0,0,640
59940,140,120,120,80,160,320,940
59941,150,100,40,0,0,0,290
59942,150,80,120,0,0,0,350
59943,230,140,200,160,160,0,890
59944,210,80,80,160,320,0,850
59945,190,100,40,80,0,0,410
59946,180,100,40,0,0,0,320
59947,210,160,120,160,160,0,810
59948,200,100,80,80,0,0,460
59949,220,120,120,80,0,0,540
59950,160,140,80,0,0,0,380
59951,200,160,80,160,0,0,600
59952,230,140,80,160,320,0,930
59953,190,120,120,80,160,0,670
59954,200,160,160,160,320,0,1000
59955,190,140,160,160,320,0,970
59956,230,180,120,160,0,0,690
59957,200,120,40,80,160,0,600
59958,180,100,80,80,160,0,600
59959,220,120,80,80,0,0,500
59960,160,140,120,160,320,0,900
59961,160,100,120,80,160,0,620
59962,190,60,40,80,160,0,530
59963,240,120,120,80,0,0,560
59964,240,140,160,80,160,0,780
59965,150,100,120,80,0,0,450
59966,260,120,80,80,0,0,540
59967,230,160,160,160,0,0,710
59968,180,80,80,80,160,0,580
59969,200,60,80,160,160,0,660
59970,240,160,120,80,160,0,760
59971,180,120,160,160,320,0,940
59972,210,100,80,0,0,0,390
59973,170,80,120,160,320,0,850
59974,220,120,80,80,160,0,660
59975,200,140,160,80,160,0,740
59976,210,100,120,160,160,0,750
59977,180,120,120,160,0,0,580
59978,240,120,160,80,160,0,760
59979,170,80,80,0,0,0,330
59980,220,140,160,80,0,0,600
59981,190,120,160,160,0,0,630
59982,190,100,40,0,0,0,330
59983,210,160,120,80,160,320,1050
59984,190,140,200,160,320,0,1010
59985,160,140,160,160,160,0,780
59986,170,80,0,0,0,0,250
59987,220,160,200,160,160,0,900
59988,180,80,80,80,0,0,420
59989,230,80,80,80,160,0,630
59990,220,120,160,240,160,0,900
59991,240,200,120,80,0,0,640
59992,180,120,120,80,160,0,660
59993,190,100,120,160,160,320,1050
59994,170,100,120,160,0,0,550
59995,140,100,80,80,0,0,400
59996,230,160,160,0,0,0,550
59997,200,140,160,240,160,0,900
59998,150,100,120,80,0,0,450
59999,200,120,160,160,320,0,960
60000,170,120,120,80,0,0,490
60001,240,100,120,80,160,0,700
60002,180,100,80,0,0,0,360
60003,190,120,80,0,0,0,390
60004,190,100,120,160,0,0,570
60005,170,100,120,160,160,0,710
60006,180,120,80,80,160,320,940
60007,180,160,80,80,160,320,980
60008,150,140,80,0,0,0,370
60009,200,200,160,0,0,0,560
60010,210,80,80,80,160,0,610
60011,230,160,200,0,0,0,590
60012,200,60,80,80,0,0,420
60013,200,120,80,80,160,0,640
60014,210,100,80,160,160,320,1030
60015,150,60,40,80,0,0,330
60016,200,120,120,80,160,0,680
60017,210,40,40,80,160,0,530
60018,190,80,80,160,160,320,990
60019,200,100,40,0,0,0,340
60020,200,160,240,240,0,0,840
60021,200,160,120,160,160,0,800
60022,190,120,80,0,0,0,390
60023,190,140,120,80,160,0,690
60024,190,100,120,80,160,0,650
60025,170,120,120,160,160,0,730
60026,210,100,80,160,320,0,870
60027,200,100,80,160,160,0,700
60028,230,80,40,80,160,0,590
60029,170,120,120,160,160,0,730
60030,220,100,120,80,160,0,680
60031,190,120,160,160,160,0,790
60032,190,120,80,160,320,320,1190
60033,180,120,160,160,160,0,780
60034,170,160,40,80,160,0,610
60035,180,100,80,160,320,0,840
60036,190,100,80,80,160,320,930
60037,190,100,160,160,160,0,770
60038,190,120,80,160,0,0,550
60039,220,200,160,80,160,0,820
60040,200,160,120,0,0,0,480
60041,210,120,40,80,160,320,930
60042,200,120,80,80,0,0,480
60043,200,120,80,80,0,0,480
60044,260,140,120,0,0,0,520
60045,190,180,160,160,320,320,1330
60046,180,120,120,160,160,0,740
60047,200,160,120,80,160,0,720
60048,170,100,120,160,160,0,710
60049,170,100,80,0,0,0,350
60050,210,120,80,0,0,0,410
60051,200,120,120,240,0,0,680
60052,220,100,120,80,160,0,680
60053,210,100,40,80,160,0,590
60054,210,120,120,160,160,0,770
60055,180,200,160,160,0,0,700
60056,200,160,160,160,160,320,1160
60057,220,120,80,80,160,320,980
60058,230,100,120,80,160,320,1010
60059,180,120,120,160,160,320,1060
60060,210,120,80,0,0,0,410
60061,210,160,120,80,0,0,570
60062,190,120,120,240,320,320,1310
60063,180,100,160,80,160,320,1000
60064,170,160,80,80,160,0,650
60065,210,160,160,240,0,0,770
60066,180,40,40,80,0,0,340
60067,200,120,80,0,0,0,400
60068,180,100,40,80,160,0,560
60069,180,120,40,80,160,0,580
60070,180,100,200,160,160,0,800
60071,210,100,40,0,0,0,350
60072,210,100,80,80,0,0,470
60073,220,180,120,0,0,0,520
60074,200,160,160,160,320,320,1320
60075,250,140,80,80,160,0,710
60076,180,100,80,0,0,0,360
60077,240,100,120,160,160,320,1100
60078,170,80,80,160,0,0,490
60079,190,100,120,80,0,0,490
60080,220,180,80,80,0,0,560
60081,160,120,160,160,160,0,760
60082,180,100,120,160,0,0,560
60083,200,80,160,80,0,0,520
60084,180,100,160,0,0,0,440
60085,220,140,160,160,160,0,840
60086,240,120,80,80,160,0,680
60087,200,120,160,160,160,320,1120
60088,180,120,40,80,160,0,580
60089,180,160,120,160,0,0,620
60090,220,120,40,80,160,0,620
60091,220,120,160,240,320,0,1060
60092,180,60,80,160,320,0,800
60093,170,100,120,160,160,0,710
60094,210,120,120,160,160,0,770
60095,210,140,40,0,0,0,390
60096,160,120,120,80,0,0,480
60097,190,120,80,0,0,0,390
60098,190,100,80,0,0,0,370
60099,240,140,120,80,160,320,1060
60100,240,120,40,80,160,0,640
60101,180,120,160,80,0,0,540
60102,200,160,80,80,160,0,680
60103,240,180,120,80,0,0,620
60104,210,100,80,80,160,0,630
60105,200,140,80,80,0,0,500
60106,190,120,120,160,320,0,910
60107,180,160,80,160,160,0,740
60108,190,140,200,240,160,0,930
60109,230,160,120,80,0,0,590
60110,170,140,40,80,160,0,590
60111,210,180,160,160,0,0,710
60112,200,140,120,80,160,0,700
60113,180,100,120,80,0,0,480
60114,180,140,120,160,320,0,920
60115,190,100,80,160,160,0,690
60116,210,100,160,160,320,0,950
60117,220,120,80,80,0,0,500
60118,180,120,80,0,0,0,380
60119,170,80,80,0,0,0,330
60120,180,120,160,80,0,0,540
60121,200,140,160,80,160,0,740
60122,170,40,40,0,0,0,250
60123,190,140,80,80,160,320,970
60124,180,160,80,160,320,320,1220
60125,220,120,40,80,0,0,460
60126,160,100,120,80,160,0,620
60127,190,160,80,160,320,320,1230
60128,160,100,160,160,320,0,900
60129,210,140,80,80,0,0,510
60130,200,120,80,0,0,0,400
60131,240,160,80,80,160,0,720
60132,220,140,80,160,160,0,760
60133,170,100,160,240,160,0,830
60134,200,160,120,160,320,0,960
60135,200,100,120,80,160,320,980
60136,180,160,160,160,160,0,820
60137,240,60,120,160,160,0,740
60138,170,80,40,0,0,0,290
60139,190,60,80,80,160,0,570
60140,200,140,40,80,160,0,620
60141,220,120,40,0,0,0,380
60142,230,160,80,0,0,0,470
60143,220,140,120,80,160,0,720
60144,190,140,120,0,0,0,450
60145,190,200,120,80,160,0,750
60146,160,100,80,80,160,0,580
60147,200,80,40,0,0,0,320
60148,200,80,40,80,160,0,560
60149,210,100,40,80,160,320,910
60150,190,60,40,80,0,0,370
60151,200,140,160,160,160,0,820
60152,180,120,120,160,160,0,740
60153,190,140,80,80,0,0,490
60154,210,200,120,80,160,0,770
60155,170,120,120,160,160,0,730
60156,160,120,120,160,160,0,720
60157,200,180,160,160,320,0,1020
60158,200,80,40,80,160,0,560
60159,190,120,40,80,0,0,430
60160,260,220,160,160,160,0,960
60161,200,120,120,80,0,0,520
60162,170,120,40,0,0,0,330
60163,220,160,120,0,0,0,500
60164,170,80,80,160,320,320,1130
60165,220,140,80,80,160,320,1000
60166,160,80,120,80,0,0,440
60167,190,140,80,80,0,0,490
60168,160,120,80,80,160,0,600
60169,200,80,120,160,160,320,1040
60170,220,120,120,160,160,0,780
60171,170,80,120,160,320,320,1170
60172,180,80,40,0,0,0,300
60173,180,80,40,80,160,0,540
60174,210,180,200,240,160,0,990
60175,200,100,80,80,160,0,620
60176,200,120,40,80,0,0,440
60177,180,100,80,0,0,0,360
60178,220,140,120,80,0,0,560
60179,220,140,120,80,160,0,720
60180,170,40,80,0,0,0,290
60181,230,80,120,160,160,0,750
60182,200,100,80,0,0,0,380
60183,180,80,160,80,160,0,660
60184,200,140,120,80,160,0,700
60185,190,120,120,160,320,320,1230
60186,170,80,120,160,160,320,1010
60187,210,200,240,160,160,0,970
60188,220,140,120,160,160,0,800
60189,190,120,120,80,160,0,670
60190,210,180,80,160,320,0,950
60191,160,120,80,80,0,0,440
60192,230,120,40,80,0,0,470
60193,190,160,160,160,160,320,1150
60194,170,80,80,80,160,320,890
60195,200,120,80,80,160,0,640
60196,190,140,80,0,0,0,410
60197,190,140,80,160,160,320,1050
60198,180,80,80,0,0,0,340
60199,230,160,80,80,160,0,710
60200,180,100,80,80,0,0,440
60201,170,140,120,160,0,0,590
60202,190,60,80,160,0,0,490
60203,240,120,160,80,160,0,760
60204,140,100,80,160,320,0,800
60205,230,120,0,0,0,0,350
60206,240,160,120,80,160,0,760
60207,200,120,120,80,0,0,520
60208,180,120,120,160,320,0,900
60209,160,120,80,0,0,0,360
60210,220,120,200,80,160,320,1100
60211,150,80,120,160,160,320,990
60212,190,80,80,80,160,0,590
60213,180,120,80,80,160,0,620
60214,200,100,120,80,160,0,660
60215,220,200,160,80,160,0,820
60216,200,120,120,80,160,320,1000
60217,170,80,80,80,0,0,410
60218,180,140,40,0,0,0,360
60219,190,120,120,160,0,0,590
60220,240,140,120,160,160,0,820
60221,210,160,80,0,0,0,450
60222,230,200,200,240,160,0,1030
60223,170,120,80,80,0,0,450
60224,160,80,120,160,320,0,840
60225,180,160,160,160,160,320,1140
60226,220,120,120,160,320,0,940
60227,160,80,80,160,320,0,800
60228,210,160,160,240,320,0,1090
60229,170,120,80,0,0,0,370
60230,190,140,160,80,0,0,570
60231,170,160,160,160,160,320,1130
60232,200,120,0,0,0,0,320
60233,230,160,80,160,160,0,790
60234,170,120,120,160,320,320,1210
60235,220,80,0,0,0,0,300
60236,170,120,120,160,160,0,730
60237,190,120,240,160,160,0,870
60238,120,80,0,0,0,0,200
60239,220,140,80,80,160,0,680
60240,210,140,120,80,160,320,1030
60241,180,80,80,160,320,0,820
60242,230,140,120,0,0,0,490
60243,180,100,40,80,160,0,560
60244,180,80,40,0,0,0,300
60245,160,80,80,0,0,0,320
60246,190,200,120,240,160,0,910
60247,170,80,40,80,160,0,530
60248,170,160,80,80,160,0,650
60249,170,100,120,160,0,0,550
60250,220,140,40,80,160,0,640
60251,190,120,40,0,0,0,350
60252,210,100,120,80,160,320,990
60253,170,120,120,160,320,320,1210
60254,150,80,40,80,160,320,830
60255,190,120,40,80,0,0,430
60256,170,120,80,80,0,0,450
60257,210,100,80,0,0,0,390
60258,220,120,80,160,160,0,740
60259,190,120,120,160,0,0,590
60260,210,60,80,160,160,320,990
60261,220,120,80,80,160,0,660
60262,210,120,80,160,160,0,730
60263,210,180,120,0,0,0,510
60264,170,100,120,160,0,0,550
60265,180,180,120,80,160,0,720
60266,180,120,160,240,160,0,860
60267,200,80,80,80,160,0,600
60268,210,160,40,80,160,0,650
60269,210,100,160,160,160,320,1110
60270,210,120,80,80,160,0,650
60271,170,120,160,80,160,0,690
60272,210,180,200,160,0,0,750
60273,170,120,80,160,160,0,690
60274,200,80,80,160,0,0,520
60275,210,160,120,80,160,0,730
60276,220,180,120,80,0,0,600
60277,190,180,160,240,320,0,1090
60278,260,140,160,80,0,0,640
60279,200,100,40,0,0,0,340
60280,230,80,120,160,160,0,750
60281,190,160,80,0,0,0,430
60282,190,100,120,80,160,0,650
60283,230,160,80,80,0,0,550
60284,160,60,80,80,160,0,540
60285,180,140,80,0,0,0,400
60286,230,140,120,80,160,0,730
60287,220,160,160,160,160,320,1180
60288,230,140,160,240,160,0,930
60289,220,180,80,80,160,0,720
60290,190,200,160,160,320,0,1030
60291,240,120,120,0,0,0,480
60292,160,120,120,240,320,320,1280
60293,180,200,160,160,160,320,1180
60294,220,100,120,80,160,320,1000
60295,230,120,120,240,160,0,870
60296,230,160,160,160,160,320,1190
60297,220,160,200,160,160,0,900
60298,220,100,120,160,160,320,1080
60299,200,60,0,0,0,0,260
60300,200,120,80,80,0,0,480
60301,170,100,40,80,160,0,550
60302,190,80,80,80,160,0,590
60303,190,80,40,80,160,0,550
60304,220,120,80,160,160,320,1060
60305,180,180,120,80,160,0,720
60306,210,140,120,80,160,0,710
60307,180,60,40,0,0,0,280
60308,180,120,120,80,160,0,660
60309,220,140,120,160,160,0,800
60310,230,140,120,80,0,0,570
60311,180,100,120,160,160,0,720
60312,230,160,160,160,160,0,870
60313,160,120,120,80,0,0,480
60314,210,120,120,0,0,0,450
60315,200,100,40,80,0,0,420
60316,200,120,120,80,160,0,680
60317,220,80,80,80,160,320,940
60318,210,120,80,160,320,320,1210
60319,200,60,120,80,160,0,620
60320,220,120,120,80,160,0,700
60321,200,140,120,80,0,0,540
60322,210,160,120,160,0,0,650
60323,170,100,80,0,0,0,350
60324,180,140,160,160,160,0,800
60325,190,120,200,160,160,0,830
60326,190,80,80,80,160,0,590
60327,200,160,80,160,160,0,760
60328,180,120,200,240,160,0,900
60329,220,140,40,0,0,0,400
60330,170,100,160,240,160,0,830
60331,180,100,160,80,0,0,520
60332,220,140,160,160,0,0,680
60333,190,120,120,80,0,0,510
60334,180,120,40,80,160,0,580
60335,210,100,120,160,160,320,1070
60336,230,140,200,160,0,0,730
60337,200,140,80,80,160,0,660
60338,220,180,160,240,320,0,1120
60339,220,120,160,80,0,0,580
60340,180,60,40,80,0,0,360
60341,210,120,160,240,320,0,1050
60342,210,120,120,80,0,0,530
60343,170,180,120,80,160,0,710
60344,230,140,40,0,0,0,410
60345,160,120,80,80,0,0,440
60346,230,140,120,160,160,0,810
60347,200,80,80,80,0,0,440
60348,210,120,80,80,160,0,650
60349,190,120,120,160,320,0,910
60350,190,120,120,160,160,0,750
60351,220,160,160,160,160,0,860
60352,200,160,120,160,0,0,640
60353,180,160,160,160,160,0,820
60354,220,120,40,0,0,0,380
60355,220,100,80,0,0,0,400
60356,220,140,80,80,160,0,680
60357,220,120,160,160,0,0,660
60358,190,140,120,0,0,0,450
60359,180,80,80,80,160,0,580
60360,230,140,160,240,160,0,930
60361,230,200,200,80,0,0,710
60362,220,80,120,160,0,0,580
60363,160,100,80,160,160,0,660
60364,230,80,40,0,0,0,350
60365,230,120,120,80,160,0,710
60366,230,140,40,80,160,0,650
60367,200,120,120,160,320,0,920
60368,210,180,120,80,160,320,1070
60369,180,60,40,80,0,0,360
60370,180,120,120,160,0,0,580
60371,200,160,200,80,160,0,800
60372,180,140,160,160,320,0,960
60373,170,200,120,160,0,0,650
60374,240,140,40,0,0,0,420
60375,200,140,160,160,160,320,1140
60376,200,160,80,80,0,0,520
60377,180,80,80,0,0,0,340
60378,240,160,120,160,0,0,680
60379,160,100,40,80,0,0,380
60380,170,120,120,80,160,0,650
60381,200,120,160,160,160,0,800
60382,200,100,80,80,0,0,460
60383,160,160,200,240,160,320,1240
60384,210,140,120,240,320,0,1030
60385,210,160,120,0,0,0,490
60386,150,120,80,80,0,0,430
60387,200,100,120,160,320,320,1220
60388,220,160,120,80,160,0,740
60389,180,80,80,80,0,0,420
60390,190,140,160,160,320,0,970
60391,190,140,120,80,160,0,690
60392,210,120,80,80,0,0,490
60393,170,80,80,80,160,0,570
60394,220,160,160,160,160,0,860
60395,190,140,120,160,160,0,770
60396,190,120,80,80,0,0,470
60397,150,120,80,160,320,0,830
60398,140,80,40,80,0,0,340
60399,150,140,40,0,0,0,330
60400,210,120,80,80,0,0,490
60401,260,180,40,0,0,0,480
60402,180,100,40,80,0,0,400
60403,190,100,120,80,0,0,490
60404,180,100,40,0,0,0,320
60405,200,80,40,0,0,0,320
60406,170,120,80,0,0,0,370
60407,150,140,120,160,160,0,730
60408,220,100,80,0,0,0,400
60409,200,120,80,80,160,0,640
60410,180,160,160,160,160,0,820
60411,220,120,160,80,160,0,740
60412,220,160,160,160,160,0,860
60413,190,100,160,240,160,0,850
60414,200,120,80,160,320,320,1200
60415,220,140,160,160,0,0,680
60416,200,120,120,80,0,0,520
60417,200,100,80,80,160,0,620
60418,180,140,80,80,160,0,640
60419,240,240,160,240,320,0,1200
60420,200,120,40,80,160,0,600
60421,230,60,40,0,0,0,330
60422,190,180,200,160,160,0,890
60423,210,100,40,80,160,320,910
60424,200,80,80,80,160,0,600
60425,210,100,40,0,0,0,350
60426,220,120,80,80,0,0,500
60427,220,180,80,80,0,0,560
60428,190,100,80,80,160,0,610
60429,210,140,40,0,0,0,390
60430,180,100,80,80,160,0,600
60431,170,120,80,160,160,0,690
60432,190,120,160,80,160,0,710
60433,210,140,120,80,160,0,710
60434,170,140,160,160,0,0,630
60435,210,80,80,160,160,0,690
60436,260,140,80,80,160,320,1040
60437,170,100,160,240,320,0,990
60438,200,160,160,80,160,0,760
60439,190,160,200,160,0,0,710
60440,200,100,120,80,160,0,660
60441,230,140,160,80,160,0,770
60442,210,100,80,0,0,0,390
60443,230,120,160,160,0,0,670
60444,140,60,40,0,0,0,240
60445,210,80,40,0,0,0,330
60446,190,120,160,80,0,0,550
60447,210,140,200,240,320,0,1110
60448,180,120,120,240,320,0,980
60449,210,180,200,160,160,0,910
60450,180,160,160,80,160,0,740
60451,190,140,160,160,0,0,650
60452,180,120,120,0,0,0,420
60453,200,160,160,80,160,0,760
60454,190,120,120,160,320,0,910
60455,210,100,80,80,0,0,470
60456,190,120,80,80,160,0,630
60457,220,100,40,0,0,0,360
60458,200,160,40,0,0,0,400
60459,230,140,160,160,0,0,690
60460,190,60,40,80,160,320,850
60461,220,120,80,0,0,0,420
60462,220,100,80,80,160,320,960
60463,200,20,0,0,0,0,220
60464,210,140,0,0,0,0,350
60465,200,120,80,80,0,0,480
60466,220,160,160,240,320,320,1420
60467,200,100,120,80,0,0,500
60468,180,140,120,80,0,0,520
60469,210,120,160,160,160,0,810
60470,210,80,120,160,320,0,890
60471,170,60,40,80,0,0,350
60472,210,100,40,0,0,0,350
60473,200,160,120,0,0,0,480
60474,230,160,200,160,0,0,750
60475,220,100,120,160,160,0,760
60476,190,120,160,160,160,320,1110
60477,170,80,0,0,0,0,250
60478,170,80,80,80,160,320,890
60479,240,160,160,160,160,0,880
60480,210,180,80,160,0,0,630
60481,170,100,120,240,320,0,950
60482,210,140,80,160,160,0,750
60483,180,100,120,160,160,320,1040
60484,180,140,200,80,0,0,600
60485,190,120,160,160,320,0,950
60486,190,120,120,0,0,0,430
60487,230,60,80,80,160,320,930
60488,190,80,40,80,160,0,550
60489,240,140,80,160,160,0,780
60490,160,100,80,80,0,0,420
60491,180,120,40,80,0,0,420
60492,190,140,80,80,0,0,490
60493,220,160,120,0,0,0,500
60494,200,140,160,80,160,0,740
60495,170,140,160,160,0,0,630
60496,190,60,0,0,0,0,250
60497,230,140,80,80,160,0,690
60498,210,60,80,80,160,320,910
60499,180,160,120,160,160,0,780
60500,170,120,80,80,0,0,450
60501,220,140,160,160,160,0,840
60502,190,80,120,0,0,0,390
60503,170,140,120,80,160,0,670
60504,190,160,240,160,160,0,910
60505,210,80,120,80,0,0,490
60506,210,200,120,80,0,0,610
60507,200,160,80,80,160,0,680
60508,200,80,120,0,0,0,400
60509,190,120,160,240,160,320,1190
60510,230,160,160,80,0,0,630
60511,200,120,120,160,160,0,760
60512,190,140,40,0,0,0,370
60513,210,180,160,160,160,0,870
60514,210,120,120,160,160,0,770
60515,230,160,120,160,320,0,990
60516,200,140,120,80,160,0,700
60517,190,140,160,240,320,320,1370
60518,200,60,40,0,0,0,300
60519,210,120,40,80,160,0,610
60520,180,160,120,240,160,0,860
60521,160,120,120,80,160,320,960
60522,190,160,120,80,160,0,710
60523,170,80,40,0,0,0,290
60524,220,160,120,80,0,0,580
60525,200,140,120,0,0,0,460
60526,190,120,120,160,160,320,1070
60527,200,120,80,80,160,0,640
60528,230,160,120,160,320,0,990
60529,160,120,120,240,320,0,960
60530,200,80,80,0,0,0,360
60531,170,100,80,80,0,0,430
60532,250,80,80,80,160,0,650
60533,150,100,40,80,0,0,370
60534,190,100,80,0,0,0,370
60535,200,160,120,80,0,0,560
60536,190,120,80,80,0,0,470
60537,170,100,80,80,160,0,590
60538,190,100,120,80,160,320,970
60539,180,140,160,160,160,0,800
60540,240,140,120,80,160,0,740
60541,140,140,80,0,0,0,360
60542,220,160,80,160,160,0,780
60543,180,80,160,80,0,0,500
60544,180,120,80,80,160,0,620
60545,200,120,80,80,0,0,480
60546,200,140,40,0,0,0,380
60547,180,100,120,80,160,0,640
60548,200,60,40,80,160,320,860
60549,210,120,120,160,320,0,930
60550,210,120,120,160,320,0,930
60551,220,180,80,160,0,0,640
60552,190,80,120,160,160,0,710
60553,200,100,120,160,160,0,740
60554,190,120,120,160,320,0,910
60555,180,120,160,80,160,0,700
60556,190,120,160,160,160,0,790
60557,200,160,80,160,160,0,760
60558,220,120,120,0,0,0,460
60559,180,60,80,160,160,320,960
60560,190,100,120,80,0,0,490
60561,190,180,160,80,160,0,770
60562,200,160,120,0,0,0,480
60563,210,120,120,160,160,0,770
60564,220,120,80,80,160,0,660
60565,180,100,120,160,320,0,880
60566,210,180,200,160,160,0,910
60567,160,100,80,80,160,0,580
60568,220,120,80,160,160,320,1060
60569,190,120,120,80,160,0,670
60570,190,140,160,160,160,320,1130
60571,210,160,160,80,0,0,610
60572,160,100,120,160,320,320,1180
60573,200,100,80,80,160,0,620
60574,160,120,80,80,160,320,920
60575,190,140,200,160,0,0,690
60576,210,120,120,160,160,0,770
60577,190,100,120,160,160,0,730
60578,210,180,200,80,160,0,830
60579,180,40,40,80,0,0,340
60580,200,100,160,160,0,0,620
60581,160,40,40,80,0,0,320
60582,200,120,120,80,160,0,680
60583,210,180,40,0,0,0,430
60584,210,80,80,80,0,0,450
60585,200,120,120,80,0,0,520
60586,210,160,160,160,0,0,690
60587,230,120,80,80,0,0,510
60588,220,80,40,80,160,0,580
60589,160,140,40,0,0,0,340
60590,190,160,120,80,160,0,710
60591,200,80,120,160,160,0,720
60592,180,160,160,160,160,0,820
60593,200,180,120,80,0,0,580
60594,220,120,120,80,160,0,700
60595,200,160,160,160,0,0,680
60596,200,100,40,0,0,0,340
60597,220,120,160,160,0,0,660
60598,210,80,120,160,160,0,730
60599,180,140,80,160,320,320,1200
60600,220,140,120,160,160,320,1120
60601,220,100,120,0,0,0,440
60602,170,80,80,80,160,320,890
60603,220,180,80,80,160,0,720
60604,170,180,160,80,160,0,750
60605,200,160,120,80,160,0,720
60606,210,120,120,160,160,320,1090
60607,210,100,80,80,160,0,630
60608,210,160,160,160,160,0,850
60609,170,100,80,0,0,0,350
60610,200,140,80,80,160,0,660
60611,180,80,40,0,0,0,300
60612,160,100,80,160,0,0,500
60613,210,160,160,80,0,0,610
60614,200,160,160,80,0,0,600
60615,190,140,160,160,160,0,810
60616,200,100,40,0,0,0,340
60617,190,120,40,80,160,0,590
60618,200,120,120,80,0,0,520
60619,200,120,120,80,160,0,680
60620,200,100,80,80,160,0,620
60621,230,140,80,160,160,0,770
60622,190,140,200,160,160,0,850
60623,200,100,120,160,160,0,740
60624,220,180,120,80,160,0,760
60625,190,80,0,0,0,0,270
60626,200,100,80,0,0,0,380
60627,160,80,80,80,160,0,560
60628,180,140,120,80,0,0,520
60629,180,60,0,0,0,0,240
60630,180,120,80,80,0,0,460
60631,200,180,120,160,0,0,660
60632,190,200,160,160,160,320,1190
60633,210,120,80,80,0,0,490
60634,160,20,40,80,160,0,460
60635,240,140,80,80,160,320,1020
60636,230,100,40,80,160,0,610
60637,220,100,160,80,160,0,720
60638,200,180,120,80,160,320,1060
60639,200,120,160,80,160,0,720
60640,200,140,80,0,0,0,420
60641,190,120,80,160,160,320,1030
60642,190,120,160,160,160,0,790
60643,160,80,40,80,160,0,520
60644,220,200,160,160,0,0,740
60645,160,100,160,160,320,320,1220
60646,190,100,40,80,160,0,570
60647,200,180,160,240,320,0,1100
60648,150,160,120,160,160,320,1070
60649,180,160,80,80,0,0,500
60650,180,160,120,160,160,0,780
60651,200,140,160,80,160,0,740
60652,220,140,40,80,160,0,640
60653,190,100,120,0,0,0,410
60654,180,140,200,160,0,0,680
60655,200,120,80,80,0,0,480
60656,160,60,40,0,0,0,260
60657,150,100,160,80,160,320,970
60658,200,140,120,80,160,0,700
60659,160,140,80,160,160,0,700
60660,220,140,160,160,160,0,840
60661,190,60,80,80,160,0,570
60662,230,120,120,80,160,0,710
60663,210,120,120,240,320,320,1330
60664,200,40,80,80,160,0,560
60665,190,140,120,80,160,0,690
60666,170,80,80,160,160,0,650
60667,200,100,120,160,0,0,580
60668,170,60,80,160,0,0,470
60669,170,100,80,80,160,0,590
60670,160,100,160,80,0,0,500
60671,180,120,80,80,160,0,620
60672,170,80,120,80,0,0,450
60673,170,120,80,80,0,0,450
60674,200,80,80,80,0,0,440
60675,190,60,80,80,0,0,410
60676,160,120,160,160,0,0,600
60677,220,140,200,160,320,0,1040
60678,220,120,200,240,320,320,1420
60679,200,120,120,80,0,0,520
60680,180,100,80,80,160,0,600
60681,180,140,120,160,320,0,920
60682,180,100,120,80,160,0,640
60683,240,200,240,240,160,0,1080
60684,190,140,80,0,0,0,410
60685,160,100,80,80,160,0,580
60686,220,180,80,0,0,0,480
60687,210,120,160,240,160,320,1210
60688,220,120,120,160,320,0,940
60689,130,100,160,80,160,0,630
60690,230,140,160,0,0,0,530
60691,160,40,40,80,160,0,480
60692,160,60,40,80,160,0,500
60693,180,140,80,80,160,320,960
60694,150,100,120,80,0,0,450
60695,180,100,40,80,0,0,400
60696,190,120,80,0,0,0,390
60697,150,100,80,80,0,0,410
60698,200,160,120,160,160,0,800
60699,210,80,80,160,160,0,690
60700,230,160,80,80,0,0,550
60701,210,140,80,80,160,0,670
60702,190,140,200,240,0,0,770
60703,200,100,80,80,0,0,460
60704,220,100,160,80,160,0,720
60705,220,100,0,0,0,0,320
60706,210,120,200,80,160,0,770
60707,210,140,120,80,160,0,710
60708,210,140,160,160,160,320,1150
60709,200,160,160,160,160,0,840
60710,200,140,40,0,0,0,380
60711,190,140,120,160,0,0,610
60712,210,120,80,80,160,0,650
60713,230,100,120,240,0,0,690
60714,190,160,160,80,0,0,590
60715,200,160,80,160,160,0,760
60716,230,120,160,240,160,0,910
60717,190,140,120,80,160,0,690
60718,190,120,80,0,0,0,390
60719,200,180,120,240,320,320,1380
60720,220,140,120,0,0,0,480
60721,180,140,80,160,160,320,1040
60722,210,60,80,160,320,0,830
60723,170,100,120,80,160,320,950
60724,190,120,120,80,0,0,510
60725,210,140,160,160,160,320,1150
60726,160,120,120,160,0,0,560
60727,210,80,80,80,160,0,610
60728,230,120,40,0,0,0,390
60729,180,80,80,80,160,0,580
60730,170,80,40,0,0,0,290
60731,190,160,80,80,0,0,510
60732,200,100,80,80,160,0,620
60733,240,220,120,80,160,0,820
60734,220,120,80,0,0,0,420
60735,190,60,40,80,160,0,530
60736,200,100,80,80,160,320,940
60737,170,100,120,240,320,320,1270
60738,160,100,160,160,0,0,580
60739,230,140,80,80,160,320,1010
60740,190,100,0,0,0,0,290
60741,160,100,80,80,160,0,580
60742,220,100,120,160,160,0,760
60743,180,120,120,80,160,0,660
60744,190,80,80,0,0,0,350
60745,220,120,80,0,0,0,420
60746,200,120,200,160,320,0,1000
60747,230,100,80,160,160,0,730
60748,190,100,40,0,0,0,330
60749,170,160,120,160,160,320,1090
60750,210,140,0,0,0,0,350
60751,210,140,120,160,320,320,1270
60752,200,160,80,80,0,0,520
60753,150,120,80,0,0,0,350
60754,170,80,80,80,0,0,410
60755,190,80,120,80,0,0,470
60756,210,120,120,160,160,320,1090
60757,210,160,120,160,320,0,970
60758,210,140,80,0,0,0,430
60759,210,120,80,0,0,0,410
60760,220,120,40,0,0,0,380
60761,170,100,80,80,0,0,430
60762,210,140,160,160,160,0,830
60763,200,100,120,80,0,0,500
60764,180,180,80,80,160,0,680
60765,170,160,160,160,320,0,970
60766,190,80,40,80,0,0,390
60767,230,120,80,0,0,0,430
60768,210,80,80,160,320,0,850
60769,220,120,80,160,160,0,740
60770,200,100,80,80,160,0,620
60771,200,140,120,80,160,0,700
60772,210,60,40,80,0,0,390
60773,210,140,40,0,0,0,390
60774,190,120,80,160,160,320,1030
60775,140,100,120,80,160,320,920
60776,210,200,160,240,160,0,970
60777,190,140,200,80,0,0,610
60778,200,140,160,160,320,0,980
60779,200,160,120,160,320,0,960
60780,180,120,160,0,0,0,460
60781,150,120,160,160,160,320,1070
60782,200,120,160,240,320,0,1040
60783,230,160,120,160,160,0,830
60784,190,120,120,160,320,320,1230
60785,200,80,160,240,320,0,1000
60786,230,200,160,160,0,0,750
60787,200,180,80,80,0,0,540
60788,200,120,80,160,160,320,1040
60789,190,160,80,80,0,0,510
60790,220,80,40,80,160,320,900
60791,220,120,80,80,0,0,500
60792,170,120,160,80,160,320,1010
60793,170,100,80,0,0,0,350
60794,230,120,120,160,320,320,1270
60795,160,60,40,80,160,0,500
60796,210,120,120,160,160,0,770
60797,190,180,80,80,160,0,690
60798,190,140,120,0,0,0,450
60799,180,120,80,0,0,0,380
60800,190,80,120,160,0,0,550
60801,190,80,80,80,0,0,430
60802,200,160,160,160,320,0,1000
60803,180,100,80,80,160,320,920
60804,170,140,200,240,160,0,910
60805,190,140,40,80,160,0,610
60806,170,140,160,160,160,320,1110
60807,220,140,120,80,0,0,560
60808,200,100,40,0,0,0,340
60809,230,60,40,0,0,0,330
60810,180,80,120,160,160,0,700
60811,200,100,80,80,0,0,460
60812,220,120,40,80,0,0,460
60813,170,60,120,80,0,0,430
60814,220,120,80,80,0,0,500
60815,190,80,80,80,160,320,910
60816,140,60,0,0,0,0,200
60817,150,60,80,160,160,320,930
60818,200,120,80,80,160,320,960
60819,200,140,160,240,160,320,1220
60820,200,140,120,160,160,0,780
60821,180,120,160,160,0,0,620
60822,190,100,80,0,0,0,370
60823,220,160,40,80,160,0,660
60824,210,100,80,80,0,0,470
60825,170,120,80,80,160,320,930
60826,190,140,40,0,0,0,370
60827,200,120,120,80,0,0,520
60828,170,60,80,0,0,0,310
60829,190,120,200,320,320,0,1150
60830,170,140,200,240,160,0,910
60831,190,140,160,160,160,0,810
60832,180,100,80,80,160,0,600
60833,200,60,40,80,160,0,540
60834,230,160,40,0,0,0,430
60835,190,120,160,240,160,320,1190
60836,200,120,80,160,160,0,720
60837,190,140,120,80,0,0,530
60838,170,120,40,80,0,0,410
60839,170,120,120,240,160,0,810
60840,240,140,120,0,0,0,500
60841,180,160,160,80,0,0,580
60842,160,140,80,0,0,0,380
60843,240,160,160,0,0,0,560
60844,180,100,80,0,0,0,360
60845,200,100,120,240,0,0,660
60846,190,160,160,80,160,320,1070
60847,210,140,80,80,160,0,670
60848,210,80,120,160,320,0,890
60849,190,60,80,80,0,0,410
60850,200,100,80,160,160,320,1020
60851,230,160,120,160,160,0,830
60852,180,80,40,0,0,0,300
60853,230,120,80,80,160,0,670
60854,190,140,80,160,160,0,730
60855,240,140,80,80,0,0,540
60856,200,160,40,0,0,0,400
60857,210,100,40,0,0,0,350
60858,230,160,120,160,160,0,830
60859,190,140,80,80,160,0,650
60860,180,100,80,80,160,0,600
60861,200,180,120,160,160,320,1140
60862,210,160,160,80,160,0,770
60863,170,100,120,160,160,0,710
60864,220,140,120,160,320,0,960
60865,210,180,160,80,160,0,790
60866,210,80,40,80,160,0,570
60867,170,80,120,80,160,0,610
60868,170,180,80,160,160,0,750
60869,220,140,80,80,160,0,680
60870,160,80,80,80,160,0,560
60871,190,100,80,80,0,0,450
60872,210,100,80,160,0,0,550
60873,230,140,160,160,320,0,1010
60874,220,180,200,0,0,0,600
60875,210,140,160,80,160,0,750
60876,190,20,0,0,0,0,210
60877,170,120,40,80,160,320,890
60878,160,120,120,160,160,0,720
60879,210,120,120,80,0,0,530
60880,190,140,160,160,160,0,810
60881,190,60,120,160,160,0,690
60882,180,140,160,80,0,0,560
60883,200,140,40,80,0,0,460
60884,180,100,80,80,160,0,600
60885,200,140,120,80,160,0,700
60886,200,60,40,80,0,0,380
60887,220,140,120,160,320,320,1280
60888,190,60,40,80,0,0,370
60889,210,160,160,160,160,0,850
60890,200,120,80,80,160,0,640
60891,200,100,120,80,160,0,660
60892,170,140,160,240,320,320,1350
60893,220,120,80,0,0,0,420
60894,200,120,80,80,160,0,640
60895,200,120,80,80,160,0,640
60896,210,140,120,80,160,0,710
60897,190,120,40,80,160,0,590
60898,190,180,80,160,160,0,770
60899,130,80,120,80,0,0,410
60900,240,120,80,80,0,0,520
60901,190,100,0,0,0,0,290
60902,180,140,160,80,160,0,720
60903,180,140,120,80,0,0,520
60904,170,60,80,80,160,0,550
60905,190,140,40,0,0,0,370
60906,170,140,80,160,0,0,550
60907,210,80,80,80,160,0,610
60908,170,100,80,80,160,320,910
60909,170,100,40,0,0,0,310
60910,180,120,160,160,320,320,1260
60911,230,200,120,80,0,0,630
60912,200,100,40,80,160,0,580
60913,180,120,80,160,320,320,1180
60914,240,140,80,80,0,0,540
60915,160,140,80,80,160,0,620
60916,170,160,160,80,0,0,570
60917,190,140,120,160,160,0,770
60918,140,160,160,160,0,0,620
60919,210,120,160,80,160,0,730
60920,170,120,120,0,0,0,410
60921,190,80,40,0,0,0,310
60922,230,120,80,80,160,0,670
60923,200,100,80,80,160,0,620
60924,180,100,120,80,160,0,640
60925,210,120,40,80,160,0,610
60926,220,160,120,160,320,0,980
60927,210,140,160,160,160,0,830
60928,170,120,120,80,0,0,490
60929,190,180,80,80,0,0,530
60930,180,160,160,160,320,0,980
60931,190,100,120,160,160,320,1050
60932,160,100,80,80,160,320,900
60933,200,120,120,160,320,320,1240
60934,200,140,80,80,160,0,660
60935,180,80,40,0,0,0,300
60936,210,140,120,80,160,0,710
60937,220,120,80,0,0,0,420
60938,230,180,200,160,320,320,1410
60939,180,140,40,0,0,0,360
60940,200,60,40,0,0,0,300
60941,160,160,120,160,160,0,760
60942,200,140,80,80,160,0,660
60943,220,120,120,80,0,0,540
60944,210,200,120,80,160,0,770
60945,170,140,120,160,0,0,590
60946,250,180,80,80,160,0,750
60947,190,120,160,80,160,0,710
60948,200,120,80,0,0,0,400
60949,230,120,160,160,160,0,830
60950,180,140,80,80,160,0,640
60951,170,60,40,80,0,0,350
60952,190,120,160,240,160,0,870
60953,180,80,80,160,160,0,660
60954,210,80,80,160,160,0,690
60955,200,160,120,80,160,0,720
60956,190,160,80,80,160,0,670
60957,210,120,80,80,0,0,490
60958,220,80,80,80,160,0,620
60959,190,120,120,160,0,0,590
60960,160,120,40,0,0,0,320
60961,220,80,80,80,0,0,460
60962,210,140,160,160,160,0,830
60963,180,120,80,0,0,0,380
60964,170,80,80,80,160,0,570
60965,190,60,80,80,160,0,570
60966,190,60,40,80,160,0,530
60967,210,100,80,80,160,0,630
60968,180,120,120,80,160,320,980
60969,170,120,80,160,160,320,1010
60970,190,180,120,160,160,0,810
60971,210,120,120,80,160,0,690
60972,180,80,40,80,0,0,380
60973,210,100,120,80,0,0,510
60974,270,100,0,0,0,0,370
60975,180,160,240,160,160,0,900
60976,200,140,120,240,0,0,700
60977,160,80,120,160,320,0,840
60978,180,200,200,80,160,0,820
60979,190,120,120,80,0,0,510
60980,170,160,120,240,160,0,850
60981,200,140,120,0,0,0,460
60982,250,180,120,160,0,0,710
60983,210,160,160,80,160,320,1090
60984,190,120,120,160,0,0,590
60985,220,120,80,80,0,0,500
60986,190,100,200,160,160,0,810
60987,190,160,120,160,160,0,790
60988,200,160,120,160,160,0,800
60989,180,100,120,240,0,0,640
60990,200,60,120,160,320,0,860
60991,190,160,80,80,160,0,670
60992,190,100,120,240,160,320,1130
60993,190,140,80,80,0,0,490
60994,160,80,120,80,0,0,440
60995,170,100,80,160,320,320,1150
60996,210,140,200,240,160,0,950
60997,210,140,80,80,160,0,670
60998,190,140,120,80,160,0,690
60999,270,220,200,160,160,320,1330
61000,180,120,120,160,320,320,1220
61001,240,140,80,160,0,0,620
61002,210,140,80,80,0,0,510
61003,190,140,160,240,160,320,1210
61004,210,160,120,160,0,0,650
61005,190,60,120,80,160,0,610
61006,190,120,80,0,0,0,390
61007,190,180,200,80,160,0,810
61008,210,140,160,160,320,0,990
61009,200,140,160,160,0,0,660
61010,170,140,120,160,160,320,1070
61011,170,80,40,0,0,0,290
61012,210,180,120,240,160,0,910
61013,150,100,120,80,0,0,450
61014,250,140,120,160,0,0,670
61015,230,160,160,80,0,0,630
61016,180,140,80,0,0,0,400
61017,190,100,80,80,0,0,450
61018,170,80,80,80,0,0,410
61019,220,60,40,0,0,0,320
61020,200,80,80,80,160,0,600
61021,170,160,120,80,160,320,1010
61022,210,140,40,80,160,0,630
61023,190,140,80,80,0,0,490
61024,160,120,40,80,0,0,400
61025,200,120,80,80,0,0,480
61026,200,160,160,80,0,0,600
61027,170,100,40,0,0,0,310
61028,220,160,120,240,160,0,900
61029,200,160,160,80,160,0,760
61030,220,140,40,0,0,0,400
61031,170,100,80,80,0,0,430
61032,210,120,160,160,160,0,810
61033,200,100,120,240,160,320,1140
61034,200,120,80,80,0,0,480
61035,200,100,80,0,0,0,380
61036,190,120,80,80,160,0,630
61037,170,100,160,80,160,0,670
61038,220,180,80,80,160,0,720
61039,210,120,80,0,0,0,410
61040,210,160,120,160,0,0,650
61041,250,120,120,80,160,0,730
61042,200,80,120,0,0,0,400
61043,220,160,80,80,160,0,700
61044,150,160,120,160,160,320,1070
61045,190,40,80,80,160,0,550
61046,200,100,40,0,0,0,340
61047,200,140,120,160,320,320,1260
61048,190,160,80,80,160,0,670
61049,220,100,40,80,0,0,440
61050,200,140,160,80,160,0,740
61051,140,80,80,80,160,0,540
61052,170,80,120,160,320,0,850
61053,190,140,120,80,160,320,1010
61054,230,80,40,0,0,0,350
61055,190,100,120,80,160,0,650
61056,170,120,80,80,160,320,930
61057,170,80,80,80,0,0,410
61058,140,120,80,80,0,0,420
61059,210,180,200,160,160,0,910
61060,210,100,120,240,320,320,1310
61061,180,160,80,80,160,0,660
61062,220,80,0,0,0,0,300
61063,220,140,120,0,0,0,480
61064,180,40,40,0,0,0,260
61065,200,140,160,160,160,0,820
61066,170,100,120,160,0,0,550
61067,210,180,120,160,160,0,830
61068,190,140,80,80,160,0,650
61069,160,100,120,160,320,0,860
61070,150,120,200,160,160,0,790
61071,170,120,120,80,0,0,490
61072,140,140,160,160,0,0,600
61073,180,160,160,160,160,0,820
61074,190,160,200,160,160,0,870
61075,190,200,120,80,0,0,590
61076,190,140,120,80,160,0,690
61077,170,80,80,160,320,0,810
61078,180,120,120,0,0,0,420
61079,170,140,120,80,0,0,510
61080,200,180,120,80,0,0,580
61081,150,140,120,160,160,0,730
61082,210,120,80,160,320,0,890
61083,200,100,120,160,320,320,1220
61084,230,140,120,160,0,0,650
61085,190,100,40,0,0,0,330
61086,190,100,40,0,0,0,330
61087,190,140,80,80,160,0,650
61088,210,100,40,0,0,0,350
61089,170,120,80,160,160,320,1010
61090,180,120,40,0,0,0,340
61091,200,120,120,160,160,0,760
61092,190,120,40,80,0,0,430
61093,140,100,80,80,160,0,560
61094,150,80,120,0,0,0,350
61095,200,100,160,240,0,0,700
61096,190,160,160,160,320,320,1310
61097,210,80,120,80,0,0,490
61098,180,100,120,80,0,0,480
61099,190,140,40,0,0,0,370
61100,200,140,120,160,160,0,780
61101,220,160,80,0,0,0,460
61102,170,80,40,80,160,0,530
61103,190,120,80,80,160,320,950
61104,200,140,0,0,0,0,340
61105,160,120,40,0,0,0,320
61106,200,180,120,80,160,0,740
61107,160,120,120,80,160,0,640
61108,200,60,120,80,0,0,460
61109,200,120,80,0,0,0,400
61110,220,160,160,0,0,0,540
61111,200,160,40,80,0,0,480
61112,160,100,160,80,0,0,500
61113,180,200,80,160,320,320,1260
61114,180,100,160,80,0,0,520
61115,220,180,120,80,0,0,600
61116,180,120,160,0,0,0,460
61117,230,120,160,80,160,0,750
61118,150,80,40,0,0,0,270
61119,200,80,80,160,160,0,680
61120,180,120,80,80,0,0,460
61121,180,160,160,160,320,320,1300
61122,210,180,200,160,0,0,750
61123,210,140,40,80,0,0,470
61124,190,120,80,80,160,0,630
61125,190,140,160,0,0,0,490
61126,200,60,0,0,0,0,260
61127,190,120,120,160,160,320,1070
61128,200,160,160,160,0,0,680
61129,190,120,120,80,160,0,670
61130,140,140,160,160,320,0,920
61131,180,160,80,80,160,0,660
61132,190,120,80,80,160,0,630
61133,200,100,120,160,160,0,740
61134,190,60,80,80,160,0,570
61135,210,80,80,160,320,320,1170
61136,210,160,200,160,160,0,890
61137,220,100,80,0,0,0,400
61138,200,160,160,160,320,320,1320
61139,170,120,40,0,0,0,330
61140,210,140,160,160,160,320,1150
61141,210,120,120,80,0,0,530
61142,200,80,40,0,0,0,320
61143,140,100,80,80,160,0,560
61144,190,80,40,80,160,0,550
61145,190,200,200,160,0,0,750
61146,180,100,40,0,0,0,320
61147,250,140,160,80,160,0,790
61148,190,120,80,0,0,0,390
61149,200,120,80,0,0,0,400
61150,210,140,80,0,0,0,430
61151,230,160,240,160,160,0,950
61152,190,100,80,80,160,0,610
61153,150,100,120,160,160,0,690
61154,180,140,200,240,160,0,920
61155,190,160,120,80,0,0,550
61156,150,100,120,80,160,320,930
61157,200,100,40,80,160,0,580
61158,240,160,160,80,160,320,1120
61159,210,140,80,80,160,0,670
61160,220,120,160,80,0,0,580
61161,160,100,160,240,160,0,820
61162,220,140,120,80,160,0,720
61163,190,140,120,80,0,0,530
61164,230,140,40,0,0,0,410
61165,180,120,160,80,160,0,700
61166,180,120,40,0,0,0,340
61167,230,160,80,80,0,0,550
61168,210,100,120,160,160,0,750
61169,220,160,120,80,0,0,580
61170,180,80,80,80,160,0,580
61171,220,140,120,160,160,0,800
61172,170,140,80,160,160,0,710
61173,190,140,160,80,160,0,730
61174,210,140,160,240,0,0,750
61175,210,120,80,80,160,0,650
61176,230,140,80,80,0,0,530
61177,200,140,80,0,0,0,420
61178,200,160,120,160,320,0,960
61179,210,80,120,160,160,320,1050
61180,140,120,160,160,160,0,740
61181,160,120,120,160,160,0,720
61182,200,100,120,80,0,0,500
61183,240,140,40,80,160,0,660
61184,230,140,80,80,160,0,690
61185,200,120,160,240,160,0,880
61186,190,100,120,160,160,0,730
61187,170,120,0,0,0,0,290
61188,170,120,80,80,0,0,450
61189,190,140,80,160,160,0,730
61190,180,20,40,80,0,0,320
61191,190,120,160,80,160,0,710
61192,210,100,160,80,160,0,710
61193,200,140,80,80,0,0,500
61194,190,140,120,80,160,0,690
61195,250,200,160,160,0,0,770
61196,210,140,80,0,0,0,430
61197,200,160,120,0,0,0,480
61198,230,120,80,80,160,0,670
61199,210,120,160,80,0,0,570
61200,200,120,120,80,160,0,680
61201,170,160,80,160,160,0,730
61202,200,120,40,0,0,0,360
61203,200,60,40,0,0,0,300
61204,250,140,80,80,160,0,710
61205,200,120,160,0,0,0,480
61206,150,120,120,160,0,0,550
61207,230,160,200,80,0,0,670
61208,150,120,120,160,160,0,710
61209,210,140,160,160,160,0,830
61210,210,140,120,80,160,320,1030
61211,230,180,200,80,160,0,850
61212,170,80,40,80,160,0,530
61213,200,100,160,240,320,320,1340
61214,190,160,160,240,160,0,910
61215,200,120,160,160,320,0,960
61216,170,140,160,240,160,0,870
61217,190,100,80,80,0,0,450
61218,160,120,120,160,0,0,560
61219,220,100,80,160,160,320,1040
61220,250,60,0,0,0,0,310
61221,210,100,80,0,0,0,390
61222,160,160,40,80,0,0,440
61223,200,100,80,0,0,0,380
61224,210,180,120,160,0,0,670
61225,190,100,40,80,160,0,570
61226,180,140,160,240,160,0,880
61227,250,160,160,0,0,0,570
61228,190,160,120,160,160,0,790
61229,190,120,40,80,0,0,430
61230,200,120,120,0,0,0,440
61231,240,160,80,80,160,0,720
61232,210,120,80,0,0,0,410
61233,210,80,80,80,0,0,450
61234,210,120,80,160,320,0,890
61235,220,120,40,0,0,0,380
61236,210,80,40,0,0,0,330
61237,190,120,40,0,0,0,350
61238,180,100,120,240,320,0,960
61239,210,60,120,80,0,0,470
61240,140,120,200,160,160,320,1100
61241,180,60,80,80,160,0,560
61242,200,140,120,80,160,0,700
61243,200,120,40,0,0,0,360
61244,200,120,40,0,0,0,360
61245,220,140,160,240,320,320,1400
61246,190,120,120,80,160,0,670
61247,200,140,120,80,160,320,1020
61248,180,60,80,80,0,0,400
61249,170,120,80,80,160,0,610
61250,160,80,120,80,160,0,600
61251,140,100,120,160,0,0,520
61252,170,120,80,80,0,0,450
61253,200,120,120,240,160,0,840
61254,170,60,80,160,160,0,630
61255,220,200,120,80,0,0,620
61256,220,160,120,240,160,0,900
61257,190,160,120,160,0,0,630
61258,220,100,120,80,160,0,680
61259,210,100,40,0,0,0,350
61260,210,120,120,160,160,0,770
61261,170,80,80,160,160,0,650
61262,190,80,160,80,0,0,510
61263,260,140,80,80,160,0,720
61264,210,160,160,0,0,0,530
61265,210,100,40,0,0,0,350
61266,180,100,120,0,0,0,400
61267,150,160,160,160,0,0,630
61268,170,180,120,80,160,0,710
61269,200,100,0,0,0,0,300
61270,210,140,200,80,160,320,1110
61271,240,160,200,80,160,320,1160
61272,190,160,160,240,160,0,910
61273,220,180,0,0,0,0,400
61274,170,140,120,80,0,0,510
61275,190,80,40,80,0,0,390
61276,220,80,80,80,160,0,620
61277,200,120,80,160,160,0,720
61278,190,80,40,0,0,0,310
61279,200,100,80,80,160,0,620
61280,190,100,40,80,0,0,410
61281,200,80,120,160,160,0,720
61282,210,140,120,80,0,0,550
61283,200,120,80,80,0,0,480
61284,240,180,160,80,0,0,660
61285,180,100,80,160,320,0,840
61286,200,140,80,80,160,0,660
61287,210,100,80,0,0,0,390
61288,250,160,160,240,160,0,970
61289,230,120,160,160,160,320,1150
61290,180,100,80,80,160,0,600
61291,170,120,160,80,160,0,690
61292,190,120,160,80,160,320,1030
61293,200,160,200,240,160,0,960
61294,210,120,80,160,320,320,1210
61295,190,160,80,80,160,320,990
61296,210,100,120,80,160,0,670
61297,200,100,120,80,160,0,660
61298,160,60,80,80,0,0,380
61299,180,180,80,80,0,0,520
61300,190,100,120,80,0,0,490
61301,180,100,40,80,0,0,400
61302,180,100,80,80,160,0,600
61303,180,140,160,160,160,0,800
61304,210,140,80,160,160,0,750
61305,160,40,40,80,160,320,800
61306,210,200,200,240,320,0,1170
61307,190,160,120,160,320,0,950
61308,180,60,40,0,0,0,280
61309,180,80,40,80,160,0,540
61310,190,120,120,240,320,0,990
61311,190,140,120,160,160,0,770
61312,200,140,80,160,0,0,580
61313,240,80,80,0,0,0,400
61314,220,100,160,80,0,0,560
61315,210,140,160,160,0,0,670
61316,230,140,40,0,0,0,410
61317,140,120,160,160,0,0,580
61318,190,140,80,0,0,0,410
61319,230,160,200,0,0,0,590
61320,190,140,120,160,160,0,770
61321,210,160,80,80,160,0,690
61322,200,100,40,80,160,0,580
61323,180,80,40,80,160,0,540
61324,220,160,80,80,160,0,700
61325,220,140,200,240,320,320,1440
61326,200,160,200,160,320,320,1360
61327,250,180,120,80,160,0,790
61328,150,120,80,160,160,320,990
61329,200,160,160,80,0,0,600
61330,150,180,120,80,160,0,690
61331,220,160,120,160,0,0,660
61332,220,100,80,80,160,0,640
61333,200,140,80,160,160,0,740
61334,210,100,40,80,160,0,590
61335,170,140,80,160,160,0,710
61336,200,100,40,80,160,0,580
61337,200,120,40,80,160,0,600
61338,180,160,160,160,160,320,1140
61339,190,140,80,0,0,0,410
61340,200,80,0,0,0,0,280
61341,160,140,120,160,0,0,580
61342,190,160,120,160,320,0,950
61343,190,160,160,80,0,0,590
61344,170,40,80,80,160,0,530
61345,210,120,120,240,160,0,850
61346,250,140,120,80,160,0,750
61347,200,120,80,80,160,0,640
61348,190,60,40,80,160,0,530
61349,130,120,80,0,0,0,330
61350,190,100,80,80,160,0,610
61351,170,100,120,160,320,320,1190
61352,190,80,80,160,160,0,670
61353,240,100,120,160,160,0,780
61354,140,120,160,240,320,320,1300
61355,230,140,80,160,160,0,770
61356,180,120,120,80,160,320,980
61357,200,80,80,80,0,0,440
61358,230,120,120,240,320,0,1030
61359,210,160,120,80,160,0,730
61360,200,180,160,80,160,0,780
61361,220,160,80,160,160,0,780
61362,210,160,200,160,160,0,890
61363,200,120,120,80,0,0,520
61364,200,140,160,80,160,0,740
61365,180,120,80,80,160,0,620
61366,220,200,120,80,160,0,780
61367,190,140,80,80,0,0,490
61368,200,120,120,160,160,0,760
61369,240,140,200,240,0,0,820
61370,190,140,120,80,0,0,530
61371,210,120,160,80,160,320,1050
61372,200,180,160,80,0,0,620
61373,190,140,120,80,0,0,530
61374,230,80,120,240,320,320,1310
61375,140,120,120,80,160,0,620
61376,220,100,120,160,320,320,1240
61377,210,120,40,0,0,0,370
61378,210,60,120,80,160,0,630
61379,170,120,120,80,160,0,650
61380,210,140,120,0,0,0,470
61381,200,60,80,80,160,0,580
61382,200,180,200,160,160,0,900
61383,190,160,120,80,160,0,710
61384,230,120,40,80,160,0,630
61385,210,120,80,80,0,0,490
61386,140,120,80,160,320,320,1140
61387,190,80,120,160,160,0,710
61388,180,120,40,0,0,0,340
61389,200,140,160,80,160,0,740
61390,200,160,80,80,0,0,520
61391,240,160,160,240,320,0,1120
61392,160,120,80,80,160,0,600
61393,230,140,200,240,320,0,1130
61394,200,120,160,80,0,0,560
61395,160,100,160,160,160,0,740
61396,230,160,120,80,160,320,1070
61397,180,120,80,0,0,0,380
61398,210,160,240,240,320,0,1170
61399,220,80,120,240,320,0,980
61400,190,140,160,160,160,0,810
61401,220,120,120,160,320,0,940
61402,220,160,160,160,160,0,860
61403,190,140,80,0,0,0,410
61404,230,140,120,240,320,320,1370
61405,240,120,120,160,160,0,800
61406,190,120,160,240,320,0,1030
61407,180,100,40,80,0,0,400
61408,180,160,120,80,0,0,540
61409,170,100,120,160,320,320,1190
61410,210,100,120,160,160,0,750
61411,210,140,160,80,0,0,590
61412,190,140,80,160,160,0,730
61413,180,100,80,80,160,0,600
61414,180,140,120,80,0,0,520
61415,170,40,40,0,0,0,250
61416,240,120,120,80,160,0,720
61417,220,100,200,320,160,0,1000
61418,190,140,80,0,0,0,410
61419,200,160,80,80,0,0,520
61420,150,60,40,0,0,0,250
61421,180,80,120,80,160,320,940
61422,240,100,120,80,160,320,1020
61423,200,120,120,160,160,0,760
61424,170,80,120,80,160,0,610
61425,200,120,160,80,160,0,720
61426,170,80,80,80,160,320,890
61427,220,160,200,80,160,0,820
61428,210,120,80,80,0,0,490
61429,240,120,80,80,160,0,680
61430,210,120,160,160,160,0,810
61431,180,80,120,80,0,0,460
61432,200,120,40,0,0,0,360
61433,180,100,120,80,160,320,960
61434,170,60,40,0,0,0,270
61435,210,100,80,160,160,320,1030
61436,220,40,40,0,0,0,300
61437,160,120,120,80,0,0,480
61438,180,120,200,240,160,320,1220
61439,190,100,80,80,0,0,450
61440,240,160,120,80,160,0,760
61441,210,40,40,0,0,0,290
61442,210,160,120,80,0,0,570
61443,190,100,40,80,0,0,410
61444,250,180,120,80,0,0,630
61445,210,120,80,80,0,0,490
61446,170,100,120,0,0,0,390
61447,200,60,0,0,0,0,260
61448,220,100,40,80,0,0,440
61449,220,80,80,0,0,0,380
61450,220,120,120,160,0,0,620
61451,220,140,120,160,320,0,960
61452,150,100,80,80,160,0,570
61453,150,100,120,80,160,0,610
61454,170,100,80,80,0,0,430
61455,180,100,120,80,0,0,480
61456,180,160,120,80,0,0,540
61457,170,60,0,0,0,0,230
61458,160,80,80,80,0,0,400
61459,210,120,80,160,0,0,570
61460,220,160,160,80,0,0,620
61461,190,40,0,0,0,0,230
61462,240,180,160,240,320,320,1460
61463,210,140,80,0,0,0,430
61464,220,120,120,80,160,0,700
61465,200,160,200,80,160,0,800
61466,180,140,40,80,160,0,600
61467,180,160,120,80,0,0,540
61468,210,100,120,0,0,0,430
61469,180,80,40,80,160,0,540
61470,200,160,120,160,320,320,1280
61471,200,100,120,80,160,0,660
61472,150,100,120,160,320,0,850
61473,200,160,80,160,320,0,920
61474,200,80,80,160,160,0,680
61475,200,160,200,80,160,0,800
61476,180,120,160,80,0,0,540
61477,170,120,80,160,320,0,850
61478,210,140,80,80,160,0,670
61479,220,140,40,80,0,0,480
61480,230,100,120,160,320,0,930
61481,220,160,120,80,0,0,580
61482,220,200,120,0,0,0,540
61483,210,180,40,80,160,0,670
61484,200,120,40,80,0,0,440
61485,180,160,160,160,320,320,1300
61486,220,120,40,80,160,0,620
61487,200,120,80,0,0,0,400
61488,180,80,120,80,160,0,620
61489,200,180,200,160,0,0,740
61490,170,120,160,80,160,320,1010
61491,200,100,80,80,160,0,620
61492,220,160,160,80,0,0,620
61493,210,140,120,80,160,0,710
61494,180,140,80,80,0,0,480
61495,230,80,40,0,0,0,350
61496,220,160,120,160,0,0,660
61497,200,140,160,160,0,0,660
61498,170,140,80,0,0,0,390
61499,190,100,120,80,0,0,490
61500,180,60,80,0,0,0,320
61501,210,120,80,160,160,0,730
61502,180,120,120,160,320,0,900
61503,200,120,80,80,160,0,640
61504,210,80,80,160,160,320,1010
61505,170,160,120,160,160,0,770
61506,220,60,80,80,160,0,600
61507,170,80,0,0,0,0,250
61508,190,120,120,80,0,0,510
61509,210,120,0,0,0,0,330
61510,190,120,120,0,0,0,430
61511,160,100,120,80,160,0,620
61512,250,180,160,80,160,320,1150
61513,170,140,80,0,0,0,390
61514,220,140,160,80,160,0,760
61515,170,100,40,0,0,0,310
61516,180,160,120,0,0,0,460
61517,180,120,160,160,160,0,780
61518,210,200,200,160,0,0,770
61519,210,100,120,160,160,0,750
61520,200,180,200,240,0,0,820
61521,210,160,120,240,160,320,1210
61522,200,160,200,80,0,0,640
61523,210,160,160,80,0,0,610
61524,200,140,40,80,160,0,620
61525,220,140,120,80,0,0,560
61526,190,160,120,160,0,0,630
61527,200,140,120,80,160,0,700
61528,200,120,80,80,160,0,640
61529,220,120,80,160,160,0,740
61530,210,160,120,160,160,0,810
61531,170,120,200,240,160,0,890
61532,210,120,120,160,160,0,770
61533,170,100,40,80,160,0,550
61534,170,140,120,160,160,0,750
61535,220,180,160,160,320,320,1360
61536,190,120,80,160,160,0,710
61537,240,100,80,80,160,0,660
61538,190,80,120,0,0,0,390
61539,200,140,40,0,0,0,380
61540,240,120,160,80,0,0,600
61541,180,100,0,0,0,0,280
61542,220,180,160,80,160,0,800
61543,210,120,40,80,160,0,610
61544,200,140,200,80,0,0,620
61545,220,100,200,240,160,0,920
61546,190,120,80,0,0,0,390
61547,180,140,120,160,160,0,760
61548,250,220,200,240,160,0,1070
61549,240,160,120,80,160,0,760
61550,160,100,80,0,0,0,340
61551,210,140,120,80,0,0,550
61552,190,100,80,80,160,0,610
61553,200,100,80,80,160,0,620
61554,190,140,200,240,160,0,930
61555,220,80,40,0,0,0,340
61556,210,100,80,80,0,0,470
61557,170,100,40,0,0,0,310
61558,170,100,80,80,0,0,430
61559,190,120,80,80,160,320,950
61560,190,140,120,80,160,0,690
61561,190,140,120,80,160,0,690
61562,190,60,40,80,160,0,530
61563,210,40,40,0,0,0,290
61564,190,120,120,80,160,0,670
61565,180,100,120,0,0,0,400
61566,180,140,80,160,160,320,1040
61567,180,160,160,240,320,320,1380
61568,170,100,120,0,0,0,390
61569,160,100,120,0,0,0,380
61570,230,100,80,80,0,0,490
61571,220,180,160,160,320,0,1040
61572,200,120,80,0,0,0,400
61573,170,120,80,80,0,0,450
61574,220,120,80,160,160,0,740
61575,190,180,160,80,0,0,610
61576,200,120,40,0,0,0,360
61577,220,140,80,160,0,0,600
61578,210,180,200,160,160,0,910
61579,210,60,80,0,0,0,350
61580,150,140,160,160,320,320,1250
61581,200,60,120,160,160,0,700
61582,210,140,120,80,0,0,550
61583,200,220,80,80,0,0,580
61584,230,180,160,80,160,0,810
61585,200,120,160,160,320,0,960
61586,230,160,120,160,160,0,830
61587,190,80,80,0,0,0,350
61588,170,160,200,240,320,320,1410
61589,200,120,160,80,160,320,1040
61590,200,120,120,80,160,0,680
61591,200,140,80,160,160,0,740
61592,210,160,160,80,0,0,610
61593,160,160,120,240,160,0,840
61594,200,100,80,80,160,320,940
61595,210,120,120,160,0,0,610
61596,230,120,120,160,320,0,950
61597,210,100,120,240,160,0,830
61598,240,160,120,160,0,0,680
61599,170,100,200,160,160,0,790
61600,210,80,120,80,160,0,650
61601,190,160,80,80,160,0,670
61602,180,100,80,80,160,0,600
61603,180,120,200,80,0,0,580
61604,200,100,120,80,160,0,660
61605,180,60,40,80,160,0,520
61606,190,140,40,0,0,0,370
61607,160,100,40,0,0,0,300
61608,160,100,80,80,0,0,420
61609,190,120,120,0,0,0,430
61610,170,120,120,80,0,0,490
61611,220,160,160,240,320,0,1100
61612,250,140,120,80,0,0,590
61613,210,140,120,80,0,0,550
61614,230,120,160,160,320,0,990
61615,220,100,80,80,0,0,480
61616,160,100,80,80,160,0,580
61617,220,120,80,80,160,0,660
61618,190,160,160,240,160,0,910
61619,220,180,80,80,0,0,560
61620,190,100,40,0,0,0,330
61621,180,120,80,0,0,0,380
61622,190,100,80,160,320,0,850
61623,220,140,160,160,320,320,1320
61624,190,120,80,160,160,0,710
61625,170,80,120,160,160,0,690
61626,240,120,160,160,320,0,1000
61627,190,120,80,160,320,320,1190
61628,190,100,160,160,160,0,770
61629,220,200,160,80,160,0,820
61630,190,100,80,160,160,0,690
61631,180,100,80,80,0,0,440
61632,250,180,80,80,160,0,750
61633,200,140,80,160,160,320,1060
61634,200,120,200,160,160,0,840
61635,190,100,120,80,160,0,650
61636,140,140,120,80,0,0,480
61637,190,120,120,160,320,0,910
61638,200,80,40,80,0,0,400
61639,220,100,120,160,160,0,760
61640,250,160,120,160,0,0,690
61641,190,120,80,80,160,0,630
61642,200,40,40,0,0,0,280
61643,160,120,80,80,0,0,440
61644,180,140,40,0,0,0,360
61645,160,60,80,80,160,0,540
61646,210,100,80,160,320,320,1190
61647,220,80,120,240,0,0,660
61648,160,60,40,80,0,0,340
61649,220,80,120,240,160,0,820
61650,200,40,0,0,0,0,240
61651,200,140,160,80,160,0,740
61652,230,100,160,160,320,0,970
61653,220,80,40,80,160,0,580
61654,190,60,80,160,160,0,650
61655,130,100,120,160,320,0,830
61656,220,160,40,80,0,0,500
61657,220,140,40,0,0,0,400
61658,210,140,120,80,0,0,550
61659,180,140,80,0,0,0,400
61660,180,140,120,80,160,320,1000
61661,210,120,80,80,0,0,490
61662,190,40,0,0,0,0,230
61663,230,140,160,80,160,0,770
61664,190,100,160,160,0,0,610
61665,220,100,0,0,0,0,320
61666,190,100,80,160,160,0,690
61667,190,160,80,80,160,0,670
61668,200,60,80,80,0,0,420
61669,210,180,120,80,0,0,590
61670,200,160,80,80,0,0,520
61671,190,80,40,80,0,0,390
61672,190,100,160,160,320,0,930
61673,170,140,120,80,160,0,670
61674,170,80,40,0,0,0,290
61675,190,120,120,80,0,0,510
61676,210,100,80,80,160,0,630
61677,180,140,120,80,160,0,680
61678,210,120,160,80,160,0,730
61679,210,120,120,80,160,320,1010
61680,190,80,80,80,160,0,590
61681,240,140,80,160,160,320,1100
61682,170,80,40,0,0,0,290
61683,190,140,160,80,160,0,730
61684,180,80,80,80,160,0,580
61685,150,80,80,80,0,0,390
61686,180,100,80,80,160,0,600
61687,220,120,120,160,0,0,620
61688,190,120,120,160,320,0,910
61689,210,120,80,160,320,320,1210
61690,210,120,80,80,0,0,490
61691,200,100,80,0,0,0,380
61692,190,80,120,160,320,320,1190
61693,190,80,120,160,160,0,710
61694,220,100,80,160,160,0,720
61695,210,140,160,240,160,0,910
61696,150,80,160,160,160,0,710
61697,200,120,80,80,160,0,640
61698,200,220,80,160,0,0,660
61699,170,140,160,80,0,0,550
61700,190,160,80,160,320,320,1230
61701,190,180,120,160,0,0,650
61702,190,120,120,160,160,0,750
61703,180,160,120,160,160,0,780
61704,140,40,40,0,0,0,220
61705,200,60,80,80,160,0,580
61706,200,120,40,0,0,0,360
61707,210,140,160,160,0,0,670
61708,230,100,80,160,0,0,570
61709,180,140,80,160,160,0,720
61710,190,140,160,240,160,320,1210
61711,160,80,80,80,160,0,560
61712,210,120,120,160,320,0,930
61713,200,120,80,160,160,0,720
61714,200,120,160,80,160,320,1040
61715,210,120,80,160,160,0,730
61716,200,120,120,160,0,0,600
61717,180,60,80,80,160,0,560
61718,230,180,160,160,320,0,1050
61719,200,100,80,160,0,0,540
61720,210,140,160,0,0,0,510
61721,200,120,80,80,160,0,640
61722,250,120,120,80,160,0,730
61723,230,120,120,160,320,0,950
61724,170,100,120,80,160,0,630
61725,210,120,40,0,0,0,370
61726,240,180,160,160,160,320,1220
61727,190,120,200,160,160,0,830
61728,200,140,120,80,160,0,700
61729,190,140,40,0,0,0,370
61730,200,140,160,80,0,0,580
61731,190,100,40,80,0,0,410
61732,210,140,160,160,320,0,990
61733,220,140,120,160,320,320,1280
61734,260,200,120,160,0,0,740
61735,180,100,80,160,160,320,1000
61736,190,160,200,160,160,320,1190
61737,200,100,80,160,320,0,860
61738,180,80,80,80,0,0,420
61739,210,120,80,80,0,0,490
61740,170,100,200,160,160,0,790
61741,240,100,40,80,0,0,460
61742,180,120,120,0,0,0,420
61743,230,140,120,0,0,0,490
61744,200,120,160,80,160,320,1040
61745,190,60,80,0,0,0,330
61746,200,100,120,80,160,0,660
61747,200,100,40,0,0,0,340
61748,180,120,120,80,0,0,500
61749,210,160,80,80,160,0,690
61750,180,20,40,0,0,0,240
61751,170,80,40,0,0,0,290
61752,200,80,80,80,160,0,600
61753,150,140,160,240,320,320,1330
61754,180,160,40,0,0,0,380
61755,180,80,40,0,0,0,300
61756,150,100,120,240,160,0,770
61757,210,80,80,0,0,0,370
61758,180,200,40,80,160,0,660
61759,230,140,200,160,0,0,730
61760,210,160,160,240,160,0,930
61761,180,160,160,160,320,320,1300
61762,220,180,120,80,0,0,600
61763,160,100,80,80,0,0,420
61764,200,140,120,0,0,0,460
61765,230,200,240,240,320,320,1550
61766,180,80,120,80,160,0,620
61767,210,100,160,160,160,320,1110
61768,190,120,120,160,0,0,590
61769,200,140,120,160,0,0,620
61770,130,60,80,80,0,0,350
61771,160,60,80,80,160,0,540
61772,190,80,40,0,0,0,310
61773,190,100,80,160,160,0,690
61774,180,80,80,80,0,0,420
61775,220,120,160,160,0,0,660
61776,180,100,80,80,0,0,440
61777,240,140,120,80,160,320,1060
61778,160,160,120,160,0,0,600
61779,140,120,120,160,160,0,700
61780,220,180,120,240,160,0,920
61781,190,140,160,160,160,0,810
61782,190,160,80,80,160,0,670
61783,220,140,120,80,160,320,1040
61784,210,160,200,80,160,0,810
61785,210,120,120,160,160,0,770
61786,210,200,200,80,160,0,850
61787,180,140,120,80,160,0,680
61788,220,140,200,240,320,0,1120
61789,210,120,40,0,0,0,370
61790,220,120,40,80,0,0,460
61791,170,140,160,160,160,0,790
61792,190,160,120,80,160,0,710
61793,160,120,120,80,160,320,960
61794,200,100,80,160,320,320,1180
61795,220,140,0,0,0,0,360
61796,220,160,160,160,320,0,1020
61797,180,60,120,80,0,0,440
61798,200,160,80,80,160,0,680
61799,200,120,0,0,0,0,320
61800,150,80,40,80,160,0,510
61801,180,120,120,160,320,0,900
61802,170,100,80,80,160,0,590
61803,200,60,0,0,0,0,260
61804,210,140,80,80,0,0,510
61805,180,160,160,240,320,0,1060
61806,190,100,40,0,0,0,330
61807,180,60,120,80,160,0,600
61808,150,120,120,80,0,0,470
61809,230,120,40,80,160,0,630
61810,160,100,80,80,160,0,580
61811,240,100,120,80,0,0,540
61812,230,160,0,0,0,0,390
61813,180,80,80,80,0,0,420
61814,150,80,160,160,160,0,710
61815,170,100,120,160,320,0,870
61816,210,140,80,80,160,0,670
61817,130,80,160,160,0,0,530
61818,200,120,80,80,160,0,640
61819,190,120,120,80,160,320,990
61820,210,40,40,80,160,0,530
61821,180,160,200,240,320,0,1100
61822,130,60,80,160,320,320,1070
61823,160,80,40,80,160,0,520
61824,200,80,120,80,0,0,480
61825,240,140,120,160,0,0,660
61826,220,60,40,0,0,0,320
61827,220,160,160,160,320,0,1020
61828,190,140,80,0,0,0,410
61829,200,140,120,80,0,0,540
61830,190,180,80,80,0,0,530
61831,230,160,80,160,160,320,1110
61832,190,160,160,80,0,0,590
61833,200,120,120,160,160,0,760
61834,210,100,80,0,0,0,390
61835,220,120,120,160,320,320,1260
61836,190,120,120,160,160,320,1070
61837,200,140,160,240,160,0,900
61838,210,100,120,0,0,0,430
61839,190,100,40,0,0,0,330
61840,160,140,160,240,320,0,1020
61841,180,100,120,80,160,320,960
61842,220,140,200,80,0,0,640
61843,160,100,120,80,160,0,620
61844,180,60,80,0,0,0,320
61845,190,160,80,80,160,0,670
61846,230,200,40,80,160,0,710
61847,170,120,80,80,0,0,450
61848,170,100,160,240,0,0,670
61849,200,140,120,160,160,0,780
61850,190,160,120,80,0,0,550
61851,190,100,40,80,160,0,570
61852,220,120,120,80,0,0,540
61853,240,180,120,160,320,0,1020
61854,200,120,160,80,160,0,720
61855,200,100,80,80,160,320,940
61856,180,120,80,0,0,0,380
61857,200,140,80,80,0,0,500
61858,200,100,120,160,160,0,740
61859,220,140,80,160,160,320,1080
61860,210,140,120,0,0,0,470
61861,200,120,160,160,0,0,640
61862,200,100,80,160,160,320,1020
61863,200,60,40,80,160,0,540
61864,190,200,200,80,160,0,830
61865,170,120,120,80,0,0,490
61866,190,160,80,80,160,0,670
61867,210,140,120,80,160,0,710
61868,180,140,120,160,320,0,920
61869,200,180,200,240,0,0,820
61870,180,140,160,80,0,0,560
61871,170,100,160,0,0,0,430
61872,240,220,200,160,160,0,980
61873,240,160,120,160,320,320,1320
61874,210,180,200,160,0,0,750
61875,220,140,120,160,160,0,800
61876,180,140,120,80,0,0,520
61877,190,120,80,0,0,0,390
61878,200,160,120,160,160,320,1120
61879,240,180,160,240,160,0,980
61880,210,160,80,80,160,320,1010
61881,200,180,120,80,160,0,740
61882,200,100,120,160,160,320,1060
61883,190,160,200,240,160,320,1270
61884,210,100,160,160,160,0,790
61885,210,160,240,160,320,0,1090
61886,200,100,160,160,160,0,780
61887,180,80,80,80,160,320,900
61888,240,100,80,160,320,320,1220
61889,190,80,80,0,0,0,350
61890,210,100,80,80,160,0,630
61891,170,160,160,160,160,0,810
61892,170,140,120,80,160,0,670
61893,160,100,120,80,0,0,460
61894,190,120,80,80,160,0,630
61895,230,120,120,0,0,0,470
61896,180,120,40,0,0,0,340
61897,180,140,120,80,160,320,1000
61898,220,100,120,160,320,320,1240
61899,170,120,120,80,160,0,650
61900,200,80,120,160,160,0,720
61901,200,100,120,240,160,0,820
61902,260,160,120,80,160,0,780
61903,220,160,120,80,0,0,580
61904,180,140,160,240,320,320,1360
61905,170,80,80,80,160,0,570
61906,210,100,80,80,0,0,470
61907,190,180,120,240,160,0,890
61908,200,120,160,160,160,320,1120
61909,220,160,120,80,0,0,580
61910,190,100,120,160,320,0,890
61911,170,120,0,0,0,0,290
61912,210,140,120,160,320,0,950
61913,240,140,160,80,160,0,780
61914,220,180,200,160,160,0,920
61915,160,100,80,0,0,0,340
61916,210,140,160,160,320,320,1310
61917,200,140,160,160,160,0,820
61918,220,120,120,80,0,0,540
61919,200,100,0,0,0,0,300
61920,240,60,40,80,160,0,580
61921,180,80,120,80,160,0,620
61922,190,120,0,0,0,0,310
61923,110,80,80,0,0,0,270
61924,190,100,80,80,160,0,610
61925,180,160,80,80,160,0,660
61926,220,160,120,80,0,0,580
61927,180,140,120,80,0,0,520
61928,210,160,120,160,160,0,810
61929,190,140,160,0,0,0,490
61930,220,140,120,160,160,320,1120
61931,210,140,160,240,160,0,910
61932,170,140,160,160,160,320,1110
61933,210,160,200,160,320,0,1050
61934,220,100,120,160,160,0,760
61935,180,120,160,80,160,0,700
61936,230,140,80,80,0,0,530
61937,230,120,80,80,160,0,670
61938,180,140,80,80,160,0,640
61939,160,80,80,160,320,320,1120
61940,200,100,200,240,160,0,900
61941,200,100,80,160,160,0,700
61942,210,100,80,160,160,0,710
61943,240,140,160,80,160,0,780
61944,210,100,120,0,0,0,430
61945,190,120,120,0,0,0,430
61946,200,140,200,240,160,320,1260
61947,130,80,80,80,160,0,530
61948,200,180,80,160,320,320,1260
61949,180,140,120,80,160,0,680
61950,180,180,120,160,320,320,1280
61951,210,40,40,0,0,0,290
61952,230,180,120,240,320,0,1090
61953,230,100,120,0,0,0,450
61954,170,80,160,160,160,0,730
61955,210,80,80,80,160,0,610
61956,210,120,120,80,160,0,690
61957,230,160,160,160,160,0,870
61958,190,120,160,160,160,0,790
61959,200,140,120,160,0,0,620
61960,190,160,200,240,160,0,950
61961,200,120,160,240,0,0,720
61962,140,80,120,80,160,320,900
61963,180,100,160,0,0,0,440
61964,190,160,200,240,160,0,950
61965,210,80,80,80,160,320,930
61966,180,140,120,160,160,320,1080
61967,200,140,80,160,320,0,900
61968,200,80,80,80,160,0,600
61969,160,80,120,80,160,0,600
61970,210,80,40,0,0,0,330
61971,170,140,120,160,160,320,1070
61972,190,140,160,160,160,0,810
61973,180,80,0,0,0,0,260
61974,230,120,120,80,0,0,550
61975,220,60,80,0,0,0,360
61976,230,80,40,0,0,0,350
61977,220,120,120,0,0,0,460
61978,220,160,120,160,160,0,820
61979,220,160,160,160,160,0,860
61980,220,160,40,80,0,0,500
61981,190,160,80,160,320,0,910
61982,190,160,160,0,0,0,510
61983,160,120,120,0,0,0,400
61984,200,120,80,160,0,0,560
61985,180,120,160,80,0,0,540
61986,220,120,80,160,320,0,900
61987,220,140,80,80,0,0,520
61988,220,160,160,160,320,320,1340
61989,180,100,80,0,0,0,360
61990,220,160,160,80,0,0,620
61991,190,80,40,0,0,0,310
61992,160,140,200,160,160,0,820
61993,190,80,40,80,160,0,550
61994,170,80,40,0,0,0,290
61995,160,100,80,80,160,0,580
61996,240,140,80,160,0,0,620
61997,200,140,120,160,160,0,780
61998,240,160,80,80,0,0,560
61999,180,140,200,160,320,320,1320
62000,180,100,80,0,0,0,360
62001,170,120,160,80,0,0,530
62002,190,100,160,80,0,0,530
62003,250,180,40,80,0,0,550
62004,170,180,120,80,0,0,550
62005,220,120,120,160,320,0,940
62006,190,120,80,0,0,0,390
62007,190,80,120,80,0,0,470
62008,170,80,80,80,160,320,890
62009,170,160,120,160,160,0,770
62010,210,180,120,240,320,320,1390
62011,140,120,80,0,0,0,340
62012,200,120,80,160,0,0,560
62013,210,120,120,160,160,320,1090
62014,180,140,160,240,160,0,880
62015,210,140,120,80,0,0,550
62016,220,80,40,0,0,0,340
62017,200,100,40,80,0,0,420
62018,190,160,200,80,160,0,790
62019,170,80,80,160,160,0,650
62020,190,140,120,80,160,320,1010
62021,230,120,120,0,0,0,470
62022,190,160,160,160,320,0,990
62023,240,200,160,240,160,0,1000
62024,230,180,160,160,160,0,890
62025,140,120,120,160,320,0,860
62026,200,120,40,0,0,0,360
62027,210,120,120,80,160,0,690
62028,190,120,120,160,0,0,590
62029,170,60,40,0,0,0,270
62030,190,160,120,160,160,0,790
62031,220,140,120,80,0,0,560
62032,160,140,120,240,160,0,820
62033,220,180,80,160,320,320,1280
62034,190,140,80,80,160,0,650
62035,210,200,160,160,160,0,890
62036,180,120,80,160,160,0,700
62037,230,200,160,80,0,0,670
62038,190,100,120,80,0,0,490
62039,170,60,40,0,0,0,270
62040,210,100,120,160,160,0,750
62041,220,140,40,80,0,0,480
62042,170,100,40,80,160,0,550
62043,250,160,160,80,0,0,650
62044,190,180,200,80,160,320,1130
62045,170,100,80,0,0,0,350
62046,240,120,160,160,160,0,840
62047,220,100,80,160,320,320,1200
62048,220,120,80,80,0,0,500
62049,200,140,120,160,160,320,1100
62050,150,60,80,0,0,0,290
62051,190,120,120,80,160,0,670
62052,200,120,120,80,0,0,520
62053,170,80,80,0,0,0,330
62054,190,100,80,80,0,0,450
62055,170,140,120,80,160,0,670
62056,180,140,160,80,160,0,720
62057,210,120,120,80,160,0,690
62058,200,160,80,160,160,0,760
62059,210,140,120,160,160,320,1110
62060,180,120,120,80,0,0,500
62061,220,100,120,240,160,0,840
62062,160,80,80,160,160,0,640
62063,200,160,160,160,0,0,680
62064,190,140,120,80,0,0,530
62065,200,100,40,80,160,0,580
62066,210,120,120,160,320,320,1250
62067,180,120,80,80,0,0,460
62068,210,120,80,80,160,0,650
62069,180,140,80,0,0,0,400
62070,220,120,120,160,320,0,940
62071,180,120,120,80,0,0,500
62072,190,140,80,0,0,0,410
62073,210,60,80,160,160,0,670
62074,170,80,80,160,320,0,810
62075,180,120,200,240,160,0,900
62076,210,60,80,80,160,0,590
62077,220,180,160,240,160,0,960
62078,190,140,160,160,160,0,810
62079,200,80,80,80,160,0,600
62080,170,100,80,80,160,320,910
62081,180,160,120,80,0,0,540
62082,250,120,160,160,0,0,690
62083,200,140,80,80,160,0,660
62084,180,160,120,0,0,0,460
62085,180,80,120,160,320,320,1180
62086,200,80,40,80,160,0,560
62087,200,80,80,160,0,0,520
62088,190,120,120,80,160,0,670
62089,200,140,200,160,160,0,860
62090,170,100,80,80,160,0,590
62091,220,120,40,80,160,0,620
62092,190,140,40,0,0,0,370
62093,180,120,120,80,160,0,660
62094,180,120,160,80,160,0,700
62095,180,60,80,160,0,0,480
62096,220,100,80,80,160,320,960
62097,200,120,80,160,160,0,720
62098,180,120,40,0,0,0,340
62099,180,140,120,80,160,0,680
62100,170,140,120,0,0,0,430
62101,190,140,160,80,0,0,570
62102,210,100,120,0,0,0,430
62103,220,80,80,80,160,0,620
62104,200,100,80,80,160,0,620
62105,190,120,80,80,0,0,470
62106,190,180,160,80,0,0,610
62107,200,120,40,80,160,0,600
62108,200,100,120,160,320,320,1220
62109,200,180,160,160,320,0,1020
62110,240,160,240,80,0,0,720
62111,210,140,80,160,320,0,910
62112,220,80,80,0,0,0,380
62113,250,140,120,240,160,0,910
62114,200,80,40,80,160,0,560
62115,200,180,200,80,0,0,660
62116,180,160,160,160,160,0,820
62117,240,120,160,240,320,320,1400
62118,200,120,80,80,0,0,480
62119,200,80,160,160,160,0,760
62120,180,140,80,0,0,0,400
62121,190,140,120,80,0,0,530
62122,150,120,160,160,160,0,750
62123,200,160,160,80,0,0,600
62124,240,120,160,160,160,0,840
62125,180,100,80,80,0,0,440
62126,210,140,120,80,0,0,550
62127,200,140,120,160,160,0,780
62128,230,100,160,80,160,0,730
62129,180,100,120,160,160,0,720
62130,200,140,160,160,160,320,1140
62131,190,80,80,160,160,0,670
62132,190,120,40,80,160,0,590
62133,200,100,40,80,0,0,420
62134,180,120,120,80,0,0,500
62135,220,100,40,0,0,0,360
62136,170,80,80,160,160,0,650
62137,180,120,80,160,0,0,540
62138,190,60,80,80,160,0,570
62139,120,80,80,160,160,0,600
62140,200,140,240,240,160,320,1300
62141,180,100,40,0,0,0,320
62142,190,40,40,0,0,0,270
62143,170,120,120,0,0,0,410
62144,190,140,80,80,0,0,490
62145,220,160,240,80,160,0,860
62146,180,140,80,80,0,0,480
62147,170,100,120,80,160,0,630
62148,220,140,120,160,320,320,1280
62149,160,80,120,160,160,0,680
62150,210,180,160,80,160,0,790
62151,190,100,160,240,320,320,1330
62152,190,140,160,160,160,0,810
62153,230,100,120,160,320,320,1250
62154,200,160,80,80,160,0,680
62155,190,180,120,80,0,0,570
62156,220,120,80,160,160,0,740
62157,160,100,160,160,320,0,900
62158,190,120,80,80,160,320,950
62159,250,160,160,80,0,0,650
62160,220,220,200,240,160,0,1040
62161,180,140,80,80,0,0,480
62162,200,180,120,160,320,0,980
62163,150,140,160,240,320,320,1330
62164,180,140,120,80,160,320,1000
62165,210,80,80,80,0,0,450
62166,190,120,80,0,0,0,390
62167,170,120,120,80,0,0,490
62168,230,160,120,0,0,0,510
62169,170,100,120,0,0,0,390
62170,210,120,80,160,160,320,1050
62171,180,120,120,240,320,320,1300
62172,200,60,40,80,160,320,860
62173,190,100,40,0,0,0,330
62174,160,120,80,80,0,0,440
62175,210,160,80,80,160,0,690
62176,220,160,160,160,160,0,860
62177,220,80,80,80,160,0,620
62178,210,80,120,80,160,0,650
62179,170,100,80,80,160,0,590
62180,190,80,120,80,0,0,470
62181,200,160,120,240,320,0,1040
62182,190,160,200,160,0,0,710
62183,200,180,160,240,160,0,940
62184,180,100,40,80,160,0,560
62185,190,120,40,80,160,0,590
62186,210,140,80,80,160,0,670
62187,200,140,160,240,160,0,900
62188,250,120,120,80,0,0,570
62189,170,60,40,80,160,320,830
62190,160,100,80,80,0,0,420
62191,200,140,120,160,160,0,780
62192,180,120,120,0,0,0,420
62193,270,140,120,80,160,0,770
62194,180,120,160,160,160,0,780
62195,200,160,200,160,160,0,880
62196,230,160,120,80,160,320,1070
62197,200,100,160,80,160,0,700
62198,230,180,160,160,320,0,1050
62199,210,160,200,160,320,320,1370
62200,200,140,160,160,160,0,820
62201,180,100,0,0,0,0,280
62202,180,80,120,0,0,0,380
62203,180,120,160,160,160,0,780
62204,190,160,80,160,160,0,750
62205,190,120,120,160,0,0,590
62206,180,160,120,80,160,0,700
62207,210,140,120,80,0,0,550
62208,180,80,160,160,0,0,580
62209,220,160,120,160,160,0,820
62210,180,140,120,240,160,0,840
62211,210,220,160,80,0,0,670
62212,230,140,160,160,320,0,1010
62213,190,140,80,160,320,0,890
62214,220,140,160,240,320,0,1080
62215,210,100,80,80,160,320,950
62216,200,160,80,80,160,0,680
62217,230,180,240,160,160,320,1290
62218,210,140,120,80,160,0,710
62219,190,100,40,80,160,0,570
62220,220,180,120,160,160,0,840
62221,210,160,120,80,160,0,730
62222,170,60,80,0,0,0,310
62223,220,160,160,0,0,0,540
62224,210,120,120,80,0,0,530
62225,170,160,160,160,160,0,810
62226,160,140,120,160,160,0,740
62227,210,120,80,80,160,0,650
62228,170,100,120,0,0,0,390
62229,200,160,120,240,0,0,720
62230,240,160,160,240,320,0,1120
62231,200,140,160,80,0,0,580
62232,190,120,120,80,160,0,670
62233,220,80,80,80,160,320,940
62234,220,100,80,80,160,0,640
62235,160,60,120,160,0,0,500
62236,190,180,120,160,0,0,650
62237,160,140,80,0,0,0,380
62238,160,120,80,160,160,0,680
62239,200,180,200,80,0,0,660
62240,200,100,80,0,0,0,380
62241,190,60,80,80,160,320,890
62242,200,120,80,80,0,0,480
62243,190,100,80,160,320,320,1170
62244,230,120,120,0,0,0,470
62245,240,140,120,0,0,0,500
62246,180,140,120,80,160,0,680
62247,200,100,80,0,0,0,380
62248,220,120,120,240,320,320,1340
62249,180,100,80,80,0,0,440
62250,220,140,120,80,160,0,720
62251,220,140,80,0,0,0,440
62252,160,100,40,80,160,0,540
62253,210,180,40,0,0,0,430
62254,200,140,120,240,320,320,1340
62255,220,120,160,80,0,0,580
62256,190,120,120,80,160,0,670
62257,190,120,80,160,160,0,710
62258,210,140,80,80,160,0,670
62259,220,140,200,240,160,0,960
62260,170,100,80,80,0,0,430
62261,210,80,80,160,160,320,1010
62262,240,140,120,160,160,0,820
62263,200,100,160,80,0,0,540
62264,190,120,80,160,320,0,870
62265,190,140,40,0,0,0,370
62266,230,100,120,80,0,0,530
62267,180,120,80,80,0,0,460
62268,210,100,40,80,0,0,430
62269,170,100,120,160,160,0,710
62270,210,160,80,160,0,0,610
62271,180,180,120,160,160,0,800
62272,230,80,80,80,0,0,470
62273,190,160,80,80,160,320,990
62274,180,120,160,160,320,320,1260
62275,190,120,120,80,160,0,670
62276,180,100,120,160,0,0,560
62277,210,80,120,80,160,0,650
62278,220,160,80,0,0,0,460
62279,170,100,200,160,160,0,790
62280,190,120,160,160,160,0,790
62281,170,120,120,160,160,0,730
62282,200,120,80,160,160,320,1040
62283,200,140,120,80,0,0,540
62284,190,100,120,0,0,0,410
62285,210,100,40,0,0,0,350
62286,180,100,80,80,160,0,600
62287,240,180,160,160,160,320,1220
62288,210,160,120,160,160,0,810
62289,200,140,120,160,160,0,780
62290,220,140,80,80,160,320,1000
62291,190,100,40,0,0,0,330
62292,230,80,80,0,0,0,390
62293,210,140,80,160,160,0,750
62294,150,60,120,80,160,320,890
62295,190,140,80,80,0,0,490
62296,180,180,120,160,160,320,1120
62297,180,140,160,80,0,0,560
62298,190,100,80,160,160,0,690
62299,180,120,120,80,0,0,500
62300,200,120,80,160,160,0,720
62301,190,140,160,160,160,0,810
62302,230,140,80,0,0,0,450
62303,220,140,120,160,160,0,800
62304,180,100,40,0,0,0,320
62305,210,100,80,80,160,320,950
62306,170,100,120,80,160,320,950
62307,190,120,160,160,160,0,790
62308,220,120,120,160,160,0,780
62309,230,120,120,80,0,0,550
62310,200,80,120,80,160,0,640
62311,170,120,120,80,0,0,490
62312,240,140,160,160,160,0,860
62313,200,160,160,80,160,0,760
62314,240,120,80,0,0,0,440
62315,200,80,160,160,160,0,760
62316,230,120,80,80,160,0,670
62317,200,120,80,80,0,0,480
62318,140,120,120,80,0,0,460
62319,180,140,160,240,320,320,1360
62320,170,80,120,0,0,0,370
62321,210,160,80,80,0,0,530
62322,180,160,160,160,320,320,1300
62323,190,100,120,80,160,0,650
62324,200,100,120,160,320,320,1220
62325,180,120,80,160,320,0,860
62326,200,180,160,160,320,0,1020
62327,180,140,120,160,160,0,760
62328,150,140,120,160,160,0,730
62329,190,80,120,0,0,0,390
62330,170,80,40,0,0,0,290
62331,210,140,120,80,160,0,710
62332,160,80,80,80,160,0,560
62333,200,100,0,0,0,0,300
62334,160,140,120,80,160,320,980
62335,210,100,40,0,0,0,350
62336,190,120,0,0,0,0,310
62337,180,80,80,80,0,0,420
62338,170,120,200,80,0,0,570
62339,190,100,120,240,160,0,810
62340,170,120,120,80,160,0,650
62341,170,140,200,0,0,0,510
62342,240,180,200,160,160,0,940
62343,230,100,120,80,160,320,1010
62344,180,80,80,0,0,0,340
62345,220,160,80,80,160,0,700
62346,180,120,80,160,320,0,860
62347,190,80,40,0,0,0,310
62348,200,160,80,80,0,0,520
62349,210,180,120,160,320,320,1310
62350,200,80,120,160,0,0,560
62351,190,120,160,160,0,0,630
62352,210,100,80,80,160,0,630
62353,210,160,120,0,0,0,490
62354,210,80,160,160,0,0,610
62355,210,140,120,160,160,0,790
62356,180,120,200,160,160,0,820
62357,160,140,200,160,160,0,820
62358,190,100,80,80,0,0,450
62359,230,120,120,240,320,320,1350
62360,180,100,160,240,160,0,840
62361,220,120,80,80,0,0,500
62362,200,120,80,80,0,0,480
62363,210,120,120,160,320,0,930
62364,180,100,40,80,160,320,880
62365,220,120,80,0,0,0,420
62366,220,120,160,160,160,0,820
62367,230,120,160,80,160,0,750
62368,170,120,160,160,320,320,1250
62369,140,80,80,0,0,0,300
62370,180,100,160,240,160,0,840
62371,180,160,200,240,0,0,780
62372,200,180,200,80,0,0,660
62373,200,100,80,0,0,0,380
62374,150,100,80,80,160,0,570
62375,220,140,160,240,320,320,1400
62376,220,160,120,160,160,0,820
62377,240,160,200,240,320,320,1480
62378,210,160,120,240,320,0,1050
62379,220,140,120,0,0,0,480
62380,170,120,40,0,0,0,330
62381,200,60,40,80,160,0,540
62382,200,100,80,80,160,320,940
62383,200,160,120,80,0,0,560
62384,210,100,120,160,160,0,750
62385,180,140,160,160,0,0,640
62386,200,160,200,80,0,0,640
62387,200,80,40,80,0,0,400
62388,210,140,40,80,160,0,630
62389,200,60,80,80,0,0,420
62390,220,100,80,80,160,0,640
62391,200,120,120,80,160,0,680
62392,200,120,160,80,0,0,560
62393,220,120,80,0,0,0,420
62394,200,100,120,160,0,0,580
62395,190,120,160,240,0,0,710
62396,230,80,120,160,0,0,590
62397,190,120,80,80,160,0,630
62398,220,120,120,80,160,320,1020
62399,190,120,120,160,320,0,910
62400,240,160,120,160,0,0,680
62401,180,180,160,160,160,320,1160
62402,190,180,160,80,160,0,770
62403,240,100,40,0,0,0,380
62404,170,140,120,80,160,0,670
62405,210,140,80,160,320,0,910
62406,180,80,120,160,160,0,700
62407,200,140,160,160,160,0,820
62408,190,80,80,160,160,0,670
62409,210,120,80,80,0,0,490
62410,190,120,40,80,160,0,590
62411,200,140,120,80,160,0,700
62412,210,160,160,160,160,0,850
62413,220,120,80,80,0,0,500
62414,160,100,160,80,0,0,500
62415,170,80,80,160,0,0,490
62416,190,100,120,160,160,0,730
62417,190,140,120,80,0,0,530
62418,190,100,40,80,0,0,410
62419,210,160,120,80,160,0,730
62420,210,140,80,160,160,0,750
62421,190,200,120,0,0,0,510
62422,200,160,160,160,0,0,680
62423,190,80,120,240,160,320,1110
62424,200,120,40,80,0,0,440
62425,170,100,120,160,160,0,710
62426,160,80,80,80,160,0,560
62427,210,100,40,0,0,0,350
62428,180,60,0,0,0,0,240
62429,150,160,160,80,160,0,710
62430,200,120,120,80,160,0,680
62431,200,120,120,80,160,0,680
62432,180,120,120,160,160,0,740
62433,180,140,160,80,160,0,720
62434,160,100,40,0,0,0,300
62435,220,120,40,0,0,0,380
62436,190,120,80,80,160,0,630
62437,190,120,40,80,160,0,590
62438,210,100,40,80,160,0,590
62439,220,160,40,80,160,0,660
62440,240,140,80,80,0,0,540
62441,130,80,80,80,0,0,370
62442,200,120,80,80,0,0,480
62443,180,180,200,80,160,0,800
62444,270,240,200,160,320,0,1190
62445,190,180,200,160,160,0,890
62446,210,80,0,0,0,0,290
62447,200,140,160,160,160,0,820
62448,200,140,40,80,160,0,620
62449,210,100,40,80,160,0,590
62450,200,80,80,0,0,0,360
62451,160,140,120,0,0,0,420
62452,190,120,120,80,160,0,670
62453,180,80,40,0,0,0,300
62454,180,80,80,80,0,0,420
62455,160,100,80,80,0,0,420
62456,190,60,80,80,160,0,570
62457,190,120,80,80,160,0,630
62458,190,100,120,0,0,0,410
62459,220,160,80,80,160,0,700
62460,200,120,80,80,0,0,480
62461,190,140,40,80,0,0,450
62462,220,120,120,80,0,0,540
62463,220,120,120,0,0,0,460
62464,210,120,0,0,0,0,330
62465,170,100,80,80,160,0,590
62466,200,180,160,160,320,320,1340
62467,190,100,80,80,160,0,610
62468,200,100,120,80,0,0,500
62469,230,140,80,0,0,0,450
62470,230,120,160,160,320,320,1310
62471,200,140,80,80,0,0,500
62472,250,240,160,0,0,0,650
62473,210,160,120,160,0,0,650
62474,180,120,160,80,160,0,700
62475,230,120,120,240,320,0,1030
62476,170,120,40,80,0,0,410
62477,210,160,160,0,0,0,530
62478,210,120,120,80,0,0,530
62479,220,140,120,240,320,320,1360
62480,180,100,120,80,160,0,640
62481,220,180,80,80,0,0,560
62482,240,180,80,80,0,0,580
62483,200,160,120,160,320,320,1280
62484,200,100,120,160,0,0,580
62485,200,140,120,160,160,0,780
62486,210,80,40,80,0,0,410
62487,180,180,120,160,0,0,640
62488,180,120,80,80,160,0,620
62489,200,140,120,240,320,320,1340
62490,160,160,40,80,0,0,440
62491,220,140,40,0,0,0,400
62492,180,100,80,80,0,0,440
62493,160,140,0,0,0,0,300
62494,160,80,80,0,0,0,320
62495,170,140,120,80,0,0,510
62496,220,120,120,160,160,0,780
62497,190,140,120,160,160,0,770
62498,200,140,120,160,160,0,780
62499,180,120,160,160,320,320,1260
62500,230,180,160,0,0,0,570
62501,200,100,80,80,0,0,460
62502,130,100,0,0,0,0,230
62503,160,100,40,80,160,320,860
62504,150,120,40,80,0,0,390
62505,270,140,80,160,160,320,1130
62506,200,100,120,0,0,0,420
62507,190,120,80,160,320,0,870
62508,140,120,80,80,160,0,580
62509,200,60,40,80,160,320,860
62510,220,120,160,160,0,0,660
62511,170,120,120,80,160,0,650
62512,200,160,160,80,0,0,600
62513,200,120,120,160,160,0,760
62514,210,120,120,160,160,320,1090
62515,220,120,120,0,0,0,460
62516,150,60,80,0,0,0,290
62517,200,140,80,80,160,320,980
62518,200,100,80,160,160,320,1020
62519,180,180,160,80,160,0,760
62520,220,60,80,80,160,0,600
62521,230,180,120,160,160,0,850
62522,160,120,120,80,160,0,640
62523,210,140,200,80,160,0,790
62524,180,60,80,80,0,0,400
62525,180,120,200,240,320,0,1060
62526,190,120,200,240,160,0,910
62527,200,120,200,80,160,0,760
62528,180,160,120,160,0,0,620
62529,200,120,80,80,160,0,640
62530,170,120,160,80,160,0,690
62531,160,80,80,80,0,0,400
62532,170,140,40,0,0,0,350
62533,210,140,120,160,320,0,950
62534,210,160,40,80,0,0,490
62535,200,60,40,80,160,0,540
62536,190,120,40,80,160,0,590
62537,200,120,120,160,320,320,1240
62538,210,140,80,80,0,0,510
62539,200,100,120,160,320,320,1220
62540,240,120,160,240,320,320,1400
62541,210,120,120,80,0,0,530
62542,170,80,80,80,160,0,570
62543,200,140,120,80,160,0,700
62544,190,80,120,160,160,0,710
62545,200,80,120,80,160,0,640
62546,200,160,160,160,320,0,1000
62547,210,100,80,160,320,320,1190
62548,230,100,120,160,160,320,1090
62549,200,140,80,0,0,0,420
62550,190,120,80,80,160,0,630
62551,240,160,120,160,160,0,840
62552,200,100,80,80,160,0,620
62553,250,160,120,240,320,0,1090
62554,180,100,160,240,320,0,1000
62555,180,100,80,80,160,320,920
62556,240,180,120,80,0,0,620
62557,210,140,80,0,0,0,430
62558,190,60,40,0,0,0,290
62559,210,180,200,240,320,320,1470
62560,190,140,80,0,0,0,410
62561,200,140,160,240,320,320,1380
62562,210,120,160,240,0,0,730
62563,200,100,80,80,160,0,620
62564,220,80,80,80,0,0,460
62565,230,120,80,80,0,0,510
62566,210,120,80,0,0,0,410
62567,180,160,120,160,0,0,620
62568,220,180,160,160,0,0,720
62569,180,80,80,160,160,320,980
62570,220,140,80,80,160,0,680
62571,190,160,160,160,160,0,830
62572,200,180,120,80,160,0,740
62573,190,140,80,0,0,0,410
62574,220,120,40,0,0,0,380
62575,230,140,120,160,320,0,970
62576,210,160,120,80,0,0,570
62577,200,140,40,0,0,0,380
62578,190,120,80,80,0,0,470
62579,200,120,160,80,160,320,1040
62580,210,100,160,160,0,0,630
62581,250,120,160,160,320,0,1010
62582,220,100,40,80,160,0,600
62583,160,80,80,0,0,0,320
62584,220,120,160,80,160,0,740
62585,160,120,40,0,0,0,320
62586,230,80,80,0,0,0,390
62587,220,220,200,80,0,0,720
62588,210,120,160,160,320,0,970
62589,160,100,120,80,160,0,620
62590,150,120,120,160,160,0,710
62591,210,180,120,0,0,0,510
62592,210,140,160,160,320,0,990
62593,150,100,40,80,0,0,370
62594,210,140,120,160,0,0,630
62595,220,140,160,80,160,320,1080
62596,220,120,120,160,160,0,780
62597,170,100,120,80,0,0,470
62598,210,100,120,160,160,0,750
62599,230,60,0,0,0,0,290
62600,220,140,120,80,0,0,560
62601,220,120,80,80,160,0,660
62602,190,140,160,240,160,320,1210
62603,190,120,80,160,160,0,710
62604,190,120,120,80,160,320,990
62605,240,100,120,160,320,0,940
62606,160,120,80,160,320,0,840
62607,130,60,80,80,160,0,510
62608,200,160,160,240,320,320,1400
62609,190,120,80,160,160,0,710
62610,170,80,0,0,0,0,250
62611,210,120,120,80,160,0,690
62612,200,80,80,160,160,320,1000
62613,160,120,120,80,160,0,640
62614,180,80,80,80,160,320,900
62615,200,120,80,80,160,0,640
62616,220,100,40,80,160,0,600
62617,200,120,160,240,320,320,1360
62618,200,100,80,80,0,0,460
62619,190,120,200,160,160,0,830
62620,170,120,120,80,160,0,650
62621,180,100,160,160,160,320,1080
62622,200,120,160,80,0,0,560
62623,180,140,80,80,160,0,640
62624,190,100,160,160,320,0,930
62625,220,100,80,80,0,0,480
62626,200,100,40,80,160,0,580
62627,210,80,120,80,0,0,490
62628,180,140,40,80,0,0,440
62629,200,100,160,240,320,320,1340
62630,190,120,80,80,160,0,630
62631,190,140,160,160,0,0,650
62632,230,140,120,80,160,0,730
62633,180,80,40,80,160,320,860
62634,190,80,120,240,320,0,950
62635,130,120,80,80,160,0,570
62636,170,60,40,0,0,0,270
62637,170,100,80,0,0,0,350
62638,190,60,40,0,0,0,290
62639,190,100,120,80,0,0,490
62640,170,140,120,160,320,0,910
62641,250,160,120,160,160,0,850
62642,200,120,80,160,0,0,560
62643,240,140,80,80,0,0,540
62644,200,120,80,80,0,0,480
62645,180,160,120,0,0,0,460
62646,190,120,120,160,320,0,910
62647,240,180,120,160,160,0,860
62648,180,140,120,160,160,0,760
62649,150,160,120,80,160,0,670
62650,180,160,120,240,320,0,1020
62651,190,120,80,80,160,0,630
62652,160,100,80,80,160,0,580
62653,200,160,160,160,160,0,840
62654,160,80,80,80,160,0,560
62655,170,80,80,160,160,0,650
62656,220,100,40,80,0,0,440
62657,190,140,120,160,160,0,770
62658,180,120,120,240,0,0,660
62659,230,140,160,160,160,0,850
62660,180,140,160,160,160,320,1120
62661,220,120,80,80,0,0,500
62662,200,140,80,80,160,0,660
62663,160,80,40,0,0,0,280
62664,190,80,120,80,160,0,630
62665,220,80,0,0,0,0,300
62666,150,140,160,80,0,0,530
62667,240,160,160,160,0,0,720
62668,230,180,80,80,160,320,1050
62669,160,180,160,160,320,320,1300
62670,220,120,160,160,160,0,820
62671,180,140,120,0,0,0,440
62672,210,80,40,80,160,0,570
62673,190,120,160,160,0,0,630
62674,210,140,120,160,160,320,1110
62675,180,140,120,160,0,0,600
62676,210,160,120,80,160,0,730
62677,150,140,160,160,160,0,770
62678,170,160,40,80,160,0,610
62679,200,140,80,80,160,0,660
62680,180,160,160,80,0,0,580
62681,230,140,160,160,320,0,1010
62682,230,120,120,160,320,0,950
62683,170,100,40,0,0,0,310
62684,240,100,160,160,160,0,820
62685,210,120,80,0,0,0,410
62686,260,200,160,160,160,0,940
62687,230,120,40,80,0,0,470
62688,210,100,80,160,160,0,710
62689,180,100,80,80,160,0,600
62690,230,80,40,80,0,0,430
62691,220,140,120,80,160,0,720
62692,210,160,80,80,0,0,530
62693,220,120,160,160,160,320,1140
62694,210,160,160,160,160,0,850
62695,160,120,160,160,160,320,1080
62696,200,120,80,0,0,0,400
62697,200,120,120,80,0,0,520
62698,260,140,160,80,160,0,800
62699,190,120,80,160,160,0,710
62700,200,100,80,0,0,0,380
62701,230,100,80,80,0,0,490
62702,190,120,0,0,0,0,310
62703,230,160,200,160,160,0,910
62704,170,100,160,80,160,0,670
62705,210,140,80,0,0,0,430
62706,230,180,160,240,160,0,970
62707,200,100,80,80,160,0,620
62708,190,80,80,0,0,0,350
62709,200,140,120,240,320,0,1020
62710,210,160,160,80,160,0,770
62711,200,160,120,80,0,0,560
62712,170,100,160,160,320,320,1230
62713,220,100,40,80,160,320,920
62714,160,60,80,0,0,0,300
62715,190,100,120,160,160,0,730
62716,210,140,160,240,320,0,1070
62717,220,80,40,0,0,0,340
62718,180,140,200,240,320,320,1400
62719,200,100,120,160,320,0,900
62720,240,100,40,0,0,0,380
62721,220,120,160,160,320,0,980
62722,190,60,40,80,160,0,530
62723,160,180,160,160,160,0,820
62724,160,80,80,80,0,0,400
62725,180,140,200,80,160,0,760
62726,210,120,40,0,0,0,370
62727,190,100,80,80,160,0,610
62728,220,180,160,80,160,0,800
62729,200,140,80,160,160,0,740
62730,170,120,200,160,160,0,810
62731,160,120,120,160,320,0,880
62732,210,180,200,160,160,0,910
62733,230,160,80,80,160,320,1030
62734,200,80,40,0,0,0,320
62735,200,120,120,80,0,0,520
62736,210,140,120,160,160,0,790
62737,140,160,160,0,0,0,460
62738,170,100,160,80,160,0,670
62739,200,120,80,0,0,0,400
62740,180,100,80,80,160,0,600
62741,170,140,200,160,160,0,830
62742,190,140,80,80,0,0,490
62743,160,60,80,80,160,0,540
62744,190,120,80,0,0,0,390
62745,170,120,120,80,160,0,650
62746,170,120,160,80,0,0,530
62747,230,200,240,80,160,0,910
62748,220,100,120,80,160,0,680
62749,190,120,80,0,0,0,390
62750,210,100,80,160,0,0,550
62751,240,120,120,160,160,320,1120
62752,210,140,120,240,160,0,870
62753,200,160,120,80,160,320,1040
62754,170,160,160,0,0,0,490
62755,210,180,80,80,160,0,710
62756,180,120,160,240,320,320,1340
62757,160,120,80,80,160,320,920
62758,220,160,80,160,160,0,780
62759,200,180,120,80,160,0,740
62760,230,180,80,80,160,320,1050
62761,190,100,80,80,160,0,610
62762,170,60,40,80,0,0,350
62763,150,80,40,0,0,0,270
62764,170,140,160,80,160,320,1030
62765,210,100,80,80,160,0,630
62766,220,220,200,80,160,0,880
62767,190,120,80,0,0,0,390
62768,170,120,40,80,0,0,410
62769,200,100,160,80,160,320,1020
62770,230,80,40,80,0,0,430
62771,190,140,160,160,160,320,1130
62772,190,120,80,160,160,0,710
62773,210,180,120,160,160,0,830
62774,230,140,80,0,0,0,450
62775,200,100,120,80,160,0,660
62776,210,100,160,80,160,0,710
62777,250,160,80,80,0,0,570
62778,180,80,160,160,160,320,1060
62779,200,140,120,160,160,0,780
62780,240,160,80,80,160,0,720
62781,190,160,40,0,0,0,390
62782,190,160,120,160,160,320,1110
62783,180,140,120,160,160,0,760
62784,180,80,80,160,160,320,980
62785,210,100,80,160,320,0,870
62786,160,120,160,160,160,0,760
62787,220,160,120,160,160,0,820
62788,210,200,240,80,160,0,890
62789,230,180,120,160,160,0,850
62790,210,140,160,160,160,320,1150
62791,160,120,120,160,160,0,720
62792,190,160,160,80,0,0,590
62793,180,100,40,80,160,0,560
62794,210,140,80,80,160,0,670
62795,200,140,120,80,160,0,700
62796,210,100,80,80,0,0,470
62797,150,100,80,0,0,0,330
62798,220,40,80,80,160,0,580
62799,180,80,80,160,320,0,820
62800,170,120,40,80,160,0,570
62801,180,80,40,0,0,0,300
62802,190,120,120,80,160,320,990
62803,240,80,160,160,160,0,800
62804,210,80,40,0,0,0,330
62805,190,100,160,160,320,0,930
62806,200,160,120,80,160,0,720
62807,210,80,40,80,160,0,570
62808,190,80,80,160,0,0,510
62809,210,160,80,80,0,0,530
62810,180,60,0,0,0,0,240
62811,170,80,40,0,0,0,290
62812,210,140,120,80,160,0,710
62813,230,140,80,80,0,0,530
62814,220,120,160,240,160,0,900
62815,210,160,40,0,0,0,410
62816,200,120,80,0,0,0,400
62817,200,60,120,80,160,0,620
62818,200,160,200,160,320,0,1040
62819,200,180,160,160,0,0,700
62820,190,120,40,80,160,320,910
62821,200,120,160,160,320,320,1280
62822,190,120,40,0,0,0,350
62823,210,80,80,160,160,0,690
62824,160,80,40,80,160,0,520
62825,160,100,120,80,160,0,620
62826,160,80,80,80,160,0,560
62827,210,120,80,80,160,0,650
62828,180,100,40,80,160,0,560
62829,170,140,80,0,0,0,390
62830,220,200,160,160,160,320,1220
62831,210,120,80,160,160,0,730
62832,210,120,120,80,160,0,690
62833,160,180,120,0,0,0,460
62834,200,120,80,0,0,0,400
62835,190,80,40,80,160,0,550
62836,190,120,40,0,0,0,350
62837,210,40,80,160,160,0,650
62838,190,100,40,80,160,0,570
62839,160,120,120,160,160,320,1040
62840,210,140,120,160,160,320,1110
62841,200,120,40,80,160,0,600
62842,200,160,160,240,160,320,1240
62843,200,120,120,160,320,320,1240
62844,180,100,80,80,160,0,600
62845,180,120,80,160,320,320,1180
62846,150,80,40,0,0,0,270
62847,180,120,40,80,0,0,420
62848,200,60,40,0,0,0,300
62849,210,160,80,80,160,0,690
62850,150,120,120,80,160,0,630
62851,240,220,120,80,0,0,660
62852,180,80,40,0,0,0,300
62853,210,80,80,80,0,0,450
62854,200,120,80,160,160,320,1040
62855,170,100,80,0,0,0,350
62856,210,140,160,160,160,0,830
62857,160,100,160,160,0,0,580
62858,190,120,120,80,160,320,990
62859,190,100,80,80,160,0,610
62860,190,100,120,160,320,0,890
62861,210,100,120,80,160,0,670
62862,210,60,40,0,0,0,310
62863,200,140,160,240,320,0,1060
62864,190,160,120,160,160,0,790
62865,200,100,40,0,0,0,340
62866,210,140,80,0,0,0,430
62867,210,160,80,80,160,0,690
62868,210,160,160,80,0,0,610
62869,170,100,40,80,160,0,550
62870,220,120,120,80,160,0,700
62871,250,120,120,160,160,0,810
62872,210,100,160,240,320,320,1350
62873,220,140,200,240,160,0,960
62874,230,120,120,80,0,0,550
62875,230,140,120,160,320,0,970
62876,200,140,200,240,160,0,940
62877,180,140,120,80,0,0,520
62878,210,80,80,0,0,0,370
62879,170,100,120,160,160,0,710
62880,190,120,40,0,0,0,350
62881,190,120,80,160,160,0,710
62882,230,100,80,160,160,0,730
62883,230,140,200,160,160,320,1210
62884,240,160,40,80,160,0,680
62885,240,80,120,160,320,320,1240
62886,200,120,40,80,160,0,600
62887,220,140,80,80,160,0,680
62888,210,100,80,80,160,0,630
62889,200,60,40,0,0,0,300
62890,200,40,0,0,0,0,240
62891,190,80,40,80,0,0,390
62892,210,100,80,80,0,0,470
62893,250,140,120,0,0,0,510
62894,190,100,80,80,160,0,610
62895,220,120,80,80,160,0,660
62896,170,60,80,80,0,0,390
62897,200,120,80,160,160,0,720
62898,180,140,160,160,0,0,640
62899,210,100,40,80,160,0,590
62900,200,180,120,160,160,0,820
62901,160,100,80,160,320,320,1140
62902,190,80,40,80,160,0,550
62903,210,100,80,80,0,0,470
62904,190,120,160,240,160,320,1190
62905,180,120,160,160,320,0,940
62906,180,140,120,160,0,0,600
62907,180,120,80,80,0,0,460
62908,180,140,120,240,320,0,1000
62909,190,160,160,80,160,320,1070
62910,190,100,160,160,0,0,610
62911,200,160,120,80,160,0,720
62912,180,120,120,160,0,0,580
62913,200,160,160,160,160,320,1160
62914,190,180,80,80,0,0,530
62915,220,140,80,0,0,0,440
62916,210,120,40,0,0,0,370
62917,210,140,160,160,160,0,830
62918,160,60,40,80,0,0,340
62919,180,140,120,0,0,0,440
62920,220,100,80,80,0,0,480
62921,220,100,80,80,160,0,640
62922,190,80,160,240,160,0,830
62923,240,160,160,80,0,0,640
62924,170,120,80,80,160,0,610
62925,220,160,120,160,160,320,1140
62926,180,120,80,160,320,0,860
62927,170,100,80,0,0,0,350
62928,210,140,40,80,0,0,470
62929,200,80,80,0,0,0,360
62930,200,160,120,160,320,0,960
62931,190,160,120,160,160,320,1110
62932,250,140,120,80,0,0,590
62933,200,120,80,80,160,320,960
62934,190,140,160,80,160,0,730
62935,160,120,160,160,0,0,600
62936,150,80,40,80,160,0,510
62937,200,100,120,80,0,0,500
62938,190,60,80,160,160,0,650
62939,200,100,80,80,160,0,620
62940,220,140,120,80,160,0,720
62941,210,180,160,160,320,0,1030
62942,170,120,0,0,0,0,290
62943,190,100,120,80,0,0,490
62944,200,120,80,0,0,0,400
62945,240,180,160,240,160,0,980
62946,200,80,40,80,160,0,560
62947,230,140,160,160,160,0,850
62948,190,120,120,160,0,0,590
62949,240,120,120,160,160,0,800
62950,190,160,160,80,0,0,590
62951,210,180,120,160,0,0,670
62952,210,160,120,80,160,0,730
62953,200,80,80,80,160,0,600
62954,190,140,120,160,0,0,610
62955,210,140,160,80,160,320,1070
62956,220,160,160,80,0,0,620
62957,220,120,80,80,0,0,500
62958,210,140,80,80,160,0,670
62959,150,100,40,0,0,0,290
62960,190,160,160,0,0,0,510
62961,170,80,0,0,0,0,250
62962,200,120,80,0,0,0,400
62963,210,100,80,80,160,0,630
62964,190,160,40,80,0,0,470
62965,200,160,120,160,160,0,800
62966,220,120,80,80,0,0,500
62967,220,100,80,160,0,0,560
62968,240,140,120,160,320,0,980
62969,210,120,160,0,0,0,490
62970,220,100,120,160,0,0,600
62971,230,160,160,240,160,0,950
62972,170,120,80,160,160,0,690
62973,160,140,40,0,0,0,340
62974,220,160,160,160,160,0,860
62975,220,160,240,160,160,320,1260
62976,180,120,120,160,0,0,580
62977,190,120,120,160,0,0,590
62978,200,100,160,160,0,0,620
62979,190,120,160,80,160,0,710
62980,180,140,160,80,160,320,1040
62981,210,80,80,80,160,0,610
62982,180,60,120,160,160,0,680
62983,180,120,80,80,160,0,620
62984,230,120,120,80,0,0,550
62985,180,160,120,80,0,0,540
62986,200,160,80,160,160,0,760
62987,190,140,40,80,0,0,450
62988,200,120,120,0,0,0,440
62989,190,140,160,80,0,0,570
62990,160,80,120,160,160,0,680
62991,220,140,120,0,0,0,480
62992,200,180,200,160,160,0,900
62993,190,100,120,160,160,320,1050
62994,160,100,160,80,160,0,660
62995,180,80,80,80,0,0,420
62996,180,140,120,80,0,0,520
62997,250,160,160,80,0,0,650
62998,190,140,200,160,160,0,850
62999,190,100,80,80,0,0,450
63000,190,60,40,80,0,0,370
63001,270,140,80,80,160,0,730
63002,180,40,0,0,0,0,220
63003,200,140,120,160,160,0,780
63004,170,120,120,80,160,0,650
63005,190,120,80,0,0,0,390
63006,230,80,40,80,160,0,590
63007,220,40,80,160,320,320,1140
63008,200,140,200,80,0,0,620
63009,180,140,120,0,0,0,440
63010,200,160,120,160,160,320,1120
63011,200,120,120,160,160,0,760
63012,220,60,80,80,160,0,600
63013,210,80,160,240,160,0,850
63014,210,160,120,80,160,0,730
63015,200,120,80,0,0,0,400
63016,180,100,80,80,0,0,440
63017,200,180,160,80,160,0,780
63018,180,120,120,160,160,0,740
63019,180,140,120,0,0,0,440
63020,200,140,160,80,160,0,740
63021,160,120,80,80,160,0,600
63022,190,100,40,80,0,0,410
63023,220,180,120,160,160,0,840
63024,160,120,120,160,320,0,880
63025,200,140,200,240,320,0,1100
63026,190,160,120,0,0,0,470
63027,210,100,80,0,0,0,390
63028,180,80,40,0,0,0,300
63029,220,140,80,160,0,0,600
63030,170,80,120,160,0,0,530
63031,200,140,160,160,160,320,1140
63032,130,140,200,160,160,0,790
63033,180,120,40,80,160,0,580
63034,200,160,40,0,0,0,400
63035,190,140,160,160,320,0,970
63036,200,120,80,80,0,0,480
63037,190,140,120,160,0,0,610
63038,200,100,80,80,0,0,460
63039,170,80,40,80,160,320,850
63040,240,100,80,0,0,0,420
63041,180,160,120,160,320,320,1260
63042,180,100,80,0,0,0,360
63043,200,160,80,80,160,0,680
63044,180,160,160,160,160,320,1140
63045,200,100,160,160,0,0,620
63046,190,120,80,0,0,0,390
63047,210,140,80,80,160,0,670
63048,200,160,160,240,160,0,920
63049,180,80,40,80,160,0,540
63050,160,100,120,160,160,0,700
63051,180,80,40,80,160,0,540
63052,180,140,120,160,160,0,760
63053,170,120,160,240,160,0,850
63054,170,120,80,80,160,0,610
63055,220,160,80,80,160,0,700
63056,220,200,40,80,160,0,700
63057,170,140,80,80,0,0,470
63058,200,120,120,160,320,320,1240
63059,210,120,200,160,160,0,850
63060,230,60,40,0,0,0,330
63061,200,100,120,80,160,0,660
63062,180,80,120,80,160,0,620
63063,210,120,120,160,160,0,770
63064,190,80,80,80,160,0,590
63065,230,120,120,240,160,0,870
63066,240,140,120,160,160,320,1140
63067,200,120,40,80,160,320,920
63068,190,140,120,80,160,0,690
63069,160,100,120,160,160,0,700
63070,190,120,80,80,160,0,630
63071,210,140,80,80,160,0,670
63072,210,140,120,80,160,320,1030
63073,200,120,40,0,0,0,360
63074,210,160,120,160,320,320,1290
63075,170,120,40,80,160,0,570
63076,170,140,80,160,160,320,1030
63077,180,100,120,80,0,0,480
63078,190,120,80,80,0,0,470
63079,150,120,160,80,160,320,990
63080,210,100,120,160,160,0,750
63081,190,100,120,160,320,0,890
63082,230,140,80,80,0,0,530
63083,200,120,80,160,320,0,880
63084,180,100,120,80,0,0,480
63085,230,120,160,80,0,0,590
63086,160,80,40,80,160,320,840
63087,160,120,40,80,0,0,400
63088,190,160,120,80,0,0,550
63089,200,140,120,240,320,0,1020
63090,200,140,160,240,160,0,900
63091,160,60,80,80,160,320,860
63092,230,140,40,0,0,0,410
63093,140,100,80,0,0,0,320
63094,200,120,120,240,320,320,1320
63095,220,140,160,240,320,320,1400
63096,190,120,80,0,0,0,390
63097,210,140,120,160,0,0,630
63098,170,80,0,0,0,0,250
63099,220,120,160,80,160,0,740
63100,160,100,160,240,160,320,1140
63101,180,120,160,240,320,0,1020
63102,220,140,160,160,160,0,840
63103,180,140,120,80,160,0,680
63104,200,140,80,80,160,320,980
63105,200,120,200,80,0,0,600
63106,220,180,160,240,320,0,1120
63107,210,100,80,0,0,0,390
63108,190,120,40,80,160,0,590
63109,230,140,80,80,0,0,530
63110,160,100,120,80,0,0,460
63111,150,120,80,80,160,320,910
63112,180,140,160,160,320,0,960
63113,230,140,40,0,0,0,410
63114,200,200,120,0,0,0,520
63115,200,60,80,160,160,320,980
63116,220,180,200,240,320,0,1160
63117,220,120,120,80,0,0,540
63118,200,80,80,80,0,0,440
63119,200,160,160,240,160,0,920
63120,230,160,80,80,0,0,550
63121,180,140,120,160,160,0,760
63122,190,120,120,80,0,0,510
63123,230,100,80,80,160,0,650
63124,180,140,80,80,160,0,640
63125,210,160,120,160,160,0,810
63126,170,60,80,0,0,0,310
63127,150,140,160,80,0,0,530
63128,200,100,120,160,0,0,580
63129,170,120,80,80,160,0,610
63130,180,100,80,80,0,0,440
63131,230,140,120,160,160,0,810
63132,180,100,160,160,320,320,1240
63133,200,200,240,240,320,0,1200
63134,270,100,0,0,0,0,370
63135,190,160,160,160,320,0,990
63136,200,140,120,80,0,0,540
63137,190,140,80,0,0,0,410
63138,160,80,80,80,160,320,880
63139,190,120,40,80,160,0,590
63140,210,160,160,160,0,0,690
63141,210,120,80,80,160,320,970
63142,210,80,40,0,0,0,330
63143,240,120,160,160,160,0,840
63144,190,160,80,160,160,0,750
63145,190,100,80,80,0,0,450
63146,190,100,120,160,0,0,570
63147,190,140,80,80,160,0,650
63148,220,160,160,240,160,0,940
63149,200,180,160,160,0,0,700
63150,210,140,120,160,320,0,950
63151,200,120,120,80,0,0,520
63152,230,120,160,160,160,0,830
63153,210,100,120,160,160,0,750
63154,200,140,120,80,160,0,700
63155,190,120,80,80,160,0,630
63156,180,120,40,0,0,0,340
63157,240,140,120,80,160,0,740
63158,210,100,120,80,160,0,670
63159,200,140,120,80,0,0,540
63160,210,120,80,0,0,0,410
63161,170,120,120,80,160,0,650
63162,200,120,80,0,0,0,400
63163,170,100,80,80,160,0,590
63164,220,140,160,80,0,0,600
63165,180,160,40,80,160,0,620
63166,170,140,80,160,160,0,710
63167,200,60,40,80,160,0,540
63168,160,120,40,80,0,0,400
63169,180,100,80,80,160,0,600
63170,200,80,80,80,160,0,600
63171,180,140,80,80,160,0,640
63172,260,140,120,80,160,0,760
63173,180,140,80,0,0,0,400
63174,160,140,80,80,160,0,620
63175,210,180,160,80,0,0,630
63176,200,180,160,240,320,0,1100
63177,150,140,120,160,320,0,890
63178,190,140,40,80,160,0,610
63179,160,40,40,0,0,0,240
63180,240,140,160,80,160,0,780
63181,220,180,80,80,0,0,560
63182,220,140,80,0,0,0,440
63183,200,120,40,0,0,0,360
63184,210,100,80,0,0,0,390
63185,160,100,80,160,160,0,660
63186,180,80,120,80,160,320,940
63187,240,180,120,80,0,0,620
63188,200,160,160,160,0,0,680
63189,190,120,120,80,0,0,510
63190,210,180,40,80,160,0,670
63191,180,80,80,80,0,0,420
63192,150,100,120,0,0,0,370
63193,220,120,80,80,0,0,500
63194,190,140,120,240,160,0,850
63195,200,120,80,80,160,0,640
63196,210,120,120,80,0,0,530
63197,190,120,80,160,0,0,550
63198,200,120,160,160,320,0,960
63199,180,140,120,80,160,0,680
63200,190,160,120,80,160,0,710
63201,240,160,200,240,160,320,1320
63202,230,140,160,80,160,0,770
63203,160,100,120,80,160,0,620
63204,220,140,120,80,160,0,720
63205,220,140,160,240,320,320,1400
63206,190,80,40,80,160,0,550
63207,200,140,200,160,0,0,700
63208,190,200,200,160,0,0,750
63209,200,140,160,80,160,0,740
63210,220,120,120,80,0,0,540
63211,190,20,40,80,0,0,330
63212,210,100,120,160,160,0,750
63213,220,100,80,160,160,0,720
63214,170,140,120,160,160,0,750
63215,250,200,120,80,160,0,810
63216,190,100,80,160,0,0,530
63217,200,120,80,0,0,0,400
63218,190,160,200,160,160,0,870
63219,170,100,120,160,160,0,710
63220,230,200,120,0,0,0,550
63221,210,160,120,80,0,0,570
63222,230,180,240,240,160,0,1050
63223,170,120,0,0,0,0,290
63224,230,140,80,80,160,0,690
63225,180,100,80,0,0,0,360
63226,240,140,120,80,0,0,580
63227,210,160,200,240,160,0,970
63228,230,140,80,80,160,0,690
63229,220,60,80,160,320,0,840
63230,210,180,40,80,0,0,510
63231,210,180,200,80,0,0,670
63232,170,120,160,160,0,0,610
63233,190,100,80,80,160,0,610
63234,180,120,160,160,160,0,780
63235,240,160,160,160,160,0,880
63236,180,100,120,80,160,0,640
63237,220,100,80,160,320,0,880
63238,180,100,120,160,160,0,720
63239,220,140,80,80,160,0,680
63240,200,100,80,80,160,320,940
63241,190,100,120,80,160,0,650
63242,170,100,40,0,0,0,310
63243,190,100,40,80,160,0,570
63244,170,140,160,160,160,0,790
63245,210,140,80,0,0,0,430
63246,210,120,80,80,160,0,650
63247,160,80,40,80,160,0,520
63248,170,160,120,80,160,0,690
63249,190,100,80,0,0,0,370
63250,230,160,40,0,0,0,430
63251,180,140,160,240,320,0,1040
63252,180,100,80,80,160,0,600
63253,180,120,80,160,160,0,700
63254,170,120,160,80,0,0,530
63255,230,160,80,80,0,0,550
63256,180,80,80,160,0,0,500
63257,190,160,160,80,160,0,750
63258,190,80,120,80,160,0,630
63259,200,100,40,0,0,0,340
63260,150,140,80,0,0,0,370
63261,230,100,40,0,0,0,370
63262,200,160,200,80,160,0,800
63263,230,160,160,0,0,0,550
63264,220,120,80,80,0,0,500
63265,220,80,120,160,160,0,740
63266,180,120,120,80,160,0,660
63267,230,180,120,160,160,320,1170
63268,200,60,40,0,0,0,300
63269,220,120,120,160,320,0,940
63270,200,120,120,80,160,0,680
63271,240,120,120,0,0,0,480
63272,240,160,80,0,0,0,480
63273,140,120,80,0,0,0,340
63274,200,60,40,0,0,0,300
63275,190,160,120,160,160,0,790
63276,150,100,80,80,160,0,570
63277,180,120,80,80,0,0,460
63278,190,140,120,160,160,0,770
63279,230,140,120,160,160,0,810
63280,190,160,200,160,320,0,1030
63281,210,140,80,80,160,0,670
63282,190,100,40,80,160,0,570
63283,210,120,80,80,0,0,490
63284,240,160,120,240,0,0,760
63285,230,140,80,80,160,0,690
63286,190,140,120,80,160,0,690
63287,180,100,80,160,320,0,840
63288,220,100,80,160,320,0,880
63289,170,100,120,80,0,0,470
63290,220,120,120,80,0,0,540
63291,220,120,80,80,0,0,500
63292,220,140,240,160,160,0,920
63293,210,200,80,0,0,0,490
63294,170,100,40,0,0,0,310
63295,200,120,160,160,0,0,640
63296,220,140,200,160,0,0,720
63297,200,100,120,80,160,320,980
63298,180,140,80,80,0,0,480
63299,190,120,40,0,0,0,350
63300,180,100,120,160,0,0,560
63301,200,180,160,80,160,0,780
63302,180,60,40,80,0,0,360
63303,220,120,80,80,160,0,660
63304,170,120,40,80,0,0,410
63305,190,140,120,0,0,0,450
63306,190,100,120,80,160,0,650
63307,210,80,80,80,160,0,610
63308,170,80,160,240,320,0,970
63309,210,140,120,80,160,0,710
63310,220,120,120,80,0,0,540
63311,220,140,120,160,160,0,800
63312,200,180,120,0,0,0,500
63313,200,120,120,240,160,0,840
63314,200,120,120,80,0,0,520
63315,210,140,120,160,160,0,790
63316,180,100,120,160,0,0,560
63317,180,160,80,80,0,0,500
63318,170,140,40,0,0,0,350
63319,180,160,80,160,320,0,900
63320,210,160,120,160,160,0,810
63321,190,160,160,160,160,0,830
63322,200,140,160,0,0,0,500
63323,140,100,80,160,320,0,800
63324,210,180,40,80,160,320,990
63325,200,100,120,0,0,0,420
63326,220,180,160,160,160,0,880
63327,170,120,80,160,160,0,690
63328,210,100,40,0,0,0,350
63329,200,140,120,0,0,0,460
63330,210,140,120,80,0,0,550
63331,220,140,120,80,0,0,560
63332,150,120,120,0,0,0,390
63333,190,140,200,160,320,0,1010
63334,180,100,80,80,160,320,920
63335,170,40,80,160,160,320,930
63336,230,140,120,80,160,320,1050
63337,160,140,160,160,160,0,780
63338,190,140,120,80,0,0,530
63339,200,120,160,160,160,0,800
63340,240,60,40,0,0,0,340
63341,180,80,40,0,0,0,300
63342,180,180,160,160,320,0,1000
63343,210,140,120,160,160,0,790
63344,180,140,80,0,0,0,400
63345,190,140,120,160,160,0,770
63346,200,120,80,160,320,320,1200
63347,210,140,80,160,160,0,750
63348,200,120,80,80,160,0,640
63349,170,140,120,80,0,0,510
63350,200,140,120,160,320,320,1260
63351,200,120,80,0,0,0,400
63352,160,80,0,0,0,0,240
63353,210,100,80,80,0,0,470
63354,200,140,120,80,0,0,540
63355,230,160,80,80,0,0,550
63356,200,80,40,0,0,0,320
63357,200,120,80,80,0,0,480
63358,260,120,0,0,0,0,380
63359,220,100,160,80,0,0,560
63360,200,120,160,80,0,0,560
63361,170,80,40,80,0,0,370
63362,190,140,160,240,320,0,1050
63363,180,80,40,0,0,0,300
63364,210,120,120,160,320,0,930
63365,250,180,120,0,0,0,550
63366,180,160,200,160,160,0,860
63367,200,120,160,160,160,320,1120
63368,200,100,160,160,0,0,620
63369,180,80,40,0,0,0,300
63370,210,160,80,80,0,0,530
63371,160,120,80,80,0,0,440
63372,180,100,120,0,0,0,400
63373,200,120,160,160,160,0,800
63374,220,100,80,0,0,0,400
63375,210,200,120,160,160,0,850
63376,220,60,80,80,160,0,600
63377,200,140,80,0,0,0,420
63378,190,100,80,80,0,0,450
63379,170,80,80,80,160,0,570
63380,250,140,0,0,0,0,390
63381,210,100,120,0,0,0,430
63382,180,180,200,160,160,320,1200
63383,190,180,200,240,320,0,1130
63384,210,120,80,80,0,0,490
63385,180,100,80,160,160,0,680
63386,170,40,40,80,0,0,330
63387,210,180,120,160,0,0,670
63388,220,160,200,160,160,0,900
63389,180,120,120,160,320,320,1220
63390,210,100,80,0,0,0,390
63391,190,140,120,0,0,0,450
63392,240,120,120,80,160,0,720
63393,200,80,40,80,160,0,560
63394,170,60,40,80,160,0,510
63395,200,120,120,80,160,0,680
63396,220,120,80,160,160,0,740
63397,160,60,80,80,0,0,380
63398,190,140,80,160,160,0,730
63399,210,100,160,0,0,0,470
63400,230,120,80,160,320,0,910
63401,190,100,80,0,0,0,370
63402,190,140,120,80,0,0,530
63403,230,80,120,160,320,320,1230
63404,180,140,40,0,0,0,360
63405,220,120,120,80,160,0,700
63406,240,100,40,0,0,0,380
63407,200,120,120,0,0,0,440
63408,150,100,120,0,0,0,370
63409,180,100,80,160,0,0,520
63410,210,120,80,80,160,0,650
63411,200,140,120,80,0,0,540
63412,210,120,40,80,160,0,610
63413,160,100,80,80,0,0,420
63414,230,40,40,0,0,0,310
63415,200,140,80,80,160,0,660
63416,190,80,120,160,320,0,870
63417,220,100,120,160,0,0,600
63418,180,80,80,80,160,0,580
63419,180,60,40,0,0,0,280
63420,190,80,120,80,160,0,630
63421,190,100,120,80,160,0,650
63422,210,80,120,0,0,0,410
63423,170,80,0,0,0,0,250
63424,210,80,40,80,160,320,890
63425,180,120,40,0,0,0,340
63426,200,120,160,0,0,0,480
63427,190,140,80,80,160,320,970
63428,240,140,120,0,0,0,500
63429,190,60,80,80,160,0,570
63430,190,120,40,0,0,0,350
63431,230,100,80,160,160,0,730
63432,220,120,80,0,0,0,420
63433,220,200,160,80,0,0,660
63434,230,160,160,160,160,0,870
63435,210,160,120,160,160,0,810
63436,210,100,120,160,160,0,750
63437,210,140,80,80,0,0,510
63438,230,140,160,160,160,0,850
63439,190,140,80,80,160,0,650
63440,210,140,80,160,160,320,1070
63441,220,140,160,160,160,0,840
63442,230,100,40,80,160,0,610
63443,210,140,80,80,0,0,510
63444,180,100,120,80,0,0,480
63445,220,140,160,160,0,0,680
63446,210,100,120,160,0,0,590
63447,230,120,40,80,160,0,630
63448,200,60,80,80,0,0,420
63449,180,160,160,80,0,0,580
63450,210,140,80,160,160,0,750
63451,170,100,80,0,0,0,350
63452,210,120,40,80,160,0,610
63453,260,140,160,160,160,0,880
63454,170,120,80,160,320,320,1170
63455,190,100,120,160,160,0,730
63456,150,80,80,80,160,320,870
63457,240,120,120,80,160,0,720
63458,210,120,120,80,160,0,690
63459,230,100,160,80,0,0,570
63460,180,100,80,160,320,0,840
63461,240,100,120,80,160,320,1020
63462,170,60,40,80,160,0,510
63463,220,100,80,80,0,0,480
63464,210,120,80,80,160,0,650
63465,210,140,80,80,0,0,510
63466,200,140,160,160,160,320,1140
63467,210,180,120,80,0,0,590
63468,230,160,120,80,160,0,750
63469,200,80,40,0,0,0,320
63470,170,140,200,160,0,0,670
63471,200,100,120,160,320,320,1220
63472,190,120,120,80,0,0,510
63473,230,100,120,240,320,320,1330
63474,210,120,120,160,160,0,770
63475,210,160,120,80,160,0,730
63476,150,80,120,160,160,0,670
63477,230,140,80,80,0,0,530
63478,200,60,80,80,160,0,580
63479,190,120,80,0,0,0,390
63480,160,100,200,240,0,0,700
63481,180,100,80,80,160,0,600
63482,170,160,160,160,160,0,810
63483,230,200,160,0,0,0,590
63484,190,80,80,160,320,0,830
63485,200,120,80,80,160,0,640
63486,170,100,120,80,160,0,630
63487,200,120,120,160,160,0,760
63488,230,140,120,80,160,320,1050
63489,190,160,200,160,160,0,870
63490,230,180,160,240,320,320,1450
63491,200,80,80,0,0,0,360
63492,190,100,40,0,0,0,330
63493,220,160,80,80,160,0,700
63494,200,160,160,240,160,0,920
63495,190,120,40,0,0,0,350
63496,140,100,120,80,160,0,600
63497,170,140,160,240,320,0,1030
63498,230,160,80,80,160,320,1030
63499,210,140,160,80,0,0,590
63500,170,80,80,0,0,0,330
63501,170,120,120,160,0,0,570
63502,190,120,80,80,160,0,630
63503,230,140,80,160,320,320,1250
63504,230,80,80,80,160,0,630
63505,260,220,80,80,160,0,800
63506,210,140,120,0,0,0,470
63507,200,120,80,80,160,0,640
63508,200,120,120,80,160,0,680
63509,170,100,120,80,0,0,470
63510,210,100,80,80,0,0,470
63511,210,120,160,160,0,0,650
63512,190,100,80,80,160,320,930
63513,210,80,80,80,160,320,930
63514,140,140,160,240,160,0,840
63515,160,80,40,0,0,0,280
63516,180,80,120,160,320,0,860
63517,190,180,120,80,160,320,1050
63518,200,180,120,80,160,0,740
63519,160,140,80,80,160,0,620
63520,210,160,160,160,0,0,690
63521,200,80,80,80,0,0,440
63522,190,160,80,0,0,0,430
63523,180,160,120,160,160,0,780
63524,160,120,160,240,320,0,1000
63525,220,100,40,80,160,0,600
63526,210,160,120,160,320,0,970
63527,210,100,160,160,320,320,1270
63528,180,160,120,240,160,0,860
63529,190,100,80,80,0,0,450
63530,210,160,120,160,160,0,810
63531,210,120,120,160,0,0,610
63532,200,140,200,80,160,0,780
63533,200,100,80,0,0,0,380
63534,210,40,40,80,160,0,530
63535,240,160,200,240,160,0,1000
63536,230,100,40,0,0,0,370
63537,240,180,120,80,160,0,780
63538,210,120,40,0,0,0,370
63539,170,60,40,80,160,0,510
63540,220,160,200,160,320,0,1060
63541,190,40,40,0,0,0,270
63542,180,160,80,80,0,0,500
63543,240,120,80,80,160,0,680
63544,210,80,80,0,0,0,370
63545,180,100,80,0,0,0,360
63546,200,160,80,80,160,0,680
63547,180,120,120,0,0,0,420
63548,180,140,80,80,0,0,480
63549,190,160,160,160,160,0,830
63550,220,100,120,80,160,0,680
63551,170,120,80,80,0,0,450
63552,220,120,80,160,160,0,740
63553,180,100,120,160,160,320,1040
63554,170,100,80,80,160,0,590
63555,190,140,120,80,0,0,530
63556,210,60,80,160,0,0,510
63557,220,120,80,80,0,0,500
63558,210,200,80,0,0,0,490
63559,160,120,160,160,160,0,760
63560,190,120,160,160,160,0,790
63561,130,100,160,160,160,0,710
63562,250,140,120,80,0,0,590
63563,200,140,80,0,0,0,420
63564,200,120,80,80,160,0,640
63565,210,140,80,0,0,0,430
63566,200,80,120,80,160,0,640
63567,140,140,120,80,160,0,640
63568,180,60,80,80,160,0,560
63569,210,140,160,80,160,0,750
63570,180,140,40,0,0,0,360
63571,180,120,160,160,160,0,780
63572,190,120,40,80,160,0,590
63573,180,140,80,160,0,0,560
63574,220,160,160,160,320,320,1340
63575,200,120,120,160,160,0,760
63576,170,120,160,80,160,0,690
63577,200,140,80,0,0,0,420
63578,150,120,120,160,320,0,870
63579,220,140,120,80,0,0,560
63580,170,140,160,240,160,0,870
63581,160,120,120,80,160,0,640
63582,190,120,80,80,160,0,630
63583,230,140,160,160,160,0,850
63584,180,180,160,160,320,0,1000
63585,180,120,0,0,0,0,300
63586,180,100,80,80,0,0,440
63587,190,80,80,160,320,320,1150
63588,190,120,160,160,160,0,790
63589,200,120,120,160,0,0,600
63590,210,120,40,80,0,0,450
63591,220,120,80,160,160,0,740
63592,190,100,40,0,0,0,330
63593,180,140,80,160,160,0,720
63594,200,140,120,0,0,0,460
63595,160,80,120,160,320,0,840
63596,210,120,160,80,160,0,730
63597,230,160,160,80,160,0,790
63598,180,100,120,80,160,0,640
63599,170,120,80,160,320,320,1170
63600,170,100,80,80,160,320,910
63601,190,80,80,80,160,0,590
63602,210,120,120,160,160,0,770
63603,170,100,120,80,0,0,470
63604,190,80,80,80,0,0,430
63605,170,140,160,160,160,0,790
63606,210,100,160,160,320,0,950
63607,180,120,80,0,0,0,380
63608,160,80,120,160,320,0,840
63609,170,60,80,80,160,0,550
63610,200,140,160,160,0,0,660
63611,190,140,120,160,160,320,1090
63612,200,100,80,80,0,0,460
63613,200,180,200,240,320,320,1460
63614,180,140,120,160,160,0,760
63615,200,60,40,0,0,0,300
63616,220,180,160,80,160,320,1120
63617,170,120,80,0,0,0,370
63618,210,140,120,0,0,0,470
63619,170,80,80,80,0,0,410
63620,200,140,120,80,160,0,700
63621,210,100,40,80,0,0,430
63622,150,80,80,80,160,320,870
63623,190,120,120,160,160,0,750
63624,210,80,0,0,0,0,290
63625,190,140,160,0,0,0,490
63626,170,80,120,160,320,320,1170
63627,180,100,40,0,0,0,320
63628,170,80,80,160,160,0,650
63629,240,160,120,80,0,0,600
63630,220,40,0,0,0,0,260
63631,170,100,120,160,160,320,1030
63632,240,160,120,160,160,0,840
63633,190,140,160,160,160,320,1130
63634,190,120,160,160,160,0,790
63635,200,120,40,0,0,0,360
63636,260,220,160,80,0,0,720
63637,170,120,120,160,320,320,1210
63638,200,120,160,80,160,0,720
63639,200,80,40,80,160,0,560
63640,200,140,0,0,0,0,340
63641,200,120,40,0,0,0,360
63642,190,120,160,80,0,0,550
63643,180,80,40,0,0,0,300
63644,210,140,120,240,160,0,870
63645,190,160,80,0,0,0,430
63646,160,120,200,160,160,0,800
63647,210,160,120,80,0,0,570
63648,160,120,160,160,160,0,760
63649,230,140,40,80,160,0,650
63650,170,140,120,160,160,0,750
63651,180,80,160,160,160,0,740
63652,150,100,40,80,160,0,530
63653,210,160,120,80,160,0,730
63654,180,180,80,0,0,0,440
63655,170,140,160,80,160,0,710
63656,250,120,120,80,160,0,730
63657,200,140,80,80,160,0,660
63658,160,140,160,240,320,320,1340
63659,200,160,160,160,160,0,840
63660,180,160,160,240,160,0,900
63661,170,160,160,160,320,0,970
63662,200,80,0,0,0,0,280
63663,230,140,160,240,320,320,1410
63664,160,80,80,80,0,0,400
63665,180,120,80,80,160,0,620
63666,210,120,80,0,0,0,410
63667,200,200,160,160,160,0,880
63668,210,120,40,0,0,0,370
63669,220,120,160,160,160,0,820
63670,160,140,160,80,160,0,700
63671,210,120,160,80,0,0,570
63672,130,100,160,160,0,0,550
63673,220,160,160,80,160,0,780
63674,190,80,40,80,160,0,550
63675,200,140,80,0,0,0,420
63676,220,140,160,160,0,0,680
63677,190,80,80,80,0,0,430
63678,130,180,160,240,320,0,1030
63679,240,140,120,160,160,320,1140
63680,240,200,200,80,160,0,880
63681,170,140,120,80,160,320,990
63682,210,160,120,80,160,320,1050
63683,160,60,80,80,0,0,380
63684,160,100,80,80,0,0,420
63685,220,120,120,160,320,320,1260
63686,200,120,120,80,0,0,520
63687,210,140,120,80,0,0,550
63688,270,200,120,160,160,0,910
63689,180,160,120,160,0,0,620
63690,170,140,160,160,160,0,790
63691,200,120,80,80,160,0,640
63692,180,80,120,80,0,0,460
63693,210,80,160,160,160,0,770
63694,190,100,120,80,160,0,650
63695,140,100,40,80,160,0,520
63696,170,120,40,80,160,320,890
63697,150,120,40,80,160,0,550
63698,200,140,120,80,0,0,540
63699,190,100,40,80,160,0,570
63700,220,160,80,160,320,0,940
63701,180,120,80,80,0,0,460
63702,140,120,80,160,160,0,660
63703,210,100,80,160,320,0,870
63704,210,100,80,0,0,0,390
63705,170,120,80,160,320,0,850
63706,200,160,120,80,0,0,560
63707,240,140,200,160,160,0,900
63708,160,100,80,160,160,320,980
63709,210,100,40,80,160,0,590
63710,240,80,40,80,160,0,600
63711,220,140,120,0,0,0,480
63712,180,160,120,80,0,0,540
63713,220,140,160,80,160,0,760
63714,200,120,200,160,160,0,840
63715,220,120,120,80,160,320,1020
63716,210,60,40,80,160,320,870
63717,200,160,240,160,0,0,760
63718,200,140,120,160,0,0,620
63719,180,180,120,80,0,0,560
63720,190,120,80,80,160,0,630
63721,170,80,120,80,0,0,450
63722,200,180,200,160,160,0,900
63723,170,160,160,0,0,0,490
63724,170,160,160,80,160,0,730
63725,200,160,200,80,160,320,1120
63726,170,120,160,0,0,0,450
63727,200,100,120,160,320,320,1220
63728,190,140,160,240,160,0,890
63729,220,100,120,160,160,0,760
63730,210,180,200,160,320,320,1390
63731,180,80,80,80,160,0,580
63732,150,140,120,0,0,0,410
63733,190,120,120,160,160,0,750
63734,240,140,120,160,160,0,820
63735,220,160,160,160,160,0,860
63736,230,180,80,0,0,0,490
63737,200,160,200,80,0,0,640
63738,250,180,200,160,0,0,790
63739,190,60,120,240,160,0,770
63740,230,120,120,160,160,0,790
63741,190,120,120,80,160,0,670
63742,190,60,40,80,160,320,850
63743,220,120,80,160,0,0,580
63744,170,140,160,160,160,0,790
63745,240,140,80,160,320,0,940
63746,190,100,120,0,0,0,410
63747,250,160,80,80,160,0,730
63748,220,180,120,0,0,0,520
63749,180,80,80,80,160,0,580
63750,210,200,240,160,0,0,810
63751,200,80,0,0,0,0,280
63752,190,80,40,80,160,0,550
63753,250,140,120,0,0,0,510
63754,200,140,40,80,160,0,620
63755,230,140,80,0,0,0,450
63756,210,200,120,80,0,0,610
63757,200,120,80,0,0,0,400
63758,240,140,120,80,160,0,740
63759,230,140,120,160,320,0,970
63760,230,140,80,80,160,320,1010
63761,190,100,80,80,0,0,450
63762,220,100,40,0,0,0,360
63763,180,60,120,160,160,0,680
63764,150,100,0,0,0,0,250
63765,160,140,120,80,160,0,660
63766,200,140,160,80,160,0,740
63767,170,180,120,160,160,0,790
63768,200,100,120,160,320,0,900
63769,190,80,80,80,160,0,590
63770,220,200,240,240,160,0,1060
63771,190,160,200,240,320,0,1110
63772,200,140,120,160,160,0,780
63773,200,200,120,80,0,0,600
63774,230,140,160,160,160,0,850
63775,220,100,80,80,160,0,640
63776,190,140,80,80,160,0,650
63777,210,100,160,160,320,0,950
63778,180,60,40,80,0,0,360
63779,230,160,80,160,160,0,790
63780,190,100,80,80,160,320,930
63781,220,120,80,160,160,320,1060
63782,200,140,40,80,0,0,460
63783,180,60,80,80,0,0,400
63784,200,160,200,160,0,0,720
63785,190,140,200,80,160,0,770
63786,250,120,120,80,0,0,570
63787,170,60,80,80,160,0,550
63788,230,160,200,160,160,0,910
63789,220,120,120,160,160,0,780
63790,210,100,40,0,0,0,350
63791,170,60,40,0,0,0,270
63792,200,120,200,160,160,320,1160
63793,180,140,160,160,0,0,640
63794,160,120,80,160,320,0,840
63795,200,140,120,80,160,0,700
63796,170,100,120,160,320,0,870
63797,190,100,80,80,0,0,450
63798,210,140,80,80,160,0,670
63799,220,100,40,0,0,0,360
63800,180,80,80,0,0,0,340
63801,150,100,80,80,0,0,410
63802,240,120,120,160,160,320,1120
63803,170,120,120,80,160,320,970
63804,200,140,200,80,160,0,780
63805,220,120,80,80,160,320,980
63806,240,160,200,80,160,0,840
63807,190,60,40,80,0,0,370
63808,180,80,80,160,320,0,820
63809,200,160,160,160,160,0,840
63810,200,180,80,160,160,0,780
63811,170,140,160,240,160,0,870
63812,190,140,80,0,0,0,410
63813,190,140,120,80,160,320,1010
63814,180,120,120,160,320,0,900
63815,250,180,160,160,160,320,1230
63816,200,160,160,160,320,0,1000
63817,250,160,120,80,0,0,610
63818,200,120,120,80,0,0,520
63819,150,60,120,160,160,320,970
63820,210,120,80,0,0,0,410
63821,200,120,120,80,160,0,680
63822,170,100,160,160,160,0,750
63823,260,160,120,160,0,0,700
63824,190,100,120,160,160,0,730
63825,180,100,80,80,160,0,600
63826,190,60,120,240,160,0,770
63827,160,100,40,80,160,0,540
63828,160,160,200,240,320,0,1080
63829,180,80,80,160,320,320,1140
63830,210,120,160,80,0,0,570
63831,150,120,120,240,320,320,1270
63832,220,160,200,160,160,0,900
63833,220,160,160,160,160,320,1180
63834,170,120,80,160,160,0,690
63835,200,140,160,80,160,0,740
63836,190,160,120,80,160,0,710
63837,230,80,80,80,160,320,950
63838,190,140,40,0,0,0,370
63839,200,120,160,240,160,0,880
63840,180,80,40,0,0,0,300
63841,180,180,160,80,160,0,760
63842,170,120,160,80,0,0,530
63843,240,140,80,0,0,0,460
63844,220,160,80,160,160,0,780
63845,220,160,160,160,160,0,860
63846,200,140,80,80,160,0,660
63847,140,100,40,0,0,0,280
63848,160,100,160,160,0,0,580
63849,180,100,40,0,0,0,320
63850,210,160,120,80,0,0,570
63851,190,120,160,160,320,0,950
63852,200,180,80,80,0,0,540
63853,150,100,80,80,0,0,410
63854,150,100,80,160,160,0,650
63855,190,160,120,80,160,0,710
63856,190,160,160,80,160,0,750
63857,190,100,80,0,0,0,370
63858,190,140,120,80,160,0,690
63859,220,120,80,0,0,0,420
63860,170,60,80,80,160,0,550
63861,210,120,40,80,160,0,610
63862,200,100,40,80,0,0,420
63863,180,120,120,160,160,0,740
63864,220,160,120,240,320,0,1060
63865,200,100,160,0,0,0,460
63866,210,140,160,160,320,0,990
63867,190,80,40,80,160,0,550
63868,200,120,120,80,160,0,680
63869,230,100,80,80,160,0,650
63870,230,100,80,160,320,0,890
63871,210,100,40,80,160,0,590
63872,200,140,160,240,320,0,1060
63873,200,140,80,0,0,0,420
63874,170,120,160,80,160,0,690
63875,210,160,200,160,0,0,730
63876,150,100,40,0,0,0,290
63877,200,100,80,80,0,0,460
63878,250,200,240,240,0,0,930
63879,190,160,200,160,320,320,1350
63880,210,160,120,0,0,0,490
63881,210,140,120,80,0,0,550
63882,210,180,120,160,160,320,1150
63883,150,60,80,80,160,0,530
63884,220,120,160,80,160,0,740
63885,180,100,40,80,0,0,400
63886,200,160,40,80,160,0,640
63887,170,80,80,160,160,0,650
63888,190,120,120,160,160,0,750
63889,210,120,40,80,0,0,450
63890,200,120,160,160,160,320,1120
63891,230,140,120,160,160,0,810
63892,190,120,120,80,160,0,670
63893,150,140,80,80,160,0,610
63894,220,120,120,80,160,0,700
63895,180,120,120,160,160,320,1060
63896,170,180,120,80,160,0,710
63897,170,100,120,160,160,320,1030
63898,180,120,40,80,160,0,580
63899,210,120,80,0,0,0,410
63900,220,140,120,80,160,320,1040
63901,160,140,160,160,320,0,940
63902,200,180,160,80,160,0,780
63903,200,160,200,240,320,0,1120
63904,170,120,120,240,320,0,970
63905,160,120,80,160,0,0,520
63906,190,120,120,160,160,0,750
63907,210,140,80,0,0,0,430
63908,190,140,120,160,160,0,770
63909,190,160,160,240,320,0,1070
63910,190,100,120,80,160,320,970
63911,170,120,160,160,320,320,1250
63912,190,100,40,80,160,0,570
63913,170,80,120,80,0,0,450
63914,190,160,120,0,0,0,470
63915,190,120,80,0,0,0,390
63916,160,140,120,160,160,320,1060
63917,220,80,40,0,0,0,340
63918,220,120,120,80,160,0,700
63919,210,80,40,0,0,0,330
63920,180,80,40,80,0,0,380
63921,200,160,200,160,0,0,720
63922,180,160,120,80,0,0,540
63923,230,120,40,0,0,0,390
63924,210,120,120,160,160,0,770
63925,240,120,40,80,0,0,480
63926,240,120,80,80,160,0,680
63927,210,120,80,0,0,0,410
63928,190,160,160,0,0,0,510
63929,220,160,160,240,160,0,940
63930,180,120,120,0,0,0,420
63931,200,120,40,80,160,0,600
63932,200,80,40,80,160,320,880
63933,200,80,40,0,0,0,320
63934,170,120,80,80,0,0,450
63935,200,100,40,80,160,0,580
63936,160,120,80,80,160,0,600
63937,210,100,120,80,160,0,670
63938,160,120,120,80,0,0,480
63939,210,160,80,80,0,0,530
63940,180,40,40,80,0,0,340
63941,250,140,160,160,320,0,1030
63942,180,100,120,160,160,320,1040
63943,190,140,80,80,160,320,970
63944,210,180,120,80,0,0,590
63945,220,120,80,80,160,0,660
63946,190,120,120,80,160,0,670
63947,230,140,80,160,160,320,1090
63948,210,120,120,160,160,0,770
63949,210,80,120,160,160,0,730
63950,190,60,80,80,160,0,570
63951,190,100,80,80,0,0,450
63952,180,80,40,0,0,0,300
63953,220,180,200,160,0,0,760
63954,170,160,200,160,160,0,850
63955,210,100,80,160,320,0,870
63956,200,160,160,240,320,320,1400
63957,180,120,80,80,160,0,620
63958,170,80,80,160,160,0,650
63959,220,140,40,80,160,320,960
63960,180,100,80,80,160,0,600
63961,230,120,80,80,0,0,510
63962,220,140,120,160,320,0,960
63963,200,100,40,0,0,0,340
63964,230,180,40,0,0,0,450
63965,180,120,160,160,160,320,1100
63966,160,140,160,0,0,0,460
63967,150,100,120,0,0,0,370
63968,210,140,120,160,320,0,950
63969,210,60,40,80,0,0,390
63970,200,100,120,160,160,0,740
63971,220,100,120,160,160,320,1080
63972,170,140,80,80,160,0,630
63973,190,140,120,80,0,0,530
63974,180,120,120,80,160,0,660
63975,180,140,200,160,160,320,1160
63976,200,160,120,80,160,0,720
63977,210,140,160,80,160,320,1070
63978,200,140,80,80,160,0,660
63979,200,120,80,80,0,0,480
63980,190,200,160,160,320,0,1030
63981,190,80,120,160,0,0,550
63982,210,100,40,0,0,0,350
63983,200,120,40,80,160,0,600
63984,170,120,80,0,0,0,370
63985,220,180,40,0,0,0,440
63986,200,120,40,0,0,0,360
63987,200,140,120,160,160,0,780
63988,160,120,80,80,160,0,600
63989,180,120,160,160,0,0,620
63990,140,120,160,80,0,0,500
63991,190,100,80,80,160,0,610
63992,230,140,80,80,160,0,690
63993,180,160,120,160,160,0,780
63994,160,80,40,0,0,0,280
63995,200,160,120,160,0,0,640
63996,190,160,160,80,0,0,590
63997,210,200,40,0,0,0,450
63998,220,140,80,80,0,0,520
63999,210,80,40,80,160,0,570
64000,210,140,120,80,0,0,550
64001,210,160,240,80,160,0,850
64002,140,120,80,80,160,0,580
64003,190,100,80,80,160,0,610
64004,190,140,120,80,0,0,530
64005,210,140,120,80,0,0,550
64006,170,60,40,80,0,0,350
64007,170,100,160,160,0,0,590
64008,210,20,40,0,0,0,270
64009,200,100,120,80,160,320,980
64010,210,80,80,0,0,0,370
64011,180,120,40,0,0,0,340
64012,200,120,80,80,160,0,640
64013,210,140,120,80,160,0,710
64014,220,140,80,0,0,0,440
64015,180,140,120,0,0,0,440
64016,180,100,80,0,0,0,360
64017,200,100,80,80,0,0,460
64018,230,200,160,160,160,0,910
64019,200,140,120,240,320,0,1020
64020,180,120,160,80,160,0,700
64021,250,120,120,160,0,0,650
64022,190,120,80,160,160,0,710
64023,200,120,40,80,160,0,600
64024,210,140,80,80,160,320,990
64025,220,100,160,240,160,320,1200
64026,220,80,40,80,160,0,580
64027,150,100,80,160,0,0,490
64028,130,20,40,80,160,0,430
64029,200,60,120,160,320,0,860
64030,240,120,80,80,160,0,680
64031,180,60,40,80,160,320,840
64032,170,100,80,80,160,0,590
64033,210,120,120,0,0,0,450
64034,210,60,80,80,160,0,590
64035,170,140,120,80,160,0,670
64036,220,100,160,160,320,320,1280
64037,220,160,120,80,0,0,580
64038,140,160,200,160,160,320,1140
64039,200,140,160,160,0,0,660
64040,210,120,80,80,0,0,490
64041,150,80,0,0,0,0,230
64042,180,120,120,80,160,0,660
64043,200,140,120,240,320,0,1020
64044,190,180,160,80,160,0,770
64045,210,160,120,80,160,0,730
64046,230,80,0,0,0,0,310
64047,210,140,160,160,160,320,1150
64048,210,140,200,80,160,320,1110
64049,210,100,160,160,160,0,790
64050,190,180,80,80,160,0,690
64051,210,160,80,160,160,0,770
64052,200,100,40,80,160,0,580
64053,160,120,160,160,160,0,760
64054,190,160,120,160,0,0,630
64055,220,120,80,80,160,0,660
64056,190,180,120,0,0,0,490
64057,170,120,120,80,160,0,650
64058,180,160,80,160,160,0,740
64059,120,40,0,0,0,0,160
64060,190,120,160,160,160,0,790
64061,190,80,120,160,160,0,710
64062,180,100,120,0,0,0,400
64063,190,160,120,240,320,0,1030
64064,180,100,120,160,160,0,720
64065,170,100,40,0,0,0,310
64066,190,120,80,0,0,0,390
64067,170,180,120,80,160,0,710
64068,230,100,40,80,160,0,610
64069,200,120,160,160,320,0,960
64070,200,80,120,80,0,0,480
64071,160,60,0,0,0,0,220
64072,230,80,40,80,160,320,910
64073,210,80,40,80,160,0,570
64074,210,180,160,80,0,0,630
64075,190,160,200,240,160,0,950
64076,150,120,80,160,0,0,510
64077,200,160,160,160,160,0,840
64078,210,100,120,80,160,0,670
64079,220,100,80,160,320,0,880
64080,180,80,120,80,160,320,940
64081,200,120,160,160,160,0,800
64082,160,160,80,160,160,0,720
64083,200,120,80,0,0,0,400
64084,210,100,120,80,0,0,510
64085,220,140,80,160,0,0,600
64086,200,160,160,160,160,0,840
64087,230,140,120,80,160,0,730
64088,240,180,80,160,0,0,660
64089,160,140,80,0,0,0,380
64090,190,120,80,0,0,0,390
64091,150,80,80,160,160,0,630
64092,200,120,200,80,0,0,600
64093,190,140,80,80,0,0,490
64094,190,60,40,80,160,0,530
64095,170,60,80,80,160,0,550
64096,190,140,160,80,0,0,570
64097,210,120,120,160,0,0,610
64098,220,100,120,160,160,0,760
64099,220,100,40,80,0,0,440
64100,160,80,80,80,160,0,560
64101,200,120,120,240,320,0,1000
64102,230,180,80,80,160,0,730
64103,170,160,160,80,160,0,730
64104,170,100,80,160,320,0,830
64105,250,200,160,80,160,0,850
64106,220,180,160,160,160,320,1200
64107,200,140,160,160,0,0,660
64108,190,100,80,80,0,0,450
64109,210,120,80,80,160,0,650
64110,190,200,120,160,160,0,830
64111,180,160,160,160,320,0,980
64112,200,140,160,160,160,320,1140
64113,200,60,40,0,0,0,300
64114,220,160,160,80,160,0,780
64115,200,80,160,80,0,0,520
64116,220,60,80,80,0,0,440
64117,170,120,160,80,160,0,690
64118,180,80,80,80,160,0,580
64119,170,100,120,160,0,0,550
64120,210,80,80,80,160,0,610
64121,190,100,80,160,320,0,850
64122,190,100,160,160,160,0,770
64123,200,180,120,160,160,0,820
64124,220,160,120,160,160,0,820
64125,230,120,120,80,160,0,710
64126,150,100,80,80,160,0,570
64127,210,140,80,80,0,0,510
64128,200,120,160,160,160,0,800
64129,170,100,40,0,0,0,310
64130,200,80,40,0,0,0,320
64131,170,80,40,0,0,0,290
64132,180,120,120,80,0,0,500
64133,190,120,80,0,0,0,390
64134,220,140,120,160,160,0,800
64135,200,80,80,80,160,0,600
64136,190,140,160,160,160,320,1130
64137,190,120,160,80,160,320,1030
64138,210,100,120,160,320,320,1230
64139,190,160,120,160,160,320,1110
64140,200,100,80,0,0,0,380
64141,170,60,120,160,0,0,510
64142,220,80,80,0,0,0,380
64143,210,160,80,0,0,0,450
64144,180,160,160,160,0,0,660
64145,220,80,80,80,0,0,460
64146,200,140,120,160,160,320,1100
64147,210,120,160,80,160,0,730
64148,210,160,160,80,160,0,770
64149,220,100,120,80,160,0,680
64150,180,160,200,80,0,0,620
64151,190,120,160,80,0,0,550
64152,210,120,120,0,0,0,450
64153,150,100,40,80,160,0,530
64154,230,140,80,80,0,0,530
64155,210,140,200,80,0,0,630
64156,170,120,120,80,0,0,490
64157,180,120,120,160,160,0,740
64158,170,120,0,0,0,0,290
64159,210,120,80,80,160,320,970
64160,200,120,80,80,160,320,960
64161,150,120,40,80,0,0,390
64162,230,100,40,0,0,0,370
64163,260,100,40,80,160,0,640
64164,220,160,120,160,0,0,660
64165,200,160,240,240,320,320,1480
64166,250,160,120,80,160,0,770
64167,240,80,40,0,0,0,360
64168,180,120,40,0,0,0,340
64169,210,100,120,160,320,320,1230
64170,180,80,120,80,0,0,460
64171,160,120,120,80,160,0,640
64172,200,120,120,160,320,0,920
64173,210,120,80,80,160,0,650
64174,210,140,160,80,160,0,750
64175,200,200,120,80,160,0,760
64176,230,140,120,80,160,0,730
64177,200,120,200,240,160,0,920
64178,210,120,120,80,0,0,530
64179,200,120,160,160,0,0,640
64180,190,80,120,80,160,320,950
64181,210,160,120,160,160,0,810
64182,200,140,40,80,0,0,460
64183,200,140,120,80,160,0,700
64184,240,140,160,160,0,0,700
64185,180,100,40,80,160,320,880
64186,220,100,160,80,160,320,1040
64187,210,180,120,240,320,320,1390
64188,170,160,80,160,160,0,730
64189,200,100,120,80,160,320,980
64190,210,180,120,160,160,0,830
64191,180,100,120,240,160,0,800
64192,210,120,80,160,160,320,1050
64193,210,160,120,160,0,0,650
64194,180,180,160,160,0,0,680
64195,210,140,80,80,160,320,990
64196,210,140,120,80,160,0,710
64197,190,180,160,160,160,0,850
64198,190,100,120,160,320,0,890
64199,190,160,80,160,160,320,1070
64200,240,100,120,240,320,0,1020
64201,200,120,120,160,0,0,600
64202,220,180,120,80,160,0,760
64203,210,160,80,80,160,0,690
64204,220,60,80,80,160,0,600
64205,230,160,120,160,160,320,1150
64206,250,140,160,80,0,0,630
64207,230,180,120,80,0,0,610
64208,180,120,120,0,0,0,420
64209,210,120,80,80,160,320,970
64210,210,80,0,0,0,0,290
64211,170,80,80,80,160,0,570
64212,190,100,120,240,0,0,650
64213,170,80,80,160,160,0,650
64214,260,180,120,80,0,0,640
64215,230,140,120,240,320,320,1370
64216,190,100,120,80,160,0,650
64217,190,140,80,80,160,0,650
64218,210,60,40,80,160,320,870
64219,170,100,40,80,160,0,550
64220,200,100,160,160,160,320,1100
64221,220,100,160,80,160,0,720
64222,160,120,80,0,0,0,360
64223,190,120,200,160,160,0,830
64224,170,120,120,160,0,0,570
64225,170,80,120,160,160,0,690
64226,170,120,80,80,160,0,610
64227,220,120,80,160,160,0,740
64228,190,80,160,160,160,0,750
64229,170,140,200,80,160,0,750
64230,170,80,0,0,0,0,250
64231,210,160,120,0,0,0,490
64232,250,100,40,0,0,0,390
64233,220,80,40,80,160,0,580
64234,170,40,40,80,0,0,330
64235,180,180,120,80,0,0,560
64236,210,140,160,240,320,0,1070
64237,230,100,120,80,160,0,690
64238,190,40,0,0,0,0,230
64239,180,120,160,160,160,0,780
64240,220,120,160,240,320,0,1060
64241,200,100,40,80,0,0,420
64242,190,100,40,0,0,0,330
64243,220,100,40,0,0,0,360
64244,210,140,80,0,0,0,430
64245,230,180,200,160,160,0,930
64246,190,140,120,160,160,0,770
64247,150,100,80,160,160,0,650
64248,190,100,80,80,160,0,610
64249,200,120,120,160,160,0,760
64250,200,120,80,80,0,0,480
64251,190,80,80,80,160,0,590
64252,230,140,80,80,160,0,690
64253,210,120,40,0,0,0,370
64254,200,120,80,160,160,0,720
64255,230,160,160,80,160,0,790
64256,220,140,0,0,0,0,360
64257,200,100,0,0,0,0,300
64258,190,100,40,0,0,0,330
64259,180,140,200,240,160,0,920
64260,200,100,120,80,160,0,660
64261,220,100,40,0,0,0,360
64262,180,180,120,0,0,0,480
64263,180,160,160,160,160,0,820
64264,230,140,120,240,160,0,890
64265,210,160,120,160,0,0,650
64266,210,160,80,160,160,320,1090
64267,200,120,80,0,0,0,400
64268,230,120,80,80,160,320,990
64269,170,120,120,0,0,0,410
64270,190,120,40,0,0,0,350
64271,220,80,120,160,320,0,900
64272,200,100,40,80,160,0,580
64273,190,140,80,0,0,0,410
64274,200,60,120,160,160,0,700
64275,160,140,160,160,0,0,620
64276,190,160,160,160,160,0,830
64277,200,100,80,160,160,0,700
64278,170,80,80,80,0,0,410
64279,210,120,80,80,0,0,490
64280,230,160,120,80,0,0,590
64281,180,100,160,80,160,320,1000
64282,200,120,160,160,320,320,1280
64283,170,120,80,80,0,0,450
64284,180,100,120,160,160,0,720
64285,180,80,80,0,0,0,340
64286,160,120,120,0,0,0,400
64287,220,180,160,80,160,0,800
64288,180,80,120,80,0,0,460
64289,170,60,80,160,160,0,630
64290,210,100,80,160,160,0,710
64291,170,60,40,0,0,0,270
64292,180,80,80,80,160,0,580
64293,190,120,160,240,160,320,1190
64294,190,100,160,160,160,320,1090
64295,190,140,160,240,160,0,890
64296,210,120,120,0,0,0,450
64297,210,120,160,240,0,0,730
64298,180,40,80,160,160,0,620
64299,130,100,80,80,160,0,550
64300,200,200,160,160,320,0,1040
64301,170,120,160,0,0,0,450
64302,180,120,120,80,160,0,660
64303,180,120,120,160,320,0,900
64304,200,160,200,240,320,0,1120
64305,240,120,160,160,160,0,840
64306,210,160,40,0,0,0,410
64307,200,140,80,80,0,0,500
64308,160,120,0,0,0,0,280
64309,220,120,80,0,0,0,420
64310,210,120,80,160,320,0,890
64311,230,180,80,0,0,0,490
64312,200,120,80,80,0,0,480
64313,210,180,200,160,160,0,910
64314,200,120,120,80,160,320,1000
64315,130,80,80,0,0,0,290
64316,160,120,160,80,160,0,680
64317,230,160,160,80,0,0,630
64318,230,80,40,80,160,0,590
64319,190,160,120,0,0,0,470
64320,190,140,160,0,0,0,490
64321,220,140,200,160,0,0,720
64322,160,80,80,160,320,320,1120
64323,200,120,120,240,160,0,840
64324,210,120,40,0,0,0,370
64325,230,180,120,80,160,0,770
64326,160,100,160,160,0,0,580
64327,230,200,200,240,320,320,1510
64328,180,140,120,80,160,320,1000
64329,190,100,160,160,0,0,610
64330,220,120,160,80,160,0,740
64331,190,100,40,0,0,0,330
64332,160,120,160,240,160,0,840
64333,220,120,120,80,160,0,700
64334,230,80,80,0,0,0,390
64335,190,80,120,160,160,0,710
64336,200,140,120,80,160,0,700
64337,220,100,120,240,160,0,840
64338,240,100,80,80,160,0,660
64339,230,140,200,160,160,0,890
64340,210,200,200,160,0,0,770
64341,200,140,120,80,0,0,540
64342,210,160,80,80,160,0,690
64343,200,160,80,160,0,0,600
64344,220,140,160,80,160,0,760
64345,220,140,160,0,0,0,520
64346,200,100,80,160,0,0,540
64347,200,80,120,0,0,0,400
64348,170,100,120,240,320,0,950
64349,220,140,120,160,320,320,1280
64350,210,120,160,80,160,320,1050
64351,230,100,80,0,0,0,410
64352,210,140,80,80,0,0,510
64353,170,120,80,0,0,0,370
64354,190,80,120,160,160,0,710
64355,200,120,160,240,320,320,1360
64356,220,120,40,0,0,0,380
64357,180,140,0,0,0,0,320
64358,190,180,160,80,160,0,770
64359,160,80,120,80,0,0,440
64360,180,120,120,240,320,320,1300
64361,210,100,40,0,0,0,350
64362,190,80,120,80,0,0,470
64363,220,140,160,80,160,0,760
64364,160,100,120,80,0,0,460
64365,140,160,120,0,0,0,420
64366,230,160,80,80,0,0,550
64367,180,100,160,160,160,0,760
64368,210,100,120,160,160,0,750
64369,190,120,80,80,0,0,470
64370,180,200,160,80,160,0,780
64371,230,100,80,80,160,0,650
64372,210,180,120,80,0,0,590
64373,190,40,0,0,0,0,230
64374,100,60,40,0,0,0,200
64375,220,140,160,160,160,0,840
64376,170,180,120,240,160,0,870
64377,180,140,40,80,160,0,600
64378,210,160,200,320,160,0,1050
64379,180,100,120,160,320,320,1200
64380,210,140,80,80,160,0,670
64381,230,160,120,160,160,0,830
64382,170,120,120,160,320,320,1210
64383,210,100,120,80,0,0,510
64384,180,100,80,160,160,0,680
64385,190,140,80,80,160,0,650
64386,210,120,120,240,320,320,1330
64387,190,140,160,80,160,320,1050
64388,130,120,120,80,0,0,450
64389,190,140,120,80,160,0,690
64390,190,120,40,0,0,0,350
64391,180,40,40,80,0,0,340
64392,200,80,80,0,0,0,360
64393,210,180,80,160,160,0,790
64394,220,120,80,160,160,0,740
64395,210,140,120,0,0,0,470
64396,210,160,200,160,320,320,1370
64397,180,120,120,160,160,0,740
64398,150,140,120,160,160,0,730
64399,150,120,120,160,160,0,710
64400,180,140,160,160,160,0,800
64401,180,120,120,80,0,0,500
64402,210,200,40,80,0,0,530
64403,200,120,80,160,160,0,720
64404,250,140,200,240,160,0,990
64405,200,140,160,160,160,0,820
64406,180,80,80,0,0,0,340
64407,180,120,120,240,320,320,1300
64408,180,140,120,80,0,0,520
64409,190,100,120,160,160,0,730
64410,180,100,0,0,0,0,280
64411,160,100,40,80,160,0,540
64412,180,140,160,160,160,0,800
64413,200,200,80,80,160,0,720
64414,180,140,120,160,320,0,920
64415,210,160,160,80,0,0,610
64416,190,60,40,80,160,320,850
64417,200,140,80,160,160,0,740
64418,180,160,80,80,160,0,660
64419,200,140,120,0,0,0,460
64420,230,120,80,160,160,320,1070
64421,210,140,80,80,160,0,670
64422,210,140,80,80,0,0,510
64423,180,140,160,240,320,0,1040
64424,200,120,160,160,160,0,800
64425,200,140,120,80,0,0,540
64426,200,140,40,0,0,0,380
64427,200,160,160,80,0,0,600
64428,200,120,120,160,320,0,920
64429,180,140,80,80,0,0,480
64430,230,180,40,80,0,0,530
64431,200,220,120,0,0,0,540
64432,210,140,120,80,0,0,550
64433,190,140,160,240,320,320,1370
64434,240,120,120,80,0,0,560
64435,210,160,160,160,160,0,850
64436,200,100,40,80,160,0,580
64437,170,80,80,80,0,0,410
64438,220,120,40,80,0,0,460
64439,180,60,40,80,160,320,840
64440,250,140,40,80,160,0,670
64441,170,120,80,80,160,0,610
64442,190,120,160,80,160,320,1030
64443,170,160,120,160,320,0,930
64444,170,140,120,0,0,0,430
64445,150,40,80,80,0,0,350
64446,220,160,200,160,320,320,1380
64447,170,80,80,80,160,0,570
64448,200,80,120,80,0,0,480
64449,200,160,160,160,320,320,1320
64450,210,160,80,0,0,0,450
64451,220,160,160,80,0,0,620
64452,240,200,160,160,0,0,760
64453,170,80,160,0,0,0,410
64454,180,120,120,80,160,0,660
64455,220,100,120,160,320,0,920
64456,220,120,160,160,0,0,660
64457,180,140,120,160,160,0,760
64458,200,120,120,160,160,0,760
64459,150,100,120,160,0,0,530
64460,240,160,120,240,160,0,920
64461,230,220,80,80,160,0,770
64462,190,80,80,80,160,0,590
64463,210,140,160,80,0,0,590
64464,190,80,40,80,0,0,390
64465,240,180,160,160,320,320,1380
64466,180,140,80,80,160,320,960
64467,180,140,160,80,0,0,560
64468,180,120,120,80,160,0,660
64469,210,80,80,80,160,0,610
64470,170,120,80,80,160,0,610
64471,190,140,120,80,0,0,530
64472,180,120,120,160,160,0,740
64473,220,80,80,80,0,0,460
64474,190,180,120,80,160,0,730
64475,210,120,120,0,0,0,450
64476,170,120,80,80,0,0,450
64477,190,140,120,240,320,320,1330
64478,170,100,40,80,160,0,550
64479,200,100,120,160,320,0,900
64480,210,100,120,160,320,0,910
64481,180,120,120,80,0,0,500
64482,190,120,160,80,0,0,550
64483,210,140,160,0,0,0,510
64484,180,140,80,160,160,0,720
64485,210,120,80,80,160,0,650
64486,210,120,80,80,0,0,490
64487,190,80,80,80,160,0,590
64488,170,160,120,160,160,0,770
64489,210,140,200,0,0,0,550
64490,180,100,120,80,160,320,960
64491,190,140,120,80,160,0,690
64492,190,160,120,160,160,0,790
64493,210,160,80,160,160,320,1090
64494,180,120,80,80,160,0,620
64495,190,180,160,160,320,0,1010
64496,170,120,0,0,0,0,290
64497,210,140,120,0,0,0,470
64498,220,120,120,80,160,0,700
64499,230,120,80,160,160,0,750
64500,170,160,240,240,320,0,1130
64501,200,120,40,80,160,0,600
64502,170,140,120,0,0,0,430
64503,220,140,200,160,160,0,880
64504,180,140,40,80,0,0,440
64505,130,140,160,80,160,0,670
64506,240,160,80,0,0,0,480
64507,130,20,0,0,0,0,150
64508,200,120,120,160,160,0,760
64509,230,120,200,160,160,0,870
64510,240,200,200,160,160,0,960
64511,170,120,120,80,160,0,650
64512,200,180,80,160,320,320,1260
64513,160,140,160,160,320,320,1260
64514,180,80,120,160,160,0,700
64515,180,100,120,0,0,0,400
64516,190,80,40,80,0,0,390
64517,170,120,80,80,160,0,610
64518,170,120,120,80,0,0,490
64519,220,100,80,0,0,0,400
64520,210,120,80,0,0,0,410
64521,180,140,160,240,160,0,880
64522,160,120,120,80,0,0,480
64523,190,160,200,320,320,0,1190
64524,180,100,120,80,0,0,480
64525,170,60,0,0,0,0,230
64526,180,80,120,160,320,0,860
64527,170,140,120,80,0,0,510
64528,200,160,80,80,0,0,520
64529,170,100,80,0,0,0,350
64530,210,180,120,80,160,0,750
64531,210,120,80,160,160,0,730
64532,210,140,160,160,0,0,670
64533,210,120,40,80,0,0,450
64534,190,120,160,240,320,320,1350
64535,220,60,120,80,160,0,640
64536,180,140,120,80,160,320,1000
64537,140,120,80,80,160,0,580
64538,240,160,160,80,0,0,640
64539,220,140,120,160,160,0,800
64540,210,160,80,80,160,0,690
64541,170,80,0,0,0,0,250
64542,190,120,160,160,160,320,1110
64543,190,120,80,160,160,0,710
64544,160,100,120,80,160,320,940
64545,200,100,120,80,0,0,500
64546,170,100,80,80,160,0,590
64547,170,160,120,80,160,0,690
64548,180,140,80,0,0,0,400
64549,210,140,160,80,160,0,750
64550,210,140,120,160,320,320,1270
64551,180,100,120,160,160,0,720
64552,190,120,80,80,160,0,630
64553,190,140,120,80,160,0,690
64554,170,120,120,160,160,0,730
64555,210,120,120,160,160,0,770
64556,200,100,120,0,0,0,420
64557,200,140,120,160,0,0,620
64558,210,160,120,240,320,320,1370
64559,210,100,80,80,160,320,950
64560,190,180,160,80,0,0,610
64561,170,140,40,0,0,0,350
64562,190,160,120,160,160,0,790
64563,180,160,120,240,320,320,1340
64564,220,80,80,80,160,320,940
64565,190,60,40,0,0,0,290
64566,230,120,240,160,320,0,1070
64567,220,120,80,80,160,320,980
64568,210,100,0,0,0,0,310
64569,210,120,80,160,0,0,570
64570,170,100,80,80,160,0,590
64571,220,100,120,160,160,0,760
64572,150,120,120,80,160,0,630
64573,240,120,120,240,320,0,1040
64574,230,160,80,80,160,0,710
64575,160,140,200,160,320,320,1300
64576,180,100,160,80,0,0,520
64577,220,120,80,80,0,0,500
64578,210,200,160,240,320,0,1130
64579,170,180,120,0,0,0,470
64580,190,100,80,80,160,320,930
64581,200,160,160,160,160,0,840
64582,170,120,160,80,160,320,1010
64583,220,120,120,80,0,0,540
64584,200,120,160,80,160,320,1040
64585,210,200,120,160,160,0,850
64586,200,120,80,80,0,0,480
64587,230,140,80,80,160,0,690
64588,190,80,80,0,0,0,350
64589,210,140,120,80,160,0,710
64590,210,140,120,80,160,320,1030
64591,260,140,160,160,320,320,1360
64592,220,80,40,80,160,0,580
64593,170,80,80,80,160,0,570
64594,210,80,40,0,0,0,330
64595,190,60,80,80,160,0,570
64596,180,100,80,80,160,320,920
64597,190,100,80,80,0,0,450
64598,150,60,120,80,160,320,890
64599,220,120,160,80,160,0,740
64600,200,140,200,160,320,0,1020
64601,210,140,160,160,160,0,830
64602,200,100,80,80,160,0,620
64603,210,100,80,160,320,0,870
64604,210,180,160,160,160,0,870
64605,220,120,80,80,0,0,500
64606,190,80,80,80,0,0,430
64607,180,100,80,160,160,0,680
64608,180,100,120,80,160,0,640
64609,180,100,80,80,0,0,440
64610,190,160,120,80,0,0,550
64611,220,200,120,80,160,0,780
64612,200,100,80,80,160,0,620
64613,150,100,120,80,0,0,450
64614,210,120,160,80,0,0,570
64615,220,100,80,80,0,0,480
64616,180,120,160,80,160,320,1020
64617,210,140,120,80,0,0,550
64618,180,80,120,80,160,0,620
64619,160,120,80,80,0,0,440
64620,220,160,160,80,0,0,620
64621,230,200,200,80,0,0,710
64622,190,160,200,160,320,0,1030
64623,180,160,80,160,160,0,740
64624,220,80,40,80,0,0,420
64625,180,100,80,0,0,0,360
64626,200,160,80,0,0,0,440
64627,180,140,80,80,0,0,480
64628,230,100,120,160,0,0,610
64629,200,160,120,80,0,0,560
64630,180,140,160,240,0,0,720
64631,190,160,80,80,160,320,990
64632,200,120,40,0,0,0,360
64633,200,160,200,160,160,0,880
64634,240,80,40,80,160,0,600
64635,180,80,40,80,0,0,380
64636,160,120,80,80,160,0,600
64637,200,120,120,240,160,0,840
64638,190,180,120,80,160,320,1050
64639,190,140,120,80,160,320,1010
64640,210,80,120,160,320,320,1210
64641,170,60,120,80,160,0,590
64642,180,120,80,160,320,0,860
64643,180,140,120,160,320,0,920
64644,230,140,200,80,160,0,810
64645,160,120,120,160,0,0,560
64646,230,140,120,160,320,0,970
64647,180,140,200,160,320,320,1320
64648,220,140,80,80,160,0,680
64649,200,100,80,80,160,0,620
64650,110,80,80,160,0,0,430
64651,210,120,80,80,160,320,970
64652,200,120,80,80,0,0,480
64653,200,100,120,80,0,0,500
64654,170,140,80,160,320,0,870
64655,210,180,200,160,160,0,910
64656,230,140,80,80,0,0,530
64657,220,120,160,160,160,0,820
64658,230,140,120,80,0,0,570
64659,200,80,120,0,0,0,400
64660,190,100,80,80,160,0,610
64661,160,80,80,0,0,0,320
64662,210,160,80,0,0,0,450
64663,180,120,80,80,160,0,620
64664,250,180,200,80,0,0,710
64665,200,120,40,80,160,0,600
64666,190,80,0,0,0,0,270
64667,220,160,80,160,160,0,780
64668,170,80,40,0,0,0,290
64669,200,100,160,80,160,0,700
64670,190,160,160,240,0,0,750
64671,210,80,40,0,0,0,330
64672,220,120,120,160,320,0,940
64673,190,60,80,80,160,320,890
64674,200,100,120,80,160,320,980
64675,230,140,120,80,0,0,570
64676,180,120,160,80,160,320,1020
64677,190,100,80,80,160,0,610
64678,230,120,120,160,160,0,790
64679,220,60,40,80,0,0,400
64680,210,120,120,160,0,0,610
64681,210,160,160,160,160,0,850
64682,230,100,40,0,0,0,370
64683,220,100,40,80,0,0,440
64684,200,160,120,80,160,0,720
64685,190,140,120,160,320,0,930
64686,200,120,160,80,0,0,560
64687,190,60,40,0,0,0,290
64688,190,120,80,80,160,0,630
64689,210,120,160,80,160,0,730
64690,200,100,80,80,160,320,940
64691,170,160,160,80,0,0,570
64692,220,120,160,160,160,0,820
64693,180,60,80,80,0,0,400
64694,180,180,120,0,0,0,480
64695,150,80,120,80,160,0,590
64696,180,180,200,160,160,320,1200
64697,190,120,80,0,0,0,390
64698,190,140,160,160,160,0,810
64699,170,140,200,240,160,320,1230
64700,190,120,160,80,0,0,550
64701,190,160,120,160,160,0,790
64702,220,120,120,80,160,0,700
64703,210,140,120,160,160,0,790
64704,170,160,200,80,160,0,770
64705,160,100,120,160,160,320,1020
64706,180,60,80,160,160,0,640
64707,200,160,160,80,160,0,760
64708,230,100,120,160,160,0,770
64709,200,220,200,240,0,0,860
64710,220,140,120,80,160,0,720
64711,200,60,80,80,160,0,580
64712,230,100,40,80,160,0,610
64713,190,140,160,80,0,0,570
64714,200,160,160,160,160,0,840
64715,220,120,120,80,160,0,700
64716,190,80,120,80,160,320,950
64717,200,80,80,80,0,0,440
64718,180,160,120,0,0,0,460
64719,220,160,120,160,320,0,980
64720,240,140,120,240,320,0,1060
64721,220,140,160,80,160,0,760
64722,200,120,80,80,160,0,640
64723,220,120,120,160,0,0,620
64724,250,100,120,80,0,0,550
64725,160,100,40,80,0,0,380
64726,210,140,80,80,0,0,510
64727,170,120,80,80,160,320,930
64728,210,100,80,80,160,0,630
64729,200,160,120,80,160,0,720
64730,200,140,200,160,160,0,860
64731,160,120,160,80,160,0,680
64732,170,120,120,80,0,0,490
64733,210,120,160,160,160,0,810
64734,190,40,40,80,160,0,510
64735,200,200,120,0,0,0,520
64736,210,100,80,80,0,0,470
64737,230,120,120,80,0,0,550
64738,220,180,80,160,0,0,640
64739,190,60,40,80,160,0,530
64740,150,60,80,80,0,0,370
64741,190,100,200,160,160,0,810
64742,200,140,120,160,0,0,620
64743,200,160,80,80,160,0,680
64744,190,80,120,160,160,0,710
64745,200,100,40,80,160,0,580
64746,200,160,160,80,160,0,760
64747,140,40,40,80,160,0,460
64748,200,120,40,0,0,0,360
64749,230,120,160,240,0,0,750
64750,180,100,120,80,0,0,480
64751,210,100,120,240,320,0,990
64752,190,100,120,160,160,320,1050
64753,230,220,200,160,160,320,1290
64754,200,100,40,80,160,0,580
64755,190,160,0,0,0,0,350
64756,200,100,120,240,0,0,660
64757,200,160,160,160,160,0,840
64758,210,120,40,0,0,0,370
64759,140,40,80,0,0,0,260
64760,190,160,120,0,0,0,470
64761,220,220,120,160,160,320,1200
64762,210,80,80,80,160,0,610
64763,210,140,160,160,0,0,670
64764,140,120,120,160,320,320,1180
64765,210,140,40,0,0,0,390
64766,180,120,80,0,0,0,380
64767,200,140,160,160,0,0,660
64768,230,120,120,160,160,320,1110
64769,150,40,80,160,320,320,1070
64770,190,200,120,160,160,0,830
64771,190,100,160,0,0,0,450
64772,200,80,0,0,0,0,280
64773,250,180,160,160,160,320,1230
64774,180,120,80,160,160,0,700
64775,190,120,120,80,0,0,510
64776,200,160,120,160,320,0,960
64777,180,160,120,160,0,0,620
64778,230,100,0,0,0,0,330
64779,160,100,40,80,160,0,540
64780,190,100,40,0,0,0,330
64781,170,160,40,0,0,0,370
64782,200,180,160,160,160,0,860
64783,200,120,80,0,0,0,400
64784,200,140,120,80,160,0,700
64785,200,80,80,0,0,0,360
64786,180,120,160,160,0,0,620
64787,170,160,120,160,160,0,770
64788,200,120,160,80,160,0,720
64789,180,120,40,0,0,0,340
64790,230,100,80,0,0,0,410
64791,180,140,80,80,0,0,480
64792,210,120,80,80,160,0,650
64793,170,140,80,80,0,0,470
64794,200,120,120,160,160,0,760
64795,220,160,40,80,160,0,660
64796,210,100,80,80,0,0,470
64797,240,140,40,80,160,0,660
64798,220,120,120,240,320,0,1020
64799,160,100,80,80,160,0,580
64800,220,180,160,80,0,0,640
64801,250,160,80,80,0,0,570
64802,200,120,120,0,0,0,440
64803,180,60,120,80,0,0,440
64804,160,100,80,160,160,0,660
64805,210,100,120,160,320,320,1230
64806,170,120,80,160,0,0,530
64807,170,120,80,80,0,0,450
64808,210,140,200,80,160,320,1110
64809,190,140,200,240,320,0,1090
64810,160,80,120,80,0,0,440
64811,190,100,120,0,0,0,410
64812,170,120,80,0,0,0,370
64813,180,60,80,80,160,0,560
64814,190,120,120,240,160,0,830
64815,170,100,80,80,160,0,590
64816,180,80,0,0,0,0,260
64817,170,160,160,80,0,0,570
64818,150,140,120,160,160,0,730
64819,190,80,80,0,0,0,350
64820,240,140,120,160,160,320,1140
64821,190,100,40,0,0,0,330
64822,200,100,120,160,160,320,1060
64823,170,140,160,160,160,0,790
64824,210,120,120,80,0,0,530
64825,160,120,160,80,160,0,680
64826,140,120,80,160,320,320,1140
64827,250,160,160,160,160,0,890
64828,190,120,160,80,0,0,550
64829,230,120,80,160,160,0,750
64830,170,60,40,0,0,0,270
64831,170,120,120,160,160,0,730
64832,200,160,160,240,320,320,1400
64833,210,140,120,160,160,0,790
64834,240,140,120,160,0,0,660
64835,240,140,160,240,320,320,1420
64836,210,120,160,80,160,0,730
64837,180,140,160,240,160,0,880
64838,200,100,160,0,0,0,460
64839,160,100,40,0,0,0,300
64840,190,140,160,240,160,0,890
64841,190,80,120,80,160,0,630
64842,170,120,80,80,160,0,610
64843,220,80,120,160,160,0,740
64844,170,120,120,160,0,0,570
64845,170,80,80,80,160,0,570
64846,150,100,160,80,160,0,650
64847,230,140,160,160,320,0,1010
64848,150,140,120,160,320,0,890
64849,230,100,80,80,0,0,490
64850,200,100,160,160,160,0,780
64851,180,100,80,0,0,0,360
64852,160,100,160,240,160,0,820
64853,170,80,120,160,0,0,530
64854,160,80,120,80,160,0,600
64855,190,80,80,80,160,0,590
64856,230,120,120,240,160,0,870
64857,200,120,120,80,0,0,520
64858,170,80,120,80,0,0,450
64859,160,120,200,160,160,0,800
64860,190,100,0,0,0,0,290
64861,190,80,80,0,0,0,350
64862,210,120,80,0,0,0,410
64863,180,40,40,80,0,0,340
64864,160,140,160,80,160,0,700
64865,190,200,200,80,0,0,670
64866,210,120,40,0,0,0,370
64867,160,120,80,0,0,0,360
64868,220,180,120,0,0,0,520
64869,210,60,40,80,0,0,390
64870,200,120,120,80,0,0,520
64871,240,100,120,160,320,320,1260
64872,210,140,0,0,0,0,350
64873,190,80,40,0,0,0,310
64874,230,220,120,80,0,0,650
64875,180,80,120,160,160,0,700
64876,150,100,160,160,0,0,570
64877,190,120,200,160,160,0,830
64878,170,120,120,80,160,0,650
64879,140,120,80,160,160,0,660
64880,170,100,40,80,160,0,550
64881,190,140,120,80,160,320,1010
64882,160,140,200,80,160,0,740
64883,180,100,120,0,0,0,400
64884,170,100,80,160,160,0,670
64885,190,180,120,0,0,0,490
64886,200,160,160,160,320,320,1320
64887,200,80,80,160,160,0,680
64888,130,100,80,160,160,0,630
64889,200,160,120,80,160,0,720
64890,200,120,80,80,160,0,640
64891,220,120,80,80,160,0,660
64892,210,120,160,160,160,0,810
64893,220,160,80,0,0,0,460
64894,180,100,80,80,0,0,440
64895,230,100,80,0,0,0,410
64896,200,180,80,0,0,0,460
64897,230,80,80,80,0,0,470
64898,190,100,0,0,0,0,290
64899,190,100,120,80,160,0,650
64900,170,140,160,160,0,0,630
64901,230,80,160,160,160,320,1110
64902,200,140,0,0,0,0,340
64903,170,100,80,80,160,320,910
64904,190,140,80,0,0,0,410
64905,200,140,80,160,160,0,740
64906,180,180,200,80,160,0,800
64907,190,140,160,160,160,0,810
64908,170,120,120,80,160,0,650
64909,200,100,120,80,160,320,980
64910,170,120,80,0,0,0,370
64911,170,80,80,0,0,0,330
64912,200,120,80,80,160,0,640
64913,180,180,120,80,160,0,720
64914,260,160,200,160,160,0,940
64915,260,140,40,0,0,0,440
64916,210,120,120,160,320,320,1250
64917,230,140,120,0,0,0,490
64918,210,80,0,0,0,0,290
64919,200,120,40,0,0,0,360
64920,200,140,160,80,160,0,740
64921,230,160,160,160,160,0,870
64922,210,180,120,80,160,0,750
64923,160,80,80,0,0,0,320
64924,180,100,80,80,160,0,600
64925,170,80,120,160,160,320,1010
64926,190,160,80,80,160,0,670
64927,190,80,120,160,160,0,710
64928,170,140,120,160,160,320,1070
64929,180,80,120,160,160,0,700
64930,190,120,40,80,0,0,430
64931,190,120,80,160,160,0,710
64932,220,120,200,160,160,0,860
64933,200,200,120,80,0,0,600
64934,220,120,120,80,160,0,700
64935,220,80,120,160,320,320,1220
64936,230,120,40,0,0,0,390
64937,150,100,120,80,160,0,610
64938,170,160,200,0,0,0,530
64939,180,120,200,80,0,0,580
64940,180,120,120,80,160,320,980
64941,200,180,120,160,160,0,820
64942,210,100,40,80,160,0,590
64943,220,180,80,0,0,0,480
64944,180,100,120,160,160,0,720
64945,190,140,120,160,160,0,770
64946,200,20,0,0,0,0,220
64947,210,100,80,80,160,0,630
64948,170,100,80,80,160,0,590
64949,210,140,80,160,160,0,750
64950,200,60,40,80,160,0,540
64951,230,160,80,80,0,0,550
64952,190,120,160,80,160,0,710
64953,210,140,120,80,0,0,550
64954,170,60,40,80,160,0,510
64955,170,120,40,0,0,0,330
64956,170,140,120,80,160,0,670
64957,170,100,40,0,0,0,310
64958,210,80,80,80,0,0,450
64959,190,120,120,80,160,0,670
64960,160,40,80,160,160,0,600
64961,200,120,160,0,0,0,480
64962,180,120,80,80,160,0,620
64963,170,120,160,80,160,0,690
64964,220,120,120,160,160,0,780
64965,220,140,80,80,0,0,520
64966,190,140,80,0,0,0,410
64967,190,160,80,80,160,0,670
64968,180,120,80,80,160,0,620
64969,160,100,80,80,0,0,420
64970,190,80,80,160,0,0,510
64971,180,80,80,0,0,0,340
64972,230,180,160,160,320,0,1050
64973,210,80,80,160,0,0,530
64974,230,120,120,160,160,0,790
64975,200,120,80,80,0,0,480
64976,210,140,120,160,160,0,790
64977,200,140,120,80,160,320,1020
64978,150,160,160,160,160,0,790
64979,200,120,40,80,0,0,440
64980,220,140,120,160,160,0,800
64981,230,160,120,160,160,0,830
64982,180,100,160,160,320,320,1240
64983,190,140,80,80,0,0,490
64984,180,140,160,160,160,0,800
64985,220,60,0,0,0,0,280
64986,160,80,40,0,0,0,280
64987,210,140,160,160,160,0,830
64988,170,80,80,160,160,320,970
64989,190,140,160,160,160,0,810
64990,200,140,160,160,160,320,1140
64991,180,160,200,160,320,320,1340
64992,170,120,120,160,160,0,730
64993,230,100,120,80,160,0,690
64994,180,100,80,80,0,0,440
64995,210,40,40,80,0,0,370
64996,170,100,80,160,160,0,670
64997,200,80,120,160,160,0,720
64998,150,100,160,80,160,0,650
64999,190,140,120,80,160,0,690
65000,200,80,40,0,0,0,320
65001,210,120,40,80,0,0,450
65002,220,160,120,160,0,0,660
65003,210,160,160,160,0,0,690
65004,190,120,120,160,160,320,1070
65005,200,80,80,160,0,0,520
65006,170,140,120,160,160,0,750
65007,200,120,120,160,0,0,600
65008,180,120,80,160,160,0,700
65009,160,60,80,80,160,0,540
65010,220,140,120,240,320,0,1040
65011,160,100,120,80,160,0,620
65012,170,100,80,80,160,0,590
65013,220,120,120,160,320,0,940
65014,220,140,160,80,160,0,760
65015,230,120,80,160,160,0,750
65016,180,80,120,160,320,0,860
65017,210,180,80,80,0,0,550
65018,200,180,120,160,320,0,980
65019,170,120,120,160,160,0,730
65020,200,80,160,80,0,0,520
65021,210,200,160,160,160,320,1210
65022,170,140,160,160,160,0,790
65023,210,140,80,80,160,320,990
65024,200,100,80,160,320,0,860
65025,220,120,80,0,0,0,420
65026,190,120,80,80,160,320,950
65027,200,160,80,80,160,0,680
65028,190,100,120,160,160,0,730
65029,170,140,80,80,0,0,470
65030,190,140,160,0,0,0,490
65031,180,160,80,80,160,320,980
65032,190,160,160,80,160,0,750
65033,210,180,120,160,320,0,990
65034,170,180,160,160,320,320,1310
65035,160,100,120,0,0,0,380
65036,240,140,160,160,160,0,860
65037,190,160,120,80,0,0,550
65038,170,120,80,80,160,0,610
65039,180,140,80,0,0,0,400
65040,210,140,120,80,160,0,710
65041,190,140,80,80,160,0,650
65042,180,140,120,160,160,0,760
65043,170,160,40,0,0,0,370
65044,210,120,120,80,160,0,690
65045,200,140,120,160,160,320,1100
65046,180,120,160,160,0,0,620
65047,160,100,160,160,160,0,740
65048,170,120,80,0,0,0,370
65049,210,100,120,160,0,0,590
65050,210,120,120,80,160,0,690
65051,190,120,120,0,0,0,430
65052,210,140,80,80,0,0,510
65053,180,100,40,80,0,0,400
65054,140,80,80,160,160,0,620
65055,180,120,120,80,160,0,660
65056,180,160,160,160,320,320,1300
65057,230,180,160,80,160,0,810
65058,210,120,120,160,320,320,1250
65059,190,60,0,0,0,0,250
65060,230,100,160,0,0,0,490
65061,240,160,120,160,160,320,1160
65062,180,120,120,80,160,0,660
65063,190,120,160,160,0,0,630
65064,220,120,80,0,0,0,420
65065,220,120,80,0,0,0,420
65066,150,120,200,240,160,0,870
65067,210,120,200,160,160,0,850
65068,180,140,120,240,0,0,680
65069,180,120,80,0,0,0,380
65070,170,140,160,240,320,320,1350
65071,160,80,80,160,160,0,640
65072,170,100,40,80,0,0,390
65073,220,100,80,160,320,320,1200
65074,200,140,80,80,0,0,500
65075,150,120,40,80,160,0,550
65076,200,140,120,80,160,320,1020
65077,200,160,120,160,160,0,800
65078,150,80,0,0,0,0,230
65079,170,100,40,80,0,0,390
65080,220,160,200,160,160,0,900
65081,180,100,80,80,0,0,440
65082,240,160,120,160,160,0,840
65083,190,140,120,160,160,0,770
65084,200,140,160,160,320,320,1300
65085,160,100,80,80,160,0,580
65086,190,140,160,160,160,320,1130
65087,240,120,120,160,160,0,800
65088,170,120,80,80,160,320,930
65089,190,120,200,160,0,0,670
65090,230,140,120,160,320,320,1290
65091,220,180,120,80,160,0,760
65092,250,100,80,80,0,0,510
65093,200,140,40,80,160,0,620
65094,210,120,120,160,160,0,770
65095,160,80,80,80,160,0,560
65096,180,120,120,80,0,0,500
65097,210,120,80,160,320,0,890
65098,180,160,120,80,160,0,700
65099,170,100,80,160,160,320,990
65100,160,100,80,80,160,0,580
65101,230,140,160,240,320,0,1090
65102,240,140,160,80,160,320,1100
65103,190,100,120,240,160,0,810
65104,220,120,80,0,0,0,420
65105,210,120,160,160,160,0,810
65106,190,140,120,160,160,0,770
65107,190,160,200,80,160,0,790
65108,200,120,120,160,160,0,760
65109,160,100,80,0,0,0,340
65110,190,80,80,0,0,0,350
65111,170,60,40,80,160,0,510
65112,190,180,160,160,160,0,850
65113,190,120,160,80,160,0,710
65114,200,180,160,0,0,0,540
65115,240,100,80,160,320,320,1220
65116,220,120,120,80,160,0,700
65117,180,160,120,0,0,0,460
65118,180,80,40,0,0,0,300
65119,190,120,40,80,160,0,590
65120,210,120,160,160,160,0,810
65121,220,140,160,80,160,0,760
65122,220,160,120,160,160,0,820
65123,220,140,80,80,0,0,520
65124,220,140,120,160,160,320,1120
65125,180,120,80,0,0,0,380
65126,180,140,200,160,160,320,1160
65127,180,160,120,0,0,0,460
65128,190,140,200,160,160,320,1170
65129,190,80,80,80,0,0,430
65130,220,100,80,80,160,320,960
65131,230,160,240,160,160,0,950
65132,220,100,120,160,320,0,920
65133,210,180,200,80,160,0,830
65134,220,140,160,160,320,0,1000
65135,170,60,40,80,160,0,510
65136,190,120,80,160,160,0,710
65137,210,80,40,80,160,0,570
65138,210,100,80,80,160,0,630
65139,200,100,80,0,0,0,380
65140,240,120,160,160,0,0,680
65141,210,120,120,80,160,0,690
65142,190,160,120,160,320,0,950
65143,170,140,160,240,320,0,1030
65144,190,120,200,240,320,0,1070
65145,240,120,120,80,160,0,720
65146,210,140,80,80,0,0,510
65147,230,140,120,160,160,0,810
65148,150,120,80,160,160,320,990
65149,210,80,40,0,0,0,330
65150,170,140,40,80,160,320,910
65151,210,160,120,80,160,0,730
65152,180,120,120,160,160,0,740
65153,220,120,160,160,320,0,980
65154,220,140,80,80,160,0,680
65155,160,120,120,80,160,0,640
65156,180,120,40,0,0,0,340
65157,190,160,240,240,320,0,1150
65158,180,120,120,80,0,0,500
65159,200,120,120,160,160,0,760
65160,210,100,120,160,0,0,590
65161,210,100,80,160,0,0,550
65162,150,120,80,80,160,0,590
65163,210,120,120,0,0,0,450
65164,240,120,160,80,160,0,760
65165,230,180,160,80,160,0,810
65166,210,120,160,160,160,0,810
65167,220,160,120,160,160,0,820
65168,220,140,120,0,0,0,480
65169,190,200,200,240,320,0,1150
65170,210,140,120,160,160,0,790
65171,160,80,0,0,0,0,240
65172,190,60,40,80,160,0,530
65173,220,160,160,0,0,0,540
65174,210,100,160,240,160,0,870
65175,230,140,160,160,160,0,850
65176,160,80,80,80,160,0,560
65177,180,80,40,80,160,0,540
65178,220,140,200,80,160,0,800
65179,200,80,40,80,160,0,560
65180,200,120,80,0,0,0,400
65181,200,140,80,80,160,320,980
65182,160,120,120,0,0,0,400
65183,220,140,80,160,160,0,760
65184,190,160,80,80,160,0,670
65185,180,80,80,80,0,0,420
65186,150,100,80,0,0,0,330
65187,180,140,40,80,160,0,600
65188,210,120,80,80,160,0,650
65189,180,100,80,160,0,0,520
65190,180,100,80,80,160,0,600
65191,190,40,40,80,0,0,350
65192,240,120,40,80,160,0,640
65193,210,180,200,80,0,0,670
65194,180,120,120,80,160,0,660
65195,210,100,80,0,0,0,390
65196,200,120,120,160,0,0,600
65197,180,100,120,160,160,0,720
65198,220,100,120,80,160,0,680
65199,210,100,120,160,160,0,750
65200,210,120,160,160,320,320,1290
65201,190,200,120,160,320,0,990
65202,170,120,80,160,0,0,530
65203,220,140,160,80,160,320,1080
65204,240,160,120,80,160,0,760
65205,220,140,80,0,0,0,440
65206,210,140,80,0,0,0,430
65207,170,80,120,80,160,0,610
65208,200,200,200,240,0,0,840
65209,170,100,80,80,160,0,590
65210,240,100,40,80,160,0,620
65211,120,80,80,0,0,0,280
65212,200,160,120,0,0,0,480
65213,200,100,120,80,160,0,660
65214,190,100,40,0,0,0,330
65215,190,140,160,80,160,320,1050
65216,190,100,80,80,0,0,450
65217,200,120,120,80,160,0,680
65218,170,140,160,80,160,0,710
65219,210,100,120,80,160,320,990
65220,230,160,120,160,160,320,1150
65221,220,180,200,160,0,0,760
65222,200,100,80,80,160,0,620
65223,220,160,200,160,160,320,1220
65224,160,160,160,80,0,0,560
65225,230,160,160,240,160,0,950
65226,200,100,80,160,320,320,1180
65227,240,160,120,160,320,320,1320
65228,220,200,160,160,160,0,900
65229,180,100,40,80,0,0,400
65230,200,160,160,80,0,0,600
65231,230,120,80,160,0,0,590
65232,180,160,160,160,160,0,820
65233,220,180,80,80,0,0,560
65234,190,100,40,0,0,0,330
65235,220,140,0,0,0,0,360
65236,170,140,120,0,0,0,430
65237,190,120,120,160,320,0,910
65238,140,80,120,80,160,0,580
65239,190,140,120,240,160,0,850
65240,180,80,0,0,0,0,260
65241,160,120,120,160,160,0,720
65242,210,160,120,0,0,0,490
65243,220,140,160,0,0,0,520
65244,170,120,40,0,0,0,330
65245,220,160,120,160,320,320,1300
65246,210,140,80,0,0,0,430
65247,180,100,80,80,160,320,920
65248,200,160,120,160,320,0,960
65249,220,120,80,0,0,0,420
65250,230,140,120,160,320,0,970
65251,180,100,120,160,320,320,1200
65252,170,80,40,80,160,0,530
65253,240,140,80,0,0,0,460
65254,250,140,120,160,0,0,670
65255,220,180,120,240,160,0,920
65256,220,140,80,160,160,320,1080
65257,190,80,40,0,0,0,310
65258,160,80,120,160,160,0,680
65259,190,160,120,80,160,0,710
65260,140,100,80,80,0,0,400
65261,180,60,0,0,0,0,240
65262,220,100,160,80,160,0,720
65263,210,120,160,0,0,0,490
65264,250,140,80,0,0,0,470
65265,210,100,160,240,320,0,1030
65266,140,100,120,160,160,0,680
65267,230,220,80,0,0,0,530
65268,280,140,120,160,160,0,860
65269,210,140,120,80,160,0,710
65270,170,80,120,160,320,0,850
65271,180,80,120,80,160,0,620
65272,180,140,200,160,160,320,1160
65273,220,140,80,160,320,0,920
65274,140,20,0,0,0,0,160
65275,180,100,120,160,320,320,1200
65276,190,120,80,0,0,0,390
65277,190,100,160,240,160,0,850
65278,240,180,120,160,320,320,1340
65279,170,140,120,160,160,0,750
65280,250,120,40,80,0,0,490
65281,200,100,80,80,0,0,460
65282,170,60,40,0,0,0,270
65283,220,180,40,80,160,0,680
65284,210,200,80,80,0,0,570
65285,210,120,80,160,160,320,1050
65286,200,80,40,80,160,0,560
65287,220,140,80,80,160,0,680
65288,210,100,80,80,0,0,470
65289,190,120,40,0,0,0,350
65290,210,120,80,0,0,0,410
65291,210,100,120,160,160,0,750
65292,190,80,40,80,0,0,390
65293,160,60,40,80,0,0,340
65294,170,60,120,160,320,0,830
65295,180,140,80,160,160,0,720
65296,220,140,40,80,160,0,640
65297,220,160,120,160,160,0,820
65298,220,120,120,80,160,320,1020
65299,180,80,80,160,320,0,820
65300,190,100,80,160,0,0,530
65301,230,120,80,80,160,0,670
65302,200,120,120,80,0,0,520
65303,230,160,200,160,0,0,750
65304,240,140,200,80,160,0,820
65305,180,100,80,160,320,0,840
65306,260,80,0,0,0,0,340
65307,190,120,120,0,0,0,430
65308,140,140,120,80,0,0,480
65309,200,80,80,80,160,0,600
65310,180,140,160,80,0,0,560
65311,210,100,80,80,160,320,950
65312,200,140,120,0,0,0,460
65313,190,140,40,80,0,0,450
65314,190,140,120,160,320,320,1250
65315,190,120,120,80,160,0,670
65316,200,140,120,160,320,0,940
65317,220,180,160,160,160,0,880
65318,200,120,120,0,0,0,440
65319,180,160,200,240,0,0,780
65320,210,140,40,80,160,0,630
65321,210,220,200,80,160,0,870
65322,230,140,120,80,160,0,730
65323,250,140,80,160,160,0,790
65324,200,100,120,80,160,0,660
65325,200,100,40,80,0,0,420
65326,240,120,120,80,0,0,560
65327,190,120,200,240,160,0,910
65328,170,100,80,80,160,0,590
65329,230,140,80,0,0,0,450
65330,190,120,120,80,160,320,990
65331,180,180,120,160,160,0,800
65332,210,160,200,160,160,320,1210
65333,160,80,80,80,160,0,560
65334,180,100,80,80,0,0,440
65335,180,140,160,160,160,0,800
65336,150,140,200,240,320,320,1370
65337,210,100,40,80,160,0,590
65338,200,80,120,80,0,0,480
65339,170,120,80,80,160,0,610
65340,180,140,120,80,160,0,680
65341,220,160,160,0,0,0,540
65342,190,100,80,0,0,0,370
65343,210,100,120,80,0,0,510
65344,210,180,160,80,0,0,630
65345,230,100,80,160,160,0,730
65346,210,100,80,80,160,0,630
65347,200,80,80,0,0,0,360
65348,200,120,160,240,160,0,880
65349,250,140,120,160,320,0,990
65350,200,120,160,80,160,0,720
65351,170,140,120,80,160,0,670
65352,180,100,120,80,0,0,480
65353,200,140,120,80,160,0,700
65354,200,160,40,80,0,0,480
65355,200,80,80,80,160,0,600
65356,240,180,80,80,0,0,580
65357,220,140,80,160,320,0,920
65358,200,140,80,160,160,0,740
65359,210,120,120,80,160,320,1010
65360,170,120,120,80,160,0,650
65361,190,100,80,80,160,320,930
65362,220,180,200,80,160,0,840
65363,190,100,120,160,320,0,890
65364,190,160,160,80,0,0,590
65365,180,100,120,160,160,0,720
65366,180,120,80,160,0,0,540
65367,160,60,120,80,0,0,420
65368,170,120,40,80,160,0,570
65369,220,140,120,80,160,0,720
65370,180,100,40,80,0,0,400
65371,210,120,160,160,160,0,810
65372,180,100,80,80,160,0,600
65373,200,120,200,160,320,320,1320
65374,170,60,40,80,160,0,510
65375,190,140,120,160,160,0,770
65376,170,40,80,160,160,0,610
65377,230,120,80,80,0,0,510
65378,220,160,200,80,0,0,660
65379,200,100,80,0,0,0,380
65380,170,60,120,80,160,0,590
65381,190,140,120,80,160,320,1010
65382,230,160,120,0,0,0,510
65383,200,120,160,160,320,320,1280
65384,180,120,80,0,0,0,380
65385,200,140,160,160,320,0,980
65386,160,80,160,160,320,320,1200
65387,200,140,160,80,0,0,580
65388,250,100,120,160,160,0,790
65389,180,100,40,80,160,0,560
65390,250,120,40,80,160,0,650
65391,200,140,80,80,160,0,660
65392,230,120,80,80,160,0,670
65393,220,140,160,160,320,320,1320
65394,170,100,40,80,0,0,390
65395,200,140,120,160,160,0,780
65396,200,140,120,80,160,0,700
65397,210,160,80,160,160,0,770
65398,200,120,80,80,160,0,640
65399,210,140,40,0,0,0,390
65400,190,140,40,0,0,0,370
65401,230,120,80,160,160,0,750
65402,230,180,120,160,0,0,690
65403,190,140,160,160,160,0,810
65404,150,120,80,0,0,0,350
65405,160,160,120,80,0,0,520
65406,220,160,160,0,0,0,540
65407,210,100,120,80,160,320,990
65408,210,100,80,0,0,0,390
65409,170,160,160,240,320,320,1370
65410,260,180,160,160,320,320,1400
65411,210,100,80,80,160,0,630
65412,230,140,120,160,320,320,1290
65413,200,160,160,160,320,320,1320
65414,180,120,80,0,0,0,380
65415,230,140,120,80,160,0,730
65416,170,40,0,0,0,0,210
65417,240,140,120,160,0,0,660
65418,170,160,120,80,160,0,690
65419,190,120,120,240,0,0,670
65420,170,120,80,0,0,0,370
65421,200,100,120,80,0,0,500
65422,190,140,0,0,0,0,330
65423,210,140,160,160,160,0,830
65424,240,100,120,80,0,0,540
65425,190,160,120,80,160,0,710
65426,230,120,120,240,320,0,1030
65427,230,160,200,160,160,0,910
65428,190,100,120,80,160,0,650
65429,160,100,80,80,0,0,420
65430,200,160,160,160,160,0,840
65431,230,160,120,160,160,0,830
65432,180,120,120,80,160,0,660
65433,180,140,200,240,160,320,1240
65434,180,160,240,80,160,0,820
65435,210,160,80,80,160,0,690
65436,170,120,120,0,0,0,410
65437,200,80,80,0,0,0,360
65438,190,180,200,160,0,0,730
65439,210,120,80,160,160,0,730
65440,160,60,80,160,160,0,620
65441,190,120,120,240,320,0,990
65442,200,140,40,80,160,0,620
65443,180,80,40,0,0,0,300
65444,190,120,120,0,0,0,430
65445,180,120,80,0,0,0,380
65446,210,120,80,160,160,0,730
65447,150,60,80,0,0,0,290
65448,160,100,120,160,160,0,700
65449,200,100,40,80,160,0,580
65450,230,160,200,160,160,0,910
65451,190,120,160,160,320,0,950
65452,190,160,80,80,160,0,670
65453,220,140,120,80,160,0,720
65454,190,100,80,80,0,0,450
65455,220,160,120,160,160,0,820
65456,180,80,40,0,0,0,300
65457,220,180,160,0,0,0,560
65458,160,140,120,160,160,0,740
65459,220,80,120,80,160,0,660
65460,170,140,40,80,160,0,590
65461,180,120,120,80,0,0,500
65462,200,120,40,80,160,0,600
65463,180,120,80,160,320,0,860
65464,210,140,160,160,0,0,670
65465,190,140,120,0,0,0,450
65466,250,160,200,240,160,0,1010
65467,200,100,40,80,0,0,420
65468,220,160,40,80,160,0,660
65469,230,100,40,80,0,0,450
65470,180,160,160,240,320,0,1060
65471,170,120,160,80,160,0,690
65472,220,160,80,160,160,320,1100
65473,210,160,120,80,160,320,1050
65474,170,100,40,0,0,0,310
65475,240,140,120,0,0,0,500
65476,170,140,120,240,160,0,830
65477,140,120,80,80,160,0,580
65478,240,140,160,240,320,0,1100
65479,220,160,160,160,160,0,860
65480,200,120,160,240,160,0,880
65481,190,120,160,80,160,320,1030
65482,210,160,120,160,160,0,810
65483,170,100,120,80,160,0,630
65484,210,120,120,80,160,0,690
65485,170,140,80,0,0,0,390
65486,160,120,80,80,160,0,600
65487,170,160,80,80,160,0,650
65488,230,140,120,80,160,0,730
65489,190,180,160,160,160,0,850
65490,180,120,160,160,320,320,1260
65491,170,100,80,0,0,0,350
65492,230,60,120,160,0,0,570
65493,200,80,120,160,160,0,720
65494,200,140,200,0,0,0,540
65495,210,100,40,0,0,0,350
65496,200,180,240,160,160,320,1260
65497,200,160,40,0,0,0,400
65498,210,100,40,80,160,0,590
65499,190,80,80,80,160,0,590
65500,170,100,80,0,0,0,350
65501,190,140,160,80,160,0,730
65502,220,140,160,80,0,0,600
65503,200,120,80,80,0,0,480
65504,250,100,40,80,0,0,470
65505,220,160,120,80,160,0,740
65506,220,100,120,160,160,0,760
65507,180,100,80,80,160,0,600
65508,210,140,160,80,0,0,590
65509,190,80,40,80,160,0,550
65510,150,140,120,160,320,0,890
65511,240,140,80,80,160,0,700
65512,190,120,40,80,160,0,590
65513,220,140,120,160,160,0,800
65514,210,120,40,80,160,0,610
65515,170,120,120,160,160,320,1050
65516,180,120,80,160,160,0,700
65517,170,100,80,80,160,0,590
65518,220,100,80,80,160,0,640
65519,200,140,80,0,0,0,420
65520,230,100,120,0,0,0,450
65521,200,180,120,160,320,320,1300
65522,220,80,40,80,160,0,580
65523,200,120,160,160,160,0,800
65524,190,80,120,0,0,0,390
65525,170,140,120,160,160,320,1070
65526,180,140,160,80,160,0,720
65527,170,80,40,80,160,0,530
65528,180,140,80,80,0,0,480
65529,150,100,80,160,320,0,810
65530,210,120,120,80,160,320,1010
65531,220,180,120,160,320,320,1320
65532,210,140,120,80,160,320,1030
65533,210,160,80,80,160,0,690
65534,220,160,120,80,160,320,1060
65535,210,200,160,160,320,0,1050
65536,130,40,0,0,0,0,170
65537,190,140,120,160,160,320,1090
65538,160,100,80,0,0,0,340
65539,200,120,120,160,0,0,600
65540,210,160,200,80,160,0,810
65541,160,80,0,0,0,0,240
65542,190,100,80,0,0,0,370
65543,160,60,40,80,0,0,340
65544,180,140,120,80,0,0,520
65545,180,100,80,80,0,0,440
65546,210,80,120,160,160,0,730
65547,230,200,120,80,0,0,630
65548,180,60,0,0,0,0,240
65549,200,120,80,80,160,0,640
65550,250,160,120,160,0,0,690
65551,210,100,160,160,160,0,790
65552,230,140,120,80,0,0,570
65553,190,100,80,80,160,0,610
65554,190,80,80,80,160,0,590
65555,190,140,120,240,160,0,850
65556,190,120,80,80,160,0,630
65557,190,160,160,160,320,0,990
65558,190,140,160,80,160,0,730
65559,190,140,120,160,320,320,1250
65560,240,180,200,80,160,320,1180
65561,190,160,160,160,0,0,670
65562,170,100,40,80,0,0,390
65563,190,100,120,80,0,0,490
65564,190,100,0,0,0,0,290
65565,210,180,80,80,160,0,710
65566,190,160,120,0,0,0,470
65567,150,120,120,160,160,0,710
65568,230,160,160,0,0,0,550
65569,190,120,120,160,160,0,750
65570,170,160,80,0,0,0,410
65571,190,120,120,80,160,0,670
65572,230,120,80,160,160,320,1070
65573,160,120,160,240,160,0,840
65574,180,120,160,80,0,0,540
65575,150,100,120,80,160,320,930
65576,160,100,160,160,0,0,580
65577,210,140,40,80,0,0,470
65578,220,140,80,160,160,0,760
65579,170,120,120,80,160,0,650
65580,180,120,200,160,0,0,660
65581,220,160,160,240,160,0,940
65582,210,140,120,0,0,0,470
65583,160,80,80,80,160,0,560
65584,230,140,80,160,160,0,770
65585,190,100,40,80,0,0,410
65586,190,140,160,80,0,0,570
65587,180,100,160,160,160,320,1080
65588,140,40,40,0,0,0,220
65589,210,140,120,80,160,0,710
65590,190,120,160,160,160,0,790
65591,190,120,160,80,160,0,710
65592,240,140,80,80,160,0,700
65593,180,100,160,160,160,0,760
65594,200,100,40,80,0,0,420
65595,180,120,80,80,0,0,460
65596,200,100,120,80,160,0,660
65597,210,100,80,80,0,0,470
65598,210,140,160,160,160,0,830
65599,210,180,160,160,160,0,870
65600,160,120,160,240,320,0,1000
65601,190,120,80,80,160,0,630
65602,160,80,80,160,320,320,1120
65603,210,120,80,80,0,0,490
65604,220,160,120,240,160,320,1220
65605,220,120,160,160,0,0,660
65606,200,100,120,160,0,0,580
65607,200,120,80,80,160,0,640
65608,190,120,80,80,160,320,950
65609,220,160,160,80,160,0,780
65610,200,140,80,80,0,0,500
65611,210,120,160,160,320,0,970
65612,190,180,160,160,160,0,850
65613,220,140,80,0,0,0,440
65614,220,140,120,240,0,0,720
65615,210,180,80,80,160,320,1030
65616,200,80,40,0,0,0,320
65617,230,80,40,80,160,0,590
65618,170,80,120,240,160,0,770
65619,240,180,160,80,0,0,660
65620,210,140,160,160,160,0,830
65621,140,80,80,80,0,0,380
65622,180,120,80,80,0,0,460
65623,160,140,160,160,0,0,620
65624,190,120,120,160,160,0,750
65625,170,140,80,80,160,0,630
65626,240,120,80,80,0,0,520
65627,220,80,120,0,0,0,420
65628,210,140,80,0,0,0,430
65629,160,100,120,160,320,320,1180
65630,230,140,160,80,160,320,1090
65631,190,100,120,80,0,0,490
65632,210,120,80,160,0,0,570
65633,210,80,120,80,0,0,490
65634,190,120,120,240,160,0,830
65635,180,140,120,160,320,320,1240
65636,200,120,160,80,160,0,720
65637,180,140,160,240,320,0,1040
65638,170,60,80,160,320,0,790
65639,220,100,80,0,0,0,400
65640,190,140,160,80,0,0,570
65641,170,100,80,80,160,0,590
65642,170,100,80,80,160,0,590
65643,190,140,40,80,160,0,610
65644,220,140,160,80,0,0,600
65645,170,120,120,80,160,320,970
65646,180,80,160,160,160,0,740
65647,180,140,120,160,160,0,760
65648,200,140,160,0,0,0,500
65649,210,160,120,160,0,0,650
65650,200,200,200,160,160,0,920
65651,230,160,120,80,160,320,1070
65652,190,140,120,160,320,0,930
65653,140,80,80,80,0,0,380
65654,160,160,120,160,0,0,600
65655,150,140,160,80,0,0,530
65656,210,140,80,160,160,0,750
65657,200,120,80,160,320,320,1200
65658,180,80,80,80,160,0,580
65659,210,160,160,80,0,0,610
65660,210,140,80,0,0,0,430
65661,150,120,80,80,160,0,590
65662,200,100,80,80,0,0,460
65663,180,120,80,80,160,0,620
65664,200,140,120,160,160,0,780
65665,210,140,120,80,160,0,710
65666,250,120,120,80,160,0,730
65667,170,100,80,0,0,0,350
65668,210,160,120,80,0,0,570
65669,260,220,120,80,0,0,680
65670,220,200,160,160,160,0,900
65671,200,120,80,160,160,0,720
65672,180,120,120,0,0,0,420
65673,210,100,80,80,160,0,630
65674,150,80,80,160,320,0,790
65675,160,120,200,240,160,0,880
65676,190,180,80,160,160,0,770
65677,200,160,120,80,160,0,720
65678,190,60,40,80,0,0,370
65679,230,120,40,80,160,320,950
65680,170,120,120,80,0,0,490
65681,180,100,80,160,160,0,680
65682,170,160,120,80,160,0,690
65683,190,80,80,80,160,0,590
65684,170,100,120,80,160,0,630
65685,160,100,160,160,320,320,1220
65686,220,120,120,160,160,0,780
65687,230,160,160,160,160,0,870
65688,200,100,120,80,0,0,500
65689,160,60,120,80,160,0,580
65690,180,80,160,160,320,0,900
65691,190,160,120,80,160,0,710
65692,210,140,120,160,160,0,790
65693,160,80,40,0,0,0,280
65694,200,140,120,160,320,320,1260
65695,160,100,80,80,160,0,580
65696,210,140,120,160,320,0,950
65697,230,80,40,80,0,0,430
65698,210,160,120,0,0,0,490
65699,180,180,200,80,160,0,800
65700,180,80,80,80,160,0,580
65701,180,160,80,80,0,0,500
65702,200,160,120,0,0,0,480
65703,190,160,40,0,0,0,390
65704,170,120,40,0,0,0,330
65705,200,220,200,80,160,0,860
65706,180,120,120,80,0,0,500
65707,180,120,80,160,0,0,540
65708,220,100,160,160,160,0,800
65709,210,60,80,80,0,0,430
65710,190,120,80,80,0,0,470
65711,190,100,80,160,160,320,1010
65712,190,140,120,80,160,0,690
65713,180,140,80,80,160,0,640
65714,200,80,40,80,0,0,400
65715,210,120,40,80,160,0,610
65716,180,120,160,160,320,0,940
65717,190,140,40,80,160,0,610
65718,200,120,120,80,0,0,520
65719,200,100,160,160,320,320,1260
65720,210,140,80,80,0,0,510
65721,200,100,160,160,320,320,1260
65722,220,160,200,160,320,320,1380
65723,230,160,120,80,0,0,590
65724,180,120,120,80,160,0,660
65725,170,120,160,160,160,0,770
65726,170,40,40,80,160,0,490
65727,190,180,160,80,160,320,1090
65728,220,100,40,0,0,0,360
65729,210,120,120,80,160,0,690
65730,180,120,120,160,160,0,740
65731,160,140,120,80,0,0,500
65732,180,20,40,80,160,0,480
65733,180,80,80,80,0,0,420
65734,210,140,200,160,320,0,1030
65735,170,160,160,0,0,0,490
65736,210,140,80,80,0,0,510
65737,190,140,160,240,160,0,890
65738,190,120,120,80,160,320,990
65739,220,120,80,160,0,0,580
65740,180,160,120,160,0,0,620
65741,240,120,120,160,160,0,800
65742,180,120,40,80,0,0,420
65743,230,200,240,160,160,0,990
65744,180,140,120,240,160,320,1160
65745,170,80,120,80,0,0,450
65746,190,80,120,80,0,0,470
65747,230,140,200,160,0,0,730
65748,200,120,200,160,0,0,680
65749,180,120,40,80,160,0,580
65750,200,120,120,160,160,0,760
65751,210,140,120,80,160,320,1030
65752,200,160,200,160,320,320,1360
65753,200,140,200,160,160,0,860
65754,180,160,40,80,160,320,940
65755,220,160,80,80,0,0,540
65756,210,140,120,160,160,0,790
65757,190,140,160,0,0,0,490
65758,160,100,120,160,160,0,700
65759,170,120,80,80,160,0,610
65760,200,100,40,80,160,0,580
65761,230,160,80,160,320,0,950
65762,180,80,120,80,160,0,620
65763,210,140,160,80,160,0,750
65764,170,60,40,0,0,0,270
65765,170,100,120,160,160,0,710
65766,220,80,120,160,160,0,740
65767,200,160,160,80,160,0,760
65768,220,60,0,0,0,0,280
65769,160,100,80,160,160,0,660
65770,160,140,120,80,0,0,500
65771,200,100,80,160,0,0,540
65772,200,100,120,160,160,0,740
65773,200,120,80,160,160,0,720
65774,190,140,160,160,160,0,810
65775,190,140,160,160,160,0,810
65776,190,120,120,80,160,0,670
65777,220,180,200,160,0,0,760
65778,180,120,160,80,0,0,540
65779,190,120,80,80,160,320,950
65780,180,120,160,240,320,0,1020
65781,230,120,80,0,0,0,430
65782,220,140,80,80,160,0,680
65783,170,100,120,240,160,0,790
65784,190,100,120,240,160,0,810
65785,200,120,120,160,320,0,920
65786,170,160,160,80,160,0,730
65787,200,180,200,240,160,0,980
65788,190,100,80,80,160,320,930
65789,220,120,80,80,0,0,500
65790,170,200,200,240,160,0,970
65791,230,120,40,80,0,0,470
65792,190,180,200,160,320,0,1050
65793,230,140,40,0,0,0,410
65794,210,180,200,240,320,0,1150
65795,200,120,120,160,0,0,600
65796,190,100,80,0,0,0,370
65797,200,140,120,240,320,320,1340
65798,210,180,240,240,160,0,1030
65799,220,140,0,0,0,0,360
65800,160,160,120,80,160,0,680
65801,220,100,120,160,160,320,1080
65802,170,100,80,80,160,0,590
65803,190,160,120,160,320,0,950
65804,180,180,160,240,160,0,920
65805,150,60,40,0,0,0,250
65806,160,60,80,80,0,0,380
65807,230,100,120,80,0,0,530
65808,170,100,80,0,0,0,350
65809,180,100,120,80,0,0,480
65810,190,80,120,160,160,0,710
65811,200,140,120,0,0,0,460
65812,220,100,80,80,160,0,640
65813,200,140,40,80,0,0,460
65814,240,200,200,160,160,0,960
65815,190,80,80,80,160,0,590
65816,200,220,200,80,160,0,860
65817,190,180,120,80,0,0,570
65818,220,160,80,80,160,0,700
65819,200,140,40,0,0,0,380
65820,220,160,120,80,160,0,740
65821,210,100,80,160,160,0,710
65822,240,140,120,0,0,0,500
65823,220,180,80,80,160,320,1040
65824,220,160,80,80,160,0,700
65825,220,120,0,0,0,0,340
65826,230,120,120,160,0,0,630
65827,150,60,80,160,320,320,1090
65828,210,100,120,160,320,0,910
65829,210,120,120,160,0,0,610
65830,170,100,0,0,0,0,270
65831,150,40,0,0,0,0,190
65832,150,80,80,80,0,0,390
65833,190,120,160,80,160,0,710
65834,180,120,120,80,160,320,980
65835,180,100,160,80,160,320,1000
65836,170,100,80,160,320,0,830
65837,200,140,120,80,0,0,540
65838,220,160,120,80,0,0,580
65839,220,180,80,80,160,0,720
65840,210,140,80,160,160,0,750
65841,210,120,80,160,160,0,730
65842,150,160,160,160,160,0,790
65843,230,160,120,240,320,0,1070
65844,210,160,80,80,160,320,1010
65845,210,140,160,160,160,0,830
65846,200,120,80,0,0,0,400
65847,210,140,120,80,160,0,710
65848,240,120,80,80,160,0,680
65849,170,120,40,80,160,0,570
65850,230,140,120,160,0,0,650
65851,220,140,80,80,160,0,680
65852,230,180,120,160,0,0,690
65853,170,120,160,240,320,320,1330
65854,210,120,80,80,0,0,490
65855,230,140,80,160,160,0,770
65856,180,100,120,160,160,0,720
65857,240,140,120,160,320,0,980
65858,200,160,120,80,0,0,560
65859,250,160,160,160,160,0,890
65860,210,160,160,80,0,0,610
65861,210,100,80,0,0,0,390
65862,200,120,120,160,160,0,760
65863,210,80,80,160,0,0,530
65864,190,120,160,160,0,0,630
65865,190,100,160,160,160,320,1090
65866,180,100,40,0,0,0,320
65867,230,80,0,0,0,0,310
65868,200,120,120,0,0,0,440
65869,190,140,40,80,0,0,450
65870,200,100,120,160,320,0,900
65871,220,120,120,80,0,0,540
65872,190,80,160,240,160,0,830
65873,170,80,120,160,320,320,1170
65874,150,100,80,160,320,0,810
65875,190,80,120,80,0,0,470
65876,220,60,40,80,0,0,400
65877,220,120,160,80,160,0,740
65878,180,160,160,80,160,0,740
65879,220,140,160,80,160,0,760
65880,220,180,120,80,160,0,760
65881,210,160,120,240,160,0,890
65882,210,140,120,160,160,0,790
65883,200,120,80,0,0,0,400
65884,170,80,160,160,160,0,730
65885,190,60,120,160,320,0,850
65886,170,100,120,160,160,0,710
65887,200,80,40,0,0,0,320
65888,230,60,40,80,160,0,570
65889,180,120,160,160,160,0,780
65890,180,80,120,0,0,0,380
65891,210,160,200,160,160,0,890
65892,230,120,240,80,160,320,1150
65893,220,120,160,160,0,0,660
65894,190,100,80,80,160,320,930
65895,200,140,160,160,320,0,980
65896,200,200,80,80,160,0,720
65897,210,120,80,160,320,0,890
65898,220,160,200,80,0,0,660
65899,170,120,160,160,160,0,770
65900,200,100,160,240,160,0,860
65901,160,140,120,80,160,0,660
65902,200,140,120,160,0,0,620
65903,190,160,40,80,0,0,470
65904,160,100,40,0,0,0,300
65905,180,80,120,80,0,0,460
65906,150,100,120,160,160,320,1010
65907,190,140,120,160,0,0,610
65908,180,60,80,0,0,0,320
65909,190,80,120,80,0,0,470
65910,200,100,80,0,0,0,380
65911,200,100,40,0,0,0,340
65912,210,120,80,80,160,320,970
65913,170,60,40,0,0,0,270
65914,200,100,80,160,160,0,700
65915,220,140,200,240,160,0,960
65916,200,120,40,80,160,0,600
65917,170,80,160,160,320,320,1210
65918,210,140,160,0,0,0,510
65919,170,160,200,240,320,0,1090
65920,200,120,40,80,160,0,600
65921,210,140,80,0,0,0,430
65922,240,140,80,160,0,0,620
65923,220,120,120,160,320,0,940
65924,180,100,80,160,160,0,680
65925,220,100,120,160,320,320,1240
65926,220,100,120,240,320,320,1320
65927,210,180,40,80,160,0,670
65928,230,200,160,80,0,0,670
65929,190,120,160,160,0,0,630
65930,180,140,80,0,0,0,400
65931,200,120,80,0,0,0,400
65932,200,100,80,80,160,0,620
65933,180,120,80,160,320,0,860
65934,180,80,120,160,160,0,700
65935,160,100,120,160,160,0,700
65936,190,120,120,80,160,0,670
65937,190,120,120,0,0,0,430
65938,190,140,120,160,160,0,770
65939,200,140,200,80,0,0,620
65940,230,120,200,80,160,0,790
65941,240,100,120,80,0,0,540
65942,180,80,120,160,160,320,1020
65943,210,120,40,0,0,0,370
65944,190,100,120,80,0,0,490
65945,220,140,120,160,160,0,800
65946,250,140,80,0,0,0,470
65947,200,160,200,160,320,320,1360
65948,160,80,40,80,0,0,360
65949,250,120,120,160,0,0,650
65950,210,140,80,80,0,0,510
65951,240,160,80,80,0,0,560
65952,170,100,120,0,0,0,390
65953,190,100,120,160,160,320,1050
65954,180,140,160,240,160,0,880
65955,200,140,80,160,320,320,1220
65956,190,100,40,80,160,0,570
65957,170,80,40,80,160,0,530
65958,190,80,120,160,160,0,710
65959,180,140,120,160,160,0,760
65960,190,80,80,0,0,0,350
65961,190,120,120,240,160,0,830
65962,180,140,200,80,160,0,760
65963,190,100,0,0,0,0,290
65964,220,140,120,80,0,0,560
65965,200,120,160,80,160,0,720
65966,230,100,120,80,0,0,530
65967,210,120,120,0,0,0,450
65968,230,80,80,80,0,0,470
65969,220,60,0,0,0,0,280
65970,200,100,80,80,160,0,620
65971,180,160,160,160,160,0,820
65972,170,80,80,80,160,0,570
65973,200,80,160,240,320,0,1000
65974,220,160,160,240,160,0,940
65975,170,80,120,80,160,0,610
65976,210,80,80,80,160,0,610
65977,180,100,120,80,160,0,640
65978,180,140,80,160,160,0,720
65979,180,160,120,240,0,0,700
65980,190,100,120,80,160,0,650
65981,210,100,160,160,160,0,790
65982,160,160,120,160,160,320,1080
65983,210,180,160,80,160,320,1110
65984,190,120,120,80,160,320,990
65985,180,60,40,0,0,0,280
65986,200,100,80,0,0,0,380
65987,210,120,160,160,160,0,810
65988,180,160,120,160,160,0,780
65989,190,100,80,80,160,0,610
65990,180,160,120,80,160,0,700
65991,190,100,120,80,0,0,490
65992,210,180,120,0,0,0,510
65993,220,180,200,240,160,0,1000
65994,220,80,40,80,160,0,580
65995,190,140,120,80,160,0,690
65996,210,100,120,0,0,0,430
65997,210,80,80,80,160,0,610
65998,220,180,120,80,0,0,600
65999,190,120,160,160,160,320,1110
66000,180,100,120,80,0,0,480
66001,200,140,80,0,0,0,420
66002,210,120,40,0,0,0,370
66003,220,100,120,80,160,320,1000
66004,160,140,160,240,320,320,1340
66005,200,120,120,80,160,0,680
66006,210,120,120,240,160,0,850
66007,180,120,120,80,160,0,660
66008,180,120,120,80,160,0,660
66009,190,80,80,80,160,0,590
66010,170,80,0,0,0,0,250
66011,180,120,40,0,0,0,340
66012,190,120,80,80,160,0,630
66013,240,180,160,160,320,0,1060
66014,200,100,80,160,160,0,700
66015,240,140,80,160,160,0,780
66016,160,100,80,160,320,0,820
66017,190,60,80,80,0,0,410
66018,180,100,80,80,160,0,600
66019,150,120,80,80,0,0,430
66020,220,100,80,80,0,0,480
66021,190,100,120,160,0,0,570
66022,220,140,40,80,0,0,480
66023,200,180,120,0,0,0,500
66024,180,100,120,160,160,0,720
66025,180,120,80,80,0,0,460
66026,200,140,120,160,160,0,780
66027,210,140,120,160,0,0,630
66028,200,100,80,0,0,0,380
66029,190,60,40,0,0,0,290
66030,170,80,80,160,320,320,1130
66031,220,80,80,80,0,0,460
66032,240,160,80,80,160,0,720
66033,210,100,120,160,160,320,1070
66034,260,180,160,80,0,0,680
66035,190,100,40,80,160,0,570
66036,140,100,120,160,0,0,520
66037,200,140,80,80,0,0,500
66038,210,120,120,80,0,0,530
66039,200,120,40,80,160,0,600
66040,220,140,160,160,160,0,840
66041,190,120,40,80,160,0,590
66042,210,80,80,0,0,0,370
66043,210,180,200,160,160,0,910
66044,200,180,160,80,0,0,620
66045,210,200,160,160,320,320,1370
66046,180,60,120,160,160,0,680
66047,230,160,160,160,160,0,870
66048,190,120,80,160,160,0,710
66049,170,100,80,160,320,0,830
66050,240,120,160,0,0,0,520
66051,230,160,160,80,160,0,790
66052,190,180,120,80,160,0,730
66053,150,140,40,80,160,0,570
66054,210,180,160,80,160,320,1110
66055,240,160,120,0,0,0,520
66056,190,140,120,160,320,320,1250
66057,180,100,80,80,0,0,440
66058,240,200,40,80,160,0,720
66059,250,180,40,0,0,0,470
66060,180,60,40,80,160,0,520
66061,170,140,80,0,0,0,390
66062,250,100,120,0,0,0,470
66063,190,120,120,160,160,320,1070
66064,180,100,80,80,160,0,600
66065,190,100,120,240,320,320,1290
66066,200,80,120,80,0,0,480
66067,170,100,80,80,160,0,590
66068,200,120,80,160,160,0,720
66069,230,100,40,80,160,320,930
66070,170,120,120,80,160,0,650
66071,210,60,40,0,0,0,310
66072,180,120,120,0,0,0,420
66073,200,120,80,160,160,0,720
66074,230,100,80,80,0,0,490
66075,220,120,80,80,160,320,980
66076,230,160,80,160,160,0,790
66077,200,140,40,0,0,0,380
66078,190,160,160,240,320,0,1070
66079,190,200,160,160,320,0,1030
66080,210,160,40,80,160,0,650
66081,200,140,80,80,0,0,500
66082,230,180,80,80,160,0,730
66083,170,160,120,80,0,0,530
66084,210,180,120,80,160,0,750
66085,170,80,80,0,0,0,330
66086,180,120,160,80,0,0,540
66087,210,100,80,80,160,0,630
66088,200,100,120,0,0,0,420
66089,190,160,80,0,0,0,430
66090,170,80,80,0,0,0,330
66091,200,200,200,80,0,0,680
66092,220,120,120,160,320,0,940
66093,220,160,200,160,320,320,1380
66094,220,100,120,80,160,0,680
66095,220,120,120,80,0,0,540
66096,200,120,120,160,320,0,920
66097,190,100,40,80,160,0,570
66098,220,100,80,80,160,0,640
66099,160,100,40,0,0,0,300
66100,190,120,80,160,0,0,550
66101,220,140,120,160,0,0,640
66102,180,140,120,160,160,0,760
66103,190,140,80,80,0,0,490
66104,200,80,80,160,320,0,840
66105,180,100,0,0,0,0,280
66106,210,80,80,80,160,0,610
66107,140,100,80,160,0,0,480
66108,250,100,40,80,0,0,470
66109,210,160,120,160,160,320,1130
66110,180,100,120,80,160,0,640
66111,230,140,80,160,160,0,770
66112,190,180,200,160,320,0,1050
66113,250,140,160,160,0,0,710
66114,200,140,160,160,0,0,660
66115,220,140,80,0,0,0,440
66116,200,80,40,0,0,0,320
66117,170,160,240,160,0,0,730
66118,180,120,80,0,0,0,380
66119,160,100,80,160,320,0,820
66120,210,120,40,80,160,320,930
66121,180,140,120,240,160,320,1160
66122,160,60,40,80,0,0,340
66123,210,80,80,80,0,0,450
66124,220,60,80,80,160,0,600
66125,240,140,80,0,0,0,460
66126,200,180,40,80,0,0,500
66127,180,40,40,0,0,0,260
66128,210,160,200,160,160,0,890
66129,190,80,80,80,160,320,910
66130,190,40,40,80,0,0,350
66131,190,160,80,80,160,0,670
66132,210,120,120,80,160,0,690
66133,200,100,80,160,320,0,860
66134,220,160,120,80,0,0,580
66135,190,160,160,160,160,0,830
66136,230,160,120,80,160,0,750
66137,210,120,120,80,0,0,530
66138,190,140,200,160,320,0,1010
66139,200,160,120,160,160,0,800
66140,210,180,120,80,0,0,590
66141,190,140,160,240,0,0,730
66142,190,140,160,160,320,0,970
66143,160,100,120,80,160,0,620
66144,250,180,200,80,0,0,710
66145,200,140,120,160,160,0,780
66146,160,100,80,0,0,0,340
66147,230,120,160,80,160,0,750
66148,230,140,80,0,0,0,450
66149,230,100,80,160,160,320,1050
66150,210,120,120,0,0,0,450
66151,180,160,160,160,0,0,660
66152,230,120,120,160,320,0,950
66153,200,160,120,160,320,0,960
66154,200,120,80,0,0,0,400
66155,230,100,80,80,160,320,970
66156,210,140,40,80,0,0,470
66157,190,100,40,80,160,0,570
66158,180,120,80,160,320,0,860
66159,150,140,80,80,160,0,610
66160,180,80,80,80,0,0,420
66161,200,100,160,160,160,0,780
66162,180,160,80,160,160,0,740
66163,190,80,80,80,0,0,430
66164,250,80,80,80,160,0,650
66165,180,120,160,240,0,0,700
66166,190,100,120,240,320,0,970
66167,240,160,80,80,160,320,1040
66168,220,60,80,80,160,0,600
66169,160,160,120,80,160,0,680
66170,180,160,80,0,0,0,420
66171,220,160,160,160,160,0,860
66172,170,100,160,80,160,0,670
66173,190,100,120,160,320,320,1210
66174,210,140,200,240,0,0,790
66175,180,120,80,160,320,320,1180
66176,220,100,40,80,160,0,600
66177,240,100,120,160,160,320,1100
66178,210,80,0,0,0,0,290
66179,200,100,120,80,0,0,500
66180,210,120,120,80,0,0,530
66181,180,100,80,80,160,0,600
66182,220,120,160,160,0,0,660
66183,200,140,80,80,0,0,500
66184,180,140,160,0,0,0,480
66185,180,120,160,160,160,0,780
66186,200,160,200,80,160,0,800
66187,210,180,160,160,160,0,870
66188,230,100,80,80,160,0,650
66189,180,120,0,0,0,0,300
66190,200,60,40,0,0,0,300
66191,180,180,160,160,160,0,840
66192,190,100,160,160,160,0,770
66193,200,120,120,80,160,320,1000
66194,190,120,80,80,160,0,630
66195,210,140,160,80,160,0,750
66196,200,180,80,80,160,320,1020
66197,210,120,80,0,0,0,410
66198,200,220,240,160,160,0,980
66199,210,120,80,80,160,0,650
66200,210,100,120,0,0,0,430
66201,160,80,120,160,160,0,680
66202,160,60,80,160,160,0,620
66203,160,100,200,160,320,0,940
66204,170,160,80,0,0,0,410
66205,180,100,80,160,160,320,1000
66206,180,140,80,80,0,0,480
66207,190,80,160,160,0,0,590
66208,190,120,80,80,160,0,630
66209,200,120,120,80,160,0,680
66210,220,160,160,160,320,320,1340
66211,250,100,80,160,160,0,750
66212,190,120,120,0,0,0,430
66213,210,60,40,0,0,0,310
66214,170,100,80,160,160,0,670
66215,240,140,80,80,0,0,540
66216,190,160,120,160,160,320,1110
66217,220,140,120,80,0,0,560
66218,190,140,120,160,160,0,770
66219,190,140,40,80,0,0,450
66220,230,140,80,0,0,0,450
66221,190,80,40,0,0,0,310
66222,130,60,80,80,0,0,350
66223,200,100,200,240,160,0,900
66224,210,160,120,80,0,0,570
66225,220,100,80,0,0,0,400
66226,150,120,120,80,160,0,630
66227,240,180,80,160,160,0,820
66228,210,160,120,80,160,0,730
66229,210,180,200,0,0,0,590
66230,160,100,80,80,160,0,580
66231,180,100,80,80,0,0,440
66232,220,120,80,0,0,0,420
66233,160,120,120,160,320,0,880
66234,200,160,120,160,0,0,640
66235,200,140,80,80,0,0,500
66236,180,120,160,160,160,320,1100
66237,190,180,120,80,160,0,730
66238,230,180,80,80,160,0,730
66239,160,120,80,80,0,0,440
66240,210,100,80,160,160,0,710
66241,200,180,40,80,160,0,660
66242,170,80,120,160,160,0,690
66243,210,80,80,160,320,0,850
66244,240,160,40,80,160,0,680
66245,180,120,160,240,160,0,860
66246,180,160,120,160,320,320,1260
66247,190,120,120,80,160,0,670
66248,170,120,120,80,160,0,650
66249,200,160,160,160,160,0,840
66250,220,160,120,160,320,320,1300
66251,220,120,120,80,160,320,1020
66252,190,120,120,0,0,0,430
66253,220,140,120,0,0,0,480
66254,230,160,120,80,160,0,750
66255,200,60,40,80,160,320,860
66256,210,140,40,80,0,0,470
66257,200,100,120,80,160,0,660
66258,180,60,0,0,0,0,240
66259,230,80,160,80,0,0,550
66260,220,100,120,240,160,0,840
66261,140,180,200,240,0,0,760
66262,220,140,160,240,320,320,1400
66263,220,120,40,0,0,0,380
66264,160,140,80,160,160,0,700
66265,190,140,120,160,320,0,930
66266,180,100,120,80,160,0,640
66267,150,180,160,160,160,0,810
66268,230,120,160,160,320,0,990
66269,160,140,160,160,0,0,620
66270,190,160,80,160,160,320,1070
66271,250,140,160,160,160,0,870
66272,210,120,40,80,0,0,450
66273,180,120,80,0,0,0,380
66274,160,140,120,160,160,320,1060
66275,220,100,80,80,160,0,640
66276,200,140,80,80,160,320,980
66277,180,140,160,80,160,320,1040
66278,170,140,40,80,0,0,430
66279,180,160,40,0,0,0,380
66280,210,160,120,80,160,0,730
66281,200,140,160,240,320,320,1380
66282,220,140,120,240,320,320,1360
66283,190,140,80,160,160,0,730
66284,210,120,120,160,160,0,770
66285,200,180,160,160,320,0,1020
66286,220,120,80,160,320,320,1220
66287,170,120,120,160,160,0,730
66288,210,160,120,240,320,320,1370
66289,180,120,160,160,320,320,1260
66290,210,140,160,80,160,0,750
66291,160,100,120,160,160,0,700
66292,220,180,160,0,0,0,560
66293,200,140,160,0,0,0,500
66294,210,140,120,80,160,0,710
66295,210,80,40,0,0,0,330
66296,210,140,120,80,160,320,1030
66297,200,180,160,160,160,0,860
66298,250,100,80,80,0,0,510
66299,200,160,40,80,0,0,480
66300,200,160,80,80,160,0,680
66301,220,160,120,160,160,0,820
66302,230,120,80,160,320,0,910
66303,190,120,80,0,0,0,390
66304,210,160,160,160,160,0,850
66305,160,80,40,0,0,0,280
66306,200,80,80,80,160,0,600
66307,200,140,80,80,160,0,660
66308,220,100,80,80,0,0,480
66309,200,140,80,160,160,0,740
66310,180,100,120,0,0,0,400
66311,230,120,120,160,320,320,1270
66312,170,100,40,80,160,320,870
66313,180,120,120,80,160,0,660
66314,180,120,120,160,160,0,740
66315,190,120,120,80,160,320,990
66316,170,120,80,80,160,0,610
66317,160,140,80,80,160,0,620
66318,180,160,160,160,160,0,820
66319,220,120,120,160,160,320,1100
66320,220,180,200,240,320,0,1160
66321,190,140,120,80,0,0,530
66322,210,160,40,80,0,0,490
66323,150,100,80,80,0,0,410
66324,180,160,120,160,160,0,780
66325,200,100,40,80,0,0,420
66326,150,80,120,80,0,0,430
66327,180,60,80,80,160,0,560
66328,210,140,160,160,320,320,1310
66329,200,100,80,160,0,0,540
66330,160,120,40,0,0,0,320
66331,170,100,80,160,160,0,670
66332,190,40,40,80,160,0,510
66333,210,120,160,80,160,0,730
66334,170,120,40,80,160,0,570
66335,180,60,120,80,0,0,440
66336,190,180,240,240,160,0,1010
66337,200,140,120,80,0,0,540
66338,170,60,80,80,0,0,390
66339,190,140,200,80,160,0,770
66340,210,80,0,0,0,0,290
66341,150,80,40,80,160,0,510
66342,200,160,120,160,320,0,960
66343,210,100,80,160,160,0,710
66344,190,140,120,80,160,320,1010
66345,240,200,80,0,0,0,520
66346,230,160,80,80,0,0,550
66347,200,160,160,240,160,0,920
66348,190,120,80,0,0,0,390
66349,240,160,120,0,0,0,520
66350,190,160,80,160,320,0,910
66351,230,120,120,160,160,0,790
66352,200,180,120,80,160,320,1060
66353,200,80,120,240,160,0,800
66354,220,180,160,0,0,0,560
66355,180,140,120,160,0,0,600
66356,240,200,160,160,160,0,920
66357,180,160,160,240,160,0,900
66358,190,80,40,80,160,320,870
66359,220,140,120,80,160,0,720
66360,210,160,120,0,0,0,490
66361,200,120,160,160,0,0,640
66362,200,120,120,160,160,0,760
66363,210,140,120,80,160,0,710
66364,190,160,160,160,160,0,830
66365,210,100,120,160,160,0,750
66366,170,100,160,240,160,0,830
66367,190,120,40,80,160,0,590
66368,200,160,200,240,160,0,960
66369,210,160,120,80,160,0,730
66370,150,120,120,80,0,0,470
66371,180,100,80,80,160,0,600
66372,190,160,160,80,160,0,750
66373,190,140,40,0,0,0,370
66374,210,100,120,80,160,0,670
66375,190,120,120,160,0,0,590
66376,170,120,160,160,160,0,770
66377,190,80,80,160,0,0,510
66378,200,100,120,80,160,0,660
66379,210,120,80,80,160,0,650
66380,210,120,0,0,0,0,330
66381,200,140,160,80,160,0,740
66382,180,120,80,160,320,0,860
66383,190,120,160,160,160,0,790
66384,190,100,80,80,160,320,930
66385,210,60,40,0,0,0,310
66386,190,100,120,160,160,0,730
66387,190,80,120,0,0,0,390
66388,220,140,80,80,0,0,520
66389,210,160,80,80,160,0,690
66390,130,140,120,80,160,0,630
66391,210,80,40,80,160,0,570
66392,230,120,120,240,160,0,870
66393,190,180,120,80,160,0,730
66394,170,120,160,240,320,320,1330
66395,170,140,120,80,0,0,510
66396,190,100,200,240,320,320,1370
66397,220,140,80,0,0,0,440
66398,180,140,120,160,160,0,760
66399,190,160,80,80,160,0,670
66400,160,60,40,0,0,0,260
66401,220,140,120,80,160,320,1040
66402,240,160,40,80,0,0,520
66403,190,80,80,80,0,0,430
66404,220,140,160,80,160,0,760
66405,160,140,120,160,160,0,740
66406,240,140,160,240,320,0,1100
66407,200,160,80,80,160,320,1000
66408,180,120,120,80,0,0,500
66409,220,140,200,160,320,320,1360
66410,210,100,120,160,320,320,1230
66411,160,160,160,160,320,0,960
66412,220,140,80,80,160,0,680
66413,200,140,120,160,0,0,620
66414,230,80,80,80,160,320,950
66415,210,120,160,0,0,0,490
66416,150,80,120,80,160,0,590
66417,200,80,40,80,160,0,560
66418,220,160,120,80,0,0,580
66419,210,120,40,0,0,0,370
66420,180,120,120,80,160,0,660
66421,210,140,160,80,160,0,750
66422,220,160,40,0,0,0,420
66423,190,140,80,0,0,0,410
66424,150,100,120,240,320,0,930
66425,230,120,40,0,0,0,390
66426,190,40,0,0,0,0,230
66427,220,60,80,80,0,0,440
66428,220,100,80,80,160,0,640
66429,220,200,160,80,160,0,820
66430,160,140,40,80,160,0,580
66431,180,120,80,80,0,0,460
66432,160,180,200,160,320,0,1020
66433,250,180,200,240,160,0,1030
66434,220,140,80,160,320,0,920
66435,170,60,40,0,0,0,270
66436,170,100,120,160,160,0,710
66437,190,100,80,80,0,0,450
66438,210,140,160,160,0,0,670
66439,210,140,120,80,0,0,550
66440,190,120,120,160,320,0,910
66441,160,140,160,160,160,0,780
66442,200,180,120,0,0,0,500
66443,180,100,120,80,160,0,640
66444,180,120,80,80,160,0,620
66445,180,100,80,80,0,0,440
66446,190,180,120,160,320,320,1290
66447,200,100,160,80,0,0,540
66448,190,140,120,160,160,0,770
66449,180,100,80,160,160,320,1000
66450,200,60,80,0,0,0,340
66451,210,80,120,160,160,0,730
66452,190,120,160,80,160,0,710
66453,170,80,80,80,160,0,570
66454,210,160,120,160,320,320,1290
66455,160,160,80,80,160,320,960
66456,210,180,160,160,320,0,1030
66457,170,120,80,80,160,0,610
66458,180,120,120,80,160,0,660
66459,210,120,160,160,160,0,810
66460,190,120,160,80,160,0,710
66461,210,120,120,80,0,0,530
66462,220,140,120,80,160,0,720
66463,160,100,120,80,160,0,620
66464,230,100,80,80,0,0,490
66465,160,100,40,0,0,0,300
66466,210,120,80,80,160,0,650
66467,210,180,40,80,0,0,510
66468,230,80,120,160,0,0,590
66469,210,140,200,80,0,0,630
66470,210,120,160,160,320,0,970
66471,180,140,200,160,160,0,840
66472,200,200,160,240,160,0,960
66473,180,180,80,80,0,0,520
66474,190,160,160,80,160,0,750
66475,190,100,160,160,0,0,610
66476,200,180,120,0,0,0,500
66477,210,140,160,160,320,0,990
66478,180,160,80,0,0,0,420
66479,200,140,80,80,0,0,500
66480,200,180,160,80,160,320,1100
66481,190,80,40,80,0,0,390
66482,210,140,120,80,160,0,710
66483,180,80,120,80,0,0,460
66484,200,100,120,80,160,320,980
66485,180,100,80,80,0,0,440
66486,230,100,120,80,0,0,530
66487,180,60,120,160,160,0,680
66488,210,140,160,160,0,0,670
66489,190,140,80,160,160,320,1050
66490,190,140,160,160,160,320,1130
66491,170,80,120,160,160,320,1010
66492,210,120,120,80,0,0,530
66493,200,120,80,80,0,0,480
66494,210,140,120,80,160,320,1030
66495,150,140,120,240,160,0,810
66496,180,120,80,80,160,0,620
66497,160,140,40,80,0,0,420
66498,180,160,40,80,160,320,940
66499,230,140,80,160,0,0,610
66500,190,80,40,80,160,0,550
66501,230,100,0,0,0,0,330
66502,210,80,80,80,160,0,610
66503,210,160,160,80,0,0,610
66504,170,120,40,0,0,0,330
66505,210,140,120,80,160,0,710
66506,130,140,160,0,0,0,430
66507,150,100,80,80,0,0,410
66508,180,60,120,80,0,0,440
66509,220,200,160,160,320,0,1060
66510,140,80,120,160,160,0,660
66511,170,160,80,160,0,0,570
66512,200,180,120,160,160,0,820
66513,160,80,40,80,160,0,520
66514,220,160,120,160,160,320,1140
66515,240,140,160,0,0,0,540
66516,230,60,120,80,0,0,490
66517,170,120,120,80,160,0,650
66518,200,140,120,160,320,320,1260
66519,210,100,0,0,0,0,310
66520,130,80,80,160,160,0,610
66521,180,120,80,80,160,0,620
66522,190,120,80,80,160,320,950
66523,200,140,80,0,0,0,420
66524,220,100,80,160,160,0,720
66525,210,160,160,160,320,0,1010
66526,230,100,120,160,160,0,770
66527,200,160,200,160,320,0,1040
66528,200,180,160,160,160,0,860
66529,210,120,120,160,320,0,930
66530,200,120,80,80,160,0,640
66531,210,80,40,80,160,0,570
66532,170,100,120,80,160,0,630
66533,190,140,160,160,320,0,970
66534,190,160,160,80,160,0,750
66535,220,180,160,160,160,0,880
66536,190,80,120,0,0,0,390
66537,190,220,120,80,0,0,610
66538,180,160,120,80,160,0,700
66539,190,100,120,160,0,0,570
66540,230,140,80,80,160,0,690
66541,240,100,120,160,160,320,1100
66542,190,140,120,80,160,320,1010
66543,140,100,120,160,160,0,680
66544,150,120,80,160,320,0,830
66545,160,140,80,80,0,0,460
66546,220,100,80,80,160,0,640
66547,180,140,120,0,0,0,440
66548,260,160,160,160,0,0,740
66549,210,140,80,80,160,0,670
66550,190,160,80,80,160,0,670
66551,160,140,120,240,320,0,980
66552,160,80,0,0,0,0,240
66553,180,140,160,240,320,320,1360
66554,210,120,160,160,160,320,1130
66555,230,100,120,80,160,0,690
66556,190,100,80,80,160,0,610
66557,240,120,80,0,0,0,440
66558,210,120,120,80,0,0,530
66559,180,60,40,0,0,0,280
66560,210,200,160,160,160,0,890
66561,220,120,120,160,320,0,940
66562,220,140,120,80,160,0,720
66563,210,80,40,0,0,0,330
66564,190,140,80,0,0,0,410
66565,170,80,40,0,0,0,290
66566,190,100,80,80,160,0,610
66567,200,120,40,80,0,0,440
66568,210,100,200,160,160,0,830
66569,180,100,80,80,160,0,600
66570,220,120,80,80,160,320,980
66571,220,100,40,80,0,0,440
66572,190,100,120,80,0,0,490
66573,260,160,160,160,320,320,1380
66574,200,160,160,160,0,0,680
66575,170,120,160,80,160,0,690
66576,190,80,120,160,320,320,1190
66577,180,100,80,80,0,0,440
66578,230,200,200,240,160,0,1030
66579,170,60,80,160,160,0,630
66580,160,100,120,160,160,0,700
66581,190,140,120,160,320,0,930
66582,230,100,80,0,0,0,410
66583,170,140,160,80,160,320,1030
66584,210,100,160,80,0,0,550
66585,200,160,80,80,0,0,520
66586,160,120,120,80,0,0,480
66587,190,100,40,80,160,0,570
66588,180,80,120,160,320,0,860
66589,170,100,160,80,160,320,990
66590,230,100,120,80,160,0,690
66591,190,60,40,80,0,0,370
66592,190,120,40,80,160,320,910
66593,200,160,120,80,160,320,1040
66594,230,160,120,160,160,0,830
66595,180,100,80,80,0,0,440
66596,210,140,120,0,0,0,470
66597,190,140,200,240,320,0,1090
66598,180,140,160,80,0,0,560
66599,190,120,120,160,160,0,750
66600,170,120,120,0,0,0,410
66601,230,160,120,240,320,320,1390
66602,210,120,120,240,160,0,850
66603,250,100,40,0,0,0,390
66604,190,120,120,240,160,0,830
66605,190,120,160,160,0,0,630
66606,180,100,40,80,160,320,880
66607,210,120,120,240,160,320,1170
66608,210,100,40,0,0,0,350
66609,140,60,0,0,0,0,200
66610,200,180,160,0,0,0,540
66611,200,120,200,240,0,0,760
66612,200,100,120,160,0,0,580
66613,270,120,80,80,0,0,550
66614,170,100,80,160,160,0,670
66615,200,120,120,80,160,0,680
66616,190,60,80,80,160,0,570
66617,180,120,120,80,160,0,660
66618,200,100,120,80,0,0,500
66619,210,120,120,80,0,0,530
66620,190,100,40,80,160,0,570
66621,170,140,160,80,160,0,710
66622,230,100,80,80,0,0,490
66623,210,140,120,80,160,0,710
66624,150,80,80,80,160,320,870
66625,190,160,160,160,160,0,830
66626,200,140,120,0,0,0,460
66627,200,160,120,80,0,0,560
66628,190,120,80,160,0,0,550
66629,170,120,80,0,0,0,370
66630,180,120,80,160,160,0,700
66631,180,120,160,160,160,0,780
66632,250,160,160,160,320,320,1370
66633,240,180,120,80,160,0,780
66634,210,140,120,80,0,0,550
66635,190,100,120,240,0,0,650
66636,220,160,80,80,0,0,540
66637,180,120,80,80,0,0,460
66638,220,180,200,160,160,0,920
66639,140,100,80,0,0,0,320
66640,200,120,40,0,0,0,360
66641,250,160,80,160,160,320,1130
66642,230,80,120,160,320,0,910
66643,230,160,120,160,0,0,670
66644,210,160,80,160,0,0,610
66645,210,120,120,0,0,0,450
66646,240,140,80,80,160,0,700
66647,190,120,40,0,0,0,350
66648,200,140,40,0,0,0,380
66649,190,60,40,0,0,0,290
66650,200,160,160,160,160,0,840
66651,170,100,120,80,0,0,470
66652,170,120,160,80,0,0,530
66653,170,160,120,160,0,0,610
66654,180,180,160,160,320,320,1320
66655,200,120,120,160,320,0,920
66656,190,160,120,160,320,320,1270
66657,210,140,160,160,320,0,990
66658,160,100,40,80,160,0,540
66659,210,120,80,80,0,0,490
66660,200,120,80,80,160,0,640
66661,200,180,120,80,160,0,740
66662,200,160,160,160,160,0,840
66663,240,140,40,80,0,0,500
66664,170,100,80,0,0,0,350
66665,220,100,80,160,160,320,1040
66666,230,140,40,0,0,0,410
66667,180,160,200,160,0,0,700
66668,200,120,120,160,160,0,760
66669,150,100,80,0,0,0,330
66670,160,100,40,0,0,0,300
66671,220,100,80,80,160,0,640
66672,190,80,120,80,0,0,470
66673,180,100,120,240,160,0,800
66674,220,180,160,80,160,0,800
66675,190,120,120,0,0,0,430
66676,220,140,160,80,0,0,600
66677,230,140,80,80,160,0,690
66678,180,100,80,80,0,0,440
66679,160,160,0,0,0,0,320
66680,210,120,120,80,160,0,690
66681,230,180,120,80,0,0,610
66682,230,140,160,80,160,0,770
66683,190,120,80,0,0,0,390
66684,180,80,120,80,160,0,620
66685,210,120,120,240,320,0,1010
66686,240,160,120,160,160,320,1160
66687,250,140,120,0,0,0,510
66688,250,200,80,80,160,0,770
66689,210,60,80,0,0,0,350
66690,240,160,80,0,0,0,480
66691,200,140,160,240,320,0,1060
66692,220,160,80,160,160,0,780
66693,180,120,120,160,160,0,740
66694,180,160,160,160,320,0,980
66695,220,100,160,160,160,0,800
66696,190,140,160,160,160,0,810
66697,210,80,40,80,0,0,410
66698,200,140,120,0,0,0,460
66699,170,140,200,160,320,0,990
66700,200,180,80,80,0,0,540
66701,220,100,80,80,0,0,480
66702,170,80,80,80,0,0,410
66703,190,80,80,80,0,0,430
66704,200,120,120,160,320,320,1240
66705,200,120,160,0,0,0,480
66706,220,140,160,160,0,0,680
66707,160,160,160,0,0,0,480
66708,210,140,160,80,0,0,590
66709,220,80,120,80,160,320,980
66710,210,80,120,160,160,0,730
66711,200,160,200,160,0,0,720
66712,200,140,80,80,0,0,500
66713,190,120,120,160,160,0,750
66714,170,80,40,0,0,0,290
66715,180,140,160,240,160,0,880
66716,190,160,80,80,160,0,670
66717,170,140,160,80,160,0,710
66718,180,140,80,160,160,0,720
66719,200,140,40,80,0,0,460
66720,200,120,80,80,0,0,480
66721,220,120,120,80,160,0,700
66722,180,160,80,0,0,0,420
66723,200,140,120,80,160,0,700
66724,180,140,80,80,160,0,640
66725,150,80,80,80,160,320,870
66726,210,120,200,160,320,0,1010
66727,160,120,120,160,320,320,1200
66728,210,80,160,80,0,0,530
66729,180,120,160,240,320,0,1020
66730,190,80,40,0,0,0,310
66731,200,100,160,80,160,0,700
66732,170,120,120,160,160,0,730
66733,190,160,200,160,160,0,870
66734,170,80,120,0,0,0,370
66735,190,140,120,160,160,0,770
66736,180,80,40,0,0,0,300
66737,180,40,40,80,160,0,500
66738,200,100,160,240,160,0,860
66739,270,160,80,160,0,0,670
66740,220,160,200,80,0,0,660
66741,160,100,80,160,320,320,1140
66742,180,120,160,160,160,0,780
66743,170,100,120,240,320,320,1270
66744,240,180,160,80,160,320,1140
66745,200,100,120,160,160,0,740
66746,200,80,40,0,0,0,320
66747,180,60,0,0,0,0,240
66748,150,160,200,160,0,0,670
66749,200,140,80,0,0,0,420
66750,170,60,80,80,160,0,550
66751,200,140,40,80,160,320,940
66752,190,100,120,160,160,0,730
66753,230,140,120,240,160,0,890
66754,150,160,200,80,160,0,750
66755,210,80,40,80,0,0,410
66756,180,100,200,160,320,0,960
66757,200,180,200,160,320,320,1380
66758,270,120,80,80,160,0,710
66759,220,80,80,160,160,0,700
66760,190,100,80,80,160,0,610
66761,200,100,80,80,160,0,620
66762,160,140,120,0,0,0,420
66763,270,160,120,240,160,0,950
66764,200,140,120,80,160,0,700
66765,210,140,200,80,160,0,790
66766,200,120,80,80,160,0,640
66767,190,100,120,160,160,0,730
66768,220,120,160,80,0,0,580
66769,200,160,160,80,0,0,600
66770,210,100,160,160,320,320,1270
66771,190,180,160,160,320,0,1010
66772,170,80,80,80,0,0,410
66773,230,100,40,80,160,0,610
66774,180,120,80,80,160,0,620
66775,160,140,120,160,320,0,900
66776,170,40,0,0,0,0,210
66777,160,80,40,0,0,0,280
66778,180,100,80,80,160,0,600
66779,190,60,40,80,160,0,530
66780,220,100,80,80,160,0,640
66781,230,120,120,160,160,0,790
66782,170,120,160,240,320,0,1010
66783,190,80,120,160,0,0,550
66784,180,100,80,80,160,0,600
66785,150,120,120,160,160,0,710
66786,190,80,120,160,320,0,870
66787,140,40,80,160,320,0,740
66788,230,100,120,160,160,0,770
66789,160,160,120,80,160,0,680
66790,170,140,80,0,0,0,390
66791,200,120,120,80,160,0,680
66792,200,60,80,80,0,0,420
66793,200,100,80,0,0,0,380
66794,180,80,120,80,160,320,940
66795,200,120,80,80,160,0,640
66796,220,100,40,80,0,0,440
66797,230,140,160,160,160,0,850
66798,220,160,160,160,0,0,700
66799,170,160,160,160,160,0,810
66800,170,140,160,160,320,0,950
66801,180,120,120,160,0,0,580
66802,230,180,160,80,0,0,650
66803,230,160,120,0,0,0,510
66804,220,100,80,80,160,0,640
66805,190,80,80,80,0,0,430
66806,150,120,120,80,160,0,630
66807,200,80,40,80,160,0,560
66808,180,100,160,160,160,0,760
66809,220,160,120,240,160,0,900
66810,180,140,200,160,320,0,1000
66811,170,80,80,160,160,320,970
66812,230,160,120,160,160,0,830
66813,220,140,80,80,160,0,680
66814,180,100,120,160,320,0,880
66815,200,140,120,80,160,0,700
66816,180,180,200,240,160,0,960
66817,210,140,120,160,0,0,630
66818,220,140,80,80,160,0,680
66819,200,80,120,0,0,0,400
66820,230,180,160,160,320,0,1050
66821,200,160,80,80,160,320,1000
66822,240,160,160,80,0,0,640
66823,200,120,80,160,160,0,720
66824,210,100,80,160,320,0,870
66825,190,160,80,0,0,0,430
66826,220,140,200,240,160,0,960
66827,160,160,120,160,320,320,1240
66828,140,60,80,160,320,0,760
66829,220,120,160,160,160,0,820
66830,200,140,120,80,160,0,700
66831,190,120,160,80,160,0,710
66832,190,120,40,0,0,0,350
66833,180,120,120,240,160,0,820
66834,180,80,40,80,160,0,540
66835,180,120,80,80,160,0,620
66836,200,60,80,80,160,0,580
66837,210,160,160,240,320,320,1410
66838,200,140,120,80,0,0,540
66839,230,160,120,80,160,0,750
66840,210,100,80,80,160,0,630
66841,190,120,80,160,160,0,710
66842,190,180,120,240,320,320,1370
66843,210,100,160,160,160,0,790
66844,150,120,120,80,0,0,470
66845,190,160,200,80,0,0,630
66846,180,140,120,80,0,0,520
66847,200,120,120,240,160,0,840
66848,210,140,160,160,160,0,830
66849,210,140,160,80,0,0,590
66850,190,140,120,160,320,0,930
66851,210,120,80,80,160,0,650
66852,170,100,0,0,0,0,270
66853,170,80,40,80,160,0,530
66854,250,140,160,160,160,0,870
66855,170,160,80,0,0,0,410
66856,210,120,120,0,0,0,450
66857,180,100,160,160,0,0,600
66858,220,160,160,80,0,0,620
66859,190,80,80,80,0,0,430
66860,180,100,80,80,0,0,440
66861,220,160,160,160,320,0,1020
66862,190,140,200,160,160,0,850
66863,220,140,40,0,0,0,400
66864,210,120,120,80,0,0,530
66865,140,100,40,0,0,0,280
66866,210,100,80,0,0,0,390
66867,190,180,240,240,160,0,1010
66868,170,120,120,80,160,0,650
66869,210,100,80,80,160,320,950
66870,200,120,80,160,160,0,720
66871,200,160,80,160,160,0,760
66872,190,100,120,160,160,0,730
66873,200,180,200,160,160,0,900
66874,200,100,80,80,0,0,460
66875,220,100,80,80,160,320,960
66876,210,160,80,80,160,0,690
66877,170,120,120,160,320,320,1210
66878,200,80,120,160,160,0,720
66879,240,160,160,80,0,0,640
66880,210,120,120,80,160,0,690
66881,200,140,160,240,160,0,900
66882,190,120,80,160,160,0,710
66883,150,100,80,0,0,0,330
66884,190,120,120,80,0,0,510
66885,240,160,200,80,160,0,840
66886,170,80,120,160,160,0,690
66887,230,100,120,160,160,0,770
66888,210,200,120,0,0,0,530
66889,210,100,120,240,160,0,830
66890,210,140,200,160,320,320,1350
66891,200,120,80,80,0,0,480
66892,200,60,40,80,0,0,380
66893,220,180,200,160,320,320,1400
66894,160,120,80,0,0,0,360
66895,170,100,120,160,160,0,710
66896,180,100,120,240,320,320,1280
66897,170,80,40,0,0,0,290
66898,210,160,120,80,160,0,730
66899,230,140,120,80,160,0,730
66900,200,100,160,240,160,0,860
66901,210,60,40,0,0,0,310
66902,200,100,80,0,0,0,380
66903,170,120,80,80,160,0,610
66904,230,200,160,80,160,0,830
66905,180,140,80,80,160,0,640
66906,160,120,160,80,160,0,680
66907,200,200,40,0,0,0,440
66908,190,120,80,0,0,0,390
66909,210,100,80,80,0,0,470
66910,180,80,120,80,160,0,620
66911,180,160,160,80,0,0,580
66912,210,100,40,80,160,0,590
66913,180,80,80,80,160,0,580
66914,210,80,80,80,160,0,610
66915,190,140,80,0,0,0,410
66916,170,80,120,80,0,0,450
66917,200,120,120,80,0,0,520
66918,180,100,120,80,160,0,640
66919,190,80,80,80,0,0,430
66920,210,180,120,80,160,0,750
66921,170,100,80,0,0,0,350
66922,200,180,120,80,160,0,740
66923,170,60,0,0,0,0,230
66924,180,60,40,80,160,0,520
66925,200,80,80,80,160,0,600
66926,220,140,120,80,160,0,720
66927,200,140,40,80,160,0,620
66928,200,200,320,320,160,0,1200
66929,190,120,120,80,160,0,670
66930,190,140,120,240,160,0,850
66931,220,140,80,0,0,0,440
66932,170,120,160,240,160,320,1170
66933,200,120,120,160,160,320,1080
66934,190,120,80,0,0,0,390
66935,230,120,160,160,160,0,830
66936,200,120,80,80,160,0,640
66937,230,140,120,160,320,0,970
66938,210,120,160,80,160,0,730
66939,250,200,160,160,160,0,930
66940,220,160,160,80,0,0,620
66941,230,160,120,160,0,0,670
66942,180,100,160,80,160,0,680
66943,220,140,120,240,320,0,1040
66944,200,100,80,160,160,0,700
66945,200,100,120,160,0,0,580
66946,210,100,40,80,0,0,430
66947,210,160,40,0,0,0,410
66948,210,140,120,160,160,0,790
66949,240,100,120,80,0,0,540
66950,210,140,120,80,0,0,550
66951,210,160,160,240,320,0,1090
66952,180,60,80,80,160,0,560
66953,180,120,120,160,320,320,1220
66954,170,120,120,160,160,0,730
66955,230,140,120,0,0,0,490
66956,180,80,80,80,160,0,580
66957,220,160,160,0,0,0,540
66958,240,180,160,160,160,320,1220
66959,180,120,160,0,0,0,460
66960,170,120,120,80,160,320,970
66961,170,80,120,80,0,0,450
66962,210,80,120,80,160,320,970
66963,210,140,160,80,160,0,750
66964,200,180,80,80,160,320,1020
66965,180,120,160,80,160,320,1020
66966,230,180,120,160,0,0,690
66967,200,120,120,160,320,0,920
66968,210,120,120,80,160,0,690
66969,190,100,80,80,160,0,610
66970,240,160,160,80,160,0,800
66971,190,120,40,80,160,0,590
66972,160,80,80,80,160,0,560
66973,160,60,120,80,0,0,420
66974,230,140,160,0,0,0,530
66975,180,100,80,80,160,0,600
66976,190,160,120,160,160,0,790
66977,200,180,120,80,0,0,580
66978,190,180,160,0,0,0,530
66979,160,140,240,80,0,0,620
66980,210,200,80,160,160,0,810
66981,180,140,80,80,160,0,640
66982,190,140,160,80,0,0,570
66983,240,220,200,160,160,0,980
66984,190,180,160,240,320,0,1090
66985,180,120,80,160,320,0,860
66986,220,100,80,160,320,0,880
66987,190,100,40,0,0,0,330
66988,200,120,40,0,0,0,360
66989,170,120,120,160,320,0,890
66990,210,120,120,80,160,320,1010
66991,200,120,40,0,0,0,360
66992,190,120,120,160,160,320,1070
66993,130,80,80,160,320,320,1090
66994,200,100,40,0,0,0,340
66995,230,160,80,80,160,0,710
66996,200,120,120,80,0,0,520
66997,170,100,120,160,160,0,710
66998,160,140,120,0,0,0,420
66999,200,120,120,0,0,0,440
67000,220,100,120,80,0,0,520
67001,180,100,80,160,160,0,680
67002,220,120,160,80,160,0,740
67003,170,140,160,240,320,0,1030
67004,200,140,160,240,0,0,740
67005,180,100,40,80,160,0,560
67006,190,120,40,0,0,0,350
67007,190,100,120,80,160,0,650
67008,210,100,40,80,0,0,430
67009,240,160,160,160,160,0,880
67010,230,120,80,160,0,0,590
67011,170,120,160,160,160,0,770
67012,180,100,120,160,160,0,720
67013,220,120,80,80,160,320,980
67014,200,80,40,80,160,0,560
67015,190,80,40,80,160,0,550
67016,160,60,80,80,0,0,380
67017,150,160,160,160,160,320,1110
67018,190,100,80,80,0,0,450
67019,180,100,80,160,160,320,1000
67020,190,80,120,80,0,0,470
67021,200,80,40,80,160,0,560
67022,170,160,120,80,160,0,690
67023,200,80,120,160,320,0,880
67024,190,100,40,80,0,0,410
67025,180,140,80,80,160,0,640
67026,160,120,160,160,160,320,1080
67027,220,100,120,0,0,0,440
67028,220,120,160,160,160,320,1140
67029,190,120,40,80,160,320,910
67030,200,80,40,80,160,0,560
67031,190,120,120,80,160,0,670
67032,240,180,120,160,160,0,860
67033,190,140,160,240,320,320,1370
67034,220,200,160,0,0,0,580
67035,210,60,0,0,0,0,270
67036,200,120,160,160,160,320,1120
67037,180,140,120,80,0,0,520
67038,200,140,80,160,0,0,580
67039,160,100,120,0,0,0,380
67040,200,120,120,240,320,0,1000
67041,200,160,160,160,320,0,1000
67042,160,120,80,80,0,0,440
67043,220,140,120,80,0,0,560
67044,240,180,160,80,160,0,820
67045,170,120,120,160,160,0,730
67046,200,140,120,240,160,320,1180
67047,200,140,80,160,320,320,1220
67048,150,120,120,240,160,0,790
67049,160,100,120,80,160,320,940
67050,200,140,120,160,160,0,780
67051,220,100,120,160,0,0,600
67052,160,120,120,80,160,320,960
67053,170,100,160,240,320,320,1310
67054,220,140,80,160,320,320,1240
67055,180,160,200,80,0,0,620
67056,200,80,120,240,160,320,1120
67057,230,120,160,240,320,0,1070
67058,180,160,120,80,0,0,540
67059,220,120,120,160,160,0,780
67060,200,160,200,160,320,320,1360
67061,190,80,0,0,0,0,270
67062,230,120,160,80,0,0,590
67063,200,180,80,80,160,0,700
67064,170,120,40,0,0,0,330
67065,170,100,120,160,320,0,870
67066,170,180,120,80,0,0,550
67067,200,160,40,80,160,320,960
67068,160,80,80,160,160,0,640
67069,230,160,120,0,0,0,510
67070,160,100,80,160,160,0,660
67071,170,140,80,160,160,0,710
67072,200,80,80,80,0,0,440
67073,170,120,120,160,160,0,730
67074,170,140,120,160,160,0,750
67075,170,100,120,160,320,0,870
67076,170,140,80,80,0,0,470
67077,210,120,120,240,0,0,690
67078,200,100,0,0,0,0,300
67079,210,120,160,80,0,0,570
67080,180,60,80,80,0,0,400
67081,210,160,120,80,160,0,730
67082,160,120,160,240,320,0,1000
67083,270,100,80,160,160,0,770
67084,210,120,40,0,0,0,370
67085,190,140,200,160,320,0,1010
67086,210,100,160,240,320,320,1350
67087,210,140,120,160,160,0,790
67088,220,100,40,80,0,0,440
67089,160,100,80,160,320,320,1140
67090,160,80,120,80,160,320,920
67091,180,180,160,240,160,0,920
67092,220,160,160,0,0,0,540
67093,180,120,160,240,320,320,1340
67094,190,140,120,160,0,0,610
67095,190,120,80,160,160,0,710
67096,190,120,80,80,160,0,630
67097,210,120,80,80,0,0,490
67098,180,120,120,240,320,0,980
67099,190,60,80,0,0,0,330
67100,220,60,40,80,160,0,560
67101,160,120,160,240,160,0,840
67102,190,140,80,0,0,0,410
67103,210,100,120,160,0,0,590
67104,200,80,40,0,0,0,320
67105,150,140,80,80,160,0,610
67106,200,140,120,160,160,320,1100
67107,220,80,40,0,0,0,340
67108,210,180,120,160,160,320,1150
67109,160,120,120,160,160,0,720
67110,150,120,200,160,0,0,630
67111,170,160,120,0,0,0,450
67112,190,120,120,80,160,0,670
67113,200,100,160,80,160,0,700
67114,210,120,40,80,160,320,930
67115,240,180,160,240,320,0,1140
67116,190,140,160,160,160,0,810
67117,170,120,120,160,160,0,730
67118,220,140,40,80,160,0,640
67119,210,120,40,80,0,0,450
67120,180,120,80,160,160,0,700
67121,200,140,80,80,160,0,660
67122,210,120,160,160,320,320,1290
67123,200,100,80,160,160,0,700
67124,230,140,120,80,0,0,570
67125,180,120,80,80,160,0,620
67126,220,120,80,160,160,0,740
67127,170,140,160,160,160,0,790
67128,210,120,120,160,320,0,930
67129,230,120,120,240,320,320,1350
67130,180,160,120,0,0,0,460
67131,190,100,120,80,0,0,490
67132,200,100,40,80,0,0,420
67133,230,160,120,160,160,320,1150
67134,190,80,80,80,0,0,430
67135,180,120,120,240,160,0,820
67136,180,80,120,80,160,0,620
67137,160,80,80,80,0,0,400
67138,210,140,40,80,160,0,630
67139,230,60,40,80,0,0,410
67140,230,140,80,80,0,0,530
67141,210,120,80,80,0,0,490
67142,160,100,120,0,0,0,380
67143,180,120,160,160,160,0,780
67144,220,200,160,160,160,320,1220
67145,240,120,40,0,0,0,400
67146,140,100,40,80,0,0,360
67147,190,120,40,80,0,0,430
67148,160,140,120,160,0,0,580
67149,250,160,120,160,320,320,1330
67150,190,80,80,160,160,0,670
67151,160,120,120,80,0,0,480
67152,170,60,80,80,160,0,550
67153,210,140,160,160,160,0,830
67154,170,100,160,160,0,0,590
67155,190,140,80,160,160,0,730
67156,190,100,80,80,160,0,610
67157,220,120,80,0,0,0,420
67158,170,100,80,80,160,0,590
67159,220,120,120,160,160,0,780
67160,120,100,120,80,0,0,420
67161,210,140,120,80,160,0,710
67162,160,140,80,80,0,0,460
67163,210,100,40,80,160,0,590
67164,170,120,160,160,160,0,770
67165,200,80,80,160,160,0,680
67166,180,140,120,80,160,0,680
67167,180,80,0,0,0,0,260
67168,200,160,120,0,0,0,480
67169,240,160,120,80,160,0,760
67170,200,60,120,160,160,0,700
67171,200,120,80,80,0,0,480
67172,170,120,80,80,160,0,610
67173,250,160,160,240,160,0,970
67174,190,120,160,80,160,0,710
67175,170,100,80,80,0,0,430
67176,170,60,0,0,0,0,230
67177,180,140,40,80,0,0,440
67178,190,120,80,80,160,320,950
67179,180,80,40,80,160,0,540
67180,160,120,80,80,160,0,600
67181,190,80,80,80,160,0,590
67182,190,80,120,80,160,0,630
67183,200,160,120,80,160,0,720
67184,190,140,40,0,0,0,370
67185,190,120,80,0,0,0,390
67186,210,80,80,80,160,0,610
67187,180,120,120,160,320,0,900
67188,170,80,120,80,160,0,610
67189,170,100,0,0,0,0,270
67190,170,140,80,80,0,0,470
67191,170,140,240,160,0,0,710
67192,180,140,120,0,0,0,440
67193,200,140,120,160,0,0,620
67194,180,80,120,160,160,320,1020
67195,200,160,120,80,160,0,720
67196,220,120,120,80,0,0,540
67197,210,140,40,0,0,0,390
67198,170,100,120,160,320,0,870
67199,230,120,80,160,160,320,1070
67200,200,160,160,0,0,0,520
67201,230,120,80,0,0,0,430
67202,180,120,120,80,0,0,500
67203,180,160,120,240,0,0,700
67204,140,100,120,0,0,0,360
67205,210,160,120,80,160,0,730
67206,140,140,80,0,0,0,360
67207,220,120,80,80,160,0,660
67208,240,140,200,160,160,0,900
67209,180,100,120,80,0,0,480
67210,180,80,120,80,160,320,940
67211,220,180,240,80,160,0,880
67212,210,140,80,80,160,0,670
67213,190,140,120,80,160,0,690
67214,180,120,120,80,160,0,660
67215,180,160,160,0,0,0,500
67216,210,160,120,80,160,0,730
67217,210,140,80,80,160,320,990
67218,230,200,160,160,160,0,910
67219,190,60,80,80,160,320,890
67220,230,160,160,80,160,320,1110
67221,170,140,120,80,160,0,670
67222,200,140,80,0,0,0,420
67223,190,180,120,240,0,0,730
67224,220,180,160,80,0,0,640
67225,180,140,40,0,0,0,360
67226,180,140,120,80,160,0,680
67227,230,120,40,0,0,0,390
67228,240,160,80,80,160,0,720
67229,180,140,160,80,160,320,1040
67230,190,100,120,80,160,0,650
67231,210,120,80,80,0,0,490
67232,200,100,80,160,160,0,700
67233,180,140,160,80,160,320,1040
67234,210,160,160,80,160,320,1090
67235,170,140,160,240,160,0,870
67236,190,160,160,80,160,0,750
67237,210,120,40,80,160,0,610
67238,200,120,80,0,0,0,400
67239,160,100,120,80,160,0,620
67240,220,200,160,80,0,0,660
67241,220,120,80,160,0,0,580
67242,160,120,40,0,0,0,320
67243,180,140,160,160,320,320,1280
67244,210,120,120,240,160,0,850
67245,200,120,160,160,160,0,800
67246,200,100,40,0,0,0,340
67247,260,140,80,80,160,0,720
67248,190,120,40,0,0,0,350
67249,220,80,40,80,160,320,900
67250,220,140,120,160,160,0,800
67251,200,160,160,0,0,0,520
67252,160,120,120,80,160,320,960
67253,190,140,160,160,0,0,650
67254,180,100,160,80,160,0,680
67255,200,120,120,80,0,0,520
67256,160,140,120,80,160,320,980
67257,180,140,160,160,0,0,640
67258,200,120,160,160,0,0,640
67259,160,80,120,80,160,0,600
67260,180,120,120,80,160,0,660
67261,120,60,80,80,160,0,500
67262,220,160,120,80,160,0,740
67263,180,120,120,0,0,0,420
67264,220,160,160,240,320,320,1420
67265,200,100,0,0,0,0,300
67266,170,140,40,80,0,0,430
67267,180,180,40,0,0,0,400
67268,190,140,120,80,160,0,690
67269,230,140,120,80,0,0,570
67270,210,80,80,80,160,0,610
67271,150,80,80,80,160,0,550
67272,170,140,80,80,160,0,630
67273,170,120,80,160,160,320,1010
67274,190,120,120,160,160,0,750
67275,200,100,80,80,0,0,460
67276,170,80,80,160,160,0,650
67277,170,160,80,0,0,0,410
67278,190,100,80,80,0,0,450
67279,210,120,80,160,320,320,1210
67280,210,140,120,160,320,0,950
67281,200,120,120,160,160,0,760
67282,200,160,160,160,160,0,840
67283,200,140,80,80,0,0,500
67284,200,160,40,80,160,0,640
67285,180,80,40,80,0,0,380
67286,160,120,80,80,160,0,600
67287,190,140,120,80,160,0,690
67288,170,120,120,160,160,0,730
67289,150,100,120,160,160,0,690
67290,190,80,80,80,0,0,430
67291,210,120,80,80,160,0,650
67292,200,120,80,80,0,0,480
67293,190,180,160,160,320,0,1010
67294,200,120,40,0,0,0,360
67295,200,60,80,0,0,0,340
67296,180,140,200,80,160,0,760
67297,240,160,160,160,160,0,880
67298,230,200,80,0,0,0,510
67299,180,80,40,0,0,0,300
67300,210,180,160,80,160,0,790
67301,150,120,160,160,0,0,590
67302,200,140,160,80,0,0,580
67303,210,80,40,80,0,0,410
67304,190,140,80,160,160,0,730
67305,190,80,120,0,0,0,390
67306,180,120,40,0,0,0,340
67307,220,160,160,160,0,0,700
67308,210,140,120,160,320,0,950
67309,230,160,120,160,0,0,670
67310,190,120,160,240,320,0,1030
67311,170,140,80,80,0,0,470
67312,240,100,40,80,0,0,460
67313,210,140,160,80,160,0,750
67314,200,120,120,80,0,0,520
67315,180,140,160,240,320,0,1040
67316,200,140,120,80,0,0,540
67317,170,140,40,0,0,0,350
67318,180,140,160,80,160,0,720
67319,190,100,80,80,0,0,450
67320,210,100,80,160,320,0,870
67321,220,100,120,80,160,0,680
67322,210,140,80,80,0,0,510
67323,210,180,200,160,320,320,1390
67324,190,120,40,80,160,0,590
67325,220,160,120,160,320,0,980
67326,190,120,80,80,0,0,470
67327,230,160,120,80,160,0,750
67328,200,140,80,80,0,0,500
67329,190,100,160,80,160,0,690
67330,180,60,120,160,160,0,680
67331,160,140,80,80,160,0,620
67332,200,100,80,160,320,320,1180
67333,250,140,120,160,160,0,830
67334,200,120,200,160,160,0,840
67335,210,60,80,160,160,0,670
67336,160,120,120,160,160,0,720
67337,160,60,40,80,160,320,820
67338,170,100,160,80,0,0,510
67339,180,80,40,80,160,0,540
67340,210,180,120,80,0,0,590
67341,210,40,0,0,0,0,250
67342,190,160,160,160,160,0,830
67343,160,100,120,0,0,0,380
67344,210,80,80,80,160,320,930
67345,180,120,40,80,160,0,580
67346,170,120,80,80,160,0,610
67347,210,120,80,80,160,0,650
67348,170,120,160,160,160,0,770
67349,150,80,80,160,320,0,790
67350,220,160,160,160,160,0,860
67351,150,100,80,80,160,320,890
67352,200,100,0,0,0,0,300
67353,200,100,120,160,0,0,580
67354,180,80,120,80,160,0,620
67355,210,200,80,160,160,0,810
67356,140,60,120,160,0,0,480
67357,190,140,160,80,0,0,570
67358,240,200,200,240,160,320,1360
67359,210,140,160,80,160,0,750
67360,160,100,80,80,0,0,420
67361,170,80,160,80,0,0,490
67362,210,120,120,240,160,0,850
67363,240,220,200,160,160,0,980
67364,210,140,160,160,0,0,670
67365,210,100,80,80,160,320,950
67366,240,180,160,160,160,320,1220
67367,200,100,120,80,160,320,980
67368,170,120,120,80,0,0,490
67369,200,180,120,80,0,0,580
67370,190,120,160,80,0,0,550
67371,220,140,40,0,0,0,400
67372,210,140,80,0,0,0,430
67373,210,120,120,80,160,0,690
67374,230,180,160,240,0,0,810
67375,210,160,120,160,160,0,810
67376,200,140,120,80,160,0,700
67377,220,140,120,160,160,0,800
67378,220,160,160,160,0,0,700
67379,140,60,80,80,160,0,520
67380,230,120,80,80,160,0,670
67381,160,100,80,80,0,0,420
67382,190,100,80,160,320,0,850
67383,170,140,80,80,160,0,630
67384,230,160,80,80,0,0,550
67385,220,140,120,240,0,0,720
67386,210,120,80,0,0,0,410
67387,210,100,160,240,320,320,1350
67388,220,120,80,160,160,0,740
67389,220,160,160,80,160,0,780
67390,180,120,160,160,320,0,940
67391,200,120,40,0,0,0,360
67392,190,140,160,0,0,0,490
67393,190,120,80,80,160,320,950
67394,200,140,120,160,0,0,620
67395,190,60,120,160,160,0,690
67396,200,120,120,0,0,0,440
67397,210,100,120,80,160,0,670
67398,140,120,80,80,160,0,580
67399,210,120,80,0,0,0,410
67400,210,140,120,80,0,0,550
67401,220,160,120,80,160,0,740
67402,210,120,120,0,0,0,450
67403,210,100,120,80,160,0,670
67404,160,100,80,80,160,0,580
67405,140,100,160,160,320,320,1200
67406,180,100,40,0,0,0,320
67407,210,120,160,160,320,0,970
67408,200,80,120,160,160,0,720
67409,130,80,80,80,0,0,370
67410,210,180,160,160,160,320,1190
67411,220,180,80,160,160,0,800
67412,230,160,80,80,160,0,710
67413,250,200,200,240,160,320,1370
67414,230,140,80,0,0,0,450
67415,170,140,240,160,160,0,870
67416,180,100,120,160,320,0,880
67417,240,160,120,80,0,0,600
67418,200,100,80,80,160,0,620
67419,250,120,120,80,160,0,730
67420,190,120,120,80,160,0,670
67421,240,80,40,0,0,0,360
67422,210,160,200,160,160,0,890
67423,170,100,40,0,0,0,310
67424,230,140,80,80,160,0,690
67425,180,100,40,80,160,320,880
67426,220,160,80,160,160,0,780
67427,190,80,40,0,0,0,310
67428,140,60,40,0,0,0,240
67429,210,120,80,160,320,320,1210
67430,180,120,120,240,160,0,820
67431,170,140,80,80,0,0,470
67432,200,120,40,80,0,0,440
67433,200,120,40,0,0,0,360
67434,140,100,80,160,160,0,640
67435,260,140,80,80,160,0,720
67436,220,140,160,80,160,0,760
67437,210,140,120,160,160,0,790
67438,220,100,80,80,160,0,640
67439,180,140,40,80,0,0,440
67440,210,120,160,240,0,0,730
67441,200,120,160,160,320,320,1280
67442,220,140,80,80,160,0,680
67443,170,100,40,80,160,0,550
67444,180,60,40,80,160,0,520
67445,130,100,200,240,160,0,830
67446,190,80,160,160,160,0,750
67447,170,100,160,80,160,0,670
67448,170,100,80,80,160,0,590
67449,200,160,200,240,160,320,1280
67450,170,140,120,80,0,0,510
67451,230,120,160,240,320,320,1390
67452,220,120,160,80,160,0,740
67453,280,220,240,240,160,320,1460
67454,160,120,160,80,160,0,680
67455,200,60,120,160,160,0,700
67456,250,160,80,80,160,0,730
67457,220,100,120,160,160,0,760
67458,180,140,80,0,0,0,400
67459,210,140,160,160,320,0,990
67460,220,100,40,0,0,0,360
67461,190,140,40,0,0,0,370
67462,220,120,120,160,160,320,1100
67463,210,160,200,160,160,0,890
67464,160,120,160,160,160,0,760
67465,220,80,120,80,0,0,500
67466,230,120,120,160,160,0,790
67467,190,160,160,80,0,0,590
67468,180,100,40,80,160,0,560
67469,150,120,80,80,160,0,590
67470,160,60,40,0,0,0,260
67471,210,100,80,0,0,0,390
67472,200,180,120,240,160,320,1220
67473,200,160,120,160,320,0,960
67474,190,120,80,0,0,0,390
67475,250,100,40,0,0,0,390
67476,210,120,120,80,160,0,690
67477,170,120,120,80,160,0,650
67478,230,100,120,160,160,0,770
67479,170,180,200,240,160,0,950
67480,160,140,80,80,0,0,460
67481,190,100,80,80,0,0,450
67482,180,80,80,80,160,0,580
67483,200,100,120,0,0,0,420
67484,200,120,160,80,0,0,560
67485,190,140,120,160,320,320,1250
67486,180,80,40,80,160,0,540
67487,190,160,120,80,0,0,550
67488,170,160,200,240,320,320,1410
67489,200,160,200,160,160,320,1200
67490,230,140,120,80,0,0,570
67491,160,100,80,0,0,0,340
67492,210,180,160,240,320,0,1110
67493,200,140,40,80,160,0,620
67494,210,100,120,160,160,0,750
67495,230,160,200,160,160,0,910
67496,200,120,160,80,160,0,720
67497,200,180,160,80,160,0,780
67498,190,120,160,160,160,0,790
67499,230,120,160,80,0,0,590
67500,190,120,120,0,0,0,430
67501,200,140,120,80,160,320,1020
67502,180,140,120,80,160,0,680
67503,190,160,160,160,160,0,830
67504,200,80,80,0,0,0,360
67505,190,80,120,160,0,0,550
67506,190,80,80,80,0,0,430
67507,200,160,160,160,160,0,840
67508,230,100,80,80,0,0,490
67509,210,180,120,160,0,0,670
67510,160,60,80,80,160,0,540
67511,200,140,160,240,320,0,1060
67512,200,100,40,80,160,320,900
67513,190,120,160,160,160,320,1110
67514,200,140,160,80,160,0,740
67515,220,120,160,240,0,0,740
67516,230,140,120,160,160,320,1130
67517,220,160,40,0,0,0,420
67518,170,120,120,0,0,0,410
67519,210,100,120,160,320,320,1230
67520,160,80,80,160,320,0,800
67521,190,80,80,80,0,0,430
67522,190,160,160,80,160,0,750
67523,210,140,80,160,160,0,750
67524,210,100,120,160,320,0,910
67525,210,160,160,160,160,320,1170
67526,230,140,120,80,160,0,730
67527,190,140,120,0,0,0,450
67528,210,200,40,80,0,0,530
67529,160,80,80,80,160,320,880
67530,200,160,120,80,0,0,560
67531,240,100,80,80,160,0,660
67532,200,160,120,80,0,0,560
67533,200,160,160,240,320,320,1400
67534,160,80,80,0,0,0,320
67535,220,160,160,160,160,0,860
67536,200,140,80,160,160,0,740
67537,180,140,120,0,0,0,440
67538,230,100,120,240,320,320,1330
67539,190,120,80,0,0,0,390
67540,220,160,160,160,320,0,1020
67541,200,100,40,80,160,0,580
67542,190,60,40,0,0,0,290
67543,180,120,40,0,0,0,340
67544,210,140,160,160,160,0,830
67545,240,140,80,160,160,0,780
67546,180,120,160,160,320,0,940
67547,190,100,40,0,0,0,330
67548,180,80,40,0,0,0,300
67549,210,80,120,0,0,0,410
67550,190,120,120,160,320,320,1230
67551,190,100,120,160,160,320,1050
67552,210,120,80,80,160,0,650
67553,190,120,120,0,0,0,430
67554,170,140,240,160,320,320,1350
67555,210,160,160,160,320,0,1010
67556,200,100,120,160,320,0,900
67557,190,80,80,80,0,0,430
67558,170,100,40,0,0,0,310
67559,190,140,120,80,0,0,530
67560,160,100,80,0,0,0,340
67561,140,80,120,160,320,0,820
67562,180,120,40,80,0,0,420
67563,190,60,40,0,0,0,290
67564,220,140,200,240,0,0,800
67565,230,160,120,80,0,0,590
67566,190,140,120,160,160,0,770
67567,200,100,160,80,160,0,700
67568,200,100,120,240,160,0,820
67569,240,180,120,160,320,320,1340
67570,190,160,120,80,0,0,550
67571,160,120,200,80,160,0,720
67572,190,120,120,160,160,0,750
67573,220,120,80,80,160,0,660
67574,240,60,40,80,160,0,580
67575,160,40,80,80,160,0,520
67576,210,160,80,160,0,0,610
67577,170,120,80,80,0,0,450
67578,220,120,120,160,160,0,780
67579,210,120,120,160,160,0,770
67580,210,100,40,80,160,0,590
67581,180,100,80,160,160,320,1000
67582,190,100,120,160,160,0,730
67583,200,160,160,240,160,0,920
67584,220,200,240,80,0,0,740
67585,190,120,40,80,160,320,910
67586,170,140,80,160,160,0,710
67587,210,100,120,160,160,0,750
67588,220,120,80,80,160,0,660
67589,180,120,120,80,0,0,500
67590,210,120,80,80,160,0,650
67591,160,100,120,0,0,0,380
67592,160,80,40,0,0,0,280
67593,210,140,160,160,160,0,830
67594,250,140,80,80,0,0,550
67595,170,140,160,80,0,0,550
67596,230,160,120,80,0,0,590
67597,220,100,0,0,0,0,320
67598,200,60,0,0,0,0,260
67599,190,60,40,80,160,0,530
67600,160,120,40,80,0,0,400
67601,230,120,40,80,0,0,470
67602,190,120,80,160,320,320,1190
67603,150,100,160,240,320,320,1290
67604,150,80,40,0,0,0,270
67605,190,160,160,160,0,0,670
67606,200,120,120,160,160,0,760
67607,250,140,80,80,0,0,550
67608,200,160,80,80,160,320,1000
67609,190,160,80,0,0,0,430
67610,150,60,40,0,0,0,250
67611,220,180,240,240,160,0,1040
67612,210,160,120,80,160,0,730
67613,200,180,160,80,0,0,620
67614,190,80,40,0,0,0,310
67615,200,200,200,160,160,0,920
67616,190,60,120,240,320,0,930
67617,170,120,120,80,160,0,650
67618,150,120,160,240,0,0,670
67619,200,80,40,80,160,320,880
67620,210,100,80,80,160,0,630
67621,250,140,120,80,0,0,590
67622,200,100,80,160,160,0,700
67623,220,120,160,160,0,0,660
67624,200,100,120,80,160,0,660
67625,140,60,0,0,0,0,200
67626,160,80,120,0,0,0,360
67627,190,140,120,160,320,0,930
67628,230,200,280,240,0,0,950
67629,180,60,40,80,160,0,520
67630,190,120,120,160,160,320,1070
67631,220,160,120,80,160,320,1060
67632,220,60,40,80,160,0,560
67633,220,120,120,160,160,320,1100
67634,210,140,80,160,160,0,750
67635,200,120,40,0,0,0,360
67636,200,120,120,160,0,0,600
67637,140,140,160,80,0,0,520
67638,210,120,120,160,160,0,770
67639,150,160,120,80,160,0,670
67640,220,100,40,80,0,0,440
67641,190,100,120,160,160,0,730
67642,200,140,120,160,160,0,780
67643,190,160,160,80,160,320,1070
67644,180,120,80,80,0,0,460
67645,220,160,160,160,160,320,1180
67646,200,160,120,240,160,0,880
67647,180,160,160,160,160,0,820
67648,220,180,160,240,160,320,1280
67649,250,160,200,80,160,0,850
67650,170,140,120,160,160,0,750
67651,170,100,0,0,0,0,270
67652,200,140,40,80,160,0,620
67653,230,200,200,160,160,0,950
67654,210,100,80,160,160,0,710
67655,180,120,80,160,0,0,540
67656,230,140,80,0,0,0,450
67657,220,160,120,160,320,320,1300
67658,170,140,200,80,0,0,590
67659,180,140,120,160,320,0,920
67660,170,160,200,160,160,0,850
67661,260,120,80,160,0,0,620
67662,210,140,80,0,0,0,430
67663,180,120,40,0,0,0,340
67664,220,120,80,160,160,0,740
67665,210,100,80,80,0,0,470
67666,180,160,120,0,0,0,460
67667,220,100,120,160,160,0,760
67668,200,80,40,80,160,0,560
67669,200,160,120,80,160,0,720
67670,210,120,160,160,0,0,650
67671,200,80,80,160,160,0,680
67672,190,120,160,80,160,0,710
67673,210,120,160,0,0,0,490
67674,180,80,80,80,160,0,580
67675,170,120,80,80,0,0,450
67676,190,160,120,80,160,0,710
67677,230,160,120,80,0,0,590
67678,190,120,160,160,160,320,1110
67679,220,140,120,160,320,320,1280
67680,180,100,120,160,160,0,720
67681,190,80,80,80,160,0,590
67682,180,100,120,160,0,0,560
67683,180,160,240,240,320,320,1460
67684,180,80,80,160,160,0,660
67685,200,80,120,160,0,0,560
67686,240,120,80,80,0,0,520
67687,210,100,160,160,320,0,950
67688,180,80,160,240,160,0,820
67689,180,100,80,80,160,0,600
67690,220,120,80,160,160,0,740
67691,180,120,120,80,0,0,500
67692,190,140,200,80,160,320,1090
67693,220,200,160,240,160,0,980
67694,180,120,120,80,160,320,980
67695,190,100,160,160,320,320,1250
67696,200,120,200,80,160,0,760
67697,230,120,80,80,0,0,510
67698,230,100,80,80,0,0,490
67699,220,120,80,80,0,0,500
67700,170,160,160,240,160,0,890
67701,250,140,240,160,160,0,950
67702,160,140,80,80,0,0,460
67703,210,140,160,160,0,0,670
67704,210,160,120,80,160,0,730
67705,210,100,120,80,160,0,670
67706,240,100,80,80,0,0,500
67707,190,120,80,0,0,0,390
67708,210,180,120,0,0,0,510
67709,160,40,80,80,160,0,520
67710,230,60,80,80,160,0,610
67711,220,140,120,80,160,0,720
67712,170,80,80,80,160,0,570
67713,200,140,120,80,160,0,700
67714,230,80,80,0,0,0,390
67715,190,160,120,80,160,0,710
67716,200,140,160,160,320,320,1300
67717,170,180,160,160,0,0,670
67718,180,180,160,80,160,0,760
67719,150,120,80,80,160,0,590
67720,210,100,120,80,160,0,670
67721,180,100,80,0,0,0,360
67722,200,100,120,160,160,0,740
67723,200,160,200,160,160,0,880
67724,180,80,80,80,0,0,420
67725,180,140,160,160,320,0,960
67726,160,60,80,80,160,320,860
67727,220,140,120,80,0,0,560
67728,150,80,120,0,0,0,350
67729,160,100,120,160,160,0,700
67730,180,160,120,80,160,0,700
67731,160,180,80,80,0,0,500
67732,180,160,160,160,160,0,820
67733,190,140,160,240,320,320,1370
67734,180,40,80,80,0,0,380
67735,200,140,40,0,0,0,380
67736,220,80,120,80,0,0,500
67737,160,140,200,80,0,0,580
67738,160,100,80,80,160,0,580
67739,210,180,160,80,160,0,790
67740,210,120,80,80,160,0,650
67741,200,140,80,0,0,0,420
67742,200,80,40,80,160,0,560
67743,190,120,40,0,0,0,350
67744,190,120,120,0,0,0,430
67745,210,140,120,80,160,0,710
67746,210,140,160,80,0,0,590
67747,200,120,80,160,160,0,720
67748,190,120,80,160,160,0,710
67749,200,120,160,160,160,0,800
67750,180,80,80,0,0,0,340
67751,200,20,0,0,0,0,220
67752,230,100,80,80,160,0,650
67753,180,100,80,160,160,0,680
67754,190,120,80,80,160,0,630
67755,200,180,80,80,160,320,1020
67756,180,80,80,80,0,0,420
67757,190,100,40,80,160,0,570
67758,200,160,120,240,320,320,1360
67759,210,140,80,80,0,0,510
67760,190,140,160,80,160,0,730
67761,190,140,120,0,0,0,450
67762,210,120,40,80,160,0,610
67763,230,140,120,80,160,0,730
67764,160,140,80,160,0,0,540
67765,200,100,80,160,320,320,1180
67766,200,80,120,160,160,0,720
67767,170,100,80,160,320,0,830
67768,170,160,80,80,0,0,490
67769,160,100,80,80,0,0,420
67770,240,180,80,80,0,0,580
67771,180,120,160,160,160,0,780
67772,200,120,80,80,160,0,640
67773,200,40,80,80,0,0,400
67774,190,140,120,80,0,0,530
67775,200,80,40,80,0,0,400
67776,210,140,80,0,0,0,430
67777,200,140,80,80,160,0,660
67778,200,100,160,80,0,0,540
67779,230,120,160,80,160,320,1070
67780,180,160,120,80,160,0,700
67781,200,140,80,80,0,0,500
67782,180,120,120,80,0,0,500
67783,220,120,80,160,160,0,740
67784,190,120,40,0,0,0,350
67785,170,80,40,80,160,0,530
67786,190,160,200,80,160,0,790
67787,170,100,40,80,160,0,550
67788,190,200,200,240,0,0,830
67789,200,120,120,160,0,0,600
67790,210,100,120,80,160,0,670
67791,200,140,160,160,160,0,820
67792,190,160,120,80,0,0,550
67793,190,160,200,160,320,320,1350
67794,240,120,80,0,0,0,440
67795,160,120,120,0,0,0,400
67796,200,100,200,240,320,0,1060
67797,160,140,160,80,160,0,700
67798,180,140,200,80,160,0,760
67799,250,120,160,80,160,0,770
67800,200,100,80,0,0,0,380
67801,200,80,80,80,160,0,600
67802,230,120,80,80,0,0,510
67803,180,120,160,80,0,0,540
67804,180,200,160,80,0,0,620
67805,180,100,120,0,0,0,400
67806,170,100,120,80,160,0,630
67807,160,100,80,80,0,0,420
67808,200,120,80,0,0,0,400
67809,210,60,80,0,0,0,350
67810,160,20,40,0,0,0,220
67811,200,120,80,80,160,320,960
67812,200,60,80,160,320,0,820
67813,240,80,120,160,160,0,760
67814,160,140,120,160,160,0,740
67815,190,80,160,80,160,320,990
67816,210,100,40,0,0,0,350
67817,160,140,80,160,320,0,860
67818,190,80,40,0,0,0,310
67819,180,120,120,80,160,0,660
67820,190,180,120,160,320,320,1290
67821,210,160,160,240,320,0,1090
67822,210,80,80,0,0,0,370
67823,230,120,80,0,0,0,430
67824,220,180,120,80,160,0,760
67825,160,100,120,80,160,0,620
67826,190,80,80,160,0,0,510
67827,160,80,40,80,0,0,360
67828,190,100,80,80,160,0,610
67829,140,120,80,160,320,0,820
67830,200,80,80,80,0,0,440
67831,190,140,80,80,160,320,970
67832,190,100,120,160,160,0,730
67833,170,120,120,160,0,0,570
67834,180,140,120,160,320,320,1240
67835,180,80,80,160,160,0,660
67836,220,180,120,80,160,0,760
67837,210,140,80,160,160,0,750
67838,220,160,120,80,0,0,580
67839,200,20,40,0,0,0,260
67840,210,120,160,80,160,0,730
67841,200,140,120,160,0,0,620
67842,200,160,80,0,0,0,440
67843,160,160,120,80,160,0,680
67844,180,140,160,240,320,0,1040
67845,170,100,160,160,320,0,910
67846,190,140,80,80,160,320,970
67847,230,140,80,160,160,0,770
67848,210,140,80,160,160,0,750
67849,210,160,200,160,0,0,730
67850,170,80,0,0,0,0,250
67851,240,140,120,160,320,0,980
67852,180,80,80,80,0,0,420
67853,190,100,120,0,0,0,410
67854,190,100,80,80,0,0,450
67855,190,140,80,0,0,0,410
67856,160,80,80,80,0,0,400
67857,200,160,200,80,0,0,640
67858,210,140,120,240,320,0,1030
67859,160,140,200,160,160,0,820
67860,200,60,40,80,160,0,540
67861,180,200,160,80,160,0,780
67862,210,120,120,80,160,0,690
67863,190,60,80,0,0,0,330
67864,230,140,120,160,320,0,970
67865,170,100,80,80,160,0,590
67866,220,180,80,160,320,0,960
67867,220,120,80,80,0,0,500
67868,190,160,200,160,160,0,870
67869,200,140,120,160,320,0,940
67870,180,140,120,80,160,0,680
67871,200,80,80,160,320,320,1160
67872,160,100,40,0,0,0,300
67873,240,140,80,80,160,0,700
67874,210,140,200,160,0,0,710
67875,230,160,160,80,160,0,790
67876,170,160,160,80,0,0,570
67877,160,140,80,0,0,0,380
67878,200,120,160,160,0,0,640
67879,180,60,40,0,0,0,280
67880,190,120,80,160,0,0,550
67881,250,180,200,80,160,0,870
67882,200,140,160,160,0,0,660
67883,170,140,120,160,160,0,750
67884,180,140,80,0,0,0,400
67885,210,100,120,80,0,0,510
67886,240,180,80,80,160,320,1060
67887,220,100,80,0,0,0,400
67888,190,140,120,160,320,320,1250
67889,180,120,80,160,320,0,860
67890,200,100,40,0,0,0,340
67891,200,80,80,80,0,0,440
67892,220,100,40,0,0,0,360
67893,190,140,160,160,0,0,650
67894,210,180,160,80,160,0,790
67895,230,140,80,160,160,0,770
67896,190,40,40,0,0,0,270
67897,190,100,120,80,0,0,490
67898,210,120,80,160,160,0,730
67899,210,220,160,160,160,0,910
67900,200,100,160,160,0,0,620
67901,170,120,80,80,160,320,930
67902,180,80,80,160,160,0,660
67903,220,120,120,240,160,0,860
67904,230,80,40,80,0,0,430
67905,170,140,160,80,0,0,550
67906,240,120,120,80,0,0,560
67907,190,100,80,0,0,0,370
67908,210,140,40,80,160,0,630
67909,220,140,80,80,160,0,680
67910,200,120,80,80,160,0,640
67911,220,180,80,0,0,0,480
67912,220,120,120,160,0,0,620
67913,170,160,240,160,320,0,1050
67914,190,120,80,0,0,0,390
67915,210,80,0,0,0,0,290
67916,190,100,160,160,160,0,770
67917,190,100,120,0,0,0,410
67918,180,80,80,0,0,0,340
67919,180,100,120,160,160,0,720
67920,160,140,160,160,160,320,1100
67921,170,120,80,160,320,320,1170
67922,200,140,120,160,320,320,1260
67923,240,100,80,160,160,0,740
67924,180,140,120,80,160,0,680
67925,210,140,160,80,160,0,750
67926,200,120,40,0,0,0,360
67927,220,140,80,80,0,0,520
67928,210,120,80,0,0,0,410
67929,170,80,160,160,320,0,890
67930,200,120,80,80,160,0,640
67931,200,140,120,0,0,0,460
67932,170,80,80,80,160,0,570
67933,250,80,120,0,0,0,450
67934,180,80,40,80,160,0,540
67935,180,120,80,0,0,0,380
67936,230,80,120,80,0,0,510
67937,230,140,80,80,0,0,530
67938,260,140,120,80,0,0,600
67939,220,160,120,80,0,0,580
67940,160,80,80,80,160,0,560
67941,190,120,40,80,160,0,590
67942,210,120,120,0,0,0,450
67943,170,160,80,0,0,0,410
67944,200,140,80,80,160,0,660
67945,190,140,160,160,160,320,1130
67946,180,120,160,240,160,0,860
67947,240,80,40,80,160,320,920
67948,190,100,40,0,0,0,330
67949,160,100,80,80,160,320,900
67950,200,100,40,80,160,0,580
67951,210,140,120,80,160,0,710
67952,130,80,120,0,0,0,330
67953,200,180,120,80,0,0,580
67954,230,100,120,80,160,0,690
67955,160,120,160,240,160,0,840
67956,190,140,40,80,0,0,450
67957,250,220,120,0,0,0,590
67958,160,140,40,80,160,0,580
67959,200,160,160,160,160,0,840
67960,200,100,120,160,0,0,580
67961,190,100,0,0,0,0,290
67962,210,140,120,80,160,0,710
67963,210,120,80,80,0,0,490
67964,170,140,80,80,160,0,630
67965,180,120,120,240,160,0,820
67966,210,100,80,160,160,0,710
67967,200,120,80,80,0,0,480
67968,190,160,120,240,160,0,870
67969,210,140,120,80,160,0,710
67970,220,140,120,80,160,0,720
67971,190,140,40,0,0,0,370
67972,250,140,160,80,0,0,630
67973,210,140,40,0,0,0,390
67974,190,120,80,0,0,0,390
67975,130,100,80,160,160,0,630
67976,180,140,120,80,160,320,1000
67977,160,100,160,0,0,0,420
67978,180,120,80,80,0,0,460
67979,190,100,160,160,0,0,610
67980,220,100,120,160,320,320,1240
67981,210,100,40,80,160,0,590
67982,240,160,120,160,160,0,840
67983,180,140,120,80,0,0,520
67984,170,60,80,80,160,0,550
67985,190,200,40,0,0,0,430
67986,220,140,80,80,0,0,520
67987,220,140,160,240,320,0,1080
67988,220,80,40,0,0,0,340
67989,240,140,160,160,160,0,860
67990,230,120,80,160,320,0,910
67991,180,120,160,160,320,0,940
67992,230,160,160,0,0,0,550
67993,220,180,160,80,160,0,800
67994,210,100,120,160,160,0,750
67995,220,160,120,80,160,0,740
67996,220,180,80,80,160,0,720
67997,220,120,160,160,160,0,820
67998,200,140,200,160,0,0,700
67999,180,160,120,240,320,320,1340
68000,220,120,80,80,160,0,660
68001,210,160,160,160,160,0,850
68002,240,140,80,80,160,0,700
68003,210,120,80,80,0,0,490
68004,180,100,160,160,160,0,760
68005,160,80,120,160,160,0,680
68006,220,120,120,80,160,0,700
68007,250,120,120,80,160,0,730
68008,210,120,120,0,0,0,450
68009,180,140,80,80,0,0,480
68010,190,120,120,240,320,0,990
68011,170,80,80,0,0,0,330
68012,220,140,160,240,160,320,1240
68013,200,140,120,80,160,0,700
68014,150,80,120,160,160,0,670
68015,210,160,120,80,0,0,570
68016,200,80,40,80,160,0,560
68017,150,120,40,80,0,0,390
68018,230,140,120,80,160,0,730
68019,250,140,120,160,320,0,990
68020,230,200,80,80,160,0,750
68021,150,100,120,80,160,0,610
68022,210,140,120,0,0,0,470
68023,170,140,80,0,0,0,390
68024,190,120,80,80,160,0,630
68025,160,100,120,80,0,0,460
68026,170,120,160,160,320,320,1250
68027,190,160,200,160,160,320,1190
68028,220,140,120,240,0,0,720
68029,190,140,120,160,0,0,610
68030,150,80,120,240,160,320,1070
68031,210,100,120,160,0,0,590
68032,220,120,80,0,0,0,420
68033,240,120,0,0,0,0,360
68034,180,60,40,80,0,0,360
68035,160,120,80,80,160,0,600
68036,230,160,80,80,0,0,550
68037,230,160,80,0,0,0,470
68038,200,140,120,160,160,0,780
68039,210,100,120,80,0,0,510
68040,140,100,160,80,0,0,480
68041,230,120,120,160,160,0,790
68042,190,100,80,80,0,0,450
68043,200,100,120,160,160,0,740
68044,180,140,200,240,320,320,1400
68045,210,160,120,80,160,0,730
68046,220,160,80,0,0,0,460
68047,230,120,80,160,160,320,1070
68048,210,100,0,0,0,0,310
68049,180,120,80,0,0,0,380
68050,220,200,80,80,0,0,580
68051,220,120,120,160,320,0,940
68052,170,100,120,80,0,0,470
68053,190,140,120,80,160,0,690
68054,210,100,40,0,0,0,350
68055,200,120,80,0,0,0,400
68056,190,100,120,160,320,0,890
68057,220,140,120,0,0,0,480
68058,150,120,200,240,160,0,870
68059,200,140,200,80,0,0,620
68060,200,160,160,160,160,0,840
68061,220,80,120,80,160,0,660
68062,170,160,40,80,0,0,450
68063,190,120,80,80,160,0,630
68064,230,160,120,80,0,0,590
68065,240,80,80,80,0,0,480
68066,210,120,40,0,0,0,370
68067,210,140,160,240,160,0,910
68068,230,140,160,160,160,0,850
68069,220,120,120,80,0,0,540
68070,190,100,80,160,160,0,690
68071,200,140,120,160,160,320,1100
68072,180,80,120,160,0,0,540
68073,200,60,40,0,0,0,300
68074,170,60,40,0,0,0,270
68075,220,160,120,160,160,320,1140
68076,190,80,80,80,160,0,590
68077,160,100,80,80,0,0,420
68078,220,180,160,240,160,0,960
68079,150,80,80,80,0,0,390
68080,200,60,0,0,0,0,260
68081,160,80,80,80,0,0,400
68082,200,120,80,80,0,0,480
68083,210,160,120,80,160,320,1050
68084,230,120,160,160,160,0,830
68085,200,80,120,160,160,320,1040
68086,220,200,200,240,160,0,1020
68087,220,140,120,80,160,0,720
68088,160,120,120,160,160,0,720
68089,210,140,160,160,0,0,670
68090,150,140,160,160,320,320,1250
68091,180,160,80,80,0,0,500
68092,190,140,80,80,160,0,650
68093,160,120,40,0,0,0,320
68094,220,140,120,80,160,0,720
68095,220,140,160,160,0,0,680
68096,190,100,80,0,0,0,370
68097,200,140,120,80,0,0,540
68098,230,140,160,160,160,0,850
68099,220,140,160,160,160,0,840
68100,190,180,160,160,0,0,690
68101,190,180,160,160,160,320,1170
68102,180,140,160,320,160,0,960
68103,180,100,80,80,0,0,440
68104,190,120,80,80,0,0,470
68105,230,100,120,160,160,0,770
68106,180,140,160,160,160,0,800
68107,160,120,160,80,160,0,680
68108,180,160,160,160,320,0,980
68109,190,180,120,160,160,0,810
68110,210,160,160,160,160,0,850
68111,190,100,80,80,160,0,610
68112,140,120,80,80,160,0,580
68113,210,140,80,80,160,0,670
68114,210,120,120,80,160,0,690
68115,230,140,200,160,160,0,890
68116,220,100,40,0,0,0,360
68117,200,120,80,0,0,0,400
68118,210,100,80,80,0,0,470
68119,200,100,160,0,0,0,460
68120,180,120,160,240,0,0,700
68121,200,180,80,0,0,0,460
68122,210,140,80,80,160,0,670
68123,200,120,120,80,0,0,520
68124,160,80,40,80,0,0,360
68125,180,120,80,0,0,0,380
68126,230,100,160,0,0,0,490
68127,190,100,160,240,320,320,1330
68128,220,120,80,0,0,0,420
68129,160,100,120,80,160,0,620
68130,200,120,80,80,160,320,960
68131,220,120,80,0,0,0,420
68132,180,120,80,80,160,320,940
68133,150,80,40,80,0,0,350
68134,180,140,120,160,0,0,600
68135,200,120,160,80,160,0,720
68136,190,180,160,80,160,320,1090
68137,210,100,80,80,0,0,470
68138,250,160,120,80,0,0,610
68139,150,80,120,80,160,0,590
68140,160,100,160,80,0,0,500
68141,180,140,200,240,320,0,1080
68142,170,100,80,80,160,0,590
68143,220,100,80,0,0,0,400
68144,230,80,40,80,160,0,590
68145,210,140,80,80,160,320,990
68146,200,100,80,80,160,320,940
68147,230,180,160,240,320,0,1130
68148,170,200,200,80,160,0,810
68149,250,80,80,80,160,0,650
68150,210,100,80,0,0,0,390
68151,170,100,80,0,0,0,350
68152,190,140,120,80,160,0,690
68153,200,140,160,0,0,0,500
68154,230,100,40,80,160,0,610
68155,190,160,0,0,0,0,350
68156,190,200,160,160,320,320,1350
68157,200,100,40,80,160,0,580
68158,200,120,120,160,160,0,760
68159,210,120,160,160,320,0,970
68160,230,100,80,80,160,0,650
68161,180,140,80,0,0,0,400
68162,200,140,80,0,0,0,420
68163,220,60,40,0,0,0,320
68164,210,100,120,160,160,0,750
68165,190,120,120,160,320,320,1230
68166,210,120,160,80,160,0,730
68167,220,100,40,0,0,0,360
68168,190,100,40,0,0,0,330
68169,200,120,120,80,160,320,1000
68170,210,80,0,0,0,0,290
68171,180,120,80,80,0,0,460
68172,210,160,120,160,160,0,810
68173,180,160,120,80,160,320,1020
68174,190,80,80,80,160,0,590
68175,230,120,160,160,160,0,830
68176,210,120,80,160,320,320,1210
68177,180,140,120,0,0,0,440
68178,190,160,200,160,0,0,710
68179,190,120,120,80,0,0,510
68180,190,140,80,80,0,0,490
68181,230,140,120,80,160,0,730
68182,190,160,200,240,320,0,1110
68183,200,80,40,80,160,0,560
68184,240,140,40,80,0,0,500
68185,220,140,160,160,160,0,840
68186,190,140,120,80,160,0,690
68187,190,140,120,80,160,320,1010
68188,190,120,160,160,160,320,1110
68189,190,160,80,80,0,0,510
68190,220,180,120,80,0,0,600
68191,190,100,80,160,0,0,530
68192,190,80,80,80,160,0,590
68193,210,100,40,80,0,0,430
68194,200,160,200,240,320,320,1440
68195,250,40,80,160,0,0,530
68196,170,120,120,160,160,0,730
68197,200,80,40,80,160,320,880
68198,160,160,160,160,0,0,640
68199,220,120,80,0,0,0,420
68200,200,100,120,160,160,0,740
68201,190,160,80,160,0,0,590
68202,210,120,120,160,160,0,770
68203,180,140,120,80,160,0,680
68204,220,160,120,160,160,0,820
68205,220,160,120,0,0,0,500
68206,200,140,120,160,160,0,780
68207,170,180,160,160,160,0,830
68208,210,140,160,240,0,0,750
68209,190,100,80,80,160,0,610
68210,190,100,120,160,160,320,1050
68211,200,120,80,160,0,0,560
68212,150,40,80,160,160,0,590
68213,200,120,120,240,320,0,1000
68214,180,120,80,80,0,0,460
68215,200,100,120,80,0,0,500
68216,210,40,40,0,0,0,290
68217,240,120,160,240,160,320,1240
68218,230,140,120,0,0,0,490
68219,220,140,80,0,0,0,440
68220,190,100,80,80,160,0,610
68221,160,100,80,160,160,0,660
68222,150,140,120,160,0,0,570
68223,200,160,40,80,160,0,640
68224,210,100,160,240,160,0,870
68225,220,120,80,0,0,0,420
68226,200,160,120,80,0,0,560
68227,220,140,160,160,160,0,840
68228,210,140,80,80,160,0,670
68229,210,140,80,0,0,0,430
68230,190,100,120,80,160,0,650
68231,240,160,120,80,160,0,760
68232,200,140,120,80,0,0,540
68233,180,140,120,80,160,0,680
68234,170,80,40,80,0,0,370
68235,210,140,200,160,320,320,1350
68236,200,100,80,80,160,0,620
68237,180,160,120,160,0,0,620
68238,210,160,120,160,160,320,1130
68239,230,60,80,160,320,320,1170
68240,200,60,80,0,0,0,340
68241,170,120,80,80,160,0,610
68242,220,80,120,240,160,0,820
68243,180,80,80,80,160,0,580
68244,190,120,120,160,160,0,750
68245,210,120,80,80,160,0,650
68246,220,240,200,160,160,0,980
68247,190,120,120,160,0,0,590
68248,180,120,120,160,160,0,740
68249,150,80,160,240,320,0,950
68250,200,120,120,160,320,0,920
68251,190,120,120,80,0,0,510
68252,210,200,120,80,160,320,1090
68253,180,140,80,80,160,0,640
68254,220,160,80,80,160,0,700
68255,220,140,200,160,0,0,720
68256,140,60,40,0,0,0,240
68257,220,120,80,80,160,0,660
68258,210,100,80,80,0,0,470
68259,190,140,160,80,160,0,730
68260,190,80,120,80,160,320,950
68261,210,120,120,0,0,0,450
68262,230,100,80,80,160,0,650
68263,180,100,40,0,0,0,320
68264,200,160,120,240,160,0,880
68265,180,140,160,240,160,0,880
68266,220,100,80,0,0,0,400
68267,220,140,160,0,0,0,520
68268,200,40,40,80,160,320,840
68269,180,120,40,80,160,0,580
68270,230,100,80,160,320,0,890
68271,170,100,120,80,160,0,630
68272,190,120,160,160,160,0,790
68273,200,80,80,160,160,0,680
68274,140,100,80,80,160,0,560
68275,170,120,120,0,0,0,410
68276,220,100,80,80,160,0,640
68277,210,180,120,0,0,0,510
68278,190,100,120,80,0,0,490
68279,220,100,120,0,0,0,440
68280,210,100,120,160,160,0,750
68281,190,120,40,0,0,0,350
68282,210,140,120,80,160,0,710
68283,210,140,160,160,160,0,830
68284,180,180,120,0,0,0,480
68285,170,100,160,160,320,320,1230
68286,220,120,80,160,160,320,1060
68287,170,120,80,160,0,0,530
68288,190,120,80,80,160,0,630
68289,210,140,80,160,320,320,1230
68290,190,120,120,80,160,0,670
68291,220,120,40,80,0,0,460
68292,150,120,120,160,160,0,710
68293,200,80,40,80,0,0,400
68294,210,120,200,240,160,0,930
68295,220,120,160,160,0,0,660
68296,220,140,120,80,0,0,560
68297,200,180,80,80,0,0,540
68298,230,100,80,80,0,0,490
68299,210,180,200,80,0,0,670
68300,190,120,80,80,160,320,950
68301,210,120,120,80,160,0,690
68302,190,60,120,160,160,0,690
68303,180,160,80,80,0,0,500
68304,180,120,80,80,0,0,460
68305,190,160,160,240,320,0,1070
68306,150,40,0,0,0,0,190
68307,200,120,80,80,160,320,960
68308,170,60,0,0,0,0,230
68309,200,100,80,80,160,0,620
68310,160,100,40,80,0,0,380
68311,180,140,160,160,0,0,640
68312,220,160,120,80,0,0,580
68313,220,180,120,80,160,0,760
68314,230,140,80,80,0,0,530
68315,190,80,40,80,160,0,550
68316,230,120,40,80,160,0,630
68317,170,100,120,160,320,0,870
68318,210,160,80,80,160,0,690
68319,230,180,80,80,160,0,730
68320,210,160,280,240,320,0,1210
68321,190,160,120,80,160,0,710
68322,200,100,40,0,0,0,340
68323,170,120,80,0,0,0,370
68324,180,120,80,80,160,0,620
68325,160,140,120,80,0,0,500
68326,210,160,160,240,0,0,770
68327,180,100,40,80,160,0,560
68328,240,100,80,80,160,0,660
68329,180,200,200,80,160,0,820
68330,160,80,80,80,0,0,400
68331,210,80,120,160,320,0,890
68332,210,120,120,80,0,0,530
68333,250,160,160,240,160,0,970
68334,170,100,160,80,0,0,510
68335,200,100,120,240,0,0,660
68336,180,100,120,160,320,320,1200
68337,190,200,80,80,0,0,550
68338,190,100,40,0,0,0,330
68339,170,140,120,80,0,0,510
68340,230,80,80,80,160,0,630
68341,170,100,80,0,0,0,350
68342,170,140,160,80,0,0,550
68343,200,160,120,80,160,0,720
68344,190,160,160,160,160,0,830
68345,230,160,120,80,160,0,750
68346,220,100,120,160,0,0,600
68347,190,140,80,80,0,0,490
68348,190,120,80,160,320,0,870
68349,190,120,80,160,160,0,710
68350,190,160,80,80,160,0,670
68351,190,120,40,80,0,0,430
68352,180,160,160,160,320,0,980
68353,210,120,80,0,0,0,410
68354,190,120,80,160,0,0,550
68355,210,80,40,80,160,320,890
68356,160,140,120,240,160,320,1140
68357,160,140,80,0,0,0,380
68358,170,120,200,240,0,0,730
68359,180,140,40,0,0,0,360
68360,200,140,120,80,160,320,1020
68361,220,120,120,0,0,0,460
68362,170,120,80,80,0,0,450
68363,180,140,120,80,160,0,680
68364,240,120,120,80,160,0,720
68365,190,160,80,160,160,0,750
68366,150,80,120,80,0,0,430
68367,210,120,120,80,0,0,530
68368,180,120,80,0,0,0,380
68369,180,80,40,80,160,320,860
68370,210,120,40,80,0,0,450
68371,220,140,80,160,160,0,760
68372,190,120,160,80,0,0,550
68373,170,120,120,160,160,320,1050
68374,190,120,120,160,320,0,910
68375,240,100,160,80,0,0,580
68376,190,140,160,160,160,0,810
68377,200,100,40,0,0,0,340
68378,200,160,120,80,160,0,720
68379,170,120,120,0,0,0,410
68380,190,120,120,240,160,0,830
68381,200,140,80,80,0,0,500
68382,220,100,80,80,0,0,480
68383,170,140,160,0,0,0,470
68384,210,40,0,0,0,0,250
68385,190,180,200,80,0,0,650
68386,190,160,40,0,0,0,390
68387,200,140,40,0,0,0,380
68388,170,80,40,0,0,0,290
68389,220,160,160,0,0,0,540
68390,190,80,120,160,160,320,1030
68391,230,120,120,160,160,0,790
68392,190,80,0,0,0,0,270
68393,180,60,40,80,160,320,840
68394,200,120,80,80,160,0,640
68395,230,120,40,80,160,0,630
68396,170,80,160,160,160,0,730
68397,190,80,0,0,0,0,270
68398,210,180,200,160,320,320,1390
68399,170,40,40,0,0,0,250
68400,170,180,160,80,160,0,750
68401,170,120,160,160,160,0,770
68402,160,120,160,80,160,0,680
68403,180,100,40,80,160,320,880
68404,200,80,120,0,0,0,400
68405,220,80,120,160,0,0,580
68406,160,80,80,80,160,0,560
68407,150,120,200,160,320,0,950
68408,210,160,160,80,0,0,610
68409,250,180,120,0,0,0,550
68410,180,100,120,160,160,0,720
68411,210,100,40,80,160,0,590
68412,200,100,120,240,320,0,980
68413,200,80,80,80,0,0,440
68414,190,180,120,80,160,0,730
68415,190,100,80,160,160,0,690
68416,200,100,80,80,0,0,460
68417,230,140,80,80,0,0,530
68418,180,180,160,240,320,0,1080
68419,210,100,120,160,160,0,750
68420,210,160,80,80,0,0,530
68421,220,120,120,160,320,0,940
68422,230,140,80,80,0,0,530
68423,200,140,120,80,0,0,540
68424,210,180,120,80,0,0,590
68425,200,100,120,160,0,0,580
68426,180,120,120,80,160,320,980
68427,210,160,160,160,320,0,1010
68428,210,60,40,80,0,0,390
68429,230,120,160,0,0,0,510
68430,160,120,120,0,0,0,400
68431,160,100,80,80,160,0,580
68432,190,160,120,80,0,0,550
68433,210,120,120,80,0,0,530
68434,200,80,80,160,160,0,680
68435,200,80,120,80,0,0,480
68436,160,160,80,80,160,320,960
68437,220,160,160,160,160,0,860
68438,180,160,120,160,320,0,940
68439,220,100,80,160,160,0,720
68440,160,120,120,80,160,0,640
68441,190,120,120,160,0,0,590
68442,200,120,80,0,0,0,400
68443,190,140,120,160,0,0,610
68444,180,100,80,0,0,0,360
68445,190,140,120,80,0,0,530
68446,210,100,160,80,160,0,710
68447,190,120,120,80,160,0,670
68448,220,140,120,160,160,320,1120
68449,190,140,200,160,0,0,690
68450,160,180,120,80,0,0,540
68451,240,120,160,160,320,0,1000
68452,200,120,120,160,160,0,760
68453,180,120,80,80,0,0,460
68454,170,120,80,80,160,320,930
68455,180,100,40,80,0,0,400
68456,160,120,200,160,0,0,640
68457,220,140,40,0,0,0,400
68458,210,100,80,80,160,0,630
68459,210,60,120,0,0,0,390
68460,210,120,160,80,0,0,570
68461,190,120,40,0,0,0,350
68462,240,180,160,0,0,0,580
68463,230,140,120,160,320,0,970
68464,150,120,80,80,0,0,430
68465,180,80,80,80,0,0,420
68466,170,120,40,80,160,0,570
68467,180,180,160,160,160,0,840
68468,200,140,80,80,160,0,660
68469,170,100,80,160,320,0,830
68470,200,220,120,160,320,0,1020
68471,180,120,80,0,0,0,380
68472,200,100,120,80,0,0,500
68473,200,160,120,80,160,0,720
68474,220,140,120,240,320,0,1040
68475,210,140,80,160,160,0,750
68476,190,80,80,0,0,0,350
68477,240,160,120,0,0,0,520
68478,200,160,120,80,160,0,720
68479,200,120,160,160,160,0,800
68480,160,80,80,80,0,0,400
68481,220,180,80,0,0,0,480
68482,200,120,120,80,0,0,520
68483,200,160,200,160,160,0,880
68484,190,140,200,80,160,0,770
68485,240,120,120,160,160,0,800
68486,190,160,120,240,160,320,1190
68487,210,120,40,80,0,0,450
68488,190,60,80,80,0,0,410
68489,230,120,120,80,160,0,710
68490,220,40,80,80,0,0,420
68491,230,140,80,0,0,0,450
68492,190,120,40,0,0,0,350
68493,160,60,0,0,0,0,220
68494,220,180,200,160,0,0,760
68495,190,80,0,0,0,0,270
68496,220,160,80,80,160,0,700
68497,180,160,80,80,160,0,660
68498,190,120,120,240,160,320,1150
68499,200,120,120,160,320,0,920
68500,180,100,160,160,160,0,760
68501,200,120,80,160,0,0,560
68502,210,160,120,160,160,0,810
68503,190,120,80,0,0,0,390
68504,160,100,120,160,160,0,700
68505,220,100,80,80,0,0,480
68506,210,180,160,160,160,0,870
68507,160,60,80,0,0,0,300
68508,210,80,120,80,0,0,490
68509,210,140,80,80,160,0,670
68510,210,140,80,80,160,0,670
68511,180,140,80,80,0,0,480
68512,180,100,80,0,0,0,360
68513,180,120,120,0,0,0,420
68514,190,120,120,80,0,0,510
68515,190,80,40,0,0,0,310
68516,240,180,160,80,160,320,1140
68517,200,160,200,80,0,0,640
68518,200,120,80,80,160,0,640
68519,160,100,200,160,160,0,780
68520,180,80,160,160,160,0,740
68521,160,100,40,0,0,0,300
68522,210,140,160,80,0,0,590
68523,220,140,80,0,0,0,440
68524,220,160,80,160,320,320,1260
68525,230,140,160,240,160,0,930
68526,210,100,120,80,160,0,670
68527,190,140,120,160,160,0,770
68528,230,180,120,80,0,0,610
68529,190,100,120,0,0,0,410
68530,190,140,80,80,0,0,490
68531,210,180,160,80,160,0,790
68532,190,100,80,80,160,0,610
68533,190,140,80,80,160,320,970
68534,220,140,80,160,320,320,1240
68535,180,60,0,0,0,0,240
68536,220,180,160,80,160,320,1120
68537,160,120,120,160,0,0,560
68538,200,80,80,80,160,0,600
68539,170,160,40,0,0,0,370
68540,210,120,120,160,160,0,770
68541,170,120,80,0,0,0,370
68542,190,140,120,80,160,0,690
68543,190,80,120,80,0,0,470
68544,200,120,160,160,320,0,960
68545,200,100,80,80,160,0,620
68546,250,160,120,160,320,0,1010
68547,130,80,80,80,160,0,530
68548,210,140,120,160,0,0,630
68549,170,160,120,0,0,0,450
68550,170,80,40,80,160,0,530
68551,190,100,120,160,0,0,570
68552,150,120,40,0,0,0,310
68553,180,100,40,0,0,0,320
68554,190,120,80,160,0,0,550
68555,200,140,40,0,0,0,380
68556,220,180,80,80,0,0,560
68557,200,120,120,160,320,320,1240
68558,240,180,40,80,0,0,540
68559,210,140,120,0,0,0,470
68560,170,100,80,80,0,0,430
68561,210,100,80,160,160,0,710
68562,190,160,120,160,160,0,790
68563,210,140,120,160,160,0,790
68564,190,100,120,160,160,320,1050
68565,200,80,120,80,160,0,640
68566,200,120,160,160,160,0,800
68567,210,160,160,80,160,0,770
68568,200,100,40,80,0,0,420
68569,200,80,120,0,0,0,400
68570,220,140,40,0,0,0,400
68571,150,100,0,0,0,0,250
68572,180,100,120,0,0,0,400
68573,190,100,80,80,160,0,610
68574,220,140,120,160,160,0,800
68575,230,120,160,80,0,0,590
68576,200,140,120,160,320,0,940
68577,190,180,160,240,0,0,770
68578,190,120,80,160,160,0,710
68579,220,120,120,80,160,320,1020
68580,170,80,120,160,320,0,850
68581,200,160,160,80,0,0,600
68582,210,120,120,160,320,0,930
68583,190,80,80,80,0,0,430
68584,170,100,120,160,160,0,710
68585,220,200,120,160,160,0,860
68586,200,140,80,80,160,0,660
68587,210,140,80,160,0,0,590
68588,210,200,160,160,0,0,730
68589,170,100,80,80,160,0,590
68590,220,200,120,0,0,0,540
68591,230,140,160,80,0,0,610
68592,210,160,120,160,0,0,650
68593,200,120,120,80,0,0,520
68594,190,80,120,160,160,0,710
68595,200,140,120,80,160,0,700
68596,240,80,40,0,0,0,360
68597,190,120,120,80,160,0,670
68598,190,120,160,80,160,0,710
68599,170,160,80,80,0,0,490
68600,170,120,120,160,160,0,730
68601,230,120,80,160,0,0,590
68602,210,120,120,240,320,0,1010
68603,190,80,40,0,0,0,310
68604,190,100,160,160,320,0,930
68605,200,120,80,80,160,0,640
68606,210,120,160,160,160,0,810
68607,170,100,80,80,0,0,430
68608,220,160,40,80,160,0,660
68609,190,160,200,80,0,0,630
68610,200,100,80,160,160,0,700
68611,220,140,80,80,160,0,680
68612,190,120,80,80,160,0,630
68613,250,120,40,80,160,0,650
68614,160,80,80,160,160,0,640
68615,190,140,120,160,160,0,770
68616,200,120,120,80,0,0,520
68617,180,80,120,0,0,0,380
68618,230,140,80,0,0,0,450
68619,160,100,120,80,160,0,620
68620,220,80,80,0,0,0,380
68621,180,140,200,80,160,0,760
68622,200,100,200,240,160,0,900
68623,220,160,80,160,0,0,620
68624,160,140,80,80,160,0,620
68625,160,100,40,0,0,0,300
68626,140,60,80,160,320,320,1080
68627,190,100,120,160,0,0,570
68628,180,100,0,0,0,0,280
68629,150,80,40,80,0,0,350
68630,220,100,80,80,0,0,480
68631,180,80,120,0,0,0,380
68632,180,120,120,80,0,0,500
68633,210,120,80,160,160,0,730
68634,220,160,240,80,0,0,700
68635,210,120,40,0,0,0,370
68636,230,120,40,80,160,0,630
68637,190,60,80,0,0,0,330
68638,200,140,120,160,160,0,780
68639,200,200,200,240,160,0,1000
68640,200,160,80,0,0,0,440
68641,230,140,160,80,0,0,610
68642,200,120,120,0,0,0,440
68643,180,120,160,240,320,0,1020
68644,240,100,40,80,0,0,460
68645,170,80,40,80,0,0,370
68646,230,160,80,80,160,0,710
68647,240,180,40,0,0,0,460
68648,200,160,80,80,160,320,1000
68649,210,160,80,0,0,0,450
68650,210,160,200,80,160,0,810
68651,170,140,160,160,320,320,1270
68652,180,100,80,0,0,0,360
68653,190,160,120,160,160,0,790
68654,190,100,160,160,160,320,1090
68655,210,120,120,80,0,0,530
68656,200,120,80,80,160,0,640
68657,180,120,40,80,160,0,580
68658,220,100,200,160,160,0,840
68659,160,80,160,240,320,0,960
68660,210,120,200,160,160,0,850
68661,180,120,120,160,160,0,740
68662,200,120,40,0,0,0,360
68663,190,160,120,160,160,0,790
68664,230,120,40,0,0,0,390
68665,150,80,80,80,160,0,550
68666,210,120,120,80,0,0,530
68667,230,120,160,80,160,0,750
68668,210,120,80,0,0,0,410
68669,210,100,80,80,160,0,630
68670,210,100,80,160,160,0,710
68671,200,140,80,0,0,0,420
68672,200,160,160,160,320,320,1320
68673,190,80,80,80,160,0,590
68674,170,120,80,80,0,0,450
68675,210,160,80,80,0,0,530
68676,180,120,160,80,160,0,700
68677,200,180,120,80,0,0,580
68678,230,140,160,320,320,320,1490
68679,210,140,200,160,160,0,870
68680,200,180,120,0,0,0,500
68681,220,40,80,0,0,0,340
68682,220,160,40,0,0,0,420
68683,210,120,120,160,0,0,610
68684,210,60,40,80,160,0,550
68685,230,160,160,160,0,0,710
68686,210,140,80,160,160,0,750
68687,190,60,80,80,160,0,570
68688,170,100,160,240,320,0,990
68689,210,120,160,240,320,0,1050
68690,250,140,40,80,160,0,670
68691,180,100,120,80,160,0,640
68692,230,160,120,240,0,0,750
68693,180,80,40,80,0,0,380
68694,230,140,120,80,160,0,730
68695,180,100,120,80,0,0,480
68696,180,140,120,80,160,0,680
68697,200,120,80,80,0,0,480
68698,200,100,160,80,160,0,700
68699,180,140,160,160,160,0,800
68700,220,140,80,0,0,0,440
68701,240,140,80,0,0,0,460
68702,200,140,120,0,0,0,460
68703,150,80,120,80,0,0,430
68704,230,140,120,80,0,0,570
68705,180,60,40,80,160,0,520
68706,180,120,120,160,160,0,740
68707,210,80,80,160,160,0,690
68708,210,100,120,160,160,0,750
68709,200,80,40,0,0,0,320
68710,180,100,80,0,0,0,360
68711,200,120,160,160,160,320,1120
68712,190,120,80,80,0,0,470
68713,190,140,200,240,320,320,1410
68714,200,180,80,80,160,0,700
68715,240,160,160,160,160,0,880
68716,190,60,80,80,160,0,570
68717,180,80,120,80,0,0,460
68718,190,160,80,80,160,0,670
68719,210,80,40,80,160,320,890
68720,190,100,80,80,0,0,450
68721,230,120,80,80,160,0,670
68722,210,180,120,160,160,0,830
68723,180,160,120,80,0,0,540
68724,180,100,80,160,320,0,840
68725,210,180,200,240,160,0,990
68726,210,140,80,80,0,0,510
68727,210,100,120,0,0,0,430
68728,180,100,80,80,160,0,600
68729,190,140,120,160,160,0,770
68730,230,140,120,0,0,0,490
68731,250,160,120,240,160,0,930
68732,220,100,120,160,0,0,600
68733,190,120,120,160,160,0,750
68734,220,100,120,80,160,0,680
68735,200,120,80,160,160,0,720
68736,190,100,0,0,0,0,290
68737,220,140,80,160,160,0,760
68738,210,80,40,0,0,0,330
68739,180,80,80,80,0,0,420
68740,200,180,160,160,160,0,860
68741,210,120,160,80,160,0,730
68742,200,140,160,240,320,320,1380
68743,190,120,80,80,160,0,630
68744,220,160,160,80,160,0,780
68745,190,140,120,0,0,0,450
68746,200,120,120,80,160,320,1000
68747,170,120,40,0,0,0,330
68748,200,140,160,80,0,0,580
68749,210,180,120,160,160,320,1150
68750,190,140,120,240,160,0,850
68751,190,120,120,80,0,0,510
68752,210,120,160,80,160,320,1050
68753,220,120,120,160,320,0,940
68754,160,120,160,0,0,0,440
68755,200,100,80,0,0,0,380
68756,190,80,120,160,0,0,550
68757,180,100,80,80,160,0,600
68758,200,120,120,80,0,0,520
68759,180,140,160,160,0,0,640
68760,190,120,120,80,160,320,990
68761,180,100,120,80,0,0,480
68762,150,120,120,160,0,0,550
68763,210,160,120,160,160,0,810
68764,160,120,120,80,160,0,640
68765,190,160,160,160,0,0,670
68766,200,120,40,80,0,0,440
68767,210,100,120,160,320,0,910
68768,180,120,120,160,160,320,1060
68769,190,60,40,0,0,0,290
68770,220,120,40,0,0,0,380
68771,180,80,120,240,0,0,620
68772,210,120,40,80,160,0,610
68773,190,120,80,160,160,0,710
68774,160,100,80,0,0,0,340
68775,220,80,80,0,0,0,380
68776,160,180,160,160,160,0,820
68777,180,100,80,80,160,0,600
68778,210,140,80,80,160,320,990
68779,220,140,80,80,160,320,1000
68780,210,100,40,80,160,0,590
68781,150,160,120,160,320,0,910
68782,190,100,160,80,160,0,690
68783,190,160,160,160,160,0,830
68784,220,160,120,160,0,0,660
68785,210,100,80,0,0,0,390
68786,200,140,80,80,160,0,660
68787,190,220,160,80,160,320,1130
68788,190,100,40,80,160,0,570
68789,220,120,40,80,0,0,460
68790,220,160,120,0,0,0,500
68791,190,80,40,80,160,0,550
68792,250,180,120,80,0,0,630
68793,130,100,120,160,320,320,1150
68794,250,140,40,80,160,0,670
68795,210,120,160,160,160,0,810
68796,200,120,120,80,160,320,1000
68797,200,160,160,240,320,0,1080
68798,160,120,80,160,320,320,1160
68799,200,80,80,80,0,0,440
68800,200,140,200,160,0,0,700
68801,200,160,120,160,160,320,1120
68802,210,140,40,80,0,0,470
68803,190,140,200,80,0,0,610
68804,210,140,160,160,160,320,1150
68805,210,140,80,0,0,0,430
68806,170,80,40,80,160,0,530
68807,150,100,80,160,160,320,970
68808,160,140,40,0,0,0,340
68809,170,120,80,160,160,320,1010
68810,240,100,120,240,320,0,1020
68811,200,80,120,0,0,0,400
68812,240,160,200,240,160,0,1000
68813,140,80,80,160,160,0,620
68814,180,120,120,80,160,0,660
68815,190,120,160,160,160,0,790
68816,190,100,80,80,160,0,610
68817,170,140,160,80,0,0,550
68818,190,140,160,240,160,320,1210
68819,190,140,80,80,160,0,650
68820,190,140,40,80,160,0,610
68821,210,80,40,80,160,0,570
68822,240,140,40,0,0,0,420
68823,160,120,120,80,160,0,640
68824,240,180,160,80,160,0,820
68825,190,80,0,0,0,0,270
68826,200,80,120,80,160,0,640
68827,200,140,160,160,320,0,980
68828,210,80,0,0,0,0,290
68829,200,120,120,80,160,0,680
68830,190,120,80,80,0,0,470
68831,180,100,160,0,0,0,440
68832,190,80,80,80,160,0,590
68833,200,120,40,80,0,0,440
68834,230,160,200,240,320,320,1470
68835,230,140,120,80,160,0,730
68836,200,140,160,240,160,0,900
68837,150,120,80,160,0,0,510
68838,180,160,120,0,0,0,460
68839,180,100,120,160,0,0,560
68840,170,80,40,0,0,0,290
68841,190,100,80,160,160,0,690
68842,170,120,80,160,320,0,850
68843,200,100,120,160,160,320,1060
68844,220,120,120,0,0,0,460
68845,190,120,40,0,0,0,350
68846,180,60,80,0,0,0,320
68847,170,120,80,160,320,320,1170
68848,220,140,40,80,0,0,480
68849,180,120,40,80,160,0,580
68850,160,80,40,0,0,0,280
68851,220,120,80,80,160,320,980
68852,240,160,120,160,160,0,840
68853,150,140,160,160,160,0,770
68854,200,120,160,0,0,0,480
68855,160,140,120,160,0,0,580
68856,200,100,40,80,160,0,580
68857,170,80,80,80,0,0,410
68858,210,140,120,160,160,320,1110
68859,150,120,80,80,160,0,590
68860,140,80,80,80,160,0,540
68861,220,100,80,80,0,0,480
68862,220,100,80,160,0,0,560
68863,200,120,40,80,0,0,440
68864,200,140,120,160,160,0,780
68865,220,140,160,160,320,320,1320
68866,180,140,80,0,0,0,400
68867,200,160,160,160,160,0,840
68868,200,120,80,80,160,0,640
68869,200,120,120,80,160,0,680
68870,170,200,200,80,160,0,810
68871,160,40,0,0,0,0,200
68872,220,80,40,80,0,0,420
68873,220,140,240,160,160,0,920
68874,200,100,80,80,160,0,620
68875,170,140,160,0,0,0,470
68876,180,160,80,80,0,0,500
68877,210,120,120,160,160,320,1090
68878,200,160,120,160,160,0,800
68879,210,160,80,80,160,0,690
68880,150,100,80,0,0,0,330
68881,230,180,40,0,0,0,450
68882,190,80,120,160,160,0,710
68883,230,140,240,160,0,0,770
68884,180,100,40,0,0,0,320
68885,180,140,0,0,0,0,320
68886,200,100,120,0,0,0,420
68887,180,160,120,80,160,320,1020
68888,200,100,80,0,0,0,380
68889,230,160,200,160,320,0,1070
68890,240,100,120,80,160,0,700
68891,210,100,80,80,160,0,630
68892,200,140,120,0,0,0,460
68893,190,100,120,160,160,320,1050
68894,200,100,80,80,160,0,620
68895,230,160,120,160,160,320,1150
68896,220,140,120,160,320,320,1280
68897,190,160,120,80,160,0,710
68898,230,180,80,160,0,0,650
68899,200,120,0,0,0,0,320
68900,200,180,120,80,0,0,580
68901,220,100,120,240,320,0,1000
68902,160,100,120,160,0,0,540
68903,170,100,80,80,160,0,590
68904,200,180,120,0,0,0,500
68905,170,160,160,160,160,0,810
68906,180,80,80,80,160,0,580
68907,160,60,40,80,0,0,340
68908,160,40,80,80,160,0,520
68909,210,140,40,80,0,0,470
68910,220,100,80,0,0,0,400
68911,220,140,80,0,0,0,440
68912,230,100,120,80,160,0,690
68913,190,40,40,80,160,320,830
68914,200,140,120,160,160,0,780
68915,220,120,80,80,0,0,500
68916,150,80,80,80,0,0,390
68917,190,100,120,160,0,0,570
68918,190,140,80,80,160,0,650
68919,200,120,120,80,0,0,520
68920,220,60,40,80,0,0,400
68921,200,220,120,160,320,0,1020
68922,210,120,120,160,160,320,1090
68923,180,200,80,0,0,0,460
68924,180,120,120,160,160,0,740
68925,210,120,160,160,320,320,1290
68926,200,160,40,80,0,0,480
68927,200,100,80,0,0,0,380
68928,190,120,120,80,0,0,510
68929,160,100,120,160,160,0,700
68930,190,100,120,80,160,0,650
68931,170,60,80,80,160,320,870
68932,170,140,80,80,0,0,470
68933,240,100,80,0,0,0,420
68934,230,200,40,0,0,0,470
68935,200,160,160,80,0,0,600
68936,220,140,80,80,0,0,520
68937,190,120,160,160,320,320,1270
68938,220,140,80,160,160,0,760
68939,200,140,120,160,160,0,780
68940,190,100,40,80,160,0,570
68941,200,120,40,0,0,0,360
68942,210,140,160,80,160,0,750
68943,220,120,160,160,160,0,820
68944,230,120,120,160,320,0,950
68945,200,140,120,160,160,320,1100
68946,170,120,120,80,160,0,650
68947,160,140,80,160,320,0,860
68948,160,120,40,0,0,0,320
68949,220,160,160,0,0,0,540
68950,180,160,120,160,320,0,940
68951,200,160,120,80,160,0,720
68952,220,200,200,80,160,0,860
68953,240,120,80,160,320,320,1240
68954,210,180,120,160,160,0,830
68955,220,140,160,240,160,0,920
68956,220,160,120,0,0,0,500
68957,210,100,80,0,0,0,390
68958,210,140,160,80,160,0,750
68959,180,100,120,160,160,320,1040
68960,170,120,160,160,320,320,1250
68961,250,60,40,80,160,0,590
68962,220,200,160,240,160,0,980
68963,200,180,240,160,160,320,1260
68964,170,60,0,0,0,0,230
68965,190,160,80,80,160,0,670
68966,190,80,40,0,0,0,310
68967,190,140,120,160,160,0,770
68968,190,160,80,160,320,0,910
68969,180,120,160,160,320,0,940
68970,200,120,120,80,0,0,520
68971,210,160,80,80,160,0,690
68972,210,100,80,0,0,0,390
68973,180,100,120,160,160,0,720
68974,240,180,120,80,0,0,620
68975,260,80,80,0,0,0,420
68976,170,100,80,80,160,0,590
68977,190,180,80,80,0,0,530
68978,220,80,40,80,160,0,580
68979,200,80,80,0,0,0,360
68980,250,140,120,160,160,0,830
68981,210,140,160,240,160,0,910
68982,230,180,80,80,160,0,730
68983,230,220,160,160,0,0,770
68984,180,100,40,80,160,0,560
68985,210,140,160,240,160,0,910
68986,220,120,120,160,0,0,620
68987,250,120,40,80,160,0,650
68988,210,100,40,80,160,0,590
68989,210,140,80,80,0,0,510
68990,190,100,40,80,160,0,570
68991,190,160,120,80,0,0,550
68992,190,100,80,160,0,0,530
68993,190,80,120,160,320,0,870
68994,170,80,80,0,0,0,330
68995,210,140,200,240,160,0,950
68996,220,140,160,80,160,0,760
68997,220,100,80,160,160,0,720
68998,220,140,120,160,320,0,960
68999,210,80,80,160,160,0,690
69000,210,100,80,160,160,0,710
69001,160,140,160,240,320,320,1340
69002,160,140,120,160,320,0,900
69003,210,180,120,80,160,0,750
69004,220,120,40,0,0,0,380
69005,190,80,160,160,160,320,1070
69006,210,140,120,160,160,320,1110
69007,170,120,80,160,160,320,1010
69008,210,60,40,80,0,0,390
69009,200,100,120,160,320,320,1220
69010,230,140,160,160,160,0,850
69011,170,80,120,160,320,0,850
69012,210,80,40,80,0,0,410
69013,230,180,160,80,0,0,650
69014,180,120,120,80,0,0,500
69015,210,120,120,160,160,0,770
69016,200,100,80,80,160,0,620
69017,210,140,160,160,160,0,830
69018,190,80,80,80,0,0,430
69019,190,140,80,80,160,0,650
69020,230,120,120,80,160,0,710
69021,200,140,120,160,0,0,620
69022,220,120,40,80,160,0,620
69023,130,100,80,160,320,320,1110
69024,200,120,160,80,0,0,560
69025,200,120,80,80,160,0,640
69026,210,120,80,0,0,0,410
69027,220,140,40,80,160,0,640
69028,230,120,120,80,160,0,710
69029,210,120,80,80,0,0,490
69030,180,60,40,80,160,0,520
69031,210,160,40,80,160,320,970
69032,190,120,200,160,160,0,830
69033,180,180,160,160,160,0,840
69034,250,140,80,0,0,0,470
69035,180,140,80,80,160,0,640
69036,240,140,160,80,0,0,620
69037,220,120,160,240,320,320,1380
69038,230,80,80,0,0,0,390
69039,180,60,120,0,0,0,360
69040,190,100,120,80,160,0,650
69041,220,140,120,160,320,0,960
69042,210,180,160,80,160,0,790
69043,180,60,40,0,0,0,280
69044,180,120,80,80,160,0,620
69045,200,120,120,160,160,0,760
69046,150,120,120,160,320,0,870
69047,160,180,160,80,0,0,580
69048,190,60,40,80,0,0,370
69049,190,100,80,80,0,0,450
69050,190,100,80,80,160,0,610
69051,150,100,40,0,0,0,290
69052,200,60,80,80,0,0,420
69053,140,80,160,160,160,0,700
69054,220,160,120,80,160,320,1060
69055,220,80,40,0,0,0,340
69056,180,100,120,160,160,0,720
69057,210,120,200,160,320,320,1330
69058,210,120,160,0,0,0,490
69059,200,140,80,160,0,0,580
69060,220,140,120,0,0,0,480
69061,200,120,120,80,0,0,520
69062,210,80,40,80,160,0,570
69063,210,140,80,80,160,0,670
69064,200,120,200,160,160,320,1160
69065,210,100,120,160,320,320,1230
69066,200,40,0,0,0,0,240
69067,210,120,120,80,0,0,530
69068,170,140,200,240,160,320,1230
69069,170,120,120,160,320,0,890
69070,230,160,120,240,160,0,910
69071,190,120,80,80,0,0,470
69072,240,200,200,160,0,0,800
69073,170,120,0,0,0,0,290
69074,250,140,80,0,0,0,470
69075,200,120,120,160,160,0,760
69076,220,80,80,80,160,0,620
69077,170,80,80,80,160,0,570
69078,190,160,240,240,160,0,990
69079,190,100,80,80,0,0,450
69080,200,160,200,240,320,0,1120
69081,190,80,80,160,160,0,670
69082,190,120,160,160,160,320,1110
69083,220,160,160,160,160,0,860
69084,200,120,120,160,160,0,760
69085,240,140,80,160,160,0,780
69086,200,160,160,80,160,0,760
69087,230,160,80,80,0,0,550
69088,180,140,160,80,0,0,560
69089,210,120,120,240,160,0,850
69090,190,160,120,160,320,320,1270
69091,190,100,160,160,160,320,1090
69092,160,80,120,80,0,0,440
69093,200,160,120,0,0,0,480
69094,200,100,80,0,0,0,380
69095,180,140,160,160,160,0,800
69096,190,180,160,160,160,0,850
69097,200,180,80,80,0,0,540
69098,220,160,120,80,160,0,740
69099,180,140,160,160,160,0,800
69100,170,100,160,240,320,0,990
69101,190,120,80,160,160,320,1030
69102,180,160,160,240,160,0,900
69103,210,160,200,160,160,0,890
69104,190,160,80,0,0,0,430
69105,180,140,120,160,0,0,600
69106,200,140,80,80,0,0,500
69107,180,140,200,240,320,320,1400
69108,180,80,120,80,0,0,460
69109,250,140,160,240,320,0,1110
69110,180,100,80,80,160,0,600
69111,160,140,120,80,0,0,500
69112,210,200,80,80,0,0,570
69113,210,120,80,80,160,320,970
69114,210,200,40,80,0,0,530
69115,230,80,120,80,160,0,670
69116,230,200,160,160,320,320,1390
69117,200,140,120,80,0,0,540
69118,200,120,120,160,0,0,600
69119,200,140,120,160,160,0,780
69120,210,80,80,160,160,0,690
69121,170,100,80,0,0,0,350
69122,240,140,120,160,160,320,1140
69123,200,120,120,160,320,320,1240
69124,180,120,80,80,0,0,460
69125,220,200,120,240,160,320,1260
69126,150,60,80,80,0,0,370
69127,230,140,120,80,160,0,730
69128,130,100,80,160,160,0,630
69129,220,180,200,160,160,0,920
69130,190,140,80,80,160,0,650
69131,200,80,120,160,320,0,880
69132,210,100,40,80,160,0,590
69133,210,100,80,80,160,0,630
69134,200,120,80,80,160,0,640
69135,140,60,40,0,0,0,240
69136,190,120,80,80,0,0,470
69137,210,140,120,80,0,0,550
69138,210,80,80,160,320,0,850
69139,210,120,40,0,0,0,370
69140,250,120,120,160,160,320,1130
69141,180,140,80,80,160,0,640
69142,170,100,40,80,160,0,550
69143,180,100,80,80,160,0,600
69144,220,140,120,80,160,0,720
69145,200,140,120,80,160,320,1020
69146,210,100,80,160,160,0,710
69147,210,120,80,160,0,0,570
69148,200,80,40,80,160,0,560
69149,240,100,120,80,0,0,540
69150,190,160,120,80,160,0,710
69151,190,200,160,160,160,0,870
69152,220,100,0,0,0,0,320
69153,240,160,200,240,160,0,1000
69154,220,80,80,80,160,0,620
69155,220,120,120,80,160,0,700
69156,190,140,120,80,0,0,530
69157,190,160,80,0,0,0,430
69158,180,80,0,0,0,0,260
69159,200,100,40,0,0,0,340
69160,210,160,200,80,0,0,650
69161,180,80,120,80,160,0,620
69162,210,160,80,80,0,0,530
69163,180,140,160,160,0,0,640
69164,230,80,80,80,0,0,470
69165,200,160,120,80,160,0,720
69166,200,80,80,0,0,0,360
69167,190,80,80,160,0,0,510
69168,200,140,160,160,160,0,820
69169,180,120,80,80,0,0,460
69170,170,140,80,80,160,0,630
69171,200,140,120,0,0,0,460
69172,180,120,200,240,0,0,740
69173,220,100,160,160,320,320,1280
69174,210,120,160,160,0,0,650
69175,180,160,120,0,0,0,460
69176,200,60,120,160,160,0,700
69177,190,120,160,160,160,320,1110
69178,140,100,40,0,0,0,280
69179,220,120,80,80,0,0,500
69180,180,140,40,80,160,0,600
69181,160,120,40,80,160,0,560
69182,200,120,160,240,0,0,720
69183,210,120,120,0,0,0,450
69184,190,140,40,80,0,0,450
69185,200,120,80,0,0,0,400
69186,210,100,120,160,160,0,750
69187,210,120,80,80,0,0,490
69188,190,160,120,80,0,0,550
69189,210,100,80,80,160,0,630
69190,200,120,120,240,160,0,840
69191,220,160,160,160,160,0,860
69192,160,140,160,80,160,0,700
69193,200,200,120,80,0,0,600
69194,220,120,120,160,160,0,780
69195,220,200,160,240,160,0,980
69196,180,80,40,80,0,0,380
69197,180,180,120,80,0,0,560
69198,170,180,160,0,0,0,510
69199,140,120,40,0,0,0,300
69200,200,140,80,80,0,0,500
69201,200,140,120,80,160,0,700
69202,180,100,40,80,0,0,400
69203,180,140,160,160,320,320,1280
69204,160,140,160,80,160,0,700
69205,230,100,80,80,0,0,490
69206,190,140,120,160,320,0,930
69207,260,160,240,80,0,0,740
69208,210,160,120,80,160,0,730
69209,190,160,200,160,0,0,710
69210,220,180,160,160,0,0,720
69211,220,60,120,80,160,0,640
69212,200,100,80,80,0,0,460
69213,180,100,40,0,0,0,320
69214,200,140,80,0,0,0,420
69215,200,180,120,160,0,0,660
69216,200,120,120,160,160,320,1080
69217,190,40,80,160,160,0,630
69218,210,120,80,80,160,0,650
69219,180,160,120,160,320,0,940
69220,180,100,80,80,160,0,600
69221,210,120,80,0,0,0,410
69222,160,100,120,160,160,0,700
69223,200,180,80,80,160,0,700
69224,200,120,120,80,0,0,520
69225,230,140,80,160,0,0,610
69226,240,180,160,160,160,0,900
69227,180,100,200,80,0,0,560
69228,210,180,120,80,0,0,590
69229,220,120,80,80,160,320,980
69230,200,160,80,160,160,320,1080
69231,210,140,80,80,160,0,670
69232,240,60,120,160,320,0,900
69233,170,100,80,80,160,0,590
69234,200,120,120,240,160,0,840
69235,190,140,160,160,0,0,650
69236,200,120,120,160,160,0,760
69237,190,120,120,80,0,0,510
69238,170,140,160,160,160,0,790
69239,230,120,160,160,160,0,830
69240,230,140,40,80,160,320,970
69241,220,140,160,0,0,0,520
69242,200,100,80,160,320,320,1180
69243,200,160,200,80,0,0,640
69244,200,60,40,0,0,0,300
69245,160,100,120,80,0,0,460
69246,190,180,160,80,0,0,610
69247,200,100,120,80,0,0,500
69248,210,120,120,80,160,0,690
69249,180,140,80,80,160,0,640
69250,180,120,80,0,0,0,380
69251,230,120,200,80,0,0,630
69252,160,100,160,160,160,0,740
69253,200,160,200,80,160,0,800
69254,150,120,160,240,320,0,990
69255,170,100,120,80,160,0,630
69256,140,60,80,80,160,320,840
69257,210,140,160,160,160,0,830
69258,210,80,80,80,160,0,610
69259,220,140,120,160,160,320,1120
69260,180,120,160,80,0,0,540
69261,200,120,160,80,0,0,560
69262,170,120,160,80,0,0,530
69263,210,100,120,80,0,0,510
69264,230,160,200,80,160,0,830
69265,190,180,120,160,320,0,970
69266,230,160,200,160,320,0,1070
69267,160,60,120,80,160,0,580
69268,220,160,80,160,160,0,780
69269,210,80,80,160,160,0,690
69270,190,140,120,160,160,320,1090
69271,160,140,80,80,160,320,940
69272,240,20,40,80,160,0,540
69273,180,120,120,80,160,0,660
69274,230,160,120,240,160,320,1230
69275,140,120,160,160,160,0,740
69276,250,160,120,80,160,320,1090
69277,230,160,120,80,160,0,750
69278,140,120,160,80,160,0,660
69279,190,100,120,160,160,0,730
69280,170,80,120,160,320,0,850
69281,180,80,120,160,160,0,700
69282,200,120,80,80,160,0,640
69283,200,160,80,0,0,0,440
69284,160,100,80,160,320,0,820
69285,170,120,40,0,0,0,330
69286,230,100,160,240,160,0,890
69287,210,100,80,80,160,0,630
69288,190,100,160,160,160,320,1090
69289,220,140,120,160,320,320,1280
69290,210,100,0,0,0,0,310
69291,250,100,120,160,320,0,950
69292,200,120,80,80,160,0,640
69293,190,100,80,80,0,0,450
69294,200,100,120,160,160,0,740
69295,220,140,200,160,0,0,720
69296,190,160,120,160,160,0,790
69297,180,160,160,160,0,0,660
69298,200,120,120,80,160,0,680
69299,180,140,120,0,0,0,440
69300,180,120,80,80,0,0,460
69301,180,120,80,80,160,0,620
69302,200,100,0,0,0,0,300
69303,210,100,80,0,0,0,390
69304,200,120,160,80,0,0,560
69305,160,100,120,160,320,320,1180
69306,180,120,80,80,160,0,620
69307,240,120,120,80,160,320,1040
69308,220,120,80,0,0,0,420
69309,200,140,160,160,0,0,660
69310,230,80,40,0,0,0,350
69311,230,160,160,0,0,0,550
69312,200,100,160,160,160,320,1100
69313,200,140,40,80,0,0,460
69314,170,100,80,160,160,320,990
69315,200,160,120,0,0,0,480
69316,210,100,120,160,160,0,750
69317,210,140,80,160,160,320,1070
69318,210,140,160,240,160,320,1230
69319,240,160,160,80,160,0,800
69320,220,180,160,240,160,0,960
69321,170,140,120,160,160,0,750
69322,220,100,120,160,160,0,760
69323,210,80,120,0,0,0,410
69324,210,100,80,80,0,0,470
69325,150,120,80,80,160,0,590
69326,190,120,80,80,160,0,630
69327,250,140,40,80,0,0,510
69328,220,80,40,80,160,0,580
69329,200,120,160,160,160,0,800
69330,180,160,120,0,0,0,460
69331,180,100,120,160,160,0,720
69332,180,80,80,160,160,320,980
69333,190,160,160,160,160,0,830
69334,190,60,0,0,0,0,250
69335,210,120,160,240,320,320,1370
69336,170,120,160,240,0,0,690
69337,180,140,80,0,0,0,400
69338,170,120,40,80,0,0,410
69339,190,200,200,240,160,0,990
69340,210,100,80,80,0,0,470
69341,180,140,160,240,160,0,880
69342,150,100,80,160,320,320,1130
69343,220,140,120,0,0,0,480
69344,170,140,120,80,160,0,670
69345,190,120,80,0,0,0,390
69346,190,120,120,160,160,0,750
69347,140,120,80,0,0,0,340
69348,200,140,120,160,160,0,780
69349,180,160,80,80,160,0,660
69350,190,60,0,0,0,0,250
69351,230,80,120,80,160,0,670
69352,210,140,80,0,0,0,430
69353,180,100,80,80,160,0,600
69354,200,100,120,160,320,0,900
69355,160,100,200,80,160,0,700
69356,190,120,120,80,0,0,510
69357,210,80,40,80,160,320,890
69358,220,100,80,80,160,0,640
69359,190,60,40,80,0,0,370
69360,160,80,0,0,0,0,240
69361,210,160,120,80,160,0,730
69362,230,120,40,0,0,0,390
69363,190,140,160,80,160,0,730
69364,230,160,120,80,0,0,590
69365,210,120,80,80,0,0,490
69366,190,80,40,80,160,0,550
69367,230,80,80,160,0,0,550
69368,250,120,80,80,160,0,690
69369,210,100,80,80,0,0,470
69370,180,100,40,80,160,320,880
69371,220,120,120,80,160,0,700
69372,210,100,80,80,160,0,630
69373,220,160,120,160,320,0,980
69374,220,140,200,0,0,0,560
69375,180,180,80,160,160,0,760
69376,200,140,160,160,320,320,1300
69377,200,180,80,80,160,320,1020
69378,190,100,0,0,0,0,290
69379,160,80,120,160,0,0,520
69380,210,100,80,0,0,0,390
69381,180,140,80,0,0,0,400
69382,180,140,160,80,0,0,560
69383,220,120,80,0,0,0,420
69384,210,120,80,80,160,0,650
69385,210,100,80,80,0,0,470
69386,180,180,160,160,320,0,1000
69387,180,120,80,80,0,0,460
69388,180,100,80,80,0,0,440
69389,210,160,160,80,160,0,770
69390,210,120,40,0,0,0,370
69391,160,100,40,0,0,0,300
69392,180,120,120,0,0,0,420
69393,170,120,0,0,0,0,290
69394,170,140,120,160,160,320,1070
69395,220,120,120,160,160,0,780
69396,220,100,40,0,0,0,360
69397,200,120,160,240,0,0,720
69398,150,100,80,80,160,0,570
69399,230,160,120,80,160,0,750
69400,180,100,160,80,0,0,520
69401,200,180,80,160,320,0,940
69402,150,100,160,160,320,0,890
69403,220,120,120,160,160,320,1100
69404,200,140,160,80,160,320,1060
69405,190,20,0,0,0,0,210
69406,190,100,120,80,160,0,650
69407,140,80,80,80,0,0,380
69408,160,160,200,160,320,0,1000
69409,220,120,120,160,160,0,780
69410,200,180,80,80,160,0,700
69411,200,100,80,80,160,0,620
69412,200,160,200,240,160,320,1280
69413,200,140,160,160,0,0,660
69414,200,120,160,80,160,0,720
69415,200,180,160,240,0,0,780
69416,210,120,120,80,0,0,530
69417,210,100,40,0,0,0,350
69418,210,140,80,80,160,320,990
69419,190,100,80,0,0,0,370
69420,170,120,80,0,0,0,370
69421,190,120,80,80,0,0,470
69422,200,180,120,0,0,0,500
69423,180,120,80,80,160,0,620
69424,190,100,80,80,0,0,450
69425,180,100,80,160,0,0,520
69426,220,160,160,160,320,0,1020
69427,160,120,120,80,160,0,640
69428,190,160,160,160,0,0,670
69429,180,140,40,80,0,0,440
69430,210,100,80,80,160,320,950
69431,220,180,120,160,0,0,680
69432,180,140,160,80,0,0,560
69433,180,120,120,80,160,0,660
69434,220,120,160,240,160,0,900
69435,190,140,240,160,160,0,890
69436,230,160,120,80,160,0,750
69437,210,100,80,0,0,0,390
69438,220,120,40,0,0,0,380
69439,210,160,160,80,160,0,770
69440,200,120,200,160,0,0,680
69441,190,120,120,0,0,0,430
69442,200,60,40,80,0,0,380
69443,220,200,120,160,160,0,860
69444,260,160,80,80,160,0,740
69445,220,180,160,80,0,0,640
69446,210,140,40,80,0,0,470
69447,170,120,120,80,160,0,650
69448,170,120,120,160,160,0,730
69449,160,180,160,160,160,0,820
69450,150,120,120,160,0,0,550
69451,160,140,0,0,0,0,300
69452,190,120,160,80,0,0,550
69453,160,120,160,160,320,320,1240
69454,190,120,160,160,160,0,790
69455,160,120,120,80,160,0,640
69456,190,140,80,0,0,0,410
69457,170,100,120,160,0,0,550
69458,180,80,80,160,160,0,660
69459,190,120,120,80,160,0,670
69460,210,140,0,0,0,0,350
69461,210,160,120,240,320,320,1370
69462,230,140,120,160,160,0,810
69463,180,160,120,160,160,0,780
69464,210,120,80,160,160,320,1050
69465,170,40,80,80,160,0,530
69466,180,120,120,160,0,0,580
69467,200,120,80,160,160,320,1040
69468,200,100,40,80,160,320,900
69469,180,120,40,80,160,0,580
69470,210,80,120,80,0,0,490
69471,190,160,80,80,160,320,990
69472,200,100,160,160,160,0,780
69473,190,160,160,80,0,0,590
69474,180,100,120,160,320,0,880
69475,210,140,80,80,160,0,670
69476,180,140,120,80,160,0,680
69477,170,100,160,160,320,0,910
69478,180,100,80,0,0,0,360
69479,200,140,160,80,160,320,1060
69480,190,140,80,160,0,0,570
69481,210,160,80,80,160,0,690
69482,220,100,120,160,160,0,760
69483,210,140,40,80,160,0,630
69484,200,100,80,0,0,0,380
69485,210,160,200,80,0,0,650
69486,200,80,80,160,0,0,520
69487,220,160,120,80,160,0,740
69488,210,140,160,240,160,0,910
69489,210,60,0,0,0,0,270
69490,140,140,120,160,160,0,720
69491,170,100,80,80,160,0,590
69492,210,180,240,240,320,0,1190
69493,180,60,80,80,160,0,560
69494,220,120,80,160,160,0,740
69495,130,60,80,160,160,320,910
69496,190,100,120,80,0,0,490
69497,150,120,120,80,160,0,630
69498,170,60,80,0,0,0,310
69499,210,100,0,0,0,0,310
69500,230,200,200,160,160,320,1270
69501,200,120,120,80,0,0,520
69502,250,200,120,240,320,0,1130
69503,190,180,200,160,160,0,890
69504,160,100,40,0,0,0,300
69505,260,140,120,160,160,0,840
69506,230,180,80,80,160,0,730
69507,170,80,120,80,160,0,610
69508,260,160,80,160,160,0,820
69509,200,120,80,80,160,320,960
69510,210,160,80,80,160,0,690
69511,180,160,120,80,0,0,540
69512,170,160,200,160,160,0,850
69513,190,100,0,0,0,0,290
69514,180,140,160,80,160,0,720
69515,210,160,120,160,320,0,970
69516,170,100,80,160,320,320,1150
69517,220,60,40,0,0,0,320
69518,190,140,40,0,0,0,370
69519,200,100,120,80,0,0,500
69520,150,120,120,160,320,0,870
69521,180,100,80,160,0,0,520
69522,200,160,120,160,160,0,800
69523,150,140,80,80,160,0,610
69524,200,100,0,0,0,0,300
69525,230,120,160,240,320,0,1070
69526,230,100,40,80,0,0,450
69527,200,180,200,160,160,0,900
69528,150,80,40,80,160,0,510
69529,200,80,40,0,0,0,320
69530,190,160,160,160,0,0,670
69531,180,80,40,80,160,320,860
69532,190,100,120,160,0,0,570
69533,220,140,160,240,0,0,760
69534,210,140,120,80,0,0,550
69535,170,100,80,160,0,0,510
69536,190,140,80,160,160,0,730
69537,220,160,240,240,160,0,1020
69538,200,120,120,80,0,0,520
69539,170,140,160,160,160,0,790
69540,190,120,40,0,0,0,350
69541,210,40,80,0,0,0,330
69542,190,120,160,240,320,320,1350
69543,190,120,120,160,320,0,910
69544,230,140,120,160,160,0,810
69545,210,100,80,0,0,0,390
69546,220,120,120,160,160,0,780
69547,180,100,80,160,160,0,680
69548,190,100,80,0,0,0,370
69549,180,140,80,80,160,0,640
69550,190,160,120,160,320,0,950
69551,200,180,200,160,320,0,1060
69552,190,140,200,240,160,0,930
69553,210,180,80,80,160,0,710
69554,180,140,200,160,320,320,1320
69555,170,100,80,0,0,0,350
69556,180,80,40,80,160,0,540
69557,200,60,80,80,0,0,420
69558,240,120,160,160,0,0,680
69559,180,100,160,160,320,0,920
69560,190,120,80,80,160,0,630
69561,170,60,80,80,160,0,550
69562,170,80,120,160,0,0,530
69563,210,120,40,0,0,0,370
69564,210,100,40,80,160,0,590
69565,190,120,80,80,0,0,470
69566,210,200,80,80,160,0,730
69567,200,120,80,160,160,0,720
69568,170,40,40,0,0,0,250
69569,200,120,80,160,0,0,560
69570,160,140,120,80,0,0,500
69571,170,160,160,160,320,320,1290
69572,220,140,120,80,160,0,720
69573,190,120,160,240,320,0,1030
69574,180,140,80,80,160,0,640
69575,230,180,160,80,160,320,1130
69576,150,80,80,160,0,0,470
69577,160,100,0,0,0,0,260
69578,200,120,80,0,0,0,400
69579,220,140,160,160,160,0,840
69580,180,120,120,80,160,0,660
69581,180,140,160,80,0,0,560
69582,160,40,0,0,0,0,200
69583,210,80,80,80,160,320,930
69584,190,80,160,160,0,0,590
69585,190,140,80,80,0,0,490
69586,210,120,80,80,160,0,650
69587,210,100,40,0,0,0,350
69588,190,120,120,80,0,0,510
69589,250,160,80,0,0,0,490
69590,180,160,0,0,0,0,340
69591,170,80,0,0,0,0,250
69592,240,140,80,0,0,0,460
69593,160,140,120,80,160,0,660
69594,170,120,160,160,160,0,770
69595,200,100,40,80,0,0,420
69596,200,160,120,80,160,0,720
69597,170,120,120,160,320,0,890
69598,210,180,200,80,0,0,670
69599,180,100,80,80,160,320,920
69600,200,100,80,80,160,0,620
69601,210,80,120,80,0,0,490
69602,170,80,160,160,320,320,1210
69603,200,80,80,0,0,0,360
69604,160,120,120,80,160,0,640
69605,200,200,160,80,160,0,800
69606,190,120,80,80,160,320,950
69607,150,160,200,160,160,0,830
69608,200,160,120,160,160,0,800
69609,180,40,80,80,0,0,380
69610,220,120,120,160,320,320,1260
69611,170,180,160,80,160,0,750
69612,210,120,160,160,160,320,1130
69613,190,160,160,160,160,320,1150
69614,190,100,120,160,160,0,730
69615,230,120,40,0,0,0,390
69616,230,120,120,160,160,0,790
69617,230,120,80,80,160,0,670
69618,190,120,120,80,160,0,670
69619,200,100,80,80,160,0,620
69620,210,100,80,0,0,0,390
69621,210,140,120,160,160,0,790
69622,180,140,120,160,160,0,760
69623,230,140,40,80,160,320,970
69624,180,120,120,160,160,0,740
69625,180,120,120,80,160,0,660
69626,180,140,80,160,160,0,720
69627,200,140,80,80,160,0,660
69628,180,160,160,80,160,0,740
69629,210,120,120,160,320,320,1250
69630,180,60,40,80,160,320,840
69631,190,120,80,80,0,0,470
69632,170,80,80,0,0,0,330
69633,220,140,40,80,0,0,480
69634,130,100,160,240,160,0,790
69635,200,100,160,160,160,320,1100
69636,230,180,80,0,0,0,490
69637,160,100,40,80,0,0,380
69638,230,160,160,160,160,320,1190
69639,210,140,80,0,0,0,430
69640,180,120,120,160,0,0,580
69641,160,160,40,80,160,0,600
69642,180,120,120,160,160,0,740
69643,150,100,160,160,160,0,730
69644,170,100,120,240,320,320,1270
69645,210,160,40,80,160,0,650
69646,200,120,80,80,160,0,640
69647,200,180,120,80,160,0,740
69648,140,120,120,80,0,0,460
69649,170,120,120,160,320,320,1210
69650,210,200,160,160,160,0,890
69651,220,120,80,0,0,0,420
69652,170,20,40,80,0,0,310
69653,160,120,160,0,0,0,440
69654,200,80,80,80,160,0,600
69655,230,120,160,240,320,0,1070
69656,230,140,120,160,0,0,650
69657,190,100,120,80,160,0,650
69658,170,100,120,160,160,0,710
69659,200,140,120,160,160,0,780
69660,220,100,80,80,160,320,960
69661,200,200,160,160,160,320,1200
69662,230,160,200,80,160,320,1150
69663,180,140,80,80,160,0,640
69664,230,140,120,80,160,0,730
69665,190,100,80,80,0,0,450
69666,220,120,160,160,320,320,1300
69667,170,160,160,240,160,0,890
69668,200,40,40,80,160,0,520
69669,190,100,160,160,0,0,610
69670,200,160,40,80,0,0,480
69671,150,100,80,80,160,0,570
69672,220,100,80,0,0,0,400
69673,180,140,80,0,0,0,400
69674,200,100,160,160,0,0,620
69675,190,160,120,80,160,0,710
69676,200,140,160,80,160,320,1060
69677,180,140,120,240,160,320,1160
69678,180,120,120,0,0,0,420
69679,200,140,160,160,160,0,820
69680,180,120,160,240,320,0,1020
69681,220,160,120,160,160,0,820
69682,170,200,200,160,0,0,730
69683,180,120,80,80,160,0,620
69684,240,180,120,160,320,0,1020
69685,210,160,40,80,160,320,970
69686,180,100,120,240,160,0,800
69687,180,120,120,80,0,0,500
69688,200,160,40,80,160,0,640
69689,230,100,80,80,0,0,490
69690,220,140,80,80,0,0,520
69691,210,120,120,160,160,0,770
69692,180,140,80,80,160,0,640
69693,210,80,40,80,0,0,410
69694,200,60,40,0,0,0,300
69695,210,140,80,0,0,0,430
69696,220,140,80,80,0,0,520
69697,190,100,40,0,0,0,330
69698,160,160,120,160,160,0,760
69699,220,180,120,160,320,0,1000
69700,230,140,80,80,160,0,690
69701,190,140,120,80,0,0,530
69702,210,180,120,0,0,0,510
69703,200,160,120,160,160,0,800
69704,170,120,80,0,0,0,370
69705,220,100,80,80,0,0,480
69706,210,120,0,0,0,0,330
69707,180,140,160,160,0,0,640
69708,160,160,120,80,160,320,1000
69709,220,160,120,80,0,0,580
69710,190,140,160,240,160,0,890
69711,230,140,80,80,0,0,530
69712,170,80,80,160,160,0,650
69713,150,120,160,160,160,0,750
69714,200,80,80,80,0,0,440
69715,190,120,80,80,160,0,630
69716,220,120,40,80,160,0,620
69717,240,120,120,160,160,0,800
69718,240,140,160,160,160,0,860
69719,160,120,120,160,320,0,880
69720,180,80,80,0,0,0,340
69721,200,140,120,80,0,0,540
69722,190,100,120,80,160,0,650
69723,180,140,80,160,320,0,880
69724,160,120,120,160,320,0,880
69725,220,220,120,80,160,0,800
69726,210,80,0,0,0,0,290
69727,180,100,120,80,160,0,640
69728,150,100,120,160,320,320,1170
69729,230,200,160,80,0,0,670
69730,200,160,120,80,0,0,560
69731,180,120,120,80,160,0,660
69732,200,120,40,80,0,0,440
69733,230,140,160,160,0,0,690
69734,190,140,120,80,160,320,1010
69735,220,180,160,80,160,0,800
69736,200,140,120,80,0,0,540
69737,210,180,40,80,0,0,510
69738,190,160,160,0,0,0,510
69739,180,120,120,160,320,0,900
69740,160,120,160,160,320,320,1240
69741,180,120,80,80,160,0,620
69742,230,180,120,160,160,0,850
69743,200,160,120,160,160,0,800
69744,210,140,40,0,0,0,390
69745,210,140,160,160,160,0,830
69746,190,120,120,0,0,0,430
69747,210,120,120,160,0,0,610
69748,160,100,80,0,0,0,340
69749,190,140,120,0,0,0,450
69750,150,120,120,80,160,320,950
69751,200,120,80,80,0,0,480
69752,190,160,80,80,160,0,670
69753,230,140,120,160,160,0,810
69754,160,100,120,160,320,0,860
69755,220,160,40,80,160,0,660
69756,210,100,80,160,320,320,1190
69757,190,100,120,160,160,0,730
69758,240,140,120,160,160,0,820
69759,210,160,160,80,0,0,610
69760,190,140,120,80,160,0,690
69761,180,120,120,0,0,0,420
69762,220,100,80,0,0,0,400
69763,260,120,80,80,0,0,540
69764,220,140,80,80,160,0,680
69765,190,120,120,80,160,0,670
69766,210,140,120,80,0,0,550
69767,250,160,120,160,160,0,850
69768,200,180,160,80,160,0,780
69769,200,100,40,80,0,0,420
69770,200,180,120,160,160,0,820
69771,160,60,40,0,0,0,260
69772,180,120,80,160,160,0,700
69773,170,80,80,80,160,0,570
69774,220,120,40,80,0,0,460
69775,220,120,160,160,160,0,820
69776,210,120,200,160,160,0,850
69777,200,120,120,160,160,0,760
69778,210,120,80,160,320,0,890
69779,210,120,120,160,320,0,930
69780,210,60,80,80,160,0,590
69781,170,120,120,160,160,0,730
69782,220,160,80,80,0,0,540
69783,190,100,80,80,0,0,450
69784,200,120,80,0,0,0,400
69785,200,140,120,80,160,0,700
69786,210,140,120,240,320,0,1030
69787,160,100,40,80,160,0,540
69788,210,180,160,160,160,0,870
69789,190,120,40,80,0,0,430
69790,210,140,120,80,160,0,710
69791,170,120,160,80,160,0,690
69792,220,140,160,160,160,0,840
69793,210,160,200,160,160,0,890
69794,170,140,200,0,0,0,510
69795,240,140,160,80,160,0,780
69796,170,80,40,0,0,0,290
69797,200,100,40,80,0,0,420
69798,200,200,160,160,0,0,720
69799,210,120,80,80,160,0,650
69800,220,80,0,0,0,0,300
69801,200,140,160,160,0,0,660
69802,230,140,120,160,160,0,810
69803,200,100,80,0,0,0,380
69804,200,60,40,0,0,0,300
69805,200,120,120,80,160,0,680
69806,200,160,200,160,160,0,880
69807,220,120,160,80,160,0,740
69808,230,140,160,0,0,0,530
69809,150,140,80,160,160,0,690
69810,230,100,40,0,0,0,370
69811,210,160,160,80,0,0,610
69812,230,160,0,0,0,0,390
69813,190,80,120,240,0,0,630
69814,220,140,160,160,320,320,1320
69815,190,120,80,80,0,0,470
69816,220,100,120,160,320,0,920
69817,230,180,80,0,0,0,490
69818,190,80,40,80,0,0,390
69819,190,180,80,160,0,0,610
69820,210,200,200,240,0,0,850
69821,140,100,80,80,160,0,560
69822,190,180,120,80,0,0,570
69823,170,80,80,160,160,0,650
69824,220,120,80,80,0,0,500
69825,200,60,40,80,160,0,540
69826,200,100,120,80,160,0,660
69827,240,160,80,160,160,0,800
69828,190,100,120,160,320,0,890
69829,200,120,80,80,0,0,480
69830,200,120,120,160,160,0,760
69831,180,100,80,80,160,0,600
69832,200,140,120,80,0,0,540
69833,220,100,80,80,160,0,640
69834,190,100,80,80,160,0,610
69835,210,140,80,0,0,0,430
69836,160,140,40,0,0,0,340
69837,220,100,80,80,0,0,480
69838,220,160,80,80,160,0,700
69839,250,140,120,80,160,0,750
69840,210,180,120,160,160,0,830
69841,180,80,120,80,160,0,620
69842,210,120,80,80,0,0,490
69843,240,180,160,80,160,0,820
69844,200,120,120,80,160,0,680
69845,250,160,120,80,0,0,610
69846,180,180,80,160,160,0,760
69847,190,100,80,160,0,0,530
69848,180,120,120,80,0,0,500
69849,220,120,120,160,160,0,780
69850,170,120,120,80,160,0,650
69851,190,120,80,160,160,0,710
69852,230,120,160,80,160,0,750
69853,190,100,0,0,0,0,290
69854,170,100,40,80,160,0,550
69855,220,200,80,80,0,0,580
69856,210,140,80,80,160,320,990
69857,150,120,160,0,0,0,430
69858,160,100,80,80,0,0,420
69859,210,120,120,160,160,0,770
69860,220,120,120,80,160,320,1020
69861,190,100,80,80,0,0,450
69862,220,100,40,0,0,0,360
69863,210,160,120,0,0,0,490
69864,180,140,120,160,160,0,760
69865,210,180,160,160,160,0,870
69866,200,140,80,80,160,320,980
69867,200,120,120,160,160,0,760
69868,200,120,120,80,160,0,680
69869,210,100,120,160,320,0,910
69870,220,140,160,240,160,0,920
69871,220,100,80,80,160,0,640
69872,180,40,40,80,160,320,820
69873,180,140,120,80,0,0,520
69874,140,100,80,80,160,0,560
69875,200,80,80,80,0,0,440
69876,200,100,120,80,0,0,500
69877,160,120,160,80,160,0,680
69878,220,140,80,80,160,0,680
69879,220,120,80,80,0,0,500
69880,160,140,160,240,160,0,860
69881,170,100,80,160,0,0,510
69882,200,120,80,0,0,0,400
69883,170,100,120,160,320,320,1190
69884,240,160,80,0,0,0,480
69885,220,160,120,160,320,0,980
69886,200,120,160,240,160,0,880
69887,170,20,40,80,160,320,790
69888,210,100,80,0,0,0,390
69889,200,120,80,80,160,320,960
69890,210,120,160,160,320,0,970
69891,210,100,120,160,0,0,590
69892,190,80,40,0,0,0,310
69893,180,100,120,160,320,0,880
69894,210,120,160,160,160,0,810
69895,200,100,80,0,0,0,380
69896,190,80,120,80,0,0,470
69897,220,100,40,80,160,0,600
69898,220,160,160,160,320,0,1020
69899,180,140,120,240,320,0,1000
69900,180,160,200,80,0,0,620
69901,220,140,120,80,0,0,560
69902,200,100,80,80,0,0,460
69903,230,120,80,0,0,0,430
69904,180,60,80,80,160,0,560
69905,190,180,160,320,320,320,1490
69906,170,120,80,80,160,0,610
69907,200,120,160,0,0,0,480
69908,200,160,80,0,0,0,440
69909,200,120,80,80,0,0,480
69910,220,140,80,80,160,0,680
69911,230,160,80,160,160,0,790
69912,220,80,40,0,0,0,340
69913,190,80,40,80,0,0,390
69914,190,100,80,80,0,0,450
69915,210,120,40,80,0,0,450
69916,190,200,160,80,160,320,1110
69917,170,100,80,80,0,0,430
69918,190,80,80,160,320,0,830
69919,160,140,120,160,160,320,1060
69920,210,160,160,80,0,0,610
69921,200,140,120,240,320,0,1020
69922,210,80,80,80,160,320,930
69923,190,160,120,160,0,0,630
69924,210,180,120,80,160,320,1070
69925,180,120,0,0,0,0,300
69926,160,100,80,80,160,0,580
69927,180,100,120,80,160,0,640
69928,230,140,160,160,320,0,1010
69929,190,80,160,160,0,0,590
69930,220,100,80,80,160,0,640
69931,220,160,160,80,0,0,620
69932,220,80,120,80,160,0,660
69933,180,140,200,0,0,0,520
69934,240,180,80,80,160,0,740
69935,190,180,80,80,160,0,690
69936,150,120,80,80,160,0,590
69937,240,140,160,80,0,0,620
69938,180,120,160,160,160,0,780
69939,160,180,200,0,0,0,540
69940,180,80,40,0,0,0,300
69941,220,140,80,160,320,0,920
69942,210,120,120,160,160,320,1090
69943,180,120,40,0,0,0,340
69944,210,160,160,160,160,0,850
69945,230,140,160,160,160,0,850
69946,190,100,80,80,160,0,610
69947,240,160,80,80,0,0,560
69948,190,140,120,240,320,0,1010
69949,240,120,160,240,320,320,1400
69950,190,80,80,80,0,0,430
69951,200,140,80,160,160,0,740
69952,190,100,80,80,160,0,610
69953,200,160,160,80,0,0,600
69954,190,100,80,160,160,0,690
69955,210,140,80,160,0,0,590
69956,210,80,40,0,0,0,330
69957,160,140,160,80,160,0,700
69958,190,140,80,160,160,0,730
69959,190,80,80,0,0,0,350
69960,180,160,80,0,0,0,420
69961,220,100,120,160,320,0,920
69962,170,100,120,0,0,0,390
69963,170,120,120,80,0,0,490
69964,210,120,120,160,160,0,770
69965,160,100,80,80,160,0,580
69966,200,80,160,80,0,0,520
69967,190,140,160,80,160,0,730
69968,230,160,200,160,160,0,910
69969,170,120,80,0,0,0,370
69970,190,80,80,80,0,0,430
69971,190,40,40,80,160,0,510
69972,160,120,80,80,160,0,600
69973,160,120,160,80,0,0,520
69974,210,120,80,0,0,0,410
69975,220,160,80,0,0,0,460
69976,210,180,120,80,160,320,1070
69977,210,120,80,0,0,0,410
69978,190,80,80,80,160,0,590
69979,150,160,200,80,160,0,750
69980,160,120,80,80,0,0,440
69981,200,100,120,160,160,0,740
69982,220,100,120,160,0,0,600
69983,170,120,120,80,160,0,650
69984,180,100,120,80,160,0,640
69985,190,100,160,240,160,320,1170
69986,220,140,80,80,0,0,520
69987,170,120,120,160,160,0,730
69988,200,140,80,80,160,0,660
69989,190,120,120,0,0,0,430
69990,190,140,200,80,160,0,770
69991,200,100,80,80,160,0,620
69992,180,100,80,80,160,0,600
69993,190,120,40,0,0,0,350
69994,230,120,200,80,0,0,630
69995,210,120,120,160,0,0,610
69996,170,80,80,160,320,320,1130
69997,180,60,40,80,0,0,360
69998,210,140,80,160,160,0,750
69999,200,160,200,80,160,0,800
70000,160,120,160,160,0,0,600
70001,180,100,120,160,320,320,1200
70002,140,140,80,80,160,320,920
70003,200,100,80,160,160,0,700
70004,200,100,40,0,0,0,340
70005,180,100,120,80,160,0,640
70006,160,160,80,0,0,0,400
70007,200,180,240,160,0,0,780
70008,220,120,80,160,160,0,740
70009,200,160,160,240,320,0,1080
70010,190,80,160,160,0,0,590
70011,240,140,80,0,0,0,460
70012,150,120,120,160,160,0,710
70013,180,80,40,0,0,0,300
70014,190,140,80,160,320,320,1210
70015,220,180,200,160,0,0,760
70016,230,160,80,0,0,0,470
70017,210,140,120,240,320,320,1350
70018,210,100,120,80,160,0,670
70019,190,120,80,80,160,0,630
70020,170,100,40,80,0,0,390
70021,180,120,120,160,160,0,740
70022,180,120,80,80,160,0,620
70023,160,120,40,0,0,0,320
70024,210,160,120,80,160,0,730
70025,230,100,80,0,0,0,410
70026,200,160,160,80,160,0,760
70027,170,120,80,160,320,320,1170
70028,210,140,160,80,160,0,750
70029,210,60,120,160,160,0,710
70030,200,120,80,0,0,0,400
70031,210,100,80,80,160,0,630
70032,220,120,160,80,0,0,580
70033,210,100,80,160,160,0,710
70034,180,120,200,0,0,0,500
70035,230,160,120,80,160,0,750
70036,210,160,160,80,0,0,610
70037,220,160,120,80,0,0,580
70038,200,140,120,80,0,0,540
70039,180,120,160,160,0,0,620
70040,190,100,120,80,0,0,490
70041,230,120,80,80,0,0,510
70042,150,140,120,160,320,0,890
70043,220,120,120,80,160,0,700
70044,180,60,40,0,0,0,280
70045,170,120,120,80,0,0,490
70046,170,140,120,160,160,0,750
70047,160,100,80,160,320,0,820
70048,180,100,120,160,0,0,560
70049,190,140,120,160,0,0,610
70050,240,160,200,240,320,0,1160
70051,200,120,120,240,160,0,840
70052,130,120,80,0,0,0,330
70053,210,100,80,80,0,0,470
70054,170,60,80,160,160,0,630
70055,220,120,80,80,160,0,660
70056,180,80,80,80,160,0,580
70057,170,80,80,80,160,0,570
70058,190,140,80,0,0,0,410
70059,210,120,80,0,0,0,410
70060,220,160,80,160,160,0,780
70061,200,120,160,160,160,320,1120
70062,160,100,120,160,320,320,1180
70063,170,100,120,240,320,0,950
70064,160,120,160,80,160,0,680
70065,160,100,40,0,0,0,300
70066,190,140,160,160,160,0,810
70067,190,100,200,80,160,0,730
70068,190,80,80,80,0,0,430
70069,220,120,160,80,160,0,740
70070,190,180,40,0,0,0,410
70071,180,120,160,240,160,320,1180
70072,210,140,160,0,0,0,510
70073,170,120,160,160,320,320,1250
70074,250,80,80,80,160,0,650
70075,220,160,160,160,320,0,1020
70076,220,120,40,80,0,0,460
70077,200,140,160,80,0,0,580
70078,150,120,160,80,160,0,670
70079,190,160,80,80,160,0,670
70080,260,80,80,80,160,0,660
70081,190,120,160,240,320,0,1030
70082,180,140,120,80,160,0,680
70083,190,120,40,80,0,0,430
70084,200,80,80,80,160,0,600
70085,210,80,80,160,160,0,690
70086,200,140,160,160,160,0,820
70087,140,120,160,160,160,0,740
70088,210,140,120,160,160,0,790
70089,210,100,160,240,320,320,1350
70090,170,140,80,0,0,0,390
70091,240,140,120,80,0,0,580
70092,230,160,80,80,160,0,710
70093,180,180,120,80,160,320,1040
70094,190,120,80,0,0,0,390
70095,190,100,120,160,160,0,730
70096,190,200,160,160,160,320,1190
70097,200,80,80,80,160,320,920
70098,220,160,160,160,160,0,860
70099,180,140,40,80,0,0,440
70100,160,120,80,80,160,0,600
70101,220,160,120,160,160,0,820
70102,210,60,80,0,0,0,350
70103,220,140,80,80,160,0,680
70104,180,100,0,0,0,0,280
70105,180,100,120,160,0,0,560
70106,190,160,120,240,0,0,710
70107,190,120,0,0,0,0,310
70108,190,140,120,160,160,0,770
70109,190,60,80,80,0,0,410
70110,170,60,40,0,0,0,270
70111,210,120,160,160,160,0,810
70112,170,80,80,80,160,0,570
70113,210,160,160,80,0,0,610
70114,190,120,160,0,0,0,470
70115,210,200,200,160,160,0,930
70116,240,220,120,80,160,0,820
70117,260,180,160,160,320,0,1080
70118,210,100,0,0,0,0,310
70119,180,140,120,80,160,0,680
70120,190,80,80,80,160,320,910
70121,230,120,120,80,160,0,710
70122,220,80,0,0,0,0,300
70123,210,140,160,80,160,0,750
70124,180,120,160,160,0,0,620
70125,180,140,80,80,160,0,640
70126,180,80,80,80,0,0,420
70127,180,120,80,80,0,0,460
70128,230,140,120,80,0,0,570
70129,180,160,120,160,160,320,1100
70130,190,140,120,160,160,0,770
70131,210,80,80,80,160,0,610
70132,240,100,120,80,0,0,540
70133,230,140,80,0,0,0,450
70134,180,140,80,0,0,0,400
70135,200,140,120,160,320,0,940
70136,200,200,160,160,160,320,1200
70137,140,100,80,80,0,0,400
70138,220,140,120,0,0,0,480
70139,210,160,120,0,0,0,490
70140,180,100,40,0,0,0,320
70141,240,100,120,160,160,0,780
70142,150,140,80,80,0,0,450
70143,250,180,120,160,160,0,870
70144,180,120,80,160,160,0,700
70145,180,120,120,160,160,0,740
70146,200,100,160,240,320,320,1340
70147,190,160,160,80,0,0,590
70148,190,120,80,80,160,0,630
70149,180,100,80,80,160,0,600
70150,180,140,160,80,160,0,720
70151,220,100,160,240,160,320,1200
70152,210,160,160,240,320,320,1410
70153,210,140,40,80,160,0,630
70154,180,120,120,0,0,0,420
70155,210,140,120,0,0,0,470
70156,190,160,80,0,0,0,430
70157,220,200,160,80,160,0,820
70158,170,140,160,160,320,0,950
70159,230,120,120,80,0,0,550
70160,180,80,80,80,160,0,580
70161,230,140,160,80,0,0,610
70162,210,140,120,160,0,0,630
70163,200,140,160,0,0,0,500
70164,190,100,120,80,160,0,650
70165,210,140,80,80,160,0,670
70166,180,120,120,80,160,320,980
70167,190,160,120,80,160,0,710
70168,240,120,160,160,160,0,840
70169,200,80,40,80,160,320,880
70170,200,180,160,240,160,0,940
70171,180,140,80,80,160,0,640
70172,180,80,0,0,0,0,260
70173,220,140,40,80,0,0,480
70174,180,140,160,160,160,0,800
70175,220,120,120,80,0,0,540
70176,210,60,80,0,0,0,350
70177,200,140,120,80,160,0,700
70178,180,80,120,0,0,0,380
70179,260,140,120,80,0,0,600
70180,180,100,80,160,0,0,520
70181,220,160,160,80,160,320,1100
70182,190,160,240,160,160,0,910
70183,180,160,160,160,160,0,820
70184,190,120,40,0,0,0,350
70185,210,160,120,80,160,0,730
70186,190,180,80,160,160,0,770
70187,180,140,80,80,160,0,640
70188,180,80,120,80,160,0,620
70189,230,100,120,160,160,320,1090
70190,220,220,0,0,0,0,440
70191,170,100,120,160,0,0,550
70192,200,120,80,80,160,0,640
70193,200,80,80,80,160,320,920
70194,190,160,160,160,320,0,990
70195,150,120,120,80,0,0,470
70196,170,140,200,160,160,0,830
70197,190,180,40,80,160,320,970
70198,230,120,80,160,0,0,590
70199,210,120,40,80,0,0,450
70200,210,140,80,0,0,0,430
70201,220,120,80,80,160,0,660
70202,200,100,80,160,160,0,700
70203,200,40,80,80,160,0,560
70204,210,120,120,80,160,0,690
70205,190,120,120,80,0,0,510
70206,150,100,120,160,0,0,530
70207,220,140,120,160,160,0,800
70208,230,140,120,240,160,320,1210
70209,210,100,120,80,0,0,510
70210,240,140,120,80,0,0,580
70211,180,120,160,160,160,0,780
70212,260,100,40,80,0,0,480
70213,200,120,120,80,160,0,680
70214,170,180,160,80,160,0,750
70215,210,180,120,240,160,320,1230
70216,180,140,120,160,320,0,920
70217,200,100,120,0,0,0,420
70218,180,100,120,160,0,0,560
70219,220,160,200,80,160,0,820
70220,180,60,40,0,0,0,280
70221,160,120,120,160,160,0,720
70222,230,100,80,80,0,0,490
70223,180,180,200,80,0,0,640
70224,200,60,40,0,0,0,300
70225,210,140,80,80,0,0,510
70226,190,80,40,0,0,0,310
70227,180,120,80,80,160,0,620
70228,210,120,40,80,160,320,930
70229,220,140,120,80,0,0,560
70230,240,140,160,160,160,320,1180
70231,170,100,40,80,160,320,870
70232,160,120,120,80,0,0,480
70233,170,120,120,80,160,0,650
70234,140,120,160,80,0,0,500
70235,180,80,40,0,0,0,300
70236,220,180,160,240,160,0,960
70237,180,120,160,160,320,0,940
70238,180,20,40,80,0,0,320
70239,210,160,160,80,0,0,610
70240,220,180,160,80,0,0,640
70241,200,80,160,80,160,0,680
70242,160,100,80,80,160,0,580
70243,180,100,80,0,0,0,360
70244,180,80,40,80,0,0,380
70245,160,140,120,240,320,0,980
70246,170,120,200,160,320,0,970
70247,200,80,80,160,320,0,840
70248,210,160,80,80,0,0,530
70249,210,100,40,80,0,0,430
70250,190,140,160,160,160,0,810
70251,190,140,120,160,160,0,770
70252,220,100,120,80,0,0,520
70253,180,140,120,80,160,0,680
70254,200,80,40,80,160,320,880
70255,200,100,160,80,0,0,540
70256,200,100,40,80,0,0,420
70257,190,120,80,160,160,0,710
70258,230,100,120,80,0,0,530
70259,220,140,160,160,160,320,1160
70260,190,60,0,0,0,0,250
70261,160,140,80,80,160,0,620
70262,210,120,160,160,160,0,810
70263,200,100,120,80,160,0,660
70264,160,40,0,0,0,0,200
70265,220,140,120,80,160,0,720
70266,180,100,80,80,0,0,440
70267,190,100,80,80,0,0,450
70268,190,80,80,80,160,0,590
70269,200,120,120,80,160,0,680
70270,170,160,40,80,160,0,610
70271,210,160,120,80,160,0,730
70272,190,100,120,160,160,0,730
70273,240,180,160,160,0,0,740
70274,240,160,80,80,0,0,560
70275,210,140,120,80,0,0,550
70276,200,160,120,160,160,320,1120
70277,200,80,80,80,0,0,440
70278,230,140,160,80,0,0,610
70279,200,120,80,80,0,0,480
70280,190,120,120,160,320,0,910
70281,200,100,0,0,0,0,300
70282,220,140,120,0,0,0,480
70283,240,180,40,0,0,0,460
70284,210,100,40,0,0,0,350
70285,170,120,160,160,0,0,610
70286,150,100,120,80,160,0,610
70287,190,120,80,0,0,0,390
70288,210,80,40,80,160,0,570
70289,190,120,120,80,160,0,670
70290,220,140,200,320,320,0,1200
70291,210,80,40,80,160,0,570
70292,220,160,160,80,160,0,780
70293,210,120,120,160,0,0,610
70294,200,140,80,80,160,0,660
70295,190,180,160,0,0,0,530
70296,220,180,120,160,160,320,1160
70297,200,180,160,80,160,0,780
70298,190,80,40,80,0,0,390
70299,200,80,160,160,0,0,600
70300,170,60,80,160,0,0,470
70301,200,120,0,0,0,0,320
70302,190,120,80,0,0,0,390
70303,170,140,200,240,160,320,1230
70304,190,100,120,160,160,0,730
70305,180,160,40,80,160,320,940
70306,160,60,40,80,160,0,500
70307,210,100,80,0,0,0,390
70308,170,100,120,240,160,0,790
70309,190,100,120,160,320,0,890
70310,200,160,160,160,160,0,840
70311,210,80,120,0,0,0,410
70312,160,80,40,0,0,0,280
70313,230,160,120,80,0,0,590
70314,170,160,200,80,0,0,610
70315,180,100,40,80,160,0,560
70316,190,120,120,160,160,0,750
70317,210,140,160,0,0,0,510
70318,210,120,160,240,320,320,1370
70319,200,160,160,240,160,0,920
70320,210,140,80,0,0,0,430
70321,200,120,160,240,0,0,720
70322,170,100,80,80,0,0,430
70323,210,120,80,0,0,0,410
70324,220,140,80,80,0,0,520
70325,220,100,120,0,0,0,440
70326,200,140,120,80,0,0,540
70327,210,140,200,160,0,0,710
70328,170,120,80,80,160,320,930
70329,190,120,120,80,160,0,670
70330,220,200,200,160,160,320,1260
70331,200,140,80,80,160,0,660
70332,170,120,80,80,0,0,450
70333,210,100,80,80,0,0,470
70334,180,140,160,160,160,0,800
70335,210,120,80,80,160,0,650
70336,190,120,120,0,0,0,430
70337,190,100,160,160,160,0,770
70338,210,100,40,80,160,0,590
70339,210,100,80,80,160,320,950
70340,240,140,160,80,0,0,620
70341,200,120,120,0,0,0,440
70342,210,160,120,0,0,0,490
70343,180,100,40,80,0,0,400
70344,200,60,120,80,160,0,620
70345,210,160,80,0,0,0,450
70346,180,100,120,80,160,0,640
70347,170,100,120,80,160,0,630
70348,210,100,40,80,160,0,590
70349,210,140,120,80,160,0,710
70350,200,160,80,80,160,0,680
70351,180,100,120,80,160,0,640
70352,140,160,160,160,320,0,940
70353,160,40,40,80,160,320,800
70354,200,80,40,0,0,0,320
70355,180,140,120,0,0,0,440
70356,220,140,120,80,160,0,720
70357,160,100,160,160,160,0,740
70358,210,160,120,80,0,0,570
70359,200,120,120,160,160,320,1080
70360,170,140,80,80,0,0,470
70361,240,160,120,160,160,0,840
70362,220,160,160,80,0,0,620
70363,170,120,120,160,320,0,890
70364,180,100,120,80,0,0,480
70365,230,180,280,160,320,0,1170
70366,220,140,120,0,0,0,480
70367,200,120,120,80,0,0,520
70368,240,160,160,160,0,0,720
70369,180,160,160,160,160,0,820
70370,200,120,80,0,0,0,400
70371,200,120,120,160,160,0,760
70372,210,80,120,160,320,0,890
70373,180,120,120,80,160,0,660
70374,170,80,40,0,0,0,290
70375,190,100,80,80,160,0,610
70376,220,140,160,160,320,320,1320
70377,220,140,120,240,160,320,1200
70378,180,120,200,160,320,320,1300
70379,200,200,120,0,0,0,520
70380,180,120,40,0,0,0,340
70381,170,160,120,80,160,0,690
70382,210,140,40,80,160,0,630
70383,190,100,40,80,0,0,410
70384,160,120,80,80,160,0,600
70385,210,140,120,160,320,0,950
70386,170,160,120,80,160,0,690
70387,170,60,80,80,0,0,390
70388,190,120,120,80,160,320,990
70389,220,120,120,160,320,0,940
70390,150,80,120,160,160,0,670
70391,170,180,80,0,0,0,430
70392,180,100,80,160,160,0,680
70393,200,120,80,0,0,0,400
70394,190,140,80,80,0,0,490
70395,220,120,40,80,160,0,620
70396,220,80,40,80,0,0,420
70397,210,180,120,80,0,0,590
70398,210,180,120,80,160,320,1070
70399,230,120,120,0,0,0,470
70400,150,100,80,80,160,0,570
70401,210,120,120,160,0,0,610
70402,170,100,40,0,0,0,310
70403,200,140,40,80,160,0,620
70404,160,140,160,240,160,0,860
70405,140,120,120,160,160,0,700
70406,190,120,160,80,0,0,550
70407,210,80,80,80,160,0,610
70408,240,120,160,80,0,0,600
70409,190,120,120,80,160,0,670
70410,230,160,120,80,160,320,1070
70411,230,180,160,160,160,0,890
70412,190,80,40,0,0,0,310
70413,170,100,200,160,320,0,950
70414,170,80,120,160,160,0,690
70415,230,180,160,160,160,320,1210
70416,150,140,80,80,0,0,450
70417,160,140,80,80,0,0,460
70418,240,140,120,80,0,0,580
70419,190,140,120,80,0,0,530
70420,190,80,80,160,160,0,670
70421,220,180,200,80,160,0,840
70422,160,120,120,160,320,0,880
70423,170,100,80,80,160,0,590
70424,210,180,160,80,160,320,1110
70425,200,160,120,80,160,0,720
70426,200,80,80,80,0,0,440
70427,220,120,80,160,320,320,1220
70428,210,120,80,80,0,0,490
70429,200,140,120,0,0,0,460
70430,230,200,160,80,160,0,830
70431,210,140,160,240,160,0,910
70432,150,120,40,80,0,0,390
70433,200,120,40,0,0,0,360
70434,210,100,120,80,0,0,510
70435,180,120,120,240,160,0,820
70436,250,160,160,160,160,0,890
70437,210,100,0,0,0,0,310
70438,160,120,80,160,320,0,840
70439,170,100,120,160,160,0,710
70440,150,100,80,0,0,0,330
70441,250,100,80,80,160,0,670
70442,220,220,160,80,160,0,840
70443,170,120,120,160,320,0,890
70444,220,60,40,0,0,0,320
70445,200,100,80,160,320,0,860
70446,190,160,120,160,0,0,630
70447,190,120,160,80,0,0,550
70448,220,60,40,80,160,320,880
70449,190,100,40,80,160,0,570
70450,190,140,80,0,0,0,410
70451,190,60,80,80,160,0,570
70452,160,120,120,80,160,320,960
70453,220,100,80,0,0,0,400
70454,190,120,120,80,160,0,670
70455,230,160,160,80,160,0,790
70456,230,120,40,80,160,320,950
70457,200,140,80,80,0,0,500
70458,210,160,160,80,0,0,610
70459,230,140,160,160,0,0,690
70460,200,180,40,80,0,0,500
70461,210,120,80,0,0,0,410
70462,190,120,80,0,0,0,390
70463,180,140,120,80,160,0,680
70464,200,160,120,160,320,320,1280
70465,220,160,240,80,160,320,1180
70466,250,120,160,160,320,320,1330
70467,200,140,80,80,0,0,500
70468,190,60,80,80,0,0,410
70469,210,140,40,0,0,0,390
70470,190,100,120,80,160,0,650
70471,230,60,80,160,320,320,1170
70472,200,160,80,160,160,0,760
70473,220,120,200,240,320,320,1420
70474,200,140,80,0,0,0,420
70475,170,120,80,80,160,0,610
70476,210,180,160,160,320,0,1030
70477,170,80,120,160,0,0,530
70478,260,100,80,80,0,0,520
70479,190,180,120,160,160,320,1130
70480,220,140,80,80,0,0,520
70481,210,140,80,0,0,0,430
70482,180,120,120,80,0,0,500
70483,220,120,160,80,0,0,580
70484,210,140,200,160,320,0,1030
70485,180,180,80,80,160,0,680
70486,210,40,0,0,0,0,250
70487,240,100,80,80,160,320,980
70488,150,180,120,160,160,0,770
70489,190,140,120,160,0,0,610
70490,200,120,40,0,0,0,360
70491,180,100,80,80,0,0,440
70492,180,100,80,80,160,320,920
70493,210,140,80,0,0,0,430
70494,190,80,80,80,0,0,430
70495,180,80,120,160,160,0,700
70496,210,140,120,80,0,0,550
70497,230,100,80,80,0,0,490
70498,190,180,80,80,160,320,1010
70499,160,40,0,0,0,0,200
70500,180,160,120,80,0,0,540
70501,210,120,160,80,160,0,730
70502,190,100,80,160,0,0,530
70503,240,180,160,160,320,0,1060
70504,210,160,120,160,160,0,810
70505,190,80,40,80,160,0,550
70506,170,100,120,80,0,0,470
70507,200,140,160,80,160,320,1060
70508,190,140,80,160,0,0,570
70509,230,120,80,80,160,0,670
70510,230,120,80,0,0,0,430
70511,190,120,120,160,320,0,910
70512,170,140,40,80,160,0,590
70513,230,140,80,80,160,0,690
70514,190,120,160,160,160,0,790
70515,240,200,160,160,0,0,760
70516,190,180,200,160,0,0,730
70517,220,160,40,0,0,0,420
70518,180,100,40,0,0,0,320
70519,210,200,200,240,320,320,1490
70520,220,120,120,80,0,0,540
70521,170,100,120,80,0,0,470
70522,200,120,80,80,160,0,640
70523,190,140,160,160,0,0,650
70524,210,140,120,160,160,0,790
70525,210,100,80,80,160,0,630
70526,150,140,40,0,0,0,330
70527,180,140,160,160,320,0,960
70528,180,120,80,160,320,0,860
70529,220,160,200,160,160,0,900
70530,230,160,80,80,160,320,1030
70531,200,120,120,80,0,0,520
70532,210,120,120,160,160,0,770
70533,190,100,120,80,160,0,650
70534,200,140,160,160,320,0,980
70535,230,140,160,240,160,0,930
70536,230,160,120,0,0,0,510
70537,200,120,120,80,0,0,520
70538,240,80,80,80,0,0,480
70539,200,180,200,240,320,320,1460
70540,230,120,80,80,160,0,670
70541,190,80,40,80,160,0,550
70542,220,140,120,0,0,0,480
70543,190,180,200,80,160,0,810
70544,200,60,40,80,160,0,540
70545,170,60,40,0,0,0,270
70546,190,120,40,80,160,0,590
70547,170,60,40,80,160,320,830
70548,170,100,40,80,0,0,390
70549,150,120,200,160,0,0,630
70550,220,120,120,160,320,320,1260
70551,180,140,200,160,160,0,840
70552,200,140,160,80,0,0,580
70553,230,140,80,0,0,0,450
70554,190,120,120,80,160,320,990
70555,160,80,80,0,0,0,320
70556,200,160,80,0,0,0,440
70557,200,140,200,160,160,320,1180
70558,170,60,80,160,160,320,950
70559,200,140,80,160,160,0,740
70560,160,100,120,80,160,320,940
70561,200,100,40,80,160,0,580
70562,190,120,200,80,160,0,750
70563,180,60,80,80,160,0,560
70564,240,160,120,80,160,0,760
70565,230,120,80,80,0,0,510
70566,230,160,80,160,160,0,790
70567,170,120,80,80,0,0,450
70568,180,160,120,80,160,0,700
70569,180,120,80,160,160,0,700
70570,240,120,120,160,160,320,1120
70571,180,100,120,80,0,0,480
70572,240,160,120,160,160,0,840
70573,220,140,80,160,320,320,1240
70574,180,120,40,80,0,0,420
70575,170,140,120,160,160,0,750
70576,180,100,0,0,0,0,280
70577,210,80,40,80,160,0,570
70578,170,80,40,80,0,0,370
70579,240,100,80,80,0,0,500
70580,160,100,80,80,0,0,420
70581,200,120,160,160,0,0,640
70582,210,120,120,240,160,0,850
70583,180,140,120,80,0,0,520
70584,200,100,80,80,160,320,940
70585,220,80,80,160,160,320,1020
70586,200,180,160,240,0,0,780
70587,220,100,80,80,0,0,480
70588,230,60,40,0,0,0,330
70589,210,140,120,0,0,0,470
70590,200,120,120,160,160,0,760
70591,200,60,80,0,0,0,340
70592,240,160,80,160,160,0,800
70593,220,140,80,160,0,0,600
70594,170,160,120,80,0,0,530
70595,180,140,160,160,320,320,1280
70596,210,120,120,160,160,0,770
70597,200,120,40,0,0,0,360
70598,200,160,80,160,0,0,600
70599,190,160,120,240,160,0,870
70600,220,160,160,160,320,0,1020
70601,190,60,80,0,0,0,330
70602,220,160,160,160,0,0,700
70603,180,100,120,160,160,320,1040
70604,170,80,80,80,160,0,570
70605,180,100,120,160,160,0,720
70606,210,100,80,160,160,0,710
70607,190,140,160,80,0,0,570
70608,180,80,80,160,160,0,660
70609,200,40,40,80,160,0,520
70610,180,160,160,160,320,320,1300
70611,180,140,40,0,0,0,360
70612,200,80,120,160,160,0,720
70613,180,120,120,80,0,0,500
70614,170,140,120,160,160,0,750
70615,200,80,80,80,0,0,440
70616,240,100,120,80,160,0,700
70617,200,140,160,80,160,0,740
70618,210,140,160,160,160,320,1150
70619,220,100,120,160,160,320,1080
70620,190,120,80,80,160,0,630
70621,190,60,80,160,160,0,650
70622,230,120,80,160,160,0,750
70623,190,120,40,0,0,0,350
70624,220,160,200,80,0,0,660
70625,230,140,120,80,160,0,730
70626,190,120,120,0,0,0,430
70627,230,160,40,0,0,0,430
70628,180,80,80,160,0,0,500
70629,190,120,80,0,0,0,390
70630,180,100,80,160,160,0,680
70631,230,80,120,80,0,0,510
70632,220,100,200,240,160,320,1240
70633,230,140,80,160,160,0,770
70634,200,140,200,160,160,0,860
70635,200,140,120,160,160,0,780
70636,210,120,80,80,160,0,650
70637,200,120,160,160,160,0,800
70638,220,120,120,80,160,0,700
70639,220,160,120,0,0,0,500
70640,160,60,80,160,320,0,780
70641,180,120,120,240,320,0,980
70642,210,120,0,0,0,0,330
70643,240,120,40,0,0,0,400
70644,190,40,40,80,160,0,510
70645,240,220,120,80,0,0,660
70646,180,140,120,160,160,320,1080
70647,200,140,40,80,160,0,620
70648,220,160,160,160,160,0,860
70649,220,140,80,0,0,0,440
70650,170,120,120,160,160,320,1050
70651,220,100,40,80,0,0,440
70652,200,80,80,160,0,0,520
70653,170,140,80,160,0,0,550
70654,230,140,80,160,160,0,770
70655,180,120,120,160,160,0,740
70656,170,100,120,80,160,320,950
70657,210,140,160,160,160,0,830
70658,160,100,80,160,320,0,820
70659,200,140,160,240,320,320,1380
70660,190,120,160,160,0,0,630
70661,200,120,40,0,0,0,360
70662,200,180,200,160,160,0,900
70663,220,120,80,80,160,0,660
70664,210,100,120,160,320,320,1230
70665,190,100,120,0,0,0,410
70666,200,120,120,160,320,320,1240
70667,230,100,80,80,0,0,490
70668,170,120,160,0,0,0,450
70669,210,120,80,80,160,0,650
70670,220,100,40,80,160,0,600
70671,170,100,80,160,160,0,670
70672,230,120,160,160,320,0,990
70673,200,100,40,80,160,0,580
70674,240,100,80,80,0,0,500
70675,210,160,200,240,160,0,970
70676,190,120,80,160,160,320,1030
70677,200,140,120,160,0,0,620
70678,190,80,80,160,320,0,830
70679,140,60,80,0,0,0,280
70680,220,200,160,160,0,0,740
70681,140,100,160,160,0,0,560
70682,200,120,80,80,0,0,480
70683,190,160,120,160,160,0,790
70684,200,80,80,0,0,0,360
70685,190,100,80,0,0,0,370
70686,200,100,40,80,160,0,580
70687,180,80,80,80,160,0,580
70688,220,120,40,0,0,0,380
70689,210,180,160,160,0,0,710
70690,160,100,120,160,320,320,1180
70691,180,140,80,0,0,0,400
70692,200,140,160,80,0,0,580
70693,180,100,80,80,160,0,600
70694,180,120,120,80,160,0,660
70695,180,120,0,0,0,0,300
70696,210,160,200,160,0,0,730
70697,170,160,120,0,0,0,450
70698,210,100,80,160,160,0,710
70699,230,120,120,0,0,0,470
70700,210,200,120,160,160,0,850
70701,180,140,160,160,320,320,1280
70702,170,100,40,80,160,0,550
70703,170,140,160,160,320,0,950
70704,140,60,80,160,160,0,600
70705,200,100,80,0,0,0,380
70706,160,100,80,80,0,0,420
70707,210,100,120,240,160,320,1150
70708,230,140,80,80,160,0,690
70709,190,160,120,160,160,320,1110
70710,210,80,120,160,160,0,730
70711,170,120,200,240,320,320,1370
70712,190,120,160,240,160,0,870
70713,200,80,80,80,160,0,600
70714,170,80,80,80,160,0,570
70715,160,80,120,80,160,0,600
70716,190,100,80,80,160,0,610
70717,210,160,200,80,160,0,810
70718,160,80,0,0,0,0,240
70719,180,120,120,80,0,0,500
70720,240,140,80,160,160,0,780
70721,220,80,80,160,160,0,700
70722,220,120,80,80,160,0,660
70723,210,100,120,80,160,0,670
70724,190,120,120,160,160,0,750
70725,180,100,120,80,160,0,640
70726,210,100,80,160,320,0,870
70727,170,140,160,80,0,0,550
70728,190,60,40,80,160,0,530
70729,220,100,80,80,160,0,640
70730,160,140,120,80,0,0,500
70731,170,100,80,80,160,0,590
70732,210,160,120,160,320,320,1290
70733,180,200,200,80,0,0,660
70734,230,140,120,0,0,0,490
70735,210,100,80,160,160,0,710
70736,210,140,120,240,320,320,1350
70737,210,100,80,0,0,0,390
70738,220,120,80,80,0,0,500
70739,190,140,120,80,160,0,690
70740,230,100,40,80,160,0,610
70741,170,60,80,80,0,0,390
70742,230,100,120,80,160,0,690
70743,190,140,160,240,320,0,1050
70744,160,120,80,80,160,0,600
70745,180,200,200,240,160,0,980
70746,200,120,80,0,0,0,400
70747,180,140,120,80,160,320,1000
70748,210,80,80,80,0,0,450
70749,210,180,120,160,320,0,990
70750,210,120,120,80,160,0,690
70751,200,100,120,0,0,0,420
70752,190,120,120,80,160,0,670
70753,220,160,120,0,0,0,500
70754,190,80,80,80,160,320,910
70755,150,80,40,0,0,0,270
70756,110,120,120,80,160,0,590
70757,160,120,80,80,160,320,920
70758,150,60,40,0,0,0,250
70759,190,120,80,0,0,0,390
70760,180,100,80,80,160,0,600
70761,220,80,40,80,0,0,420
70762,200,180,120,80,160,0,740
70763,160,80,80,160,160,0,640
70764,240,140,80,160,160,0,780
70765,170,120,120,160,160,0,730
70766,180,80,120,80,0,0,460
70767,180,100,120,240,160,0,800
70768,190,160,80,80,160,0,670
70769,200,140,160,160,320,0,980
70770,200,140,160,80,0,0,580
70771,230,180,160,80,160,0,810
70772,200,60,80,80,160,320,900
70773,180,100,120,160,160,0,720
70774,240,220,80,80,0,0,620
70775,170,100,120,80,0,0,470
70776,200,140,120,240,160,0,860
70777,200,100,80,80,0,0,460
70778,150,80,120,80,0,0,430
70779,160,40,40,0,0,0,240
70780,170,80,40,80,0,0,370
70781,210,80,40,0,0,0,330
70782,190,160,200,160,0,0,710
70783,230,140,120,160,320,0,970
70784,230,140,160,240,160,0,930
70785,210,140,120,240,320,0,1030
70786,180,140,120,160,160,0,760
70787,230,120,160,80,0,0,590
70788,240,140,80,80,0,0,540
70789,200,140,160,160,160,0,820
70790,190,140,160,160,160,320,1130
70791,190,100,40,0,0,0,330
70792,170,160,160,0,0,0,490
70793,230,120,120,80,160,0,710
70794,220,100,80,80,160,320,960
70795,200,160,200,160,0,0,720
70796,150,120,80,160,160,0,670
70797,180,140,80,80,0,0,480
70798,170,120,80,80,160,320,930
70799,200,100,40,0,0,0,340
70800,200,120,40,80,160,0,600
70801,230,120,160,80,0,0,590
70802,210,100,80,0,0,0,390
70803,140,80,80,160,320,0,780
70804,190,140,160,80,160,320,1050
70805,190,120,120,160,0,0,590
70806,170,140,80,0,0,0,390
70807,200,160,160,160,320,0,1000
70808,180,120,80,80,160,0,620
70809,190,80,80,160,320,0,830
70810,230,180,80,0,0,0,490
70811,180,160,120,0,0,0,460
70812,190,80,80,80,160,0,590
70813,170,80,40,0,0,0,290
70814,160,100,80,80,160,0,580
70815,180,100,80,0,0,0,360
70816,180,160,240,240,160,0,980
70817,180,100,80,160,320,0,840
70818,220,180,120,80,160,0,760
70819,190,160,120,240,160,0,870
70820,180,100,40,80,0,0,400
70821,190,120,120,160,320,0,910
70822,210,120,40,80,160,0,610
70823,240,160,120,0,0,0,520
70824,200,140,160,80,0,0,580
70825,170,80,80,80,0,0,410
70826,190,140,160,240,320,320,1370
70827,180,100,160,80,0,0,520
70828,170,100,80,80,0,0,430
70829,200,60,80,160,320,0,820
70830,190,100,120,80,160,0,650
70831,250,120,120,0,0,0,490
70832,210,120,120,0,0,0,450
70833,240,140,120,160,320,320,1300
70834,200,200,200,240,320,0,1160
70835,190,120,120,160,160,0,750
70836,150,160,120,80,0,0,510
70837,150,40,40,80,160,0,470
70838,140,100,40,80,160,0,520
70839,210,80,80,160,160,0,690
70840,200,120,40,0,0,0,360
70841,160,100,120,80,0,0,460
70842,180,100,120,80,160,0,640
70843,180,140,120,240,320,0,1000
70844,140,60,80,80,0,0,360
70845,150,160,160,80,160,0,710
70846,200,100,80,80,0,0,460
70847,160,140,120,80,0,0,500
70848,180,140,80,80,160,320,960
70849,180,160,120,80,160,0,700
70850,170,100,80,80,0,0,430
70851,200,220,120,160,160,0,860
70852,200,160,120,0,0,0,480
70853,160,100,0,0,0,0,260
70854,180,40,40,80,160,320,820
70855,200,120,120,160,320,320,1240
70856,180,60,80,80,0,0,400
70857,190,160,160,80,160,0,750
70858,190,160,120,240,320,0,1030
70859,180,60,40,80,0,0,360
70860,150,100,120,80,0,0,450
70861,140,100,80,80,0,0,400
70862,200,120,120,160,160,320,1080
70863,200,140,160,80,160,320,1060
70864,230,120,40,80,0,0,470
70865,210,100,40,0,0,0,350
70866,220,180,120,160,160,0,840
70867,210,180,240,160,320,0,1110
70868,190,80,80,0,0,0,350
70869,210,120,80,80,160,0,650
70870,170,120,120,160,0,0,570
70871,220,120,160,80,160,0,740
70872,200,140,80,80,0,0,500
70873,190,140,120,80,0,0,530
70874,190,200,80,80,0,0,550
70875,140,80,40,0,0,0,260
70876,210,140,120,80,160,0,710
70877,220,120,160,0,0,0,500
70878,150,40,40,80,160,320,790
70879,220,180,120,160,0,0,680
70880,180,140,160,160,160,0,800
70881,190,120,120,80,160,0,670
70882,220,180,160,80,0,0,640
70883,200,120,160,80,160,0,720
70884,190,100,80,80,0,0,450
70885,190,40,80,0,0,0,310
70886,170,100,80,80,160,320,910
70887,170,120,80,160,160,0,690
70888,170,80,40,0,0,0,290
70889,210,120,120,80,160,320,1010
70890,170,120,80,80,0,0,450
70891,210,160,120,80,0,0,570
70892,200,160,160,240,320,0,1080
70893,220,180,160,240,320,0,1120
70894,230,180,160,160,0,0,730
70895,230,100,40,80,160,0,610
70896,190,100,120,80,0,0,490
70897,190,60,40,80,0,0,370
70898,200,120,160,240,0,0,720
70899,180,100,120,80,160,320,960
70900,150,120,120,160,160,320,1030
70901,230,100,40,80,160,0,610
70902,190,160,120,0,0,0,470
70903,210,160,160,240,320,320,1410
70904,180,120,40,0,0,0,340
70905,210,120,120,160,160,0,770
70906,150,120,200,80,0,0,550
70907,140,120,120,160,160,320,1020
70908,240,180,120,160,160,320,1180
70909,180,60,80,160,0,0,480
70910,210,100,80,80,0,0,470
70911,200,100,0,0,0,0,300
70912,150,80,120,80,0,0,430
70913,230,80,80,160,0,0,550
70914,210,140,120,0,0,0,470
70915,200,120,120,80,0,0,520
70916,220,140,160,160,160,0,840
70917,240,200,160,80,160,0,840
70918,160,80,120,240,160,0,760
70919,170,140,160,240,320,0,1030
70920,200,140,160,80,160,0,740
70921,180,160,120,160,320,320,1260
70922,200,160,200,160,0,0,720
70923,200,120,40,80,160,0,600
70924,180,120,80,0,0,0,380
70925,210,140,120,80,160,0,710
70926,200,80,120,80,160,0,640
70927,180,160,160,160,0,0,660
70928,190,60,0,0,0,0,250
70929,180,40,40,80,0,0,340
70930,250,180,120,80,160,0,790
70931,190,60,120,160,160,0,690
70932,140,80,120,160,160,320,980
70933,170,160,80,160,160,0,730
70934,170,140,120,0,0,0,430
70935,160,100,120,80,0,0,460
70936,190,120,80,80,0,0,470
70937,180,120,160,0,0,0,460
70938,200,100,80,80,160,0,620
70939,230,120,80,0,0,0,430
70940,190,180,80,80,160,0,690
70941,190,80,120,0,0,0,390
70942,180,120,160,160,160,0,780
70943,160,80,80,0,0,0,320
70944,150,120,120,240,160,320,1110
70945,190,120,120,160,160,0,750
70946,180,100,40,0,0,0,320
70947,170,140,160,160,160,0,790
70948,210,100,120,160,320,320,1230
70949,200,140,160,160,320,0,980
70950,220,120,40,0,0,0,380
70951,270,160,160,160,160,0,910
70952,160,140,80,80,160,0,620
70953,220,120,80,0,0,0,420
70954,190,120,120,160,160,320,1070
70955,190,120,80,0,0,0,390
70956,180,60,0,0,0,0,240
70957,200,100,80,0,0,0,380
70958,180,140,80,80,0,0,480
70959,220,100,120,80,0,0,520
70960,200,180,120,0,0,0,500
70961,230,200,160,240,0,0,830
70962,190,140,120,80,0,0,530
70963,220,160,120,240,320,0,1060
70964,210,100,40,0,0,0,350
70965,210,160,120,80,0,0,570
70966,170,100,120,80,160,320,950
70967,190,60,40,80,0,0,370
70968,210,80,40,80,160,320,890
70969,200,60,40,80,0,0,380
70970,220,120,80,80,160,0,660
70971,210,160,40,0,0,0,410
70972,230,120,80,80,160,0,670
70973,220,140,120,160,160,0,800
70974,190,60,40,80,0,0,370
70975,180,80,40,0,0,0,300
70976,190,140,80,80,0,0,490
70977,180,140,120,80,0,0,520
70978,180,100,80,80,0,0,440
70979,180,120,80,160,160,0,700
70980,200,160,200,160,160,0,880
70981,210,100,80,80,160,0,630
70982,190,140,120,0,0,0,450
70983,170,120,120,0,0,0,410
70984,210,140,80,160,320,0,910
70985,190,100,80,80,0,0,450
70986,180,60,40,80,160,0,520
70987,210,120,120,160,0,0,610
70988,200,180,120,160,160,0,820
70989,190,80,120,80,0,0,470
70990,220,140,120,160,320,0,960
70991,190,160,120,80,0,0,550
70992,200,140,80,80,160,0,660
70993,180,100,120,80,0,0,480
70994,210,140,80,160,160,320,1070
70995,210,100,80,80,160,0,630
70996,230,140,80,80,0,0,530
70997,220,120,40,80,160,320,940
70998,190,120,120,160,160,0,750
70999,160,160,80,160,160,320,1040
71000,200,160,160,160,160,0,840
71001,240,60,40,0,0,0,340
71002,200,140,120,240,160,0,860
71003,190,100,80,0,0,0,370
71004,210,120,200,80,160,320,1090
71005,150,100,120,160,160,0,690
71006,170,80,80,160,160,0,650
71007,180,160,160,0,0,0,500
71008,220,160,240,80,0,0,700
71009,170,120,40,80,0,0,410
71010,170,100,80,80,0,0,430
71011,170,140,160,80,0,0,550
71012,160,120,160,80,160,0,680
71013,170,120,160,80,0,0,530
71014,180,100,120,160,320,0,880
71015,180,160,160,80,160,0,740
71016,200,80,80,80,0,0,440
71017,200,140,120,80,160,0,700
71018,210,40,40,0,0,0,290
71019,210,140,160,160,160,0,830
71020,210,140,120,0,0,0,470
71021,240,140,160,160,320,320,1340
71022,160,120,160,160,0,0,600
71023,190,140,160,160,160,0,810
71024,240,100,80,80,0,0,500
71025,200,140,120,160,320,0,940
71026,160,80,40,0,0,0,280
71027,210,140,160,240,320,320,1390
71028,180,160,160,160,0,0,660
71029,220,160,160,80,0,0,620
71030,230,160,160,160,160,0,870
71031,210,180,120,160,160,0,830
71032,190,140,120,160,160,0,770
71033,170,100,160,160,0,0,590
71034,180,120,80,80,160,0,620
71035,200,160,80,0,0,0,440
71036,210,120,80,80,0,0,490
71037,170,140,160,160,0,0,630
71038,180,140,80,80,160,0,640
71039,220,100,120,160,320,0,920
71040,210,100,80,80,0,0,470
71041,220,140,200,160,0,0,720
71042,240,160,120,160,0,0,680
71043,170,120,120,160,160,0,730
71044,200,120,80,80,160,320,960
71045,210,120,40,0,0,0,370
71046,180,100,160,240,160,0,840
71047,210,120,80,160,320,0,890
71048,190,160,160,160,160,0,830
71049,180,140,40,80,160,320,920
71050,180,100,120,160,0,0,560
71051,200,160,80,160,160,320,1080
71052,200,60,80,0,0,0,340
71053,200,160,160,80,160,0,760
71054,250,100,40,80,160,0,630
71055,200,120,160,160,0,0,640
71056,220,180,120,80,0,0,600
71057,200,140,120,160,160,0,780
71058,170,100,120,80,160,0,630
71059,130,80,80,80,0,0,370
71060,180,140,120,80,160,0,680
71061,210,100,120,160,160,320,1070
71062,220,140,160,160,320,320,1320
71063,190,80,80,80,160,0,590
71064,210,120,80,0,0,0,410
71065,200,120,80,160,160,0,720
71066,220,140,80,0,0,0,440
71067,160,100,120,80,160,0,620
71068,230,140,40,0,0,0,410
71069,200,120,80,80,0,0,480
71070,180,120,80,0,0,0,380
71071,160,40,80,80,160,0,520
71072,210,60,80,80,160,0,590
71073,190,140,160,80,0,0,570
71074,180,120,120,80,160,320,980
71075,190,140,120,80,160,320,1010
71076,190,120,80,160,0,0,550
71077,210,180,80,0,0,0,470
71078,180,120,120,160,320,0,900
71079,230,120,80,0,0,0,430
71080,210,140,120,80,160,320,1030
71081,220,160,160,160,0,0,700
71082,150,120,120,160,160,0,710
71083,200,140,80,0,0,0,420
71084,210,100,40,0,0,0,350
71085,180,120,40,0,0,0,340
71086,160,80,80,160,160,0,640
71087,220,160,160,240,160,0,940
71088,200,80,40,0,0,0,320
71089,180,140,120,0,0,0,440
71090,220,140,120,240,160,0,880
71091,200,100,160,80,0,0,540
71092,220,140,80,80,160,0,680
71093,190,100,40,0,0,0,330
71094,190,120,120,80,160,0,670
71095,190,120,80,80,0,0,470
71096,170,140,80,160,160,320,1030
71097,200,100,80,80,160,0,620
71098,190,120,120,160,0,0,590
71099,210,100,120,80,160,0,670
71100,210,140,120,160,320,0,950
71101,220,140,200,160,320,320,1360
71102,230,120,80,0,0,0,430
71103,240,120,120,80,0,0,560
71104,200,120,80,80,160,320,960
71105,220,140,80,80,160,0,680
71106,170,120,160,80,160,0,690
71107,230,100,40,0,0,0,370
71108,190,120,120,80,0,0,510
71109,190,80,40,0,0,0,310
71110,170,120,80,80,160,320,930
71111,220,100,120,240,160,0,840
71112,210,100,40,80,160,0,590
71113,220,140,80,0,0,0,440
71114,200,80,80,160,0,0,520
71115,190,120,120,80,0,0,510
71116,210,160,160,240,320,0,1090
71117,180,100,80,80,160,0,600
71118,190,80,120,160,320,320,1190
71119,190,100,80,160,160,0,690
71120,200,160,120,80,160,0,720
71121,190,120,80,80,0,0,470
71122,200,120,120,160,160,0,760
71123,180,80,80,80,160,0,580
71124,200,140,80,80,0,0,500
71125,200,100,80,0,0,0,380
71126,220,140,160,160,160,0,840
71127,230,140,120,160,160,320,1130
71128,220,100,80,160,320,0,880
71129,200,120,80,80,160,0,640
71130,190,80,40,80,160,0,550
71131,190,100,40,80,0,0,410
71132,220,100,40,0,0,0,360
71133,180,80,40,80,160,320,860
71134,190,140,120,0,0,0,450
71135,200,140,160,0,0,0,500
71136,210,160,160,160,320,0,1010
71137,180,120,160,240,160,320,1180
71138,210,140,160,240,320,320,1390
71139,190,140,80,160,160,0,730
71140,170,60,0,0,0,0,230
71141,200,140,0,0,0,0,340
71142,160,100,120,160,0,0,540
71143,230,140,160,80,0,0,610
71144,220,100,120,80,0,0,520
71145,190,200,200,160,160,0,910
71146,190,140,160,80,160,320,1050
71147,230,80,40,80,160,0,590
71148,200,140,160,320,160,0,980
71149,200,160,120,160,160,0,800
71150,250,160,120,160,0,0,690
71151,150,60,80,160,160,0,610
71152,210,140,80,0,0,0,430
71153,200,180,200,160,160,0,900
71154,220,120,80,0,0,0,420
71155,180,80,80,80,160,320,900
71156,170,100,80,0,0,0,350
71157,190,140,40,0,0,0,370
71158,180,120,80,80,160,0,620
71159,230,120,120,80,160,0,710
71160,180,120,160,80,0,0,540
71161,160,80,80,80,160,0,560
71162,200,100,80,0,0,0,380
71163,200,200,120,0,0,0,520
71164,190,160,120,160,160,320,1110
71165,180,140,160,80,160,0,720
71166,210,120,40,80,160,0,610
71167,220,140,120,80,0,0,560
71168,190,180,200,160,0,0,730
71169,240,140,80,80,160,0,700
71170,190,200,120,160,0,0,670
71171,250,160,80,160,160,0,810
71172,180,140,120,160,160,320,1080
71173,200,140,120,80,160,0,700
71174,170,80,120,240,320,0,930
71175,220,160,120,160,320,0,980
71176,200,80,40,0,0,0,320
71177,210,160,80,0,0,0,450
71178,160,120,160,80,0,0,520
71179,220,200,80,80,160,0,740
71180,180,140,160,240,320,0,1040
71181,180,120,200,160,160,0,820
71182,190,140,80,80,160,0,650
71183,200,100,80,80,160,0,620
71184,230,60,40,0,0,0,330
71185,150,140,160,80,0,0,530
71186,140,80,80,160,0,0,460
71187,180,140,80,80,160,0,640
71188,210,180,160,160,160,0,870
71189,240,140,120,160,0,0,660
71190,190,140,120,160,160,320,1090
71191,200,80,80,0,0,0,360
71192,200,140,80,80,160,320,980
71193,200,200,120,160,160,0,840
71194,180,80,80,160,160,0,660
71195,190,120,80,160,320,0,870
71196,210,120,120,160,0,0,610
71197,140,80,0,0,0,0,220
71198,160,100,80,80,160,0,580
71199,140,120,80,160,320,0,820
71200,220,140,120,0,0,0,480
71201,180,20,0,0,0,0,200
71202,200,120,80,80,0,0,480
71203,180,100,160,160,160,0,760
71204,240,140,160,240,160,0,940
71205,160,120,80,160,160,0,680
71206,190,120,120,160,320,0,910
71207,170,80,40,0,0,0,290
71208,190,180,200,160,160,0,890
71209,210,120,120,160,160,0,770
71210,230,100,40,80,0,0,450
71211,170,100,160,80,0,0,510
71212,200,140,40,0,0,0,380
71213,180,140,120,160,160,320,1080
71214,210,180,120,80,0,0,590
71215,150,120,160,80,160,0,670
71216,190,140,120,80,0,0,530
71217,230,140,80,160,160,0,770
71218,180,140,80,80,160,320,960
71219,170,100,80,0,0,0,350
71220,210,100,120,0,0,0,430
71221,190,60,40,80,160,0,530
71222,190,140,120,160,160,320,1090
71223,210,120,80,160,0,0,570
71224,170,100,80,80,160,320,910
71225,190,160,120,160,0,0,630
71226,230,120,120,160,160,0,790
71227,210,120,160,160,160,320,1130
71228,230,140,40,80,0,0,490
71229,210,120,80,160,0,0,570
71230,190,180,160,240,0,0,770
71231,180,120,80,160,160,0,700
71232,160,140,120,80,160,0,660
71233,200,160,200,240,160,0,960
71234,200,160,120,160,160,0,800
71235,200,120,40,0,0,0,360
71236,230,80,80,160,0,0,550
71237,200,120,120,0,0,0,440
71238,170,100,80,160,160,0,670
71239,220,180,120,80,0,0,600
71240,210,140,160,240,160,0,910
71241,210,140,80,80,0,0,510
71242,210,160,120,80,0,0,570
71243,180,120,80,160,160,0,700
71244,200,100,80,0,0,0,380
71245,200,160,160,240,0,0,760
71246,180,100,40,80,160,0,560
71247,210,140,40,80,0,0,470
71248,220,200,120,160,160,0,860
71249,210,160,160,80,160,0,770
71250,190,160,120,80,160,0,710
71251,190,160,80,80,160,320,990
71252,200,100,40,0,0,0,340
71253,210,80,80,160,0,0,530
71254,180,80,120,0,0,0,380
71255,180,140,120,240,320,0,1000
71256,180,60,0,0,0,0,240
71257,190,160,120,160,320,0,950
71258,160,100,80,80,160,0,580
71259,210,100,80,0,0,0,390
71260,190,140,80,80,160,0,650
71261,220,160,120,80,160,0,740
71262,190,140,120,160,160,0,770
71263,190,100,80,160,160,0,690
71264,210,40,0,0,0,0,250
71265,190,140,120,80,0,0,530
71266,210,140,40,0,0,0,390
71267,250,180,160,80,0,0,670
71268,240,140,40,0,0,0,420
71269,170,160,120,240,160,0,850
71270,170,180,160,160,160,0,830
71271,200,160,80,0,0,0,440
71272,210,60,40,80,160,0,550
71273,210,120,120,160,320,320,1250
71274,200,120,40,80,0,0,440
71275,190,120,120,80,160,0,670
71276,210,120,120,160,160,0,770
71277,190,160,80,160,160,320,1070
71278,200,160,160,160,160,320,1160
71279,210,80,120,160,160,0,730
71280,190,140,120,80,160,320,1010
71281,200,140,120,160,320,320,1260
71282,170,100,80,80,160,0,590
71283,200,140,40,0,0,0,380
71284,200,120,120,80,160,0,680
71285,230,160,120,160,160,0,830
71286,190,140,120,0,0,0,450
71287,180,140,40,80,160,0,600
71288,170,60,0,0,0,0,230
71289,200,120,80,80,160,0,640
71290,220,120,80,80,160,0,660
71291,250,220,160,80,160,0,870
71292,210,120,160,320,320,320,1450
71293,190,80,0,0,0,0,270
71294,170,80,120,0,0,0,370
71295,200,100,160,80,0,0,540
71296,200,80,80,80,0,0,440
71297,160,60,40,80,160,0,500
71298,210,120,120,160,320,320,1250
71299,200,120,120,0,0,0,440
71300,200,40,40,0,0,0,280
71301,190,120,120,80,160,0,670
71302,190,100,120,160,160,0,730
71303,210,140,160,80,160,0,750
71304,180,140,120,0,0,0,440
71305,160,140,120,160,320,0,900
71306,200,140,200,240,160,0,940
71307,210,40,40,80,160,0,530
71308,190,60,0,0,0,0,250
71309,210,140,160,160,160,0,830
71310,230,60,80,80,160,0,610
71311,200,160,120,160,160,0,800
71312,210,100,40,80,160,0,590
71313,170,100,80,160,160,0,670
71314,210,120,80,160,320,0,890
71315,200,120,120,160,0,0,600
71316,200,100,80,160,0,0,540
71317,200,120,80,80,0,0,480
71318,230,80,40,80,0,0,430
71319,200,160,80,80,160,0,680
71320,230,120,40,80,160,320,950
71321,190,120,80,160,0,0,550
71322,230,120,80,80,160,320,990
71323,130,120,80,80,160,0,570
71324,190,120,80,0,0,0,390
71325,210,140,120,160,160,320,1110
71326,180,100,120,80,160,0,640
71327,220,100,40,0,0,0,360
71328,210,160,120,80,160,0,730
71329,200,140,200,80,0,0,620
71330,230,180,200,160,160,320,1250
71331,180,140,160,160,0,0,640
71332,150,80,80,0,0,0,310
71333,130,60,40,0,0,0,230
71334,190,180,160,80,160,0,770
71335,200,80,80,80,0,0,440
71336,220,140,40,80,0,0,480
71337,170,40,40,0,0,0,250
71338,190,120,120,160,160,0,750
71339,180,160,120,0,0,0,460
71340,200,100,80,0,0,0,380
71341,200,140,120,160,320,0,940
71342,150,100,40,0,0,0,290
71343,190,100,120,160,160,0,730
71344,200,120,80,0,0,0,400
71345,130,60,0,0,0,0,190
71346,190,160,120,0,0,0,470
71347,220,140,80,80,0,0,520
71348,190,120,200,240,320,320,1390
71349,210,180,120,160,160,0,830
71350,200,160,80,80,160,320,1000
71351,180,100,80,80,160,0,600
71352,220,120,80,0,0,0,420
71353,200,60,80,80,0,0,420
71354,180,140,80,80,0,0,480
71355,220,80,120,80,0,0,500
71356,220,180,200,240,160,0,1000
71357,210,100,80,0,0,0,390
71358,200,120,120,80,160,0,680
71359,140,120,160,240,320,320,1300
71360,220,80,120,80,160,320,980
71361,220,140,200,160,160,0,880
71362,200,160,80,0,0,0,440
71363,200,80,80,160,160,0,680
71364,220,120,80,160,160,0,740
71365,230,120,80,160,160,0,750
71366,210,120,0,0,0,0,330
71367,170,120,120,160,160,0,730
71368,170,160,160,160,160,0,810
71369,200,120,160,0,0,0,480
71370,190,100,160,160,160,0,770
71371,150,100,80,160,160,0,650
71372,190,120,120,160,160,0,750
71373,170,120,120,160,160,0,730
71374,180,100,0,0,0,0,280
71375,210,160,160,80,0,0,610
71376,180,120,120,80,160,320,980
71377,170,100,40,0,0,0,310
71378,190,180,240,240,320,0,1170
71379,200,80,80,80,160,0,600
71380,220,100,0,0,0,0,320
71381,230,100,0,0,0,0,330
71382,200,120,120,160,320,0,920
71383,220,120,80,0,0,0,420
71384,200,120,40,80,160,0,600
71385,200,160,40,80,160,0,640
71386,210,100,160,160,320,0,950
71387,180,140,80,160,160,320,1040
71388,190,100,80,80,160,0,610
71389,200,120,80,80,160,0,640
71390,230,100,80,80,0,0,490
71391,220,60,40,0,0,0,320
71392,190,100,160,80,160,320,1010
71393,160,100,120,0,0,0,380
71394,200,140,80,0,0,0,420
71395,190,80,120,240,160,0,790
71396,180,140,80,80,160,320,960
71397,180,140,160,0,0,0,480
71398,210,160,200,160,320,0,1050
71399,210,140,120,160,0,0,630
71400,180,80,80,160,160,0,660
71401,200,140,120,80,160,320,1020
71402,210,160,160,80,160,320,1090
71403,230,140,160,80,0,0,610
71404,200,120,120,0,0,0,440
71405,180,100,80,80,0,0,440
71406,160,100,120,160,160,0,700
71407,220,160,80,160,160,0,780
71408,180,120,40,80,0,0,420
71409,190,140,160,0,0,0,490
71410,170,180,160,160,320,320,1310
71411,180,140,160,240,0,0,720
71412,190,140,120,160,320,0,930
71413,210,80,40,0,0,0,330
71414,190,160,160,160,320,0,990
71415,220,100,120,0,0,0,440
71416,210,160,120,160,160,0,810
71417,220,120,120,160,320,0,940
71418,190,160,80,80,160,0,670
71419,170,120,80,160,0,0,530
71420,170,160,120,160,320,0,930
71421,220,100,80,0,0,0,400
71422,220,160,120,160,0,0,660
71423,210,120,0,0,0,0,330
71424,160,80,40,0,0,0,280
71425,180,80,40,80,160,320,860
71426,200,120,80,160,160,0,720
71427,180,120,120,160,160,0,740
71428,220,120,80,80,160,320,980
71429,170,160,160,240,160,0,890
71430,180,100,80,80,160,0,600
71431,190,140,80,160,160,0,730
71432,130,120,120,80,160,0,610
71433,230,120,160,160,160,0,830
71434,170,120,120,160,320,0,890
71435,180,100,160,160,160,0,760
71436,160,100,40,80,160,0,540
71437,210,100,120,160,320,0,910
71438,140,140,120,80,0,0,480
71439,200,140,200,240,0,0,780
71440,200,140,160,80,160,0,740
71441,180,80,120,160,160,320,1020
71442,160,140,120,0,0,0,420
71443,220,140,120,80,160,0,720
71444,190,120,40,80,160,320,910
71445,240,140,160,240,160,0,940
71446,180,60,80,80,160,0,560
71447,180,100,120,80,160,0,640
71448,190,80,80,80,0,0,430
71449,220,120,40,80,160,0,620
71450,180,160,160,160,160,0,820
71451,160,80,40,80,160,0,520
71452,180,100,120,160,160,0,720
71453,190,160,200,160,160,320,1190
71454,180,80,40,0,0,0,300
71455,200,140,120,160,0,0,620
71456,200,120,80,160,160,0,720
71457,170,140,80,80,160,0,630
71458,160,120,120,0,0,0,400
71459,200,60,40,0,0,0,300
71460,200,120,120,80,0,0,520
71461,220,140,80,80,0,0,520
71462,210,100,40,80,160,0,590
71463,180,80,120,160,320,320,1180
71464,170,120,120,80,160,0,650
71465,210,100,120,160,320,320,1230
71466,190,140,120,160,160,0,770
71467,180,120,40,80,160,0,580
71468,220,160,160,0,0,0,540
71469,190,120,120,160,160,0,750
71470,230,180,120,0,0,0,530
71471,170,120,80,80,160,0,610
71472,200,140,40,80,0,0,460
71473,220,160,120,80,0,0,580
71474,210,100,80,160,320,0,870
71475,210,120,40,0,0,0,370
71476,180,160,80,80,160,0,660
71477,200,100,120,160,160,320,1060
71478,250,120,80,0,0,0,450
71479,140,80,80,160,320,0,780
71480,190,140,120,240,160,0,850
71481,190,140,120,160,320,0,930
71482,220,120,120,160,160,0,780
71483,210,80,80,160,0,0,530
71484,200,120,80,160,160,0,720
71485,220,160,160,160,160,0,860
71486,220,140,80,80,160,0,680
71487,220,100,80,160,320,0,880
71488,210,160,120,80,160,0,730
71489,200,140,80,0,0,0,420
71490,150,80,80,80,160,0,550
71491,210,140,160,160,0,0,670
71492,200,120,80,0,0,0,400
71493,190,80,120,0,0,0,390
71494,200,180,160,80,160,320,1100
71495,230,160,80,160,320,0,950
71496,140,80,80,0,0,0,300
71497,200,140,120,0,0,0,460
71498,240,120,120,80,160,0,720
71499,180,20,40,80,160,0,480
71500,220,100,160,0,0,0,480
71501,180,80,120,80,0,0,460
71502,200,80,0,0,0,0,280
71503,220,120,160,80,160,0,740
71504,230,160,40,0,0,0,430
71505,180,140,120,0,0,0,440
71506,220,80,120,160,160,320,1060
71507,190,120,160,160,160,0,790
71508,170,200,120,80,160,0,730
71509,180,80,40,80,160,0,540
71510,220,160,80,0,0,0,460
71511,150,120,40,80,160,0,550
71512,180,120,80,80,160,0,620
71513,230,140,120,80,160,0,730
71514,140,140,160,160,160,0,760
71515,190,100,80,80,160,0,610
71516,180,120,120,160,320,320,1220
71517,200,80,40,80,160,0,560
71518,170,160,160,80,160,320,1050
71519,180,120,80,0,0,0,380
71520,190,140,120,80,0,0,530
71521,200,160,160,160,160,0,840
71522,200,120,120,0,0,0,440
71523,210,100,120,160,160,0,750
71524,160,140,160,160,320,0,940
71525,200,100,160,160,0,0,620
71526,210,160,40,80,160,0,650
71527,220,160,160,240,0,0,780
71528,180,120,120,80,0,0,500
71529,200,120,160,160,320,320,1280
71530,260,180,120,80,0,0,640
71531,190,120,120,80,160,0,670
71532,180,100,40,80,0,0,400
71533,200,100,80,80,0,0,460
71534,190,140,200,80,0,0,610
71535,250,120,120,160,160,0,810
71536,220,160,120,0,0,0,500
71537,260,180,80,80,0,0,600
71538,190,100,120,0,0,0,410
71539,160,120,160,80,160,0,680
71540,210,60,80,160,0,0,510
71541,210,140,120,160,160,0,790
71542,220,100,80,80,0,0,480
71543,250,200,120,160,320,0,1050
71544,210,120,120,160,320,0,930
71545,240,140,160,240,160,0,940
71546,200,140,80,0,0,0,420
71547,180,120,40,80,0,0,420
71548,160,100,40,80,0,0,380
71549,220,120,120,160,0,0,620
71550,190,120,120,80,0,0,510
71551,150,120,200,240,0,0,710
71552,180,160,160,160,0,0,660
71553,190,140,120,160,160,320,1090
71554,160,100,120,80,160,320,940
71555,220,100,80,80,160,0,640
71556,210,180,160,80,160,0,790
71557,190,100,40,80,160,0,570
71558,220,140,120,160,160,0,800
71559,160,80,40,0,0,0,280
71560,230,120,120,160,160,0,790
71561,240,100,80,160,160,0,740
71562,210,100,40,80,0,0,430
71563,240,140,0,0,0,0,380
71564,220,160,120,160,160,0,820
71565,230,100,120,160,160,0,770
71566,190,140,160,160,160,0,810
71567,180,120,120,80,0,0,500
71568,230,100,80,160,160,0,730
71569,200,100,120,160,160,320,1060
71570,170,180,120,160,160,0,790
71571,200,120,80,160,320,0,880
71572,210,140,120,160,320,320,1270
71573,180,80,120,80,0,0,460
71574,180,120,200,160,320,0,980
71575,220,120,160,0,0,0,500
71576,230,120,160,160,160,0,830
71577,210,160,160,240,320,320,1410
71578,210,40,40,80,160,0,530
71579,160,120,160,240,160,0,840
71580,160,80,40,0,0,0,280
71581,180,140,160,160,320,0,960
71582,210,160,120,160,320,0,970
71583,200,100,120,240,320,0,980
71584,210,120,120,80,160,0,690
71585,190,140,120,160,160,0,770
71586,160,80,80,80,160,0,560
71587,200,120,160,80,0,0,560
71588,210,160,120,160,160,0,810
71589,210,140,160,160,160,0,830
71590,210,160,200,160,320,320,1370
71591,220,160,160,160,160,0,860
71592,180,60,80,80,160,0,560
71593,190,140,160,80,0,0,570
71594,250,140,80,0,0,0,470
71595,250,140,80,80,160,320,1030
71596,180,160,120,160,160,0,780
71597,210,160,120,80,160,0,730
71598,170,60,120,160,160,0,670
71599,160,40,80,80,160,0,520
71600,190,120,120,160,320,0,910
71601,170,140,160,160,160,0,790
71602,180,80,120,80,160,0,620
71603,190,140,80,80,0,0,490
71604,190,100,40,0,0,0,330
71605,200,160,120,80,160,0,720
71606,180,100,120,160,0,0,560
71607,210,100,80,80,0,0,470
71608,200,160,120,160,160,0,800
71609,220,140,160,160,320,0,1000
71610,220,180,160,240,320,320,1440
71611,180,80,80,80,160,0,580
71612,190,100,40,0,0,0,330
71613,210,120,160,80,0,0,570
71614,180,140,120,80,160,0,680
71615,220,120,80,0,0,0,420
71616,140,80,120,80,0,0,420
71617,220,180,120,0,0,0,520
71618,250,140,80,80,160,0,710
71619,250,140,120,160,160,320,1150
71620,230,160,120,80,0,0,590
71621,210,100,160,240,320,0,1030
71622,190,160,160,160,320,0,990
71623,220,100,120,80,0,0,520
71624,230,100,120,80,0,0,530
71625,200,160,120,160,0,0,640
71626,180,180,160,80,0,0,600
71627,190,80,80,0,0,0,350
71628,220,120,160,80,160,320,1060
71629,170,100,80,80,0,0,430
71630,200,120,120,80,160,0,680
71631,200,120,80,80,160,0,640
71632,170,120,120,160,320,0,890
71633,180,80,40,80,160,0,540
71634,230,120,40,80,160,320,950
71635,180,120,120,240,320,0,980
71636,210,60,40,80,160,320,870
71637,170,40,40,80,160,320,810
71638,230,180,200,80,160,0,850
71639,190,120,120,80,0,0,510
71640,210,100,40,0,0,0,350
71641,230,140,120,80,0,0,570
71642,210,120,80,160,0,0,570
71643,210,140,160,80,160,0,750
71644,210,100,80,80,0,0,470
71645,200,180,160,160,160,0,860
71646,230,120,160,0,0,0,510
71647,240,220,80,0,0,0,540
71648,190,100,160,160,160,320,1090
71649,160,120,240,240,160,0,920
71650,190,120,80,80,0,0,470
71651,170,100,40,80,0,0,390
71652,220,160,200,240,320,0,1140
71653,190,80,80,0,0,0,350
71654,230,120,200,80,160,0,790
71655,180,140,160,160,160,320,1120
71656,200,120,120,160,160,0,760
71657,200,160,160,80,0,0,600
71658,190,100,120,160,0,0,570
71659,200,120,80,160,160,0,720
71660,190,140,160,0,0,0,490
71661,220,40,40,0,0,0,300
71662,200,100,120,240,320,320,1300
71663,240,160,160,80,0,0,640
71664,200,140,200,80,160,0,780
71665,150,120,120,160,320,0,870
71666,200,40,80,0,0,0,320
71667,250,140,80,80,160,0,710
71668,170,140,160,0,0,0,470
71669,210,100,80,80,160,0,630
71670,220,100,120,0,0,0,440
71671,220,180,160,80,0,0,640
71672,210,80,120,160,160,0,730
71673,190,100,40,80,160,320,890
71674,230,180,120,80,0,0,610
71675,170,100,80,0,0,0,350
71676,250,140,40,80,0,0,510
71677,190,120,120,240,160,0,830
71678,240,160,80,0,0,0,480
71679,210,160,160,80,160,0,770
71680,190,80,80,160,160,0,670
71681,230,120,80,160,320,320,1230
71682,190,120,120,0,0,0,430
71683,200,140,120,160,160,0,780
71684,190,140,120,80,160,0,690
71685,190,120,120,160,160,320,1070
71686,170,120,80,160,160,0,690
71687,180,120,80,160,160,0,700
71688,210,120,120,80,160,0,690
71689,200,140,40,80,0,0,460
71690,190,120,160,80,160,0,710
71691,240,60,40,0,0,0,340
71692,180,80,80,0,0,0,340
71693,180,140,160,240,320,320,1360
71694,200,180,160,160,0,0,700
71695,190,120,200,240,160,0,910
71696,210,120,160,160,320,320,1290
71697,170,140,40,0,0,0,350
71698,180,120,120,0,0,0,420
71699,200,40,0,0,0,0,240
71700,180,100,120,160,160,0,720
71701,220,180,120,160,160,0,840
71702,200,200,200,160,320,0,1080
71703,200,100,120,240,160,0,820
71704,220,140,160,160,160,0,840
71705,170,100,40,0,0,0,310
71706,190,80,120,80,160,0,630
71707,220,120,80,80,160,320,980
71708,160,60,40,0,0,0,260
71709,220,140,120,80,0,0,560
71710,140,120,80,80,0,0,420
71711,210,100,80,0,0,0,390
71712,190,120,160,160,160,0,790
71713,210,140,120,160,160,0,790
71714,230,140,80,160,320,0,930
71715,200,100,40,80,0,0,420
71716,200,160,40,80,160,320,960
71717,180,100,40,0,0,0,320
71718,210,60,80,80,0,0,430
71719,180,140,160,0,0,0,480
71720,230,140,200,160,320,0,1050
71721,190,120,160,160,160,0,790
71722,180,160,40,80,160,0,620
71723,150,140,80,80,160,0,610
71724,190,80,120,80,0,0,470
71725,240,160,120,160,320,320,1320
71726,210,140,120,240,160,0,870
71727,190,120,120,80,160,320,990
71728,150,120,120,160,320,0,870
71729,220,120,160,160,160,320,1140
71730,210,80,80,160,160,0,690
71731,220,120,80,80,0,0,500
71732,200,140,80,0,0,0,420
71733,200,80,0,0,0,0,280
71734,190,100,120,160,160,0,730
71735,210,100,120,80,0,0,510
71736,180,140,80,80,0,0,480
71737,210,140,120,0,0,0,470
71738,180,180,160,240,320,0,1080
71739,210,160,120,80,160,0,730
71740,190,160,120,80,160,0,710
71741,200,120,200,240,160,320,1240
71742,200,60,40,80,160,0,540
71743,190,160,80,0,0,0,430
71744,230,140,160,160,320,320,1330
71745,180,80,120,0,0,0,380
71746,240,180,80,0,0,0,500
71747,210,200,120,160,0,0,690
71748,220,160,120,80,160,0,740
71749,200,140,80,80,0,0,500
71750,210,160,200,160,160,0,890
71751,210,180,200,80,0,0,670
71752,230,120,200,80,160,0,790
71753,160,100,80,0,0,0,340
71754,240,160,120,240,160,0,920
71755,180,80,80,80,160,0,580
71756,180,140,120,160,160,0,760
71757,210,160,200,320,160,0,1050
71758,230,160,160,160,160,0,870
71759,160,120,120,160,320,0,880
71760,210,140,160,160,160,0,830
71761,200,180,160,80,160,0,780
71762,210,140,120,80,160,0,710
71763,160,60,40,80,0,0,340
71764,220,120,120,160,160,0,780
71765,190,140,80,0,0,0,410
71766,240,180,160,160,160,0,900
71767,210,160,120,80,160,0,730
71768,200,80,120,160,320,0,880
71769,220,100,160,240,160,0,880
71770,240,180,80,160,0,0,660
71771,190,160,80,80,160,0,670
71772,180,220,200,160,160,0,920
71773,200,120,120,80,0,0,520
71774,190,100,80,0,0,0,370
71775,200,140,120,0,0,0,460
71776,210,140,160,160,0,0,670
71777,200,160,120,160,0,0,640
71778,210,120,80,80,160,320,970
71779,210,220,160,160,0,0,750
71780,230,160,200,240,160,0,990
71781,190,100,80,80,160,320,930
71782,210,160,80,0,0,0,450
71783,220,100,40,80,0,0,440
71784,190,100,80,160,160,0,690
71785,190,100,120,80,0,0,490
71786,190,100,80,160,0,0,530
71787,210,120,80,80,160,0,650
71788,150,100,80,160,320,0,810
71789,220,120,120,160,160,0,780
71790,210,180,160,160,0,0,710
71791,200,140,80,160,160,320,1060
71792,180,80,80,80,160,0,580
71793,190,60,120,160,160,0,690
71794,200,160,120,160,160,0,800
71795,210,180,160,160,160,0,870
71796,180,120,80,80,160,0,620
71797,190,100,40,80,160,0,570
71798,180,80,40,80,0,0,380
71799,210,80,40,80,0,0,410
71800,230,140,80,0,0,0,450
71801,170,140,80,80,160,0,630
71802,190,100,160,80,0,0,530
71803,170,100,160,80,0,0,510
71804,210,160,200,80,0,0,650
71805,180,160,200,240,320,0,1100
71806,190,60,40,80,0,0,370
71807,210,140,160,160,160,0,830
71808,190,120,160,80,160,0,710
71809,150,140,160,240,160,0,850
71810,210,160,120,80,160,0,730
71811,180,120,200,160,0,0,660
71812,210,140,120,80,160,0,710
71813,180,100,120,160,0,0,560
71814,230,160,80,160,320,0,950
71815,220,220,120,240,320,0,1120
71816,150,120,200,80,160,0,710
71817,210,100,160,160,160,0,790
71818,200,100,120,80,160,0,660
71819,230,180,160,240,320,320,1450
71820,190,120,160,80,0,0,550
71821,210,140,160,80,160,320,1070
71822,200,120,80,160,0,0,560
71823,200,80,120,80,0,0,480
71824,170,100,80,80,160,0,590
71825,200,140,120,160,160,320,1100
71826,170,140,120,80,160,0,670
71827,220,100,120,160,0,0,600
71828,200,100,80,80,160,0,620
71829,210,140,120,160,320,0,950
71830,160,100,120,160,0,0,540
71831,220,100,80,80,0,0,480
71832,180,120,80,80,0,0,460
71833,180,100,120,80,160,0,640
71834,210,160,80,160,160,0,770
71835,180,80,80,80,160,320,900
71836,220,160,80,80,0,0,540
71837,220,120,80,0,0,0,420
71838,180,100,80,160,160,0,680
71839,190,180,120,80,0,0,570
71840,180,160,160,80,0,0,580
71841,200,160,120,80,0,0,560
71842,180,140,200,240,320,0,1080
71843,190,100,120,160,320,320,1210
71844,200,80,80,80,160,320,920
71845,220,100,160,0,0,0,480
71846,200,120,80,160,0,0,560
71847,210,100,160,160,160,0,790
71848,220,100,120,80,160,0,680
71849,190,120,120,0,0,0,430
71850,150,60,80,80,160,0,530
71851,170,140,120,160,320,0,910
71852,250,160,120,80,0,0,610
71853,210,140,40,80,160,320,950
71854,210,140,120,160,160,320,1110
71855,180,80,80,160,160,0,660
71856,160,140,160,160,320,0,940
71857,170,120,0,0,0,0,290
71858,200,140,120,80,0,0,540
71859,220,140,120,160,160,0,800
71860,200,100,120,160,160,0,740
71861,210,120,80,80,160,0,650
71862,220,100,120,80,160,0,680
71863,170,60,40,80,160,0,510
71864,240,140,200,240,320,0,1140
71865,210,160,120,80,160,0,730
71866,170,100,160,240,160,0,830
71867,180,60,80,80,0,0,400
71868,220,140,80,0,0,0,440
71869,200,140,120,0,0,0,460
71870,190,100,120,240,160,0,810
71871,200,120,80,0,0,0,400
71872,200,140,120,80,0,0,540
71873,240,140,40,0,0,0,420
71874,210,80,120,80,160,0,650
71875,190,100,120,160,160,0,730
71876,220,120,80,80,0,0,500
71877,180,100,120,160,0,0,560
71878,200,120,160,160,0,0,640
71879,210,140,80,160,160,0,750
71880,180,120,120,160,0,0,580
71881,200,140,200,160,160,0,860
71882,250,120,80,160,320,0,930
71883,210,160,160,240,0,0,770
71884,220,120,80,80,160,320,980
71885,210,160,80,80,160,0,690
71886,180,80,120,160,160,0,700
71887,150,100,120,0,0,0,370
71888,200,120,160,160,0,0,640
71889,200,80,0,0,0,0,280
71890,230,140,160,160,0,0,690
71891,150,100,120,80,160,320,930
71892,220,120,160,80,0,0,580
71893,220,100,80,160,320,320,1200
71894,180,120,80,80,0,0,460
71895,230,140,160,240,160,0,930
71896,200,160,120,160,0,0,640
71897,200,80,120,80,0,0,480
71898,160,120,80,80,160,0,600
71899,210,140,120,80,160,320,1030
71900,190,120,80,80,0,0,470
71901,220,160,120,80,160,0,740
71902,190,140,120,160,0,0,610
71903,210,180,160,160,160,0,870
71904,170,80,120,80,0,0,450
71905,190,120,120,160,160,320,1070
71906,120,100,160,80,160,0,620
71907,210,140,160,80,160,0,750
71908,190,160,160,160,0,0,670
71909,180,100,160,80,0,0,520
71910,230,120,80,160,160,0,750
71911,170,140,120,80,160,0,670
71912,240,120,120,0,0,0,480
71913,210,160,120,80,160,0,730
71914,190,80,80,160,160,320,990
71915,210,140,160,160,0,0,670
71916,240,80,120,160,320,0,920
71917,150,100,120,160,320,320,1170
71918,160,80,80,0,0,0,320
71919,210,180,120,80,160,0,750
71920,180,100,80,0,0,0,360
71921,210,100,40,0,0,0,350
71922,210,140,80,160,160,0,750
71923,170,140,160,80,160,0,710
71924,240,140,160,160,160,0,860
71925,180,100,80,80,160,0,600
71926,190,140,0,0,0,0,330
71927,210,100,40,80,160,0,590
71928,190,100,160,160,160,0,770
71929,200,160,80,160,320,320,1240
71930,230,160,120,80,0,0,590
71931,230,140,80,80,0,0,530
71932,200,100,120,160,160,0,740
71933,200,100,120,160,320,0,900
71934,200,120,80,80,160,0,640
71935,200,100,160,240,320,0,1020
71936,200,180,120,80,160,0,740
71937,210,120,120,80,0,0,530
71938,170,120,120,80,160,320,970
71939,200,100,40,0,0,0,340
71940,240,160,80,0,0,0,480
71941,160,40,80,160,160,0,600
71942,210,120,160,160,160,0,810
71943,210,200,160,80,0,0,650
71944,170,100,120,80,160,0,630
71945,170,100,120,80,160,320,950
71946,210,80,40,80,160,0,570
71947,170,100,120,160,320,0,870
71948,180,140,120,160,160,0,760
71949,220,100,80,80,0,0,480
71950,190,160,120,80,160,0,710
71951,220,220,240,240,160,0,1080
71952,170,140,80,160,160,0,710
71953,210,80,80,80,160,0,610
71954,190,120,80,0,0,0,390
71955,220,100,40,0,0,0,360
71956,180,140,80,80,0,0,480
71957,170,120,120,160,0,0,570
71958,210,60,80,160,160,0,670
71959,200,80,40,80,0,0,400
71960,170,100,80,160,160,0,670
71961,180,80,80,160,320,0,820
71962,210,100,40,0,0,0,350
71963,150,120,80,0,0,0,350
71964,220,120,160,80,160,320,1060
71965,170,120,80,80,160,320,930
71966,180,80,40,0,0,0,300
71967,190,100,80,80,160,0,610
71968,240,120,80,0,0,0,440
71969,230,120,80,80,0,0,510
71970,190,120,40,80,160,0,590
71971,190,120,160,80,0,0,550
71972,190,80,120,80,160,0,630
71973,210,120,80,160,320,0,890
71974,230,120,80,80,0,0,510
71975,190,120,120,160,160,0,750
71976,150,100,120,80,160,0,610
71977,150,120,160,160,160,0,750
71978,210,100,120,160,0,0,590
71979,210,120,160,160,0,0,650
71980,220,140,80,160,160,0,760
71981,200,160,160,160,0,0,680
71982,210,140,80,160,320,0,910
71983,170,140,160,160,0,0,630
71984,200,120,80,0,0,0,400
71985,130,100,0,0,0,0,230
71986,220,120,120,80,0,0,540
71987,190,120,120,80,160,0,670
71988,190,100,80,80,0,0,450
71989,220,120,0,0,0,0,340
71990,170,140,200,160,0,0,670
71991,190,120,120,0,0,0,430
71992,180,120,120,80,0,0,500
71993,180,100,120,80,160,0,640
71994,170,120,160,160,160,0,770
71995,170,160,40,80,0,0,450
71996,210,140,120,160,160,0,790
71997,270,100,160,160,320,320,1330
71998,150,140,120,160,320,320,1210
71999,230,140,80,160,320,0,930
72000,190,140,160,160,160,0,810
72001,170,120,120,160,160,0,730
72002,190,120,80,80,0,0,470
72003,180,120,120,160,160,0,740
72004,220,140,120,160,0,0,640
72005,190,80,40,80,160,0,550
72006,160,100,40,80,160,320,860
72007,160,140,120,80,160,320,980
72008,230,120,80,80,160,0,670
72009,230,140,160,80,0,0,610
72010,210,120,80,80,160,0,650
72011,190,120,80,160,320,320,1190
72012,180,120,80,80,160,0,620
72013,210,160,160,80,160,320,1090
72014,210,160,160,0,0,0,530
72015,160,120,160,160,320,320,1240
72016,180,120,80,160,320,320,1180
72017,210,160,120,80,160,0,730
72018,190,120,80,160,160,0,710
72019,200,120,80,0,0,0,400
72020,210,100,80,0,0,0,390
72021,180,180,160,160,160,0,840
72022,200,120,40,80,0,0,440
72023,180,140,120,80,0,0,520
72024,180,100,80,0,0,0,360
72025,210,100,80,80,160,320,950
72026,230,180,160,160,320,0,1050
72027,190,140,200,80,160,0,770
72028,150,80,40,80,160,0,510
72029,180,100,80,0,0,0,360
72030,200,120,80,80,160,0,640
72031,170,100,120,80,160,0,630
72032,200,100,80,0,0,0,380
72033,140,100,0,0,0,0,240
72034,200,100,160,240,160,0,860
72035,160,140,160,160,160,0,780
72036,160,100,80,160,160,320,980
72037,200,180,160,160,0,0,700
72038,210,180,40,80,160,0,670
72039,230,140,160,160,160,0,850
72040,150,100,120,160,320,320,1170
72041,190,80,80,80,0,0,430
72042,190,120,160,160,0,0,630
72043,170,100,120,160,160,0,710
72044,250,160,120,80,0,0,610
72045,150,80,40,0,0,0,270
72046,200,140,80,80,160,0,660
72047,190,80,40,80,160,0,550
72048,220,140,40,80,160,320,960
72049,220,160,120,160,320,320,1300
72050,160,120,160,80,160,0,680
72051,150,100,80,160,160,0,650
72052,190,140,120,80,160,0,690
72053,170,80,40,0,0,0,290
72054,270,80,80,80,160,0,670
72055,200,160,40,0,0,0,400
72056,220,140,80,160,0,0,600
72057,180,60,120,80,160,0,600
72058,200,80,40,80,160,0,560
72059,220,140,120,160,160,0,800
72060,220,140,80,160,160,0,760
72061,180,100,80,160,160,0,680
72062,140,60,40,0,0,0,240
72063,180,100,120,0,0,0,400
72064,170,160,200,240,320,320,1410
72065,240,120,120,0,0,0,480
72066,190,120,80,160,320,0,870
72067,190,100,80,80,160,0,610
72068,170,80,80,80,160,0,570
72069,190,100,80,0,0,0,370
72070,190,80,80,160,160,0,670
72071,230,100,80,80,0,0,490
72072,160,120,120,160,0,0,560
72073,180,120,120,80,0,0,500
72074,180,80,40,0,0,0,300
72075,200,120,200,240,320,0,1080
72076,240,120,160,80,160,0,760
72077,220,120,120,160,0,0,620
72078,210,160,200,80,0,0,650
72079,200,40,40,80,160,0,520
72080,190,120,200,160,160,0,830
72081,180,140,80,0,0,0,400
72082,190,100,40,0,0,0,330
72083,200,120,120,240,160,320,1160
72084,170,100,80,0,0,0,350
72085,210,140,80,80,0,0,510
72086,190,140,120,80,160,0,690
72087,170,140,40,80,160,0,590
72088,190,120,200,80,0,0,590
72089,230,180,80,80,160,320,1050
72090,230,140,80,80,160,0,690
72091,160,60,80,80,0,0,380
72092,170,120,160,160,320,0,930
72093,200,60,40,80,0,0,380
72094,210,140,200,160,320,0,1030
72095,200,100,120,160,320,0,900
72096,200,120,80,160,160,0,720
72097,190,100,120,160,160,0,730
72098,180,100,80,80,0,0,440
72099,200,100,80,0,0,0,380
72100,190,120,80,0,0,0,390
72101,240,160,80,160,0,0,640
72102,200,140,120,80,0,0,540
72103,190,100,120,160,320,0,890
72104,190,120,80,80,160,320,950
72105,170,140,80,80,160,0,630
72106,200,140,200,160,320,320,1340
72107,180,200,200,160,160,0,900
72108,190,80,80,80,160,0,590
72109,190,140,120,160,320,0,930
72110,180,120,80,80,160,0,620
72111,170,100,120,240,320,0,950
72112,210,120,80,80,160,0,650
72113,180,140,120,160,320,0,920
72114,220,140,80,80,0,0,520
72115,180,140,160,240,320,0,1040
72116,190,120,80,80,160,0,630
72117,200,120,0,0,0,0,320
72118,230,140,120,80,160,0,730
72119,170,100,80,80,0,0,430
72120,200,100,80,160,320,0,860
72121,190,120,200,160,0,0,670
72122,200,100,160,240,160,0,860
72123,200,120,160,160,0,0,640
72124,210,180,120,240,160,320,1230
72125,220,140,80,80,160,0,680
72126,190,120,120,80,160,0,670
72127,150,60,80,80,160,0,530
72128,210,100,120,160,320,320,1230
72129,190,120,120,160,160,0,750
72130,190,120,160,160,0,0,630
72131,210,100,160,240,320,0,1030
72132,170,140,80,0,0,0,390
72133,220,100,80,160,160,320,1040
72134,250,120,120,160,160,0,810
72135,160,100,80,160,320,320,1140
72136,180,160,80,80,160,320,980
72137,220,100,160,80,160,0,720
72138,170,160,120,0,0,0,450
72139,160,120,120,80,160,0,640
72140,180,100,40,0,0,0,320
72141,230,200,80,160,160,0,830
72142,200,160,160,160,0,0,680
72143,190,120,80,80,0,0,470
72144,190,160,160,160,320,0,990
72145,210,160,160,80,0,0,610
72146,200,120,120,160,160,0,760
72147,170,120,120,160,160,0,730
72148,190,120,80,80,160,0,630
72149,180,100,120,160,320,0,880
72150,180,100,160,80,160,0,680
72151,150,100,40,80,160,0,530
72152,200,100,80,160,320,320,1180
72153,230,140,120,80,160,0,730
72154,210,200,240,160,160,0,970
72155,190,80,0,0,0,0,270
72156,190,180,160,160,160,0,850
72157,180,100,80,0,0,0,360
72158,180,80,80,80,0,0,420
72159,190,120,160,80,0,0,550
72160,200,100,120,0,0,0,420
72161,220,140,120,160,0,0,640
72162,180,200,120,160,320,0,980
72163,200,140,120,80,160,320,1020
72164,180,140,80,80,0,0,480
72165,200,120,80,160,160,0,720
72166,210,120,80,80,0,0,490
72167,220,140,120,80,0,0,560
72168,220,140,80,0,0,0,440
72169,170,60,80,0,0,0,310
72170,200,120,40,80,160,0,600
72171,210,60,40,80,0,0,390
72172,220,100,80,0,0,0,400
72173,210,140,120,80,0,0,550
72174,170,120,200,160,320,0,970
72175,190,80,80,0,0,0,350
72176,200,120,120,80,0,0,520
72177,170,120,160,160,160,320,1090
72178,230,120,200,240,320,0,1110
72179,190,140,160,80,160,320,1050
72180,200,100,120,240,160,0,820
72181,170,100,120,80,160,0,630
72182,210,100,120,160,160,0,750
72183,220,120,160,160,160,0,820
72184,160,40,40,80,160,0,480
72185,250,160,160,0,0,0,570
72186,220,140,120,80,160,0,720
72187,210,100,120,160,160,0,750
72188,200,120,80,160,320,320,1200
72189,190,120,160,160,320,0,950
72190,210,160,120,160,160,320,1130
72191,200,60,40,80,160,0,540
72192,180,180,80,160,160,0,760
72193,170,120,120,160,0,0,570
72194,150,80,80,80,160,0,550
72195,160,140,40,80,0,0,420
72196,180,120,160,240,320,0,1020
72197,240,140,120,80,160,0,740
72198,200,180,200,160,0,0,740
72199,170,80,40,0,0,0,290
72200,200,120,200,240,0,0,760
72201,210,140,160,240,160,0,910
72202,220,100,80,160,0,0,560
72203,220,140,120,240,160,0,880
72204,160,120,200,160,160,0,800
72205,260,200,160,240,160,0,1020
72206,160,120,120,80,160,0,640
72207,170,140,80,80,160,0,630
72208,180,120,120,160,0,0,580
72209,210,180,120,160,160,320,1150
72210,170,120,40,80,160,0,570
72211,200,100,40,0,0,0,340
72212,200,160,160,240,320,320,1400
72213,220,100,40,0,0,0,360
72214,230,140,80,80,160,0,690
72215,190,120,120,80,0,0,510
72216,210,140,120,160,0,0,630
72217,200,140,80,80,160,0,660
72218,160,80,40,80,160,0,520
72219,190,100,120,160,160,320,1050
72220,200,120,40,80,160,0,600
72221,200,120,160,80,0,0,560
72222,180,120,80,0,0,0,380
72223,170,160,200,80,0,0,610
72224,250,120,80,80,160,0,690
72225,170,100,120,160,320,0,870
72226,230,120,80,80,160,0,670
72227,180,100,160,80,160,0,680
72228,210,160,160,160,0,0,690
72229,200,120,80,160,160,0,720
72230,190,100,80,160,320,0,850
72231,200,160,80,80,160,0,680
72232,170,80,80,160,160,0,650
72233,180,100,80,80,0,0,440
72234,190,160,120,80,160,0,710
72235,180,120,160,160,160,0,780
72236,210,60,40,80,160,0,550
72237,170,120,120,80,0,0,490
72238,180,140,200,160,160,0,840
72239,190,100,120,80,0,0,490
72240,190,80,40,80,160,0,550
72241,190,100,120,80,160,0,650
72242,190,100,0,0,0,0,290
72243,200,160,160,160,160,0,840
72244,190,180,160,80,160,0,770
72245,220,100,40,0,0,0,360
72246,210,160,120,80,0,0,570
72247,200,140,80,80,0,0,500
72248,180,100,80,0,0,0,360
72249,220,120,40,80,160,0,620
72250,230,80,80,80,160,320,950
72251,180,120,160,240,160,320,1180
72252,180,100,120,80,0,0,480
72253,150,100,80,80,160,0,570
72254,220,160,120,80,160,0,740
72255,180,100,40,0,0,0,320
72256,200,100,40,80,160,0,580
72257,220,160,40,80,160,0,660
72258,200,120,80,160,0,0,560
72259,150,120,160,80,0,0,510
72260,220,180,160,160,320,320,1360
72261,190,120,80,160,160,0,710
72262,170,120,120,160,320,0,890
72263,210,160,120,80,160,0,730
72264,160,80,40,80,160,0,520
72265,200,120,160,160,160,0,800
72266,170,120,80,80,160,320,930
72267,190,140,160,160,160,0,810
72268,180,120,40,80,160,0,580
72269,170,80,120,160,320,0,850
72270,200,140,120,160,320,0,940
72271,190,120,80,80,0,0,470
72272,200,160,80,80,0,0,520
72273,230,140,80,80,160,0,690
72274,200,200,120,160,320,320,1320
72275,170,140,40,0,0,0,350
72276,190,100,80,80,160,0,610
72277,200,120,80,80,0,0,480
72278,160,120,80,0,0,0,360
72279,160,120,80,0,0,0,360
72280,220,180,200,240,320,0,1160
72281,150,100,120,160,0,0,530
72282,150,160,160,80,0,0,550
72283,240,80,40,80,160,0,600
72284,210,180,160,80,160,0,790
72285,200,140,120,80,160,320,1020
72286,190,140,80,80,160,0,650
72287,190,80,40,0,0,0,310
72288,210,120,120,160,160,0,770
72289,180,160,160,240,160,0,900
72290,170,100,40,80,160,0,550
72291,220,100,40,0,0,0,360
72292,150,120,120,160,320,320,1190
72293,250,180,160,80,160,0,830
72294,190,80,120,160,160,0,710
72295,220,120,80,160,320,0,900
72296,190,80,80,160,160,0,670
72297,180,80,120,240,320,0,940
72298,180,140,120,160,320,0,920
72299,210,100,160,160,0,0,630
72300,210,180,120,160,160,0,830
72301,200,120,80,80,160,0,640
72302,200,140,160,80,0,0,580
72303,220,180,80,160,160,0,800
72304,230,120,80,160,160,320,1070
72305,210,100,120,160,0,0,590
72306,210,160,240,240,320,0,1170
72307,160,140,120,160,160,320,1060
72308,210,100,40,80,160,0,590
72309,210,80,80,0,0,0,370
72310,210,180,160,160,160,0,870
72311,180,100,160,160,0,0,600
72312,180,100,160,160,160,0,760
72313,140,120,80,80,160,320,900
72314,170,140,160,240,320,0,1030
72315,230,140,40,80,0,0,490
72316,160,140,120,240,160,320,1140
72317,190,100,120,160,320,320,1210
72318,170,140,200,160,160,320,1150
72319,200,140,80,160,320,0,900
72320,220,140,80,80,0,0,520
72321,200,160,0,0,0,0,360
72322,200,180,120,0,0,0,500
72323,170,80,80,80,0,0,410
72324,190,120,120,160,0,0,590
72325,200,120,80,160,320,0,880
72326,240,80,120,240,320,0,1000
72327,220,160,80,160,0,0,620
72328,200,160,120,160,160,0,800
72329,200,100,120,80,0,0,500
72330,170,80,40,80,0,0,370
72331,190,100,120,80,160,0,650
72332,210,120,200,80,0,0,610
72333,150,60,40,80,0,0,330
72334,200,140,120,160,160,0,780
72335,220,60,80,80,160,320,920
72336,230,80,80,160,160,0,710
72337,190,140,80,80,0,0,490
72338,180,100,40,0,0,0,320
72339,180,100,120,80,0,0,480
72340,180,120,160,80,160,0,700
72341,200,80,0,0,0,0,280
72342,180,80,120,160,160,320,1020
72343,190,100,160,160,320,0,930
72344,180,80,80,80,0,0,420
72345,220,160,120,160,160,0,820
72346,190,120,120,160,0,0,590
72347,240,120,120,160,320,320,1280
72348,210,120,80,160,320,320,1210
72349,200,140,160,160,0,0,660
72350,170,140,120,0,0,0,430
72351,170,120,40,0,0,0,330
72352,190,80,80,80,160,0,590
72353,200,140,200,80,160,320,1100
72354,170,120,120,160,160,0,730
72355,210,200,160,160,160,0,890
72356,200,200,120,80,0,0,600
72357,180,160,160,0,0,0,500
72358,210,140,120,80,160,0,710
72359,180,120,40,0,0,0,340
72360,230,160,80,80,0,0,550
72361,180,160,200,160,0,0,700
72362,180,100,80,0,0,0,360
72363,180,120,120,80,160,0,660
72364,210,100,80,160,160,0,710
72365,160,60,80,160,320,0,780
72366,180,80,120,80,0,0,460
72367,180,80,80,160,320,320,1140
72368,220,180,200,80,160,320,1160
72369,170,140,200,0,0,0,510
72370,190,120,40,80,0,0,430
72371,220,100,0,0,0,0,320
72372,180,160,120,80,0,0,540
72373,180,160,120,160,320,320,1260
72374,190,120,120,160,160,0,750
72375,150,100,40,80,160,0,530
72376,190,100,40,80,160,0,570
72377,240,200,160,80,160,0,840
72378,220,160,160,160,160,0,860
72379,210,140,160,80,0,0,590
72380,200,120,40,80,160,0,600
72381,240,140,120,80,160,0,740
72382,160,140,120,160,320,0,900
72383,240,100,80,80,160,0,660
72384,190,80,160,160,320,0,910
72385,170,120,160,160,160,0,770
72386,210,140,120,160,0,0,630
72387,170,100,80,80,0,0,430
72388,180,180,120,80,0,0,560
72389,210,140,120,80,160,320,1030
72390,160,180,240,160,0,0,740
72391,210,80,120,160,160,320,1050
72392,190,120,120,80,160,320,990
72393,210,100,80,160,320,0,870
72394,200,140,120,80,0,0,540
72395,190,120,0,0,0,0,310
72396,220,160,120,80,160,0,740
72397,180,140,120,160,160,0,760
72398,170,100,80,0,0,0,350
72399,190,120,120,240,160,0,830
72400,230,140,120,0,0,0,490
72401,210,120,200,240,320,0,1090
72402,180,100,80,80,160,0,600
72403,250,160,240,160,0,0,810
72404,200,120,160,160,320,0,960
72405,190,160,80,80,160,0,670
72406,200,100,80,160,0,0,540
72407,140,100,120,0,0,0,360
72408,210,60,80,80,0,0,430
72409,200,160,120,80,0,0,560
72410,210,140,120,80,0,0,550
72411,160,100,120,0,0,0,380
72412,170,100,120,80,0,0,470
72413,200,60,40,80,160,0,540
72414,230,120,80,160,160,0,750
72415,180,60,80,80,160,0,560
72416,180,80,120,80,160,0,620
72417,180,120,80,160,160,320,1020
72418,210,80,80,160,160,0,690
72419,190,100,120,80,0,0,490
72420,180,160,160,160,320,0,980
72421,200,180,120,160,160,0,820
72422,240,100,80,0,0,0,420
72423,180,100,80,80,160,0,600
72424,200,100,120,80,0,0,500
72425,180,80,40,0,0,0,300
72426,190,160,120,80,0,0,550
72427,170,120,120,80,160,0,650
72428,230,100,80,80,160,0,650
72429,160,60,40,80,0,0,340
72430,200,140,120,160,320,0,940
72431,220,120,160,160,320,0,980
72432,210,140,160,160,320,320,1310
72433,180,140,160,160,320,0,960
72434,190,140,160,240,320,0,1050
72435,230,120,80,0,0,0,430
72436,210,80,40,0,0,0,330
72437,200,100,80,0,0,0,380
72438,240,140,120,240,160,0,900
72439,160,100,160,80,160,320,980
72440,190,160,80,80,0,0,510
72441,220,140,160,240,320,320,1400
72442,210,120,120,240,320,320,1330
72443,180,120,160,240,160,0,860
72444,210,40,40,80,160,0,530
72445,180,100,80,80,0,0,440
72446,230,100,160,80,160,320,1050
72447,190,100,80,160,320,0,850
72448,230,80,80,160,160,0,710
72449,210,60,40,80,160,0,550
72450,150,80,120,160,320,320,1150
72451,210,140,120,160,160,0,790
72452,190,100,80,80,160,0,610
72453,180,140,160,160,0,0,640
72454,200,160,160,160,0,0,680
72455,190,140,160,160,320,0,970
72456,170,140,160,160,160,0,790
72457,190,120,120,240,320,0,990
72458,190,140,120,80,160,0,690
72459,190,80,120,80,160,0,630
72460,200,140,120,160,160,0,780
72461,150,100,80,160,160,320,970
72462,200,140,80,80,0,0,500
72463,180,160,160,160,160,0,820
72464,210,120,160,80,160,0,730
72465,180,120,40,80,0,0,420
72466,220,140,120,160,320,0,960
72467,230,120,160,0,0,0,510
72468,200,80,40,80,0,0,400
72469,200,160,240,240,320,0,1160
72470,240,180,160,160,160,0,900
72471,240,120,40,0,0,0,400
72472,160,120,120,0,0,0,400
72473,230,140,120,0,0,0,490
72474,240,180,160,80,160,320,1140
72475,150,80,120,160,160,0,670
72476,190,80,80,160,0,0,510
72477,220,140,80,80,0,0,520
72478,190,140,120,80,0,0,530
72479,160,120,160,80,0,0,520
72480,240,200,200,240,160,0,1040
72481,170,120,80,80,160,0,610
72482,200,80,40,80,160,0,560
72483,160,100,120,0,0,0,380
72484,210,160,160,80,0,0,610
72485,240,60,40,80,160,0,580
72486,180,80,80,160,160,0,660
72487,160,120,160,0,0,0,440
72488,260,220,240,0,0,0,720
72489,210,100,160,240,160,0,870
72490,200,180,120,0,0,0,500
72491,200,120,120,80,0,0,520
72492,230,120,80,80,0,0,510
72493,210,100,160,160,320,320,1270
72494,210,80,80,80,160,0,610
72495,170,140,160,160,320,0,950
72496,210,180,120,240,320,320,1390
72497,260,160,160,160,160,0,900
72498,220,80,80,80,0,0,460
72499,210,120,80,160,160,0,730
72500,190,120,0,0,0,0,310
72501,200,140,120,160,320,320,1260
72502,230,140,120,160,160,0,810
72503,160,100,120,80,160,0,620
72504,240,160,120,160,0,0,680
72505,210,140,120,160,320,0,950
72506,200,140,80,0,0,0,420
72507,210,100,80,0,0,0,390
72508,200,80,80,160,0,0,520
72509,190,140,120,160,160,320,1090
72510,240,120,80,80,0,0,520
72511,220,80,80,160,160,0,700
72512,190,120,80,80,0,0,470
72513,170,140,160,160,0,0,630
72514,170,120,120,160,320,320,1210
72515,180,120,120,80,160,0,660
72516,170,160,120,80,160,0,690
72517,160,80,120,160,0,0,520
72518,220,120,160,240,320,0,1060
72519,150,100,40,80,160,320,850
72520,230,120,160,160,320,320,1310
72521,190,160,120,240,320,320,1350
72522,210,100,120,0,0,0,430
72523,180,80,80,80,160,320,900
72524,180,80,40,0,0,0,300
72525,240,160,120,160,320,0,1000
72526,170,140,0,0,0,0,310
72527,160,80,120,80,160,0,600
72528,170,80,80,80,0,0,410
72529,200,140,120,240,160,0,860
72530,190,120,120,160,320,320,1230
72531,190,80,120,80,0,0,470
72532,160,180,200,80,0,0,620
72533,230,120,120,80,160,320,1030
72534,230,140,80,80,160,0,690
72535,180,140,120,240,160,0,840
72536,200,140,120,160,160,0,780
72537,210,80,40,80,0,0,410
72538,190,120,0,0,0,0,310
72539,230,80,80,80,0,0,470
72540,260,100,120,80,0,0,560
72541,190,120,120,160,0,0,590
72542,210,140,80,80,0,0,510
72543,170,100,80,160,160,0,670
72544,220,100,40,0,0,0,360
72545,200,120,120,160,160,0,760
72546,190,160,80,80,160,0,670
72547,160,120,80,80,160,320,920
72548,170,100,80,80,160,320,910
72549,190,80,80,80,0,0,430
72550,200,120,120,160,320,320,1240
72551,230,140,80,0,0,0,450
72552,230,140,80,80,0,0,530
72553,210,160,120,160,160,0,810
72554,220,140,120,160,160,320,1120
72555,180,140,40,80,0,0,440
72556,210,140,120,240,320,320,1350
72557,240,200,160,240,320,320,1480
72558,200,140,120,80,0,0,540
72559,180,60,80,80,0,0,400
72560,200,140,160,160,160,0,820
72561,190,120,120,80,160,0,670
72562,180,120,80,80,0,0,460
72563,210,120,80,0,0,0,410
72564,180,160,160,240,160,0,900
72565,220,140,80,0,0,0,440
72566,180,100,120,160,0,0,560
72567,240,140,160,0,0,0,540
72568,180,120,160,160,160,0,780
72569,200,100,80,80,160,0,620
72570,230,120,120,0,0,0,470
72571,250,160,160,80,160,0,810
72572,200,140,40,0,0,0,380
72573,220,100,120,160,320,0,920
72574,160,80,40,0,0,0,280
72575,210,140,160,160,160,0,830
72576,190,100,80,0,0,0,370
72577,190,220,200,160,320,0,1090
72578,210,140,80,0,0,0,430
72579,150,100,120,160,160,0,690
72580,230,80,80,160,320,0,870
72581,240,160,160,80,160,0,800
72582,180,120,40,0,0,0,340
72583,160,100,80,80,160,0,580
72584,220,160,160,80,160,0,780
72585,200,140,120,160,160,0,780
72586,190,120,160,160,320,0,950
72587,180,140,80,0,0,0,400
72588,190,120,80,80,0,0,470
72589,190,80,80,0,0,0,350
72590,210,160,80,160,320,0,930
72591,190,160,120,80,0,0,550
72592,210,120,80,80,160,0,650
72593,220,120,120,160,160,0,780
72594,200,120,80,80,160,0,640
72595,180,100,120,0,0,0,400
72596,180,80,40,80,160,0,540
72597,180,140,160,240,160,0,880
72598,200,100,40,0,0,0,340
72599,200,120,40,0,0,0,360
72600,190,120,160,80,160,0,710
72601,210,80,40,0,0,0,330
72602,190,120,80,80,0,0,470
72603,200,180,160,0,0,0,540
72604,190,100,120,0,0,0,410
72605,210,180,160,240,320,0,1110
72606,200,80,80,0,0,0,360
72607,160,80,120,160,0,0,520
72608,190,120,160,160,320,320,1270
72609,190,100,120,240,320,0,970
72610,200,140,120,80,160,0,700
72611,220,120,120,80,0,0,540
72612,230,180,120,160,320,0,1010
72613,170,140,80,80,160,0,630
72614,170,100,160,80,0,0,510
72615,170,120,80,160,320,0,850
72616,200,120,80,80,160,320,960
72617,210,180,160,160,320,0,1030
72618,230,160,160,160,320,0,1030
72619,190,80,80,80,160,0,590
72620,190,120,80,80,0,0,470
72621,180,100,40,0,0,0,320
72622,210,160,120,80,0,0,570
72623,200,60,40,0,0,0,300
72624,160,120,160,160,160,0,760
72625,160,40,80,160,320,0,760
72626,220,100,80,0,0,0,400
72627,190,120,40,80,160,0,590
72628,240,180,160,240,160,0,980
72629,200,140,160,240,320,320,1380
72630,180,120,40,80,0,0,420
72631,170,160,160,160,320,0,970
72632,240,140,120,160,160,0,820
72633,200,120,160,160,0,0,640
72634,190,120,120,80,0,0,510
72635,180,80,160,0,0,0,420
72636,190,60,0,0,0,0,250
72637,160,80,80,0,0,0,320
72638,190,100,40,0,0,0,330
72639,170,120,80,160,160,0,690
72640,180,140,80,80,0,0,480
72641,180,140,120,160,160,320,1080
72642,220,100,80,160,160,0,720
72643,230,180,240,240,160,0,1050
72644,170,120,80,80,0,0,450
72645,230,180,160,160,0,0,730
72646,220,80,80,160,320,0,860
72647,180,80,80,80,0,0,420
72648,180,160,160,160,320,0,980
72649,230,80,120,160,160,0,750
72650,190,100,160,80,0,0,530
72651,230,200,120,80,160,0,790
72652,160,120,80,80,160,0,600
72653,210,140,80,80,0,0,510
72654,180,100,160,160,160,0,760
72655,170,140,120,160,160,0,750
72656,230,120,120,80,0,0,550
72657,210,120,0,0,0,0,330
72658,220,180,80,160,160,0,800
72659,180,180,200,160,320,0,1040
72660,190,80,80,80,160,320,910
72661,170,120,80,80,0,0,450
72662,190,140,200,80,160,0,770
72663,160,120,160,80,0,0,520
72664,200,100,80,80,0,0,460
72665,210,140,120,80,160,0,710
72666,200,140,120,80,0,0,540
72667,150,100,80,160,160,0,650
72668,200,100,120,0,0,0,420
72669,220,180,120,80,160,0,760
72670,200,160,160,80,160,320,1080
72671,220,120,120,80,160,0,700
72672,160,60,120,240,160,320,1060
72673,190,140,80,160,0,0,570
72674,220,180,160,80,160,0,800
72675,260,140,120,0,0,0,520
72676,180,140,80,160,0,0,560
72677,230,180,160,160,320,0,1050
72678,180,120,120,160,320,0,900
72679,200,140,80,0,0,0,420
72680,130,80,40,80,0,0,330
72681,180,100,80,80,0,0,440
72682,200,180,160,80,160,320,1100
72683,240,100,80,160,160,320,1060
72684,200,140,40,0,0,0,380
72685,230,180,120,80,160,320,1090
72686,190,140,120,80,160,320,1010
72687,190,140,160,80,0,0,570
72688,170,100,40,0,0,0,310
72689,240,120,120,160,160,0,800
72690,170,100,80,80,160,320,910
72691,160,100,80,80,160,0,580
72692,180,180,200,80,160,0,800
72693,230,120,160,80,0,0,590
72694,200,160,80,80,160,0,680
72695,250,80,120,160,160,0,770
72696,250,140,80,80,0,0,550
72697,180,100,80,160,160,0,680
72698,190,100,80,0,0,0,370
72699,200,180,120,80,0,0,580
72700,160,160,160,160,160,0,800
72701,170,120,120,160,160,0,730
72702,230,160,80,0,0,0,470
72703,200,60,40,80,160,0,540
72704,180,160,120,160,160,320,1100
72705,190,100,40,0,0,0,330
72706,210,160,160,160,160,0,850
72707,190,100,80,160,160,0,690
72708,200,180,120,80,0,0,580
72709,180,200,160,80,0,0,620
72710,210,140,80,80,160,0,670
72711,190,140,120,80,0,0,530
72712,210,100,120,240,320,0,990
72713,200,160,160,160,160,0,840
72714,180,140,160,160,160,0,800
72715,190,100,160,80,0,0,530
72716,200,140,120,160,160,0,780
72717,170,100,120,80,0,0,470
72718,200,140,120,80,0,0,540
72719,210,140,120,0,0,0,470
72720,200,160,200,80,0,0,640
72721,200,100,80,80,0,0,460
72722,200,140,80,160,0,0,580
72723,240,100,40,0,0,0,380
72724,240,100,80,160,160,0,740
72725,230,80,40,80,160,0,590
72726,160,120,120,160,160,0,720
72727,220,100,120,80,160,0,680
72728,220,100,160,160,320,320,1280
72729,160,60,40,80,160,320,820
72730,230,140,120,160,320,0,970
72731,200,100,120,160,160,0,740
72732,210,120,40,0,0,0,370
72733,190,140,80,0,0,0,410
72734,230,120,40,0,0,0,390
72735,190,80,80,160,160,0,670
72736,160,100,120,160,320,0,860
72737,180,160,160,160,160,320,1140
72738,220,120,80,0,0,0,420
72739,200,220,160,160,320,0,1060
72740,230,140,120,160,320,320,1290
72741,230,100,40,80,160,320,930
72742,230,140,120,0,0,0,490
72743,200,180,80,80,0,0,540
72744,230,100,80,80,0,0,490
72745,220,140,160,0,0,0,520
72746,210,120,120,160,160,320,1090
72747,170,120,120,80,0,0,490
72748,230,120,120,160,160,0,790
72749,180,80,160,80,160,0,660
72750,190,100,120,240,160,0,810
72751,110,120,160,160,320,320,1190
72752,220,140,40,0,0,0,400
72753,200,100,120,160,160,0,740
72754,230,100,120,80,160,0,690
72755,240,100,80,80,160,320,980
72756,200,80,120,160,160,0,720
72757,210,80,40,80,160,0,570
72758,170,120,120,160,0,0,570
72759,220,100,40,0,0,0,360
72760,200,140,120,160,320,0,940
72761,230,200,200,80,160,0,870
72762,190,140,80,80,0,0,490
72763,200,180,80,0,0,0,460
72764,190,100,0,0,0,0,290
72765,250,200,160,80,0,0,690
72766,210,180,80,80,0,0,550
72767,200,140,200,160,320,0,1020
72768,210,100,40,0,0,0,350
72769,200,160,40,80,0,0,480
72770,190,100,120,160,160,0,730
72771,170,60,40,0,0,0,270
72772,220,180,120,0,0,0,520
72773,240,140,120,0,0,0,500
72774,170,100,120,240,160,320,1110
72775,210,80,80,80,0,0,450
72776,190,80,40,80,160,0,550
72777,170,160,160,80,0,0,570
72778,190,160,120,80,160,0,710
72779,190,160,160,80,0,0,590
72780,220,160,120,0,0,0,500
72781,190,100,80,80,0,0,450
72782,220,80,40,80,0,0,420
72783,170,100,120,160,160,0,710
72784,200,60,40,0,0,0,300
72785,210,120,80,80,0,0,490
72786,180,160,120,0,0,0,460
72787,180,80,80,80,0,0,420
72788,210,120,200,160,320,0,1010
72789,190,160,160,160,320,320,1310
72790,180,180,160,160,320,320,1320
72791,160,80,80,80,0,0,400
72792,220,140,160,160,320,0,1000
72793,210,140,160,160,320,0,990
72794,200,80,120,80,0,0,480
72795,190,140,120,160,0,0,610
72796,220,120,120,80,160,320,1020
72797,170,120,120,80,0,0,490
72798,190,140,80,80,0,0,490
72799,200,140,160,80,160,0,740
72800,220,180,160,80,160,0,800
72801,220,120,80,80,0,0,500
72802,210,100,40,0,0,0,350
72803,210,180,120,160,320,320,1310
72804,200,160,80,80,160,320,1000
72805,250,180,200,80,0,0,710
72806,160,120,160,80,0,0,520
72807,170,120,80,160,160,0,690
72808,200,120,80,80,160,0,640
72809,220,120,40,80,160,0,620
72810,200,100,120,80,160,0,660
72811,170,140,80,80,160,0,630
72812,200,160,40,80,0,0,480
72813,150,60,80,80,160,0,530
72814,210,200,120,160,0,0,690
72815,190,60,80,80,0,0,410
72816,230,80,80,80,160,0,630
72817,160,120,120,160,0,0,560
72818,210,120,40,0,0,0,370
72819,200,160,200,160,320,320,1360
72820,240,120,80,160,320,0,920
72821,210,120,160,160,320,320,1290
72822,220,140,200,160,320,0,1040
72823,200,160,80,160,160,0,760
72824,220,180,200,240,160,0,1000
72825,190,160,160,160,160,0,830
72826,200,120,80,80,160,0,640
72827,200,120,160,160,320,320,1280
72828,210,120,80,0,0,0,410
72829,230,120,80,0,0,0,430
72830,220,160,120,80,160,0,740
72831,200,120,40,0,0,0,360
72832,220,100,80,80,0,0,480
72833,210,100,120,80,160,320,990
72834,170,120,80,160,160,0,690
72835,250,140,80,160,160,320,1110
72836,210,200,120,160,160,0,850
72837,180,140,120,80,160,0,680
72838,220,80,120,160,160,0,740
72839,200,140,80,80,0,0,500
72840,230,140,120,240,160,0,890
72841,210,140,80,0,0,0,430
72842,190,100,120,80,160,0,650
72843,180,80,80,0,0,0,340
72844,210,100,120,80,160,0,670
72845,200,100,80,160,160,320,1020
72846,220,100,80,80,0,0,480
72847,200,60,0,0,0,0,260
72848,160,100,160,240,320,0,980
72849,220,180,160,160,0,0,720
72850,200,160,80,80,160,0,680
72851,130,100,80,160,160,0,630
72852,140,80,40,80,0,0,340
72853,200,140,120,80,160,320,1020
72854,180,140,80,0,0,0,400
72855,210,140,80,160,160,0,750
72856,160,80,120,160,160,0,680
72857,190,120,80,160,160,0,710
72858,220,120,160,160,0,0,660
72859,170,100,160,160,0,0,590
72860,240,140,120,160,160,0,820
72861,180,120,200,80,160,0,740
72862,190,80,80,160,320,320,1150
72863,230,180,160,80,160,320,1130
72864,190,100,40,80,160,0,570
72865,200,120,160,80,160,320,1040
72866,190,120,80,80,0,0,470
72867,210,140,40,0,0,0,390
72868,190,100,0,0,0,0,290
72869,190,120,40,80,0,0,430
72870,220,120,120,80,160,0,700
72871,140,60,40,0,0,0,240
72872,200,120,80,160,160,0,720
72873,200,140,80,160,320,320,1220
72874,170,120,80,80,160,0,610
72875,220,120,80,80,160,0,660
72876,210,80,120,80,160,0,650
72877,200,120,160,80,160,0,720
72878,200,100,120,160,160,320,1060
72879,220,160,160,80,160,320,1100
72880,200,100,80,80,0,0,460
72881,200,120,40,80,160,320,920
72882,260,80,120,160,320,0,940
72883,170,140,160,160,160,0,790
72884,200,100,40,0,0,0,340
72885,210,180,80,80,160,0,710
72886,180,80,40,0,0,0,300
72887,200,160,160,160,160,0,840
72888,220,100,120,240,160,320,1160
72889,200,120,120,80,160,320,1000
72890,230,200,120,160,320,320,1350
72891,220,120,160,80,160,320,1060
72892,140,60,80,160,320,0,760
72893,170,80,120,160,160,0,690
72894,160,80,80,80,0,0,400
72895,150,80,80,0,0,0,310
72896,170,140,160,80,0,0,550
72897,240,120,120,160,320,0,960
72898,170,140,120,160,0,0,590
72899,180,160,160,80,160,0,740
72900,190,140,160,160,0,0,650
72901,230,140,40,80,160,0,650
72902,200,160,120,160,160,0,800
72903,190,140,120,160,0,0,610
72904,220,120,80,0,0,0,420
72905,170,120,80,80,0,0,450
72906,150,120,120,80,0,0,470
72907,180,80,40,0,0,0,300
72908,230,120,80,80,160,0,670
72909,210,80,40,0,0,0,330
72910,230,160,200,240,320,320,1470
72911,180,160,120,160,0,0,620
72912,170,120,0,0,0,0,290
72913,170,120,160,160,160,0,770
72914,240,120,80,80,160,0,680
72915,180,100,160,80,160,0,680
72916,210,100,40,80,160,0,590
72917,240,180,240,160,320,320,1460
72918,200,160,120,0,0,0,480
72919,190,60,80,0,0,0,330
72920,190,100,80,80,0,0,450
72921,180,160,120,80,160,0,700
72922,200,80,40,80,160,0,560
72923,170,100,160,160,160,0,750
72924,170,100,120,80,160,320,950
72925,230,140,80,160,160,0,770
72926,190,100,40,80,0,0,410
72927,200,80,120,80,0,0,480
72928,180,120,120,160,160,320,1060
72929,220,120,80,80,0,0,500
72930,170,120,80,80,0,0,450
72931,240,100,80,80,160,0,660
72932,230,160,160,160,160,0,870
72933,170,140,80,80,0,0,470
72934,210,140,120,80,0,0,550
72935,220,140,120,160,320,0,960
72936,190,120,80,80,160,0,630
72937,170,100,120,160,160,0,710
72938,180,140,80,0,0,0,400
72939,190,100,40,80,0,0,410
72940,160,140,120,80,0,0,500
72941,210,80,40,0,0,0,330
72942,210,160,160,80,0,0,610
72943,160,80,40,0,0,0,280
72944,170,160,160,80,0,0,570
72945,200,100,120,160,160,320,1060
72946,180,120,120,160,160,0,740
72947,200,160,160,80,160,0,760
72948,210,140,120,160,160,0,790
72949,170,100,120,160,0,0,550
72950,220,200,160,160,320,0,1060
72951,160,120,40,80,160,0,560
72952,150,200,160,0,0,0,510
72953,210,100,120,160,320,0,910
72954,200,60,80,160,320,0,820
72955,200,100,80,160,0,0,540
72956,210,120,40,80,0,0,450
72957,210,160,120,160,320,320,1290
72958,230,180,120,80,160,0,770
72959,210,140,80,80,0,0,510
72960,180,80,80,80,160,320,900
72961,180,140,80,80,160,0,640
72962,200,80,120,80,0,0,480
72963,210,80,0,0,0,0,290
72964,220,140,120,80,0,0,560
72965,190,100,80,0,0,0,370
72966,240,140,80,80,160,320,1020
72967,230,160,160,160,320,0,1030
72968,180,80,120,160,160,320,1020
72969,170,140,120,0,0,0,430
72970,180,120,40,0,0,0,340
72971,180,80,120,0,0,0,380
72972,200,100,80,160,160,0,700
72973,200,140,200,160,160,0,860
72974,190,80,120,80,160,0,630
72975,170,80,40,80,160,0,530
72976,220,160,200,160,160,0,900
72977,180,100,80,160,0,0,520
72978,230,140,160,160,0,0,690
72979,160,120,40,0,0,0,320
72980,170,40,40,80,160,0,490
72981,170,160,120,80,160,0,690
72982,180,100,120,80,0,0,480
72983,220,160,120,80,160,0,740
72984,200,80,80,0,0,0,360
72985,210,120,80,160,160,0,730
72986,160,120,80,80,160,0,600
72987,180,60,80,80,160,0,560
72988,170,180,80,80,0,0,510
72989,180,160,120,80,160,0,700
72990,190,80,80,0,0,0,350
72991,160,140,40,80,160,0,580
72992,180,100,160,240,320,320,1320
72993,190,140,80,80,160,320,970
72994,200,140,120,160,320,320,1260
72995,190,120,160,80,160,0,710
72996,140,100,120,0,0,0,360
72997,220,120,80,80,160,0,660
72998,170,80,80,80,0,0,410
72999,190,140,120,160,320,0,930
73000,230,100,80,80,160,0,650
73001,210,160,160,160,0,0,690
73002,200,180,160,160,160,0,860
73003,200,140,120,80,160,0,700
73004,190,100,120,160,320,0,890
73005,230,180,120,0,0,0,530
73006,200,180,160,240,320,320,1420
73007,210,100,80,80,160,0,630
73008,230,140,80,80,0,0,530
73009,190,120,200,160,160,0,830
73010,190,80,80,80,160,0,590
73011,210,140,120,80,0,0,550
73012,190,140,160,160,0,0,650
73013,220,140,120,80,160,320,1040
73014,180,120,80,160,160,0,700
73015,180,100,80,160,160,320,1000
73016,210,100,120,80,160,0,670
73017,230,120,120,160,0,0,630
73018,190,120,160,160,0,0,630
73019,230,100,120,160,0,0,610
73020,260,80,40,80,0,0,460
73021,150,140,120,80,160,0,650
73022,240,160,80,80,0,0,560
73023,200,140,120,160,320,0,940
73024,190,100,120,160,0,0,570
73025,200,60,120,80,0,0,460
73026,200,120,80,80,160,0,640
73027,220,140,120,160,320,320,1280
73028,210,160,80,160,0,0,610
73029,180,80,80,160,320,320,1140
73030,170,100,160,80,160,0,670
73031,210,120,120,80,0,0,530
73032,210,140,120,160,160,0,790
73033,220,120,200,240,320,0,1100
73034,230,140,40,0,0,0,410
73035,180,120,80,80,0,0,460
73036,180,140,160,160,0,0,640
73037,220,140,160,240,160,0,920
73038,180,80,80,80,160,0,580
73039,190,140,160,160,0,0,650
73040,160,40,40,0,0,0,240
73041,180,100,80,80,0,0,440
73042,210,200,200,0,0,0,610
73043,210,120,160,160,160,0,810
73044,220,120,80,160,0,0,580
73045,190,160,120,160,160,0,790
73046,200,140,160,160,320,0,980
73047,200,160,80,80,160,0,680
73048,220,180,80,80,160,320,1040
73049,160,140,120,160,160,0,740
73050,230,140,120,80,160,0,730
73051,220,160,120,160,160,0,820
73052,200,120,160,240,320,0,1040
73053,170,120,40,80,0,0,410
73054,170,120,80,160,320,0,850
73055,200,100,0,0,0,0,300
73056,170,80,80,160,160,0,650
73057,150,160,160,80,0,0,550
73058,180,120,120,0,0,0,420
73059,190,80,120,80,0,0,470
73060,220,100,120,160,320,320,1240
73061,210,120,160,80,0,0,570
73062,160,140,120,160,160,0,740
73063,200,80,80,160,160,0,680
73064,200,180,80,80,0,0,540
73065,220,140,120,80,0,0,560
73066,170,80,120,80,0,0,450
73067,220,100,40,0,0,0,360
73068,200,140,120,80,0,0,540
73069,200,100,80,160,160,0,700
73070,240,160,120,80,160,0,760
73071,210,120,120,160,320,0,930
73072,190,80,0,0,0,0,270
73073,180,100,80,80,160,0,600
73074,180,160,160,160,0,0,660
73075,250,140,120,240,160,0,910
73076,180,120,160,80,0,0,540
73077,200,80,40,80,0,0,400
73078,210,160,120,160,0,0,650
73079,190,120,120,80,160,320,990
73080,190,160,120,0,0,0,470
73081,200,80,120,160,160,0,720
73082,210,120,120,160,320,320,1250
73083,210,140,80,160,160,0,750
73084,200,80,120,80,160,0,640
73085,170,60,80,160,160,0,630
73086,200,120,40,80,160,0,600
73087,190,180,120,80,0,0,570
73088,230,160,80,160,320,0,950
73089,200,140,40,80,0,0,460
73090,200,100,80,80,0,0,460
73091,270,180,200,240,320,0,1210
73092,170,80,80,80,160,0,570
73093,200,140,160,160,0,0,660
73094,250,160,80,80,160,0,730
73095,240,220,160,240,0,0,860
73096,230,120,120,80,160,0,710
73097,200,120,120,80,160,0,680
73098,190,160,160,160,160,0,830
73099,200,160,80,80,160,0,680
73100,220,140,120,240,160,0,880
73101,190,100,160,80,160,0,690
73102,210,180,160,160,0,0,710
73103,180,80,120,0,0,0,380
73104,200,120,120,80,160,0,680
73105,230,120,80,80,160,320,990
73106,190,80,80,80,0,0,430
73107,200,140,120,80,160,0,700
73108,230,180,40,0,0,0,450
73109,180,100,80,80,160,0,600
73110,240,140,120,160,320,0,980
73111,190,120,120,80,0,0,510
73112,190,100,80,80,160,0,610
73113,210,100,40,0,0,0,350
73114,210,120,80,160,160,0,730
73115,170,80,120,160,160,0,690
73116,190,140,40,0,0,0,370
73117,190,160,80,160,160,0,750
73118,240,100,80,160,160,0,740
73119,180,140,120,80,160,0,680
73120,180,160,40,0,0,0,380
73121,180,200,240,160,160,0,940
73122,160,120,80,80,160,0,600
73123,200,160,200,80,160,320,1120
73124,170,140,200,240,160,0,910
73125,190,140,200,240,160,0,930
73126,200,80,160,80,160,320,1000
73127,240,160,80,80,160,0,720
73128,230,160,80,80,0,0,550
73129,200,160,120,80,160,0,720
73130,160,80,80,160,320,0,800
73131,180,140,160,160,160,0,800
73132,160,140,120,80,160,0,660
73133,210,160,120,240,320,0,1050
73134,160,100,120,0,0,0,380
73135,170,120,120,80,160,320,970
73136,210,160,160,80,0,0,610
73137,220,180,120,80,0,0,600
73138,160,120,40,0,0,0,320
73139,220,180,120,80,0,0,600
73140,230,140,120,80,0,0,570
73141,220,120,80,160,160,0,740
73142,190,80,40,80,160,320,870
73143,200,80,40,80,0,0,400
73144,180,120,40,80,160,0,580
73145,220,140,120,80,0,0,560
73146,210,100,80,160,0,0,550
73147,200,100,120,80,160,0,660
73148,200,140,200,160,0,0,700
73149,190,60,40,80,160,0,530
73150,210,180,120,160,320,320,1310
73151,240,140,80,80,0,0,540
73152,170,100,80,80,0,0,430
73153,200,140,160,80,160,0,740
73154,190,140,160,240,160,0,890
73155,190,80,0,0,0,0,270
73156,180,120,120,80,160,0,660
73157,190,100,120,80,160,320,970
73158,220,140,200,240,160,0,960
73159,190,120,120,160,160,0,750
73160,200,100,120,80,0,0,500
73161,230,160,120,80,160,0,750
73162,200,120,0,0,0,0,320
73163,200,80,40,0,0,0,320
73164,170,120,120,160,160,0,730
73165,200,80,80,80,160,0,600
73166,180,100,0,0,0,0,280
73167,210,180,80,80,160,0,710
73168,200,120,120,240,160,0,840
73169,200,160,160,80,160,0,760
73170,130,100,160,80,0,0,470
73171,200,120,40,80,0,0,440
73172,210,140,160,160,320,0,990
73173,250,140,80,0,0,0,470
73174,220,180,120,160,160,0,840
73175,190,120,40,0,0,0,350
73176,180,80,80,80,0,0,420
73177,230,80,80,160,320,320,1190
73178,200,120,40,80,160,0,600
73179,230,80,120,0,0,0,430
73180,190,100,120,80,160,0,650
73181,210,140,120,240,320,0,1030
73182,230,80,80,160,160,0,710
73183,220,180,120,80,0,0,600
73184,220,180,120,160,320,0,1000
73185,190,140,80,160,160,0,730
73186,200,120,80,80,0,0,480
73187,190,120,160,240,160,0,870
73188,220,160,80,160,160,0,780
73189,190,160,120,80,160,0,710
73190,190,140,200,80,0,0,610
73191,180,160,240,240,160,0,980
73192,240,120,120,80,160,0,720
73193,200,20,0,0,0,0,220
73194,230,120,120,240,160,0,870
73195,180,100,40,80,160,0,560
73196,230,120,80,80,160,0,670
73197,220,160,160,160,160,0,860
73198,220,120,80,80,160,0,660
73199,190,140,40,80,160,0,610
73200,200,100,120,80,160,0,660
73201,160,100,120,80,0,0,460
73202,180,120,80,160,160,320,1020
73203,190,160,120,80,160,0,710
73204,230,120,80,80,0,0,510
73205,170,60,80,0,0,0,310
73206,190,80,80,80,0,0,430
73207,170,100,80,0,0,0,350
73208,170,80,80,0,0,0,330
73209,200,140,80,160,320,0,900
73210,210,120,80,80,160,0,650
73211,210,80,120,0,0,0,410
73212,220,80,120,80,0,0,500
73213,180,80,40,0,0,0,300
73214,180,60,80,160,320,0,800
73215,220,140,80,160,160,0,760
73216,210,140,200,160,320,320,1350
73217,200,160,80,80,160,0,680
73218,210,100,40,80,160,0,590
73219,190,140,200,80,160,0,770
73220,230,140,160,80,160,0,770
73221,170,120,40,80,160,0,570
73222,190,120,120,160,320,0,910
73223,160,100,120,0,0,0,380
73224,230,180,120,80,160,0,770
73225,210,60,120,80,160,320,950
73226,210,120,80,160,160,0,730
73227,190,140,120,160,320,0,930
73228,190,120,80,80,0,0,470
73229,210,100,160,160,0,0,630
73230,210,160,240,160,160,0,930
73231,240,120,40,80,160,0,640
73232,200,100,120,80,160,0,660
73233,190,120,80,160,160,0,710
73234,170,80,40,80,160,0,530
73235,220,140,120,80,160,0,720
73236,190,140,120,80,160,320,1010
73237,170,60,80,0,0,0,310
73238,210,160,160,240,320,320,1410
73239,190,120,160,80,0,0,550
73240,200,160,200,240,160,0,960
73241,210,100,40,80,0,0,430
73242,160,100,80,80,0,0,420
73243,180,100,160,160,160,0,760
73244,180,120,200,160,0,0,660
73245,220,160,40,80,160,0,660
73246,170,100,40,0,0,0,310
73247,190,120,120,80,160,0,670
73248,210,120,80,80,160,0,650
73249,170,120,160,160,160,0,770
73250,240,100,40,80,0,0,460
73251,200,80,120,80,160,0,640
73252,150,60,120,0,0,0,330
73253,210,120,120,160,160,320,1090
73254,200,60,40,0,0,0,300
73255,190,120,80,0,0,0,390
73256,180,120,40,0,0,0,340
73257,220,140,80,80,0,0,520
73258,200,80,120,80,160,320,960
73259,190,120,120,160,160,0,750
73260,190,60,0,0,0,0,250
73261,200,160,120,80,160,0,720
73262,190,120,120,160,160,0,750
73263,230,120,120,80,160,0,710
73264,230,140,160,160,320,0,1010
73265,220,80,40,0,0,0,340
73266,170,60,80,80,160,0,550
73267,220,140,160,240,320,320,1400
73268,160,100,40,80,160,0,540
73269,210,120,120,80,0,0,530
73270,220,140,80,160,0,0,600
73271,240,100,80,0,0,0,420
73272,200,140,160,80,0,0,580
73273,180,160,120,80,0,0,540
73274,230,160,160,0,0,0,550
73275,250,160,200,240,160,0,1010
73276,210,180,200,80,160,0,830
73277,200,100,120,80,160,0,660
73278,160,140,200,80,160,320,1060
73279,190,100,80,80,0,0,450
73280,160,120,80,80,160,320,920
73281,180,120,80,80,0,0,460
73282,160,120,120,80,160,0,640
73283,220,160,80,80,160,0,700
73284,210,160,120,80,160,0,730
73285,200,140,40,0,0,0,380
73286,220,140,40,80,160,320,960
73287,240,160,120,240,160,0,920
73288,230,140,80,80,0,0,530
73289,210,40,40,80,160,0,530
73290,160,120,160,80,0,0,520
73291,230,140,120,160,160,0,810
73292,220,120,80,80,160,0,660
73293,220,160,120,160,160,0,820
73294,220,120,160,160,320,320,1300
73295,180,80,80,0,0,0,340
73296,160,100,80,80,0,0,420
73297,200,120,0,0,0,0,320
73298,190,120,120,80,160,320,990
73299,160,160,120,160,160,0,760
73300,190,140,40,0,0,0,370
73301,180,80,80,160,0,0,500
73302,160,100,80,80,160,0,580
73303,220,140,40,80,0,0,480
73304,230,100,80,80,160,0,650
73305,150,160,160,160,160,0,790
73306,220,140,120,160,160,0,800
73307,180,100,120,240,320,320,1280
73308,230,120,80,160,160,0,750
73309,190,120,80,160,160,320,1030
73310,200,120,80,80,160,0,640
73311,220,160,80,0,0,0,460
73312,240,160,160,80,0,0,640
73313,180,100,40,0,0,0,320
73314,160,100,80,80,160,0,580
73315,240,180,200,80,0,0,700
73316,190,80,40,0,0,0,310
73317,190,80,40,0,0,0,310
73318,190,160,80,80,160,0,670
73319,200,140,200,160,320,0,1020
73320,220,180,120,160,0,0,680
73321,200,100,0,0,0,0,300
73322,210,160,160,160,0,0,690
73323,210,40,40,80,160,0,530
73324,210,100,160,160,160,0,790
73325,200,120,40,0,0,0,360
73326,210,100,80,160,320,0,870
73327,200,140,120,80,0,0,540
73328,190,140,120,80,0,0,530
73329,160,120,80,80,0,0,440
73330,210,120,80,80,0,0,490
73331,190,140,80,0,0,0,410
73332,220,120,120,80,0,0,540
73333,210,120,80,80,160,0,650
73334,220,100,120,160,160,320,1080
73335,230,60,0,0,0,0,290
73336,200,100,80,80,0,0,460
73337,240,80,80,80,160,0,640
73338,180,80,120,240,160,320,1100
73339,200,160,160,240,320,0,1080
73340,200,100,160,240,160,0,860
73341,180,140,80,160,320,0,880
73342,210,120,160,160,160,320,1130
73343,200,160,160,240,320,0,1080
73344,190,160,120,160,160,0,790
73345,220,120,40,0,0,0,380
73346,200,120,80,80,0,0,480
73347,210,160,200,160,0,0,730
73348,180,140,120,80,160,0,680
73349,170,140,120,80,160,320,990
73350,180,120,80,80,0,0,460
73351,200,140,120,0,0,0,460
73352,140,80,120,80,160,0,580
73353,170,100,80,0,0,0,350
73354,210,80,120,80,0,0,490
73355,190,120,40,0,0,0,350
73356,160,100,120,0,0,0,380
73357,190,140,120,80,160,0,690
73358,200,120,160,80,160,320,1040
73359,240,140,120,0,0,0,500
73360,140,100,80,80,160,0,560
73361,210,80,40,0,0,0,330
73362,180,120,120,80,160,0,660
73363,150,80,0,0,0,0,230
73364,170,60,80,160,160,0,630
73365,140,80,120,0,0,0,340
73366,150,100,80,80,160,0,570
73367,210,160,160,160,320,0,1010
73368,230,180,160,160,0,0,730
73369,220,120,40,80,160,320,940
73370,190,140,80,0,0,0,410
73371,190,120,120,160,0,0,590
73372,210,100,160,0,0,0,470
73373,220,120,120,80,160,0,700
73374,170,100,40,0,0,0,310
73375,200,120,120,80,160,320,1000
73376,190,120,160,160,0,0,630
73377,220,120,160,80,160,0,740
73378,230,140,80,80,160,0,690
73379,200,100,80,160,0,0,540
73380,120,60,40,80,160,0,460
73381,190,80,120,80,160,0,630
73382,190,100,120,80,160,0,650
73383,190,100,120,80,160,0,650
73384,200,140,120,160,0,0,620
73385,190,120,80,160,160,0,710
73386,200,180,80,0,0,0,460
73387,190,120,120,160,160,0,750
73388,180,140,120,160,0,0,600
73389,180,60,80,160,160,0,640
73390,190,180,160,240,160,0,930
73391,190,100,80,80,160,0,610
73392,170,100,0,0,0,0,270
73393,240,100,80,160,0,0,580
73394,190,180,160,80,160,0,770
73395,200,160,160,160,160,0,840
73396,220,200,160,0,0,0,580
73397,180,120,120,0,0,0,420
73398,160,140,160,80,160,0,700
73399,220,120,80,80,160,320,980
73400,170,120,80,160,160,0,690
73401,240,140,120,160,160,0,820
73402,220,160,40,80,0,0,500
73403,190,100,120,160,320,320,1210
73404,170,100,80,0,0,0,350
73405,230,60,80,160,160,0,690
73406,190,80,40,80,160,0,550
73407,210,100,80,80,0,0,470
73408,200,200,160,0,0,0,560
73409,200,120,40,0,0,0,360
73410,190,60,40,80,160,0,530
73411,220,80,80,80,0,0,460
73412,240,140,80,80,0,0,540
73413,180,160,120,80,160,0,700
73414,150,40,80,0,0,0,270
73415,210,180,160,160,0,0,710
73416,230,160,120,80,0,0,590
73417,210,140,120,160,320,0,950
73418,160,60,80,80,160,0,540
73419,220,140,120,80,0,0,560
73420,210,160,200,160,160,0,890
73421,150,140,160,80,160,0,690
73422,250,180,120,80,0,0,630
73423,180,120,80,80,160,0,620
73424,230,100,80,160,160,0,730
73425,210,140,80,80,0,0,510
73426,240,140,120,80,160,0,740
73427,210,180,160,160,0,0,710
73428,200,100,40,80,160,0,580
73429,200,100,120,80,160,0,660
73430,180,160,80,160,320,320,1220
73431,250,200,160,80,0,0,690
73432,210,120,200,160,0,0,690
73433,170,120,80,80,160,0,610
73434,160,80,40,0,0,0,280
73435,210,140,160,80,160,0,750
73436,170,120,40,80,160,320,890
73437,200,100,120,160,0,0,580
73438,190,160,200,240,160,320,1270
73439,240,160,200,80,160,0,840
73440,200,140,80,0,0,0,420
73441,190,140,120,160,160,0,770
73442,180,80,40,80,0,0,380
73443,180,80,120,80,0,0,460
73444,200,140,160,80,160,320,1060
73445,210,140,120,80,160,0,710
73446,210,180,80,80,160,320,1030
73447,210,120,80,160,320,320,1210
73448,220,100,80,80,0,0,480
73449,210,100,120,0,0,0,430
73450,210,180,160,240,160,0,950
73451,240,140,80,0,0,0,460
73452,210,100,120,80,0,0,510
73453,210,140,160,80,160,0,750
73454,200,60,40,80,160,320,860
73455,200,100,80,80,160,0,620
73456,190,120,120,80,160,320,990
73457,230,100,80,80,160,320,970
73458,230,160,120,160,160,0,830
73459,190,100,120,80,0,0,490
73460,180,100,120,160,160,0,720
73461,180,100,160,80,0,0,520
73462,170,180,160,0,0,0,510
73463,210,140,80,80,160,0,670
73464,150,100,120,240,160,0,770
73465,190,100,40,80,160,0,570
73466,160,120,80,160,160,0,680
73467,190,140,120,0,0,0,450
73468,160,160,160,160,320,0,960
73469,230,140,160,160,320,0,1010
73470,170,140,160,160,160,0,790
73471,170,60,40,80,0,0,350
73472,190,160,160,160,160,0,830
73473,180,100,40,80,160,0,560
73474,170,80,80,0,0,0,330
73475,190,80,0,0,0,0,270
73476,190,120,40,80,160,0,590
73477,200,140,80,80,160,0,660
73478,180,160,120,160,320,320,1260
73479,150,160,120,80,160,0,670
73480,230,180,160,80,0,0,650
73481,210,140,80,80,160,0,670
73482,170,120,120,80,0,0,490
73483,170,60,40,80,0,0,350
73484,210,120,160,0,0,0,490
73485,170,160,160,80,0,0,570
73486,170,100,40,0,0,0,310
73487,200,120,40,80,0,0,440
73488,180,100,80,160,160,0,680
73489,200,120,120,160,320,0,920
73490,210,180,120,160,0,0,670
73491,230,60,40,80,160,0,570
73492,210,140,160,80,0,0,590
73493,260,140,160,0,0,0,560
73494,190,60,40,0,0,0,290
73495,210,40,0,0,0,0,250
73496,210,60,40,0,0,0,310
73497,170,140,160,240,160,320,1190
73498,190,120,120,80,160,0,670
73499,190,140,120,0,0,0,450
73500,190,100,160,240,160,0,850
73501,190,140,80,80,160,0,650
73502,240,140,120,80,0,0,580
73503,230,100,80,80,160,0,650
73504,220,160,120,80,160,0,740
73505,180,100,120,160,0,0,560
73506,150,80,160,160,160,320,1030
73507,200,140,80,0,0,0,420
73508,210,80,80,80,160,0,610
73509,200,120,160,80,160,0,720
73510,220,140,80,80,160,0,680
73511,200,60,80,80,160,0,580
73512,160,160,160,160,160,0,800
73513,220,180,160,160,0,0,720
73514,190,100,120,160,160,0,730
73515,190,60,0,0,0,0,250
73516,180,160,120,160,160,0,780
73517,210,160,80,80,160,0,690
73518,190,80,120,80,160,0,630
73519,200,140,40,0,0,0,380
73520,190,120,160,160,160,0,790
73521,150,100,0,0,0,0,250
73522,230,120,120,160,320,320,1270
73523,200,140,120,160,160,0,780
73524,220,100,120,160,160,0,760
73525,170,60,40,80,160,0,510
73526,140,140,160,240,320,320,1320
73527,190,80,80,0,0,0,350
73528,220,160,80,160,160,0,780
73529,170,140,160,160,160,320,1110
73530,190,100,80,80,160,320,930
73531,210,120,120,80,160,0,690
73532,200,140,120,80,0,0,540
73533,170,60,40,0,0,0,270
73534,210,140,80,0,0,0,430
73535,180,40,40,80,160,0,500
73536,250,160,120,0,0,0,530
73537,150,20,40,80,160,320,770
73538,200,80,80,160,160,0,680
73539,240,100,160,160,160,0,820
73540,200,140,120,160,320,0,940
73541,210,140,80,80,0,0,510
73542,210,160,160,240,160,0,930
73543,200,100,120,160,320,0,900
73544,210,100,80,80,160,0,630
73545,170,120,120,0,0,0,410
73546,180,100,160,240,160,0,840
73547,230,120,80,160,160,0,750
73548,170,80,40,80,0,0,370
73549,200,140,160,160,0,0,660
73550,230,140,80,0,0,0,450
73551,190,200,160,0,0,0,550
73552,180,160,80,160,320,320,1220
73553,240,140,200,80,160,0,820
73554,210,140,200,80,160,0,790
73555,220,160,160,160,160,0,860
73556,240,120,40,0,0,0,400
73557,180,140,120,160,160,0,760
73558,240,160,160,160,0,0,720
73559,200,140,120,80,0,0,540
73560,270,160,80,80,0,0,590
73561,200,80,40,80,160,0,560
73562,220,80,0,0,0,0,300
73563,220,160,80,80,160,0,700
73564,200,120,120,160,160,0,760
73565,210,200,80,160,160,0,810
73566,190,120,0,0,0,0,310
73567,200,160,120,160,160,320,1120
73568,200,140,80,80,160,0,660
73569,190,100,120,240,160,0,810
73570,190,120,80,80,160,320,950
73571,200,180,160,160,320,0,1020
73572,190,160,160,80,160,0,750
73573,260,120,80,80,0,0,540
73574,200,100,120,80,160,0,660
73575,190,100,40,80,0,0,410
73576,220,120,40,0,0,0,380
73577,160,80,40,0,0,0,280
73578,200,100,80,80,160,0,620
73579,150,80,80,0,0,0,310
73580,220,80,120,80,160,0,660
73581,210,140,80,80,0,0,510
73582,170,140,40,0,0,0,350
73583,230,180,80,160,160,320,1130
73584,190,100,40,80,160,0,570
73585,130,60,40,80,160,0,470
73586,180,80,80,0,0,0,340
73587,190,80,80,80,160,0,590
73588,250,160,160,240,160,320,1290
73589,200,120,120,160,160,0,760
73590,170,100,40,80,0,0,390
73591,200,120,120,160,160,0,760
73592,160,60,40,80,160,0,500
73593,210,180,160,80,160,0,790
73594,190,140,120,80,0,0,530
73595,200,140,120,0,0,0,460
73596,220,80,80,80,160,320,940
73597,230,100,80,0,0,0,410
73598,240,120,120,160,0,0,640
73599,210,160,160,160,160,320,1170
73600,240,140,160,0,0,0,540
73601,230,80,80,80,160,0,630
73602,180,100,80,160,320,0,840
73603,170,120,80,80,160,0,610
73604,190,120,80,160,160,0,710
73605,190,80,120,80,160,320,950
73606,180,60,80,80,160,0,560
73607,220,100,80,80,0,0,480
73608,190,160,80,80,160,320,990
73609,210,100,40,80,160,0,590
73610,160,120,120,0,0,0,400
73611,190,120,120,160,0,0,590
73612,210,160,80,80,160,0,690
73613,250,140,120,160,160,0,830
73614,230,140,120,160,320,0,970
73615,210,100,80,160,160,0,710
73616,210,140,120,80,160,0,710
73617,200,100,80,0,0,0,380
73618,190,140,120,0,0,0,450
73619,210,140,120,240,320,320,1350
73620,210,180,200,160,160,0,910
73621,210,160,200,80,0,0,650
73622,170,80,160,160,160,0,730
73623,190,100,80,80,160,0,610
73624,190,100,40,0,0,0,330
73625,210,160,160,0,0,0,530
73626,180,140,120,160,160,0,760
73627,240,140,120,160,320,0,980
73628,210,100,160,0,0,0,470
73629,180,100,120,0,0,0,400
73630,220,140,160,80,160,0,760
73631,220,220,160,160,320,0,1080
73632,180,80,40,80,160,0,540
73633,170,140,120,160,0,0,590
73634,190,120,80,80,0,0,470
73635,190,140,160,80,0,0,570
73636,190,100,40,0,0,0,330
73637,160,120,160,80,160,0,680
73638,180,100,80,80,160,0,600
73639,210,140,120,80,0,0,550
73640,230,140,160,80,160,0,770
73641,180,120,40,0,0,0,340
73642,230,160,120,80,0,0,590
73643,190,120,120,80,160,0,670
73644,230,160,120,80,160,0,750
73645,230,160,160,160,0,0,710
73646,190,100,40,80,160,0,570
73647,190,120,80,160,160,0,710
73648,180,140,120,160,320,0,920
73649,170,60,80,160,160,0,630
73650,210,120,120,80,160,0,690
73651,260,140,80,160,0,0,640
73652,170,100,40,80,160,0,550
73653,200,140,120,160,320,0,940
73654,200,160,120,160,320,320,1280
73655,160,120,120,160,320,320,1200
73656,170,120,80,80,160,0,610
73657,160,80,40,0,0,0,280
73658,210,80,120,80,0,0,490
73659,190,180,120,0,0,0,490
73660,200,160,120,80,0,0,560
73661,190,140,120,160,320,320,1250
73662,180,120,160,160,320,0,940
73663,180,100,120,160,320,0,880
73664,200,140,160,80,160,0,740
73665,180,80,80,80,160,0,580
73666,200,120,160,160,0,0,640
73667,170,40,40,0,0,0,250
73668,210,160,80,80,160,320,1010
73669,180,100,40,80,160,0,560
73670,150,140,80,80,0,0,450
73671,260,60,80,160,320,320,1200
73672,180,100,80,160,320,0,840
73673,220,140,120,80,0,0,560
73674,210,120,120,160,160,320,1090
73675,190,140,40,80,160,0,610
73676,190,160,120,160,320,0,950
73677,130,100,120,160,0,0,510
73678,170,80,80,160,160,0,650
73679,180,120,160,160,160,0,780
73680,220,120,80,160,320,0,900
73681,220,120,120,160,320,0,940
73682,200,140,160,240,320,0,1060
73683,170,80,120,160,320,0,850
73684,200,120,120,0,0,0,440
73685,190,100,80,80,160,320,930
73686,190,100,80,160,160,0,690
73687,190,160,200,160,320,0,1030
73688,190,160,80,0,0,0,430
73689,230,160,160,240,320,0,1110
73690,200,100,120,80,160,0,660
73691,260,180,120,80,160,0,800
73692,140,100,80,160,320,320,1120
73693,210,160,120,80,160,0,730
73694,190,100,160,80,160,0,690
73695,210,120,120,80,0,0,530
73696,210,120,120,160,160,0,770
73697,180,60,80,160,320,0,800
73698,180,120,80,80,160,320,940
73699,200,100,80,0,0,0,380
73700,190,100,40,0,0,0,330
73701,210,140,40,80,0,0,470
73702,270,120,120,240,320,0,1070
73703,170,160,120,160,160,0,770
73704,220,120,120,80,160,0,700
73705,200,100,120,240,160,320,1140
73706,190,120,160,80,160,0,710
73707,170,120,160,80,0,0,530
73708,180,120,120,80,160,320,980
73709,210,60,40,80,160,0,550
73710,120,120,160,240,160,0,800
73711,220,140,40,0,0,0,400
73712,210,120,120,80,0,0,530
73713,180,100,40,80,160,0,560
73714,210,140,120,160,320,320,1270
73715,220,140,120,240,320,0,1040
73716,170,120,120,160,160,0,730
73717,190,80,80,80,0,0,430
73718,200,100,120,0,0,0,420
73719,160,100,80,80,160,320,900
73720,220,140,120,160,0,0,640
73721,200,80,40,80,160,0,560
73722,200,140,200,160,160,0,860
73723,200,140,40,80,160,0,620
73724,190,140,200,160,160,0,850
73725,190,100,40,0,0,0,330
73726,180,120,120,0,0,0,420
73727,240,180,160,80,0,0,660
73728,210,100,80,160,0,0,550
73729,210,180,120,80,0,0,590
73730,190,120,160,160,160,320,1110
73731,200,100,40,80,0,0,420
73732,220,120,80,80,0,0,500
73733,190,120,120,160,320,0,910
73734,230,100,120,160,320,0,930
73735,210,140,160,240,0,0,750
73736,240,120,160,240,0,0,760
73737,220,140,120,80,0,0,560
73738,170,60,80,80,160,0,550
73739,170,80,80,0,0,0,330
73740,210,120,120,80,160,0,690
73741,210,160,120,160,160,320,1130
73742,260,200,200,240,320,320,1540
73743,190,120,80,80,0,0,470
73744,160,120,80,160,160,0,680
73745,220,140,80,80,0,0,520
73746,210,80,80,0,0,0,370
73747,190,140,120,80,160,320,1010
73748,210,100,120,80,160,0,670
73749,210,100,160,160,320,0,950
73750,210,160,120,0,0,0,490
73751,170,80,80,0,0,0,330
73752,180,180,240,160,160,320,1240
73753,190,140,160,80,0,0,570
73754,210,80,80,80,160,0,610
73755,230,120,200,240,160,0,950
73756,190,100,80,80,0,0,450
73757,170,120,80,80,160,0,610
73758,200,60,40,0,0,0,300
73759,180,80,80,160,320,0,820
73760,210,160,80,80,160,0,690
73761,180,60,80,80,0,0,400
73762,210,160,80,80,160,0,690
73763,220,100,40,80,160,0,600
73764,250,180,80,80,160,0,750
73765,220,100,80,160,320,320,1200
73766,240,140,80,80,0,0,540
73767,200,120,160,240,160,320,1200
73768,190,140,160,160,160,320,1130
73769,210,100,80,160,320,0,870
73770,180,80,80,160,160,0,660
73771,210,100,80,0,0,0,390
73772,190,140,120,80,0,0,530
73773,210,120,40,0,0,0,370
73774,190,100,80,80,160,0,610
73775,210,120,120,80,0,0,530
73776,220,160,80,80,160,0,700
73777,200,120,120,80,0,0,520
73778,170,140,160,240,320,0,1030
73779,230,120,80,80,0,0,510
73780,170,140,80,80,160,0,630
73781,190,80,40,80,160,320,870
73782,210,120,80,0,0,0,410
73783,190,160,80,80,160,0,670
73784,210,100,40,80,160,0,590
73785,220,160,80,0,0,0,460
73786,180,200,160,160,160,0,860
73787,160,120,80,160,320,0,840
73788,210,180,80,80,0,0,550
73789,220,120,120,160,160,0,780
73790,220,140,160,160,160,0,840
73791,180,100,160,80,0,0,520
73792,200,160,160,0,0,0,520
73793,240,140,160,160,320,0,1020
73794,200,160,40,80,160,320,960
73795,180,120,120,160,320,320,1220
73796,230,120,160,160,160,0,830
73797,200,120,120,160,160,0,760
73798,220,160,160,240,160,0,940
73799,210,120,40,80,0,0,450
73800,220,80,120,160,160,0,740
73801,210,80,120,160,320,0,890
73802,220,140,120,80,0,0,560
73803,190,60,80,160,160,0,650
73804,240,100,80,80,160,0,660
73805,210,140,80,80,160,0,670
73806,170,120,0,0,0,0,290
73807,170,60,80,160,160,0,630
73808,200,60,0,0,0,0,260
73809,220,160,80,160,0,0,620
73810,200,120,120,160,160,0,760
73811,180,60,80,160,160,0,640
73812,220,160,120,80,160,0,740
73813,230,160,200,160,160,0,910
73814,180,160,120,240,160,0,860
73815,200,120,80,160,160,0,720
73816,170,140,40,80,0,0,430
73817,210,120,120,80,0,0,530
73818,190,120,120,160,320,320,1230
73819,200,140,40,80,0,0,460
73820,200,100,40,80,0,0,420
73821,190,180,200,160,0,0,730
73822,250,140,160,80,0,0,630
73823,180,100,200,160,320,320,1280
73824,170,120,160,160,160,0,770
73825,180,120,120,160,160,320,1060
73826,190,120,120,160,160,320,1070
73827,190,200,120,80,0,0,590
73828,210,160,160,240,0,0,770
73829,170,140,160,80,160,0,710
73830,200,100,80,80,160,0,620
73831,170,100,80,80,0,0,430
73832,210,160,120,80,160,0,730
73833,160,60,40,80,0,0,340
73834,170,100,80,160,320,320,1150
73835,220,140,120,80,0,0,560
73836,220,120,120,80,160,0,700
73837,180,120,120,0,0,0,420
73838,210,160,120,80,160,0,730
73839,210,140,120,0,0,0,470
73840,210,160,80,80,160,0,690
73841,190,100,80,160,160,0,690
73842,150,40,40,80,160,0,470
73843,200,140,80,80,160,0,660
73844,200,120,80,80,160,0,640
73845,180,140,40,80,160,0,600
73846,200,120,80,80,0,0,480
73847,210,120,80,80,160,0,650
73848,190,160,200,160,160,320,1190
73849,140,100,80,160,0,0,480
73850,180,100,40,80,160,320,880
73851,170,100,80,80,0,0,430
73852,170,180,80,160,160,0,750
73853,190,140,80,160,160,0,730
73854,220,80,80,160,160,0,700
73855,240,140,200,240,320,320,1460
73856,210,120,120,160,320,0,930
73857,220,180,120,80,160,0,760
73858,210,140,80,80,160,0,670
73859,190,120,80,80,160,0,630
73860,170,80,0,0,0,0,250
73861,200,80,120,0,0,0,400
73862,200,100,120,80,0,0,500
73863,240,80,80,0,0,0,400
73864,230,100,120,160,160,0,770
73865,210,120,160,240,320,320,1370
73866,210,160,200,80,160,0,810
73867,180,120,40,0,0,0,340
73868,220,140,120,160,320,320,1280
73869,210,140,160,80,160,0,750
73870,180,80,80,160,320,320,1140
73871,200,120,80,80,160,0,640
73872,210,140,40,80,0,0,470
73873,200,140,200,160,320,0,1020
73874,190,160,120,160,320,320,1270
73875,210,200,160,80,160,0,810
73876,220,100,120,80,160,0,680
73877,220,100,120,0,0,0,440
73878,220,140,160,160,320,320,1320
73879,190,140,160,160,160,320,1130
73880,210,180,120,160,160,0,830
73881,180,120,80,160,160,0,700
73882,170,80,120,160,160,0,690
73883,180,140,80,80,0,0,480
73884,180,120,120,80,160,0,660
73885,190,120,80,80,0,0,470
73886,220,80,40,80,0,0,420
73887,150,100,160,160,160,0,730
73888,180,140,120,80,160,320,1000
73889,190,100,80,80,160,0,610
73890,200,80,40,80,160,0,560
73891,210,140,40,0,0,0,390
73892,180,180,120,160,160,0,800
73893,240,140,120,80,160,0,740
73894,200,160,120,80,0,0,560
73895,170,120,40,0,0,0,330
73896,210,160,120,160,160,320,1130
73897,260,160,160,160,320,320,1380
73898,210,160,120,240,320,320,1370
73899,240,160,120,80,0,0,600
73900,200,140,80,160,0,0,580
73901,180,120,120,160,160,0,740
73902,230,140,120,160,160,0,810
73903,210,100,120,80,160,0,670
73904,190,100,80,80,160,0,610
73905,220,180,200,160,0,0,760
73906,190,100,120,160,160,0,730
73907,160,120,40,0,0,0,320
73908,190,120,40,80,160,0,590
73909,240,160,200,80,0,0,680
73910,170,120,120,160,0,0,570
73911,230,120,160,160,320,320,1310
73912,180,120,120,160,160,0,740
73913,220,200,120,0,0,0,540
73914,210,140,80,0,0,0,430
73915,210,140,120,160,160,0,790
73916,170,80,80,160,320,0,810
73917,170,80,40,80,160,0,530
73918,200,120,120,160,160,320,1080
73919,250,100,40,80,0,0,470
73920,210,140,160,240,160,0,910
73921,180,120,80,80,0,0,460
73922,240,120,160,160,160,0,840
73923,170,120,80,0,0,0,370
73924,200,80,80,80,160,0,600
73925,200,80,120,160,320,320,1200
73926,170,120,80,80,160,0,610
73927,210,100,120,240,160,0,830
73928,190,80,80,160,160,0,670
73929,180,140,160,80,160,320,1040
73930,210,80,120,80,160,0,650
73931,190,100,80,80,0,0,450
73932,220,120,80,160,160,0,740
73933,210,80,0,0,0,0,290
73934,230,120,80,80,160,0,670
73935,190,140,160,160,160,0,810
73936,240,140,120,80,160,0,740
73937,200,180,160,160,160,0,860
73938,210,100,80,80,0,0,470
73939,210,120,80,80,0,0,490
73940,180,200,160,80,160,0,780
73941,220,120,120,80,0,0,540
73942,210,140,80,160,320,0,910
73943,230,120,120,80,0,0,550
73944,200,120,200,320,320,320,1480
73945,180,60,80,80,160,0,560
73946,190,160,200,240,320,0,1110
73947,190,180,200,160,0,0,730
73948,180,140,160,160,160,0,800
73949,180,120,160,160,160,0,780
73950,180,100,80,0,0,0,360
73951,180,100,120,160,160,0,720
73952,220,120,0,0,0,0,340
73953,200,160,120,240,320,0,1040
73954,180,120,120,0,0,0,420
73955,200,80,0,0,0,0,280
73956,220,160,120,240,160,0,900
73957,150,80,120,160,160,0,670
73958,200,200,200,160,160,0,920
73959,210,180,120,80,0,0,590
73960,230,160,120,80,0,0,590
73961,160,80,40,0,0,0,280
73962,200,140,120,160,0,0,620
73963,210,80,80,80,0,0,450
73964,170,120,120,80,160,0,650
73965,190,100,120,160,160,0,730
73966,200,140,160,160,320,320,1300
73967,150,120,40,0,0,0,310
73968,180,100,40,80,160,0,560
73969,210,120,80,160,160,0,730
73970,180,120,160,80,0,0,540
73971,190,140,120,160,320,0,930
73972,200,100,160,80,160,320,1020
73973,180,80,40,80,0,0,380
73974,130,120,160,80,160,0,650
73975,220,60,80,80,0,0,440
73976,190,160,200,160,160,0,870
73977,220,160,80,80,160,0,700
73978,190,140,80,0,0,0,410
73979,170,120,120,80,160,320,970
73980,190,120,120,160,160,0,750
73981,170,100,40,0,0,0,310
73982,200,100,80,80,160,0,620
73983,180,120,80,80,0,0,460
73984,220,60,40,0,0,0,320
73985,160,100,80,80,160,0,580
73986,210,100,80,80,160,320,950
73987,180,100,80,80,160,0,600
73988,250,180,160,80,0,0,670
73989,210,100,80,80,160,0,630
73990,230,180,120,80,0,0,610
73991,190,160,80,0,0,0,430
73992,200,140,160,160,0,0,660
73993,220,120,80,80,160,0,660
73994,190,160,160,160,160,0,830
73995,160,100,80,160,160,0,660
73996,170,120,120,160,160,0,730
73997,190,80,80,160,0,0,510
73998,170,60,80,0,0,0,310
73999,130,60,80,80,160,0,510
74000,210,180,120,80,160,0,750
74001,180,160,40,0,0,0,380
74002,190,80,120,80,160,320,950
74003,170,80,120,240,320,0,930
74004,190,140,160,80,0,0,570
74005,190,80,160,80,160,0,670
74006,210,160,40,80,0,0,490
74007,180,120,160,80,160,320,1020
74008,220,180,160,80,160,0,800
74009,210,100,120,160,0,0,590
74010,210,80,40,0,0,0,330
74011,210,120,120,160,320,0,930
74012,230,80,80,0,0,0,390
74013,210,160,120,80,160,0,730
74014,200,140,120,80,160,320,1020
74015,160,80,40,80,160,0,520
74016,190,120,80,0,0,0,390
74017,220,140,160,160,160,0,840
74018,140,120,80,80,0,0,420
74019,200,140,200,80,160,0,780
74020,210,180,80,0,0,0,470
74021,170,100,80,80,160,0,590
74022,200,120,40,80,0,0,440
74023,230,180,160,160,160,0,890
74024,200,140,120,240,160,320,1180
74025,190,80,80,80,160,0,590
74026,180,40,80,0,0,0,300
74027,170,80,40,0,0,0,290
74028,200,100,40,0,0,0,340
74029,190,120,200,80,160,0,750
74030,190,100,80,0,0,0,370
74031,230,180,120,160,320,320,1330
74032,200,100,80,160,160,0,700
74033,190,100,80,80,0,0,450
74034,190,180,160,160,160,0,850
74035,180,120,200,80,160,320,1060
74036,180,100,160,240,320,320,1320
74037,200,60,80,80,0,0,420
74038,160,140,160,160,0,0,620
74039,150,160,120,80,160,0,670
74040,210,160,160,80,160,0,770
74041,160,80,40,80,160,320,840
74042,170,140,120,80,160,0,670
74043,240,120,160,160,160,0,840
74044,190,180,120,160,0,0,650
74045,170,160,120,160,160,320,1090
74046,160,60,40,80,0,0,340
74047,230,160,160,160,160,0,870
74048,190,120,160,240,320,320,1350
74049,160,140,120,80,160,0,660
74050,220,160,80,80,0,0,540
74051,260,140,80,80,160,0,720
74052,150,80,120,80,160,0,590
74053,250,160,160,240,0,0,810
74054,210,100,120,80,160,0,670
74055,210,140,40,0,0,0,390
74056,220,160,160,160,160,0,860
74057,210,120,80,80,0,0,490
74058,160,60,80,80,0,0,380
74059,220,160,120,160,0,0,660
74060,190,140,160,0,0,0,490
74061,220,120,120,80,160,0,700
74062,200,140,40,80,160,0,620
74063,190,160,120,80,0,0,550
74064,190,100,120,80,160,0,650
74065,230,120,80,160,160,0,750
74066,210,120,80,160,320,0,890
74067,230,140,120,80,0,0,570
74068,200,180,120,0,0,0,500
74069,240,160,200,80,0,0,680
74070,190,100,40,0,0,0,330
74071,160,140,120,160,160,320,1060
74072,180,140,80,80,160,0,640
74073,190,100,160,160,160,0,770
74074,170,140,160,240,320,0,1030
74075,210,160,120,160,160,0,810
74076,210,80,120,80,0,0,490
74077,220,140,80,0,0,0,440
74078,170,80,120,160,160,0,690
74079,200,120,80,80,160,0,640
74080,190,100,80,80,0,0,450
74081,200,180,120,160,160,0,820
74082,210,120,160,160,160,0,810
74083,160,100,120,240,320,320,1260
74084,160,140,200,160,320,0,980
74085,220,160,120,160,160,320,1140
74086,220,120,40,0,0,0,380
74087,200,120,120,80,0,0,520
74088,210,160,40,0,0,0,410
74089,190,160,120,240,160,0,870
74090,220,100,160,160,320,320,1280
74091,200,140,80,80,160,0,660
74092,170,120,40,0,0,0,330
74093,190,120,120,0,0,0,430
74094,200,140,160,160,320,320,1300
74095,240,120,120,0,0,0,480
74096,170,140,160,160,160,0,790
74097,200,160,120,160,320,0,960
74098,140,120,120,0,0,0,380
74099,210,60,40,80,160,320,870
74100,210,180,80,160,160,0,790
74101,160,60,80,160,320,0,780
74102,180,120,80,160,160,320,1020
74103,180,100,120,80,160,0,640
74104,210,120,120,160,320,320,1250
74105,190,80,40,80,0,0,390
74106,190,100,120,80,0,0,490
74107,150,120,80,80,160,0,590
74108,210,100,120,80,0,0,510
74109,190,80,160,240,320,0,990
74110,210,180,80,160,320,320,1270
74111,200,140,160,80,0,0,580
74112,150,60,80,160,160,0,610
74113,200,180,200,0,0,0,580
74114,220,140,160,80,160,320,1080
74115,200,140,200,160,160,0,860
74116,220,180,160,160,320,0,1040
74117,150,120,80,160,160,320,990
74118,170,120,80,0,0,0,370
74119,240,140,80,80,160,320,1020
74120,190,100,40,80,160,320,890
74121,180,100,80,80,160,0,600
74122,180,100,80,160,160,0,680
74123,210,160,200,160,160,0,890
74124,180,100,120,80,160,0,640
74125,210,160,160,160,160,320,1170
74126,220,140,120,160,320,320,1280
74127,190,160,200,80,0,0,630
74128,190,120,200,160,0,0,670
74129,170,120,120,80,0,0,490
74130,200,100,80,80,0,0,460
74131,180,80,40,0,0,0,300
74132,230,100,80,80,160,0,650
74133,190,100,80,80,160,0,610
74134,170,140,200,240,160,320,1230
74135,220,140,120,0,0,0,480
74136,200,80,40,80,160,0,560
74137,230,80,80,80,0,0,470
74138,210,180,80,160,0,0,630
74139,230,180,120,80,0,0,610
74140,210,80,80,80,0,0,450
74141,150,80,40,0,0,0,270
74142,190,100,40,0,0,0,330
74143,210,100,80,0,0,0,390
74144,220,120,120,0,0,0,460
74145,180,140,120,80,160,0,680
74146,210,160,120,160,160,320,1130
74147,170,60,80,80,160,0,550
74148,200,140,160,80,160,0,740
74149,180,80,80,80,160,0,580
74150,200,160,160,160,160,0,840
74151,180,180,200,160,160,0,880
74152,200,200,120,160,320,0,1000
74153,180,100,80,80,0,0,440
74154,170,120,120,160,0,0,570
74155,160,140,120,160,160,0,740
74156,190,120,80,0,0,0,390
74157,210,180,80,80,160,0,710
74158,200,100,80,160,160,0,700
74159,140,100,120,160,320,320,1160
74160,240,140,120,80,0,0,580
74161,160,100,80,160,320,320,1140
74162,170,180,120,80,160,0,710
74163,190,120,80,80,160,0,630
74164,200,180,120,160,0,0,660
74165,260,160,40,80,160,0,700
74166,210,100,120,80,0,0,510
74167,210,120,80,80,160,0,650
74168,210,140,80,0,0,0,430
74169,210,140,120,160,160,320,1110
74170,200,80,120,160,0,0,560
74171,200,80,120,160,160,0,720
74172,200,160,120,160,320,320,1280
74173,180,140,160,240,320,320,1360
74174,240,220,120,160,160,320,1220
74175,230,140,160,240,160,0,930
74176,140,80,80,0,0,0,300
74177,240,140,120,160,320,320,1300
74178,180,140,80,80,160,0,640
74179,220,180,120,160,320,0,1000
74180,210,120,120,240,320,0,1010
74181,210,140,120,160,160,0,790
74182,210,160,120,160,160,0,810
74183,180,80,80,0,0,0,340
74184,200,100,80,80,0,0,460
74185,140,120,80,160,320,320,1140
74186,210,140,120,160,320,0,950
74187,250,160,160,0,0,0,570
74188,210,120,160,160,160,0,810
74189,170,120,120,80,0,0,490
74190,230,120,120,160,160,320,1110
74191,170,140,160,80,0,0,550
74192,190,80,80,80,160,320,910
74193,190,120,80,80,160,0,630
74194,190,80,80,80,0,0,430
74195,230,160,200,160,160,320,1230
74196,220,140,160,160,160,0,840
74197,190,120,40,0,0,0,350
74198,170,100,120,160,160,0,710
74199,170,120,160,160,160,0,770
74200,180,80,80,0,0,0,340
74201,160,120,40,80,160,0,560
74202,200,100,160,80,0,0,540
74203,210,200,120,80,160,0,770
74204,170,120,80,160,160,0,690
74205,200,120,80,80,160,0,640
74206,190,80,120,240,160,0,790
74207,180,120,200,160,160,320,1140
74208,180,80,80,0,0,0,340
74209,220,140,160,160,160,0,840
74210,210,100,80,80,160,0,630
74211,190,160,200,160,0,0,710
74212,150,160,80,80,0,0,470
74213,220,120,160,80,0,0,580
74214,230,120,80,80,160,320,990
74215,180,140,120,80,0,0,520
74216,230,100,120,160,320,0,930
74217,210,200,160,80,0,0,650
74218,160,100,80,80,0,0,420
74219,190,80,80,160,160,0,670
74220,250,160,80,80,0,0,570
74221,220,120,80,80,160,320,980
74222,210,140,160,160,160,0,830
74223,170,160,160,80,160,0,730
74224,210,60,40,0,0,0,310
74225,160,40,80,0,0,0,280
74226,210,120,160,240,160,0,890
74227,190,140,80,80,160,0,650
74228,160,80,80,160,160,0,640
74229,190,160,160,80,0,0,590
74230,200,100,80,80,160,0,620
74231,180,100,120,80,0,0,480
74232,200,160,160,80,160,0,760
74233,170,80,0,0,0,0,250
74234,180,140,120,160,160,0,760
74235,170,100,0,0,0,0,270
74236,210,120,120,80,0,0,530
74237,160,40,40,0,0,0,240
74238,190,100,80,0,0,0,370
74239,200,160,120,160,320,320,1280
74240,190,160,80,0,0,0,430
74241,200,180,80,160,320,320,1260
74242,170,120,120,160,0,0,570
74243,200,120,120,160,320,0,920
74244,170,120,120,160,320,0,890
74245,200,120,40,0,0,0,360
74246,200,160,160,240,160,0,920
74247,220,120,80,80,160,0,660
74248,210,120,160,160,0,0,650
74249,200,120,120,80,0,0,520
74250,200,140,160,80,0,0,580
74251,190,100,160,240,160,0,850
74252,210,80,120,80,160,0,650
74253,220,140,40,80,0,0,480
74254,230,140,200,160,160,0,890
74255,200,120,40,80,160,0,600
74256,210,140,80,160,320,320,1230
74257,210,100,80,80,160,0,630
74258,180,160,80,80,0,0,500
74259,200,80,120,80,160,0,640
74260,180,120,40,80,160,0,580
74261,220,120,120,160,160,0,780
74262,210,120,120,80,0,0,530
74263,200,120,40,0,0,0,360
74264,200,140,80,80,0,0,500
74265,210,80,120,80,160,0,650
74266,210,140,120,160,160,0,790
74267,220,100,80,160,0,0,560
74268,170,120,120,0,0,0,410
74269,190,120,120,160,160,320,1070
74270,180,120,80,0,0,0,380
74271,170,120,80,80,0,0,450
74272,180,140,80,80,0,0,480
74273,200,120,80,80,0,0,480
74274,220,100,120,160,160,0,760
74275,190,120,40,80,160,0,590
74276,190,120,120,0,0,0,430
74277,220,160,160,160,0,0,700
74278,240,140,80,80,0,0,540
74279,190,120,120,0,0,0,430
74280,160,80,120,80,0,0,440
74281,210,140,120,160,160,0,790
74282,190,120,120,160,0,0,590
74283,210,140,80,160,320,0,910
74284,170,120,80,80,160,0,610
74285,180,100,160,160,320,320,1240
74286,150,60,120,160,160,0,650
74287,180,120,160,0,0,0,460
74288,210,140,80,80,160,0,670
74289,220,140,80,80,160,0,680
74290,190,160,80,80,160,0,670
74291,170,140,200,240,160,0,910
74292,210,160,160,240,0,0,770
74293,210,140,200,80,0,0,630
74294,200,100,120,80,0,0,500
74295,170,100,160,160,160,320,1070
74296,170,120,120,0,0,0,410
74297,200,100,40,80,0,0,420
74298,210,140,80,80,0,0,510
74299,180,140,120,80,160,0,680
74300,180,100,160,160,0,0,600
74301,220,140,40,0,0,0,400
74302,180,140,160,160,160,0,800
74303,220,180,80,80,160,0,720
74304,150,100,80,160,0,0,490
74305,180,80,40,80,0,0,380
74306,190,60,80,80,0,0,410
74307,180,100,120,80,0,0,480
74308,230,20,0,0,0,0,250
74309,190,100,80,0,0,0,370
74310,200,180,120,80,160,0,740
74311,200,100,80,80,0,0,460
74312,170,120,160,160,320,320,1250
74313,190,140,160,160,160,0,810
74314,220,120,80,80,160,320,980
74315,220,120,80,80,160,0,660
74316,190,140,80,80,0,0,490
74317,230,160,80,80,160,0,710
74318,200,80,80,80,160,0,600
74319,210,160,120,160,160,320,1130
74320,200,120,120,160,160,0,760
74321,180,140,120,80,160,0,680
74322,190,100,80,80,160,0,610
74323,210,100,80,0,0,0,390
74324,250,120,240,80,0,0,690
74325,130,80,80,80,0,0,370
74326,220,140,200,160,160,0,880
74327,200,120,160,160,0,0,640
74328,160,80,80,80,160,0,560
74329,190,100,80,160,160,0,690
74330,170,100,120,0,0,0,390
74331,220,200,160,160,320,0,1060
74332,180,100,120,80,160,0,640
74333,160,100,120,160,0,0,540
74334,180,120,40,0,0,0,340
74335,180,80,0,0,0,0,260
74336,200,60,0,0,0,0,260
74337,210,40,40,80,160,0,530
74338,160,80,40,0,0,0,280
74339,200,100,120,160,320,320,1220
74340,210,120,160,160,160,0,810
74341,210,100,80,80,160,0,630
74342,140,100,120,80,160,0,600
74343,190,120,120,80,0,0,510
74344,180,60,120,0,0,0,360
74345,210,120,120,160,320,0,930
74346,170,140,120,80,0,0,510
74347,190,140,120,80,160,320,1010
74348,200,100,120,240,320,0,980
74349,200,120,80,0,0,0,400
74350,190,100,80,80,160,0,610
74351,230,100,40,80,0,0,450
74352,150,160,160,160,320,0,950
74353,190,140,120,160,320,0,930
74354,200,120,120,0,0,0,440
74355,190,60,40,80,0,0,370
74356,220,160,160,160,160,0,860
74357,220,160,80,0,0,0,460
74358,170,80,120,240,160,0,770
74359,210,80,40,0,0,0,330
74360,180,140,200,240,0,0,760
74361,170,140,120,80,160,0,670
74362,230,160,120,80,0,0,590
74363,200,160,120,160,160,0,800
74364,170,200,120,240,160,0,890
74365,190,100,80,80,160,0,610
74366,150,100,160,80,0,0,490
74367,230,120,160,80,0,0,590
74368,220,160,160,80,0,0,620
74369,210,140,80,0,0,0,430
74370,160,120,40,0,0,0,320
74371,230,140,120,80,160,0,730
74372,210,120,120,80,0,0,530
74373,220,100,160,160,320,0,960
74374,210,120,80,80,160,0,650
74375,180,80,120,0,0,0,380
74376,180,140,80,80,160,0,640
74377,170,100,120,160,160,0,710
74378,210,120,120,160,160,0,770
74379,210,140,160,240,160,0,910
74380,190,140,80,80,160,0,650
74381,190,120,160,80,0,0,550
74382,210,160,160,80,160,0,770
74383,230,180,160,160,320,0,1050
74384,180,100,120,240,160,0,800
74385,200,80,40,80,0,0,400
74386,180,120,120,80,0,0,500
74387,200,100,0,0,0,0,300
74388,190,60,40,0,0,0,290
74389,160,80,80,80,160,0,560
74390,200,100,120,160,0,0,580
74391,190,80,160,160,160,0,750
74392,170,160,120,160,320,0,930
74393,270,160,80,0,0,0,510
74394,190,60,80,80,160,0,570
74395,260,120,80,160,160,0,780
74396,190,160,80,80,0,0,510
74397,190,100,120,0,0,0,410
74398,190,120,80,80,160,0,630
74399,220,100,80,80,0,0,480
74400,190,120,120,80,160,320,990
74401,200,120,80,80,0,0,480
74402,240,100,40,80,0,0,460
74403,230,180,80,80,0,0,570
74404,220,120,80,80,0,0,500
74405,200,100,80,80,160,0,620
74406,220,160,80,80,160,0,700
74407,230,100,40,0,0,0,370
74408,200,80,80,80,160,0,600
74409,200,120,80,80,0,0,480
74410,190,120,120,160,160,0,750
74411,190,100,120,80,160,0,650
74412,210,100,80,80,0,0,470
74413,170,120,40,80,160,320,890
74414,220,100,80,80,0,0,480
74415,170,160,160,80,160,0,730
74416,170,80,80,160,0,0,490
74417,230,100,80,80,0,0,490
74418,240,180,80,160,320,320,1300
74419,160,160,160,80,0,0,560
74420,150,40,40,80,160,0,470
74421,140,120,160,240,320,320,1300
74422,160,140,160,160,160,0,780
74423,220,120,40,80,0,0,460
74424,220,100,80,160,0,0,560
74425,200,100,80,80,160,0,620
74426,170,120,160,80,0,0,530
74427,170,140,160,240,160,0,870
74428,130,120,40,0,0,0,290
74429,210,160,80,0,0,0,450
74430,210,140,80,80,160,0,670
74431,220,140,80,80,0,0,520
74432,180,140,120,160,160,0,760
74433,160,100,160,0,0,0,420
74434,200,160,160,160,320,0,1000
74435,230,120,80,80,0,0,510
74436,210,120,80,80,160,0,650
74437,130,100,120,80,160,0,590
74438,190,80,120,80,160,0,630
74439,190,160,200,240,160,0,950
74440,180,120,80,80,0,0,460
74441,230,140,40,80,0,0,490
74442,200,120,120,80,160,0,680
74443,190,60,80,80,160,0,570
74444,210,160,80,80,160,0,690
74445,160,100,0,0,0,0,260
74446,230,160,80,160,320,320,1270
74447,230,120,80,80,160,0,670
74448,230,140,120,160,160,0,810
74449,160,140,80,160,160,0,700
74450,230,80,80,160,160,0,710
74451,180,100,40,0,0,0,320
74452,180,120,80,0,0,0,380
74453,200,160,80,80,0,0,520
74454,180,100,40,0,0,0,320
74455,190,80,40,0,0,0,310
74456,180,140,40,0,0,0,360
74457,210,180,120,0,0,0,510
74458,180,100,120,240,320,0,960
74459,220,160,160,160,160,0,860
74460,200,80,120,80,0,0,480
74461,180,140,80,0,0,0,400
74462,210,120,120,80,0,0,530
74463,250,180,160,160,160,0,910
74464,210,120,160,80,160,0,730
74465,150,100,120,80,160,0,610
74466,180,160,120,80,160,0,700
74467,200,140,80,0,0,0,420
74468,210,140,80,80,0,0,510
74469,240,180,120,240,0,0,780
74470,190,100,120,0,0,0,410
74471,200,80,120,240,320,320,1280
74472,170,140,80,80,0,0,470
74473,210,160,120,80,160,0,730
74474,170,140,160,160,160,320,1110
74475,190,140,120,80,160,0,690
74476,220,100,80,80,160,0,640
74477,190,120,120,160,160,0,750
74478,190,120,120,80,160,0,670
74479,240,200,200,160,160,0,960
74480,180,140,160,80,160,0,720
74481,200,160,160,160,160,0,840
74482,210,140,120,80,0,0,550
74483,200,100,160,320,320,0,1100
74484,180,140,160,160,160,0,800
74485,190,80,40,80,160,320,870
74486,180,100,120,160,160,0,720
74487,200,140,160,80,160,0,740
74488,210,100,120,80,0,0,510
74489,170,180,120,0,0,0,470
74490,210,120,40,80,160,0,610
74491,220,120,120,160,0,0,620
74492,240,140,160,80,0,0,620
74493,190,60,40,0,0,0,290
74494,200,140,80,80,0,0,500
74495,210,120,160,80,0,0,570
74496,220,100,120,160,320,0,920
74497,190,40,40,0,0,0,270
74498,210,160,120,160,320,320,1290
74499,210,60,80,160,160,0,670
74500,210,180,160,80,160,0,790
74501,180,120,120,160,160,0,740
74502,200,100,80,160,320,320,1180
74503,210,160,120,160,160,0,810
74504,190,160,80,0,0,0,430
74505,200,120,80,0,0,0,400
74506,160,140,80,160,320,320,1180
74507,170,160,160,160,160,0,810
74508,190,100,80,160,0,0,530
74509,240,100,120,160,160,0,780
74510,190,80,80,0,0,0,350
74511,160,140,160,160,160,0,780
74512,200,120,40,80,160,0,600
74513,190,140,120,80,160,320,1010
74514,200,100,120,0,0,0,420
74515,200,100,80,80,160,0,620
74516,190,120,160,240,160,0,870
74517,210,120,120,160,320,320,1250
74518,170,80,80,80,160,0,570
74519,200,160,200,160,320,0,1040
74520,220,120,80,160,160,0,740
74521,180,120,80,80,160,0,620
74522,160,100,40,0,0,0,300
74523,180,100,80,160,160,0,680
74524,180,160,120,160,160,0,780
74525,200,200,120,240,160,0,920
74526,190,100,80,0,0,0,370
74527,200,100,160,240,160,0,860
74528,170,140,80,160,160,0,710
74529,210,120,120,160,320,0,930
74530,200,100,80,80,0,0,460
74531,190,100,160,80,0,0,530
74532,220,120,120,80,160,0,700
74533,220,120,40,80,0,0,460
74534,240,160,80,160,160,0,800
74535,210,180,200,240,320,320,1470
74536,190,160,160,80,160,320,1070
74537,180,100,40,0,0,0,320
74538,190,120,120,80,160,0,670
74539,220,200,160,240,320,0,1140
74540,240,160,160,80,160,0,800
74541,200,100,80,80,0,0,460
74542,180,120,40,80,0,0,420
74543,220,180,160,160,160,0,880
74544,180,140,120,80,0,0,520
74545,210,140,200,160,160,320,1190
74546,200,100,120,80,160,0,660
74547,220,180,200,160,160,0,920
74548,200,140,160,80,160,0,740
74549,200,100,120,80,160,0,660
74550,210,160,120,160,160,0,810
74551,180,120,120,80,0,0,500
74552,210,180,120,160,160,0,830
74553,200,80,40,80,160,0,560
74554,200,160,160,160,0,0,680
74555,190,140,120,80,160,320,1010
74556,190,100,80,0,0,0,370
74557,170,100,120,80,160,320,950
74558,180,100,160,80,0,0,520
74559,200,120,200,240,160,0,920
74560,200,140,160,160,160,320,1140
74561,190,120,80,80,0,0,470
74562,160,60,40,0,0,0,260
74563,210,160,120,80,160,0,730
74564,190,140,120,160,0,0,610
74565,200,160,120,160,320,320,1280
74566,190,140,160,160,320,0,970
74567,200,140,40,80,0,0,460
74568,180,140,120,160,160,0,760
74569,190,160,120,80,0,0,550
74570,230,160,160,0,0,0,550
74571,180,20,40,80,160,320,800
74572,240,100,120,240,160,0,860
74573,180,120,120,160,160,0,740
74574,210,120,80,0,0,0,410
74575,230,160,160,240,160,0,950
74576,220,140,120,160,320,0,960
74577,210,120,80,80,160,320,970
74578,180,120,120,80,160,0,660
74579,180,60,80,80,160,320,880
74580,160,140,200,160,0,0,660
74581,200,160,120,80,0,0,560
74582,210,160,200,160,160,0,890
74583,200,160,240,240,320,0,1160
74584,170,100,40,0,0,0,310
74585,180,100,40,80,160,320,880
74586,210,100,40,0,0,0,350
74587,260,140,200,80,160,0,840
74588,200,120,120,240,320,320,1320
74589,200,160,200,160,160,0,880
74590,200,120,80,160,160,0,720
74591,190,120,80,80,160,0,630
74592,210,160,240,160,160,0,930
74593,220,160,200,160,0,0,740
74594,230,140,120,160,160,0,810
74595,200,80,80,160,160,0,680
74596,210,140,120,160,320,320,1270
74597,180,80,80,160,160,320,980
74598,230,100,80,80,0,0,490
74599,210,140,160,160,160,0,830
74600,220,120,120,0,0,0,460
74601,230,180,200,160,160,0,930
74602,230,100,40,80,0,0,450
74603,180,100,80,160,0,0,520
74604,190,160,200,80,160,0,790
74605,190,140,120,80,160,0,690
74606,230,120,40,80,160,320,950
74607,200,60,80,80,160,0,580
74608,190,140,120,160,0,0,610
74609,240,140,120,0,0,0,500
74610,170,80,80,80,160,0,570
74611,200,80,120,80,0,0,480
74612,170,120,80,160,320,0,850
74613,240,120,120,80,0,0,560
74614,210,120,120,160,0,0,610
74615,220,80,80,80,0,0,460
74616,210,160,80,80,0,0,530
74617,210,60,40,0,0,0,310
74618,180,140,80,80,0,0,480
74619,200,120,160,160,160,0,800
74620,170,140,80,0,0,0,390
74621,170,100,40,80,160,0,550
74622,190,80,120,160,160,0,710
74623,210,120,120,80,160,0,690
74624,190,160,160,160,160,0,830
74625,180,160,160,240,160,0,900
74626,220,180,160,160,0,0,720
74627,240,160,40,0,0,0,440
74628,230,160,120,80,160,0,750
74629,220,140,120,80,160,0,720
74630,190,120,120,80,0,0,510
74631,220,140,80,0,0,0,440
74632,230,160,160,160,320,0,1030
74633,200,120,120,160,160,0,760
74634,220,140,120,160,0,0,640
74635,230,140,120,160,320,0,970
74636,210,160,120,0,0,0,490
74637,210,120,80,80,160,0,650
74638,200,120,120,0,0,0,440
74639,200,120,80,80,160,0,640
74640,190,100,80,80,0,0,450
74641,180,160,160,160,0,0,660
74642,220,120,80,80,0,0,500
74643,190,160,160,80,160,0,750
74644,190,100,160,80,160,0,690
74645,200,160,200,240,160,0,960
74646,210,180,200,160,160,0,910
74647,190,100,80,0,0,0,370
74648,220,100,80,80,160,0,640
74649,180,20,40,80,160,0,480
74650,200,100,40,0,0,0,340
74651,190,160,40,0,0,0,390
74652,220,120,160,80,0,0,580
74653,220,140,120,0,0,0,480
74654,200,160,80,80,0,0,520
74655,190,100,80,160,160,0,690
74656,220,160,120,160,160,0,820
74657,180,80,80,160,320,320,1140
74658,210,180,200,160,0,0,750
74659,230,140,160,160,160,0,850
74660,230,60,0,0,0,0,290
74661,190,140,120,80,160,0,690
74662,210,120,120,160,160,0,770
74663,200,100,40,80,160,320,900
74664,210,160,200,240,160,0,970
74665,230,160,160,160,0,0,710
74666,220,120,120,160,160,0,780
74667,190,100,120,80,160,0,650
74668,230,140,200,160,320,0,1050
74669,230,140,40,0,0,0,410
74670,210,160,80,80,160,0,690
74671,150,140,80,80,160,0,610
74672,170,120,80,80,0,0,450
74673,210,120,120,80,0,0,530
74674,200,160,160,240,0,0,760
74675,200,160,160,160,160,0,840
74676,200,120,120,160,0,0,600
74677,170,60,80,0,0,0,310
74678,190,140,160,160,160,0,810
74679,200,140,160,80,0,0,580
74680,210,140,120,160,160,0,790
74681,210,80,40,80,160,0,570
74682,190,100,40,0,0,0,330
74683,230,120,40,80,160,0,630
74684,240,200,160,160,320,0,1080
74685,230,120,80,80,160,320,990
74686,230,120,120,160,0,0,630
74687,200,160,200,160,320,0,1040
74688,170,40,40,0,0,0,250
74689,210,80,80,0,0,0,370
74690,190,120,80,80,160,320,950
74691,140,60,80,80,0,0,360
74692,220,160,80,160,160,0,780
74693,170,100,80,80,0,0,430
74694,190,100,80,160,160,0,690
74695,240,120,80,80,160,0,680
74696,240,120,160,160,160,0,840
74697,200,120,120,80,0,0,520
74698,160,60,40,0,0,0,260
74699,190,100,80,80,0,0,450
74700,160,80,120,160,160,0,680
74701,190,140,160,240,160,0,890
74702,190,160,120,80,160,320,1030
74703,210,120,80,0,0,0,410
74704,230,180,120,80,0,0,610
74705,170,80,40,0,0,0,290
74706,200,80,120,80,160,320,960
74707,200,120,40,0,0,0,360
74708,180,120,120,160,0,0,580
74709,250,180,80,160,320,0,990
74710,200,100,120,0,0,0,420
74711,170,140,120,0,0,0,430
74712,150,140,120,0,0,0,410
74713,210,80,40,80,160,320,890
74714,170,120,80,160,0,0,530
74715,170,100,40,80,0,0,390
74716,190,160,160,80,160,320,1070
74717,180,100,80,160,160,0,680
74718,230,140,40,0,0,0,410
74719,230,120,0,0,0,0,350
74720,160,120,160,80,160,320,1000
74721,170,120,120,160,160,320,1050
74722,210,100,0,0,0,0,310
74723,140,80,80,80,160,0,540
74724,240,180,80,80,160,0,740
74725,220,140,80,80,0,0,520
74726,230,160,40,80,160,0,670
74727,230,100,120,80,160,320,1010
74728,210,40,40,80,160,0,530
74729,230,140,160,80,160,320,1090
74730,150,140,120,80,160,0,650
74731,220,140,80,80,160,0,680
74732,220,80,40,80,160,320,900
74733,190,160,160,80,160,0,750
74734,220,60,80,80,0,0,440
74735,180,100,80,0,0,0,360
74736,190,80,40,80,0,0,390
74737,140,120,120,80,0,0,460
74738,180,140,40,0,0,0,360
74739,180,140,80,160,160,0,720
74740,170,100,160,240,160,0,830
74741,210,100,160,240,320,0,1030
74742,230,140,80,0,0,0,450
74743,180,120,200,160,160,0,820
74744,180,120,40,0,0,0,340
74745,170,60,40,80,160,0,510
74746,180,140,80,80,0,0,480
74747,170,120,120,160,0,0,570
74748,180,100,200,240,320,0,1040
74749,200,120,120,80,160,320,1000
74750,200,140,120,80,0,0,540
74751,190,80,40,80,160,0,550
74752,180,40,80,80,0,0,380
74753,200,80,80,80,0,0,440
74754,180,60,40,0,0,0,280
74755,200,120,80,0,0,0,400
74756,230,180,120,160,320,320,1330
74757,170,60,120,160,160,0,670
74758,190,120,80,0,0,0,390
74759,240,160,120,80,160,0,760
74760,250,100,120,0,0,0,470
74761,190,60,120,160,160,0,690
74762,160,100,120,80,160,0,620
74763,200,120,40,80,0,0,440
74764,180,80,120,160,320,0,860
74765,150,60,0,0,0,0,210
74766,200,80,80,80,0,0,440
74767,170,60,120,160,0,0,510
74768,200,120,40,0,0,0,360
74769,180,120,120,160,160,0,740
74770,190,80,80,0,0,0,350
74771,200,60,40,0,0,0,300
74772,230,120,120,80,160,0,710
74773,160,160,120,160,160,320,1080
74774,160,100,120,160,320,0,860
74775,180,160,80,160,320,320,1220
74776,200,160,200,160,320,0,1040
74777,190,60,0,0,0,0,250
74778,200,120,120,160,160,0,760
74779,210,140,120,160,160,0,790
74780,210,120,160,160,320,0,970
74781,190,140,120,80,160,0,690
74782,200,80,120,160,160,0,720
74783,180,120,40,0,0,0,340
74784,170,60,40,0,0,0,270
74785,180,120,160,160,320,0,940
74786,200,60,40,80,0,0,380
74787,170,140,80,80,160,0,630
74788,210,140,0,0,0,0,350
74789,200,120,120,160,320,320,1240
74790,190,140,160,80,160,0,730
74791,230,120,80,0,0,0,430
74792,170,80,80,160,160,320,970
74793,180,80,40,80,160,0,540
74794,170,120,160,80,160,0,690
74795,180,80,160,160,320,0,900
74796,210,120,80,80,160,320,970
74797,200,100,80,80,0,0,460
74798,210,140,80,80,160,0,670
74799,210,180,40,80,0,0,510
74800,200,80,80,80,160,0,600
74801,220,180,200,80,160,320,1160
74802,230,140,120,80,0,0,570
74803,150,140,40,80,0,0,410
74804,200,140,120,160,0,0,620
74805,200,60,120,80,0,0,460
74806,160,120,160,160,160,0,760
74807,190,80,80,160,320,0,830
74808,190,120,80,0,0,0,390
74809,240,120,40,80,160,0,640
74810,200,140,120,80,0,0,540
74811,200,140,200,160,160,0,860
74812,210,120,200,80,0,0,610
74813,200,100,40,80,0,0,420
74814,200,120,120,80,0,0,520
74815,150,80,40,0,0,0,270
74816,220,120,80,80,160,0,660
74817,150,100,80,160,320,0,810
74818,230,140,80,160,320,0,930
74819,170,120,80,0,0,0,370
74820,240,220,40,80,160,0,740
74821,180,100,80,160,160,320,1000
74822,210,160,160,160,160,320,1170
74823,200,200,120,160,160,0,840
74824,210,160,120,160,160,0,810
74825,210,120,120,80,160,0,690
74826,180,160,120,80,0,0,540
74827,180,80,120,160,320,320,1180
74828,190,80,120,80,0,0,470
74829,220,160,160,0,0,0,540
74830,210,140,120,80,160,0,710
74831,150,140,120,80,160,320,970
74832,200,180,80,80,160,0,700
74833,210,140,200,80,0,0,630
74834,180,120,80,0,0,0,380
74835,170,80,40,80,0,0,370
74836,210,120,120,0,0,0,450
74837,190,60,120,80,160,0,610
74838,190,100,80,0,0,0,370
74839,180,140,160,160,160,0,800
74840,170,120,120,160,320,0,890
74841,230,80,40,80,0,0,430
74842,150,80,40,80,160,0,510
74843,230,200,80,80,160,0,750
74844,180,120,120,160,160,0,740
74845,200,140,80,160,160,0,740
74846,160,160,160,160,320,0,960
74847,190,120,80,160,0,0,550
74848,220,140,80,0,0,0,440
74849,220,160,120,0,0,0,500
74850,190,140,120,0,0,0,450
74851,220,140,40,80,0,0,480
74852,210,160,160,160,160,0,850
74853,200,140,80,80,0,0,500
74854,200,160,120,160,0,0,640
74855,180,160,120,80,160,0,700
74856,240,180,120,80,160,0,780
74857,190,140,120,0,0,0,450
74858,190,100,120,160,320,320,1210
74859,200,160,120,160,320,320,1280
74860,190,100,160,160,160,320,1090
74861,220,80,0,0,0,0,300
74862,170,120,80,160,320,0,850
74863,200,120,0,0,0,0,320
74864,190,100,40,0,0,0,330
74865,160,100,120,0,0,0,380
74866,180,120,120,160,0,0,580
74867,190,120,120,80,160,0,670
74868,210,120,80,0,0,0,410
74869,210,120,120,0,0,0,450
74870,200,140,120,0,0,0,460
74871,210,140,80,80,160,0,670
74872,230,160,80,80,160,0,710
74873,190,120,40,0,0,0,350
74874,160,140,80,80,160,0,620
74875,190,140,40,0,0,0,370
74876,200,160,160,160,320,0,1000
74877,190,80,80,80,160,0,590
74878,200,140,200,160,320,0,1020
74879,200,100,120,80,0,0,500
74880,190,120,120,160,160,0,750
74881,200,120,120,240,160,0,840
74882,210,120,120,160,160,0,770
74883,190,60,80,80,160,0,570
74884,200,140,80,0,0,0,420
74885,210,160,200,80,0,0,650
74886,190,100,160,240,320,0,1010
74887,190,140,120,160,0,0,610
74888,210,120,120,80,160,0,690
74889,200,160,80,80,160,320,1000
74890,190,80,80,160,0,0,510
74891,190,80,120,160,160,0,710
74892,240,160,120,80,160,320,1080
74893,230,140,120,80,0,0,570
74894,250,100,80,0,0,0,430
74895,170,120,120,0,0,0,410
74896,180,220,120,80,160,0,760
74897,200,100,0,0,0,0,300
74898,240,100,80,160,160,0,740
74899,140,100,80,160,320,0,800
74900,190,120,120,80,160,0,670
74901,200,200,120,80,160,0,760
74902,190,120,80,80,0,0,470
74903,200,160,120,160,0,0,640
74904,150,80,40,0,0,0,270
74905,230,120,80,80,160,320,990
74906,200,100,120,240,320,0,980
74907,190,180,120,80,160,0,730
74908,210,100,80,0,0,0,390
74909,180,120,80,80,160,0,620
74910,230,120,40,80,160,0,630
74911,160,100,80,0,0,0,340
74912,210,140,80,0,0,0,430
74913,170,120,120,160,0,0,570
74914,220,140,120,160,160,0,800
74915,150,120,40,0,0,0,310
74916,200,80,120,160,320,0,880
74917,200,160,120,160,160,0,800
74918,220,100,120,80,0,0,520
74919,200,80,80,160,160,0,680
74920,220,120,40,80,160,0,620
74921,200,160,80,80,160,0,680
74922,230,160,120,160,160,0,830
74923,200,100,40,80,160,0,580
74924,230,120,160,240,320,0,1070
74925,200,160,120,160,160,0,800
74926,190,120,120,80,160,320,990
74927,190,120,120,0,0,0,430
74928,160,80,160,80,0,0,480
74929,190,120,120,240,320,0,990
74930,190,140,160,80,0,0,570
74931,210,180,120,80,0,0,590
74932,170,140,40,0,0,0,350
74933,180,120,40,0,0,0,340
74934,240,140,40,80,0,0,500
74935,190,60,120,80,160,0,610
74936,220,100,0,0,0,0,320
74937,190,100,120,160,160,0,730
74938,170,100,40,80,0,0,390
74939,170,180,160,160,160,0,830
74940,220,120,40,0,0,0,380
74941,200,120,160,160,320,320,1280
74942,150,120,120,160,160,0,710
74943,160,140,80,80,160,0,620
74944,170,140,40,0,0,0,350
74945,200,120,200,160,160,0,840
74946,180,100,40,80,0,0,400
74947,210,140,160,160,0,0,670
74948,180,40,80,0,0,0,300
74949,180,120,160,240,160,0,860
74950,200,120,80,80,160,0,640
74951,180,60,120,160,160,0,680
74952,200,140,120,160,160,0,780
74953,210,180,120,160,320,0,990
74954,230,100,120,80,0,0,530
74955,200,160,120,160,160,0,800
74956,150,140,120,160,160,0,730
74957,200,220,160,80,0,0,660
74958,200,60,40,0,0,0,300
74959,150,120,160,160,160,0,750
74960,240,140,120,160,320,320,1300
74961,210,100,120,160,160,320,1070
74962,200,140,40,0,0,0,380
74963,190,100,120,160,160,0,730
74964,230,120,40,80,0,0,470
74965,180,120,40,80,0,0,420
74966,240,60,80,160,160,0,700
74967,170,100,80,160,160,320,990
74968,170,120,80,80,160,320,930
74969,190,80,40,0,0,0,310
74970,200,60,80,80,160,0,580
74971,170,100,120,160,0,0,550
74972,160,140,80,0,0,0,380
74973,180,60,40,80,0,0,360
74974,180,120,80,80,160,0,620
74975,190,140,160,160,160,0,810
74976,240,140,120,160,0,0,660
74977,180,160,40,80,160,0,620
74978,220,100,80,80,0,0,480
74979,240,160,80,80,160,0,720
74980,180,60,120,160,160,320,1000
74981,210,140,80,80,160,0,670
74982,190,200,200,160,320,0,1070
74983,210,160,120,160,320,0,970
74984,230,140,120,80,160,0,730
74985,210,200,120,80,160,0,770
74986,190,140,80,80,160,0,650
74987,200,120,80,160,160,0,720
74988,230,100,80,160,160,0,730
74989,210,100,40,80,0,0,430
74990,200,120,160,0,0,0,480
74991,180,160,120,160,0,0,620
74992,200,120,120,240,320,0,1000
74993,220,100,80,160,320,0,880
74994,190,120,80,80,0,0,470
74995,150,120,120,80,0,0,470
74996,210,120,80,160,320,320,1210
74997,140,40,40,0,0,0,220
74998,170,80,0,0,0,0,250
74999,230,100,80,0,0,0,410
75000,180,140,160,240,160,0,880
75001,260,140,80,160,320,320,1280
75002,220,140,80,160,0,0,600
75003,210,220,120,80,0,0,630
75004,160,120,80,160,160,0,680
75005,220,140,80,80,160,320,1000
75006,200,100,120,240,320,320,1300
75007,190,140,160,0,0,0,490
75008,190,160,120,80,160,320,1030
75009,180,100,80,80,160,0,600
75010,210,120,120,160,160,0,770
75011,190,180,240,160,160,0,930
75012,240,120,160,160,160,320,1160
75013,210,100,80,160,160,0,710
75014,190,120,120,80,160,0,670
75015,200,120,160,160,160,0,800
75016,240,140,200,160,160,0,900
75017,210,120,80,80,160,0,650
75018,240,120,40,80,0,0,480
75019,230,140,160,160,160,0,850
75020,220,120,160,160,160,0,820
75021,180,140,120,80,160,320,1000
75022,150,100,80,80,160,0,570
75023,250,180,80,160,320,0,990
75024,210,120,160,240,0,0,730
75025,200,160,160,80,160,0,760
75026,150,80,160,80,160,0,630
75027,190,80,80,160,320,0,830
75028,210,160,160,160,160,0,850
75029,160,80,80,0,0,0,320
75030,240,100,80,160,160,0,740
75031,200,120,120,160,160,0,760
75032,190,180,120,160,160,320,1130
75033,210,140,80,80,0,0,510
75034,210,160,160,160,320,0,1010
75035,200,160,160,160,160,0,840
75036,180,100,120,160,160,0,720
75037,160,140,120,160,0,0,580
75038,240,180,160,160,160,0,900
75039,160,120,120,160,160,320,1040
75040,210,80,80,0,0,0,370
75041,180,140,80,160,160,0,720
75042,240,180,200,240,320,320,1500
75043,200,100,40,80,160,0,580
75044,190,100,80,0,0,0,370
75045,170,140,80,80,160,0,630
75046,250,220,200,160,160,0,990
75047,210,140,120,160,160,0,790
75048,230,80,120,80,160,0,670
75049,220,80,40,0,0,0,340
75050,190,100,80,0,0,0,370
75051,160,160,160,160,0,0,640
75052,160,120,0,0,0,0,280
75053,180,80,80,80,160,0,580
75054,210,140,80,80,160,320,990
75055,220,80,80,80,160,0,620
75056,200,120,40,80,0,0,440
75057,230,60,40,0,0,0,330
75058,180,140,40,80,160,0,600
75059,170,140,80,160,320,320,1190
75060,210,140,80,80,0,0,510
75061,170,100,120,240,320,320,1270
75062,190,140,120,80,160,0,690
75063,200,60,40,80,160,0,540
75064,210,100,120,0,0,0,430
75065,190,120,120,160,160,320,1070
75066,190,160,120,160,160,0,790
75067,190,100,80,80,0,0,450
75068,160,100,120,160,160,0,700
75069,200,140,240,160,320,320,1380
75070,180,200,240,240,160,0,1020
75071,120,120,120,80,160,320,920
75072,220,160,200,240,160,320,1300
75073,160,140,120,0,0,0,420
75074,230,140,160,80,160,0,770
75075,180,100,40,0,0,0,320
75076,210,140,160,80,0,0,590
75077,190,120,160,160,320,0,950
75078,250,120,40,80,160,320,970
75079,190,80,40,0,0,0,310
75080,190,120,80,160,320,0,870
75081,190,140,80,80,160,0,650
75082,200,120,120,160,160,0,760
75083,220,120,80,0,0,0,420
75084,210,120,120,80,160,0,690
75085,230,120,160,80,160,0,750
75086,190,180,80,80,160,0,690
75087,210,120,40,80,160,320,930
75088,220,120,120,160,160,0,780
75089,230,180,120,0,0,0,530
75090,210,140,160,160,160,0,830
75091,170,100,80,80,160,0,590
75092,190,140,120,80,160,0,690
75093,190,180,200,240,0,0,810
75094,170,120,120,80,160,320,970
75095,190,120,80,0,0,0,390
75096,170,140,120,80,0,0,510
75097,220,100,120,80,160,0,680
75098,200,120,120,80,0,0,520
75099,170,100,120,160,160,0,710
75100,210,160,200,240,160,0,970
75101,200,120,120,80,160,0,680
75102,210,140,120,160,160,0,790
75103,210,140,120,160,160,320,1110
75104,240,80,80,160,0,0,560
75105,200,120,80,80,160,0,640
75106,170,120,120,160,160,0,730
75107,210,160,80,160,160,320,1090
75108,190,80,80,80,160,0,590
75109,160,80,80,80,160,0,560
75110,200,80,80,0,0,0,360
75111,190,100,80,160,160,0,690
75112,180,180,200,160,160,0,880
75113,200,100,80,160,320,0,860
75114,210,140,160,80,160,0,750
75115,150,100,120,240,320,0,930
75116,170,100,160,80,160,0,670
75117,200,160,120,160,160,0,800
75118,150,120,80,160,160,0,670
75119,180,120,120,80,160,0,660
75120,220,180,120,0,0,0,520
75121,200,100,120,0,0,0,420
75122,240,180,200,160,0,0,780
75123,190,160,80,80,160,0,670
75124,180,200,120,240,320,320,1380
75125,180,160,200,240,320,320,1420
75126,220,140,120,160,0,0,640
75127,180,120,160,160,160,0,780
75128,180,140,120,160,160,0,760
75129,240,180,240,160,160,320,1300
75130,170,180,120,160,160,0,790
75131,200,80,120,80,0,0,480
75132,190,100,40,0,0,0,330
75133,200,140,120,160,160,320,1100
75134,240,120,120,80,160,0,720
75135,200,60,80,160,160,320,980
75136,170,180,120,80,160,320,1030
75137,170,160,200,240,160,0,930
75138,210,120,80,80,160,0,650
75139,220,140,80,80,0,0,520
75140,200,80,40,80,160,0,560
75141,210,80,40,80,160,0,570
75142,150,60,80,80,160,0,530
75143,150,120,80,80,0,0,430
75144,230,160,120,160,160,320,1150
75145,210,140,80,160,320,320,1230
75146,150,60,80,0,0,0,290
75147,190,140,160,0,0,0,490
75148,190,140,120,80,0,0,530
75149,210,120,160,160,320,0,970
75150,190,200,80,80,160,0,710
75151,160,80,80,160,160,320,960
75152,170,60,120,160,320,0,830
75153,180,120,120,160,0,0,580
75154,210,120,120,0,0,0,450
75155,170,100,120,160,160,0,710
75156,190,120,120,160,0,0,590
75157,200,160,160,80,160,0,760
75158,170,100,40,80,160,0,550
75159,210,120,120,80,160,0,690
75160,190,180,160,160,0,0,690
75161,250,120,40,0,0,0,410
75162,190,100,80,160,320,0,850
75163,170,100,160,160,0,0,590
75164,210,80,80,80,160,0,610
75165,210,120,80,80,160,0,650
75166,180,100,80,0,0,0,360
75167,210,160,160,240,160,320,1250
75168,210,100,80,0,0,0,390
75169,190,140,120,160,320,0,930
75170,200,140,160,80,160,0,740
75171,210,160,40,80,0,0,490
75172,230,140,120,0,0,0,490
75173,220,180,200,160,320,0,1080
75174,190,80,120,80,160,0,630
75175,170,100,120,160,160,0,710
75176,220,100,80,80,160,0,640
75177,220,180,200,160,160,0,920
75178,220,160,120,160,0,0,660
75179,210,100,120,80,0,0,510
75180,200,160,120,80,0,0,560
75181,210,160,120,80,0,0,570
75182,200,140,80,80,0,0,500
75183,160,100,120,80,0,0,460
75184,170,80,120,80,0,0,450
75185,210,80,40,0,0,0,330
75186,230,160,160,160,0,0,710
75187,210,180,80,80,0,0,550
75188,160,100,80,80,160,0,580
75189,220,160,120,160,160,0,820
75190,210,100,40,80,160,0,590
75191,220,160,160,160,0,0,700
75192,200,200,160,80,0,0,640
75193,200,140,200,240,160,0,940
75194,190,140,160,160,160,0,810
75195,220,180,120,0,0,0,520
75196,170,100,80,160,160,0,670
75197,210,120,120,240,160,0,850
75198,210,140,40,80,160,0,630
75199,180,100,80,160,320,0,840
75200,190,120,160,80,0,0,550
75201,220,160,240,160,160,0,940
75202,220,120,80,80,0,0,500
75203,230,200,120,80,160,0,790
75204,200,100,40,0,0,0,340
75205,180,120,120,160,160,0,740
75206,190,160,160,160,0,0,670
75207,180,100,80,80,160,0,600
75208,230,100,40,80,160,0,610
75209,220,60,80,80,160,0,600
75210,240,140,40,0,0,0,420
75211,210,180,80,80,0,0,550
75212,190,100,120,80,0,0,490
75213,180,120,120,160,160,0,740
75214,200,120,160,0,0,0,480
75215,250,100,40,80,160,0,630
75216,180,100,120,240,160,0,800
75217,180,140,160,240,320,0,1040
75218,170,140,160,160,320,320,1270
75219,220,180,160,160,320,320,1360
75220,210,140,160,160,160,0,830
75221,170,100,40,80,0,0,390
75222,190,100,120,160,320,320,1210
75223,190,140,40,80,0,0,450
75224,210,140,120,160,0,0,630
75225,200,80,120,80,160,0,640
75226,220,160,120,160,160,0,820
75227,160,100,120,160,320,0,860
75228,190,160,120,160,160,320,1110
75229,220,40,80,80,0,0,420
75230,170,80,40,80,160,0,530
75231,200,140,160,80,0,0,580
75232,160,120,160,0,0,0,440
75233,240,100,80,80,160,0,660
75234,190,100,80,80,0,0,450
75235,210,160,80,80,160,0,690
75236,160,80,160,80,160,0,640
75237,230,140,160,160,0,0,690
75238,190,100,120,0,0,0,410
75239,190,140,80,80,0,0,490
75240,160,120,80,80,160,320,920
75241,210,160,200,160,160,320,1210
75242,190,60,40,0,0,0,290
75243,240,180,160,80,0,0,660
75244,180,120,80,80,160,0,620
75245,180,160,80,80,0,0,500
75246,230,120,120,160,0,0,630
75247,220,100,40,0,0,0,360
75248,200,140,200,240,320,320,1420
75249,220,180,200,160,320,320,1400
75250,210,180,40,0,0,0,430
75251,190,100,80,80,0,0,450
75252,200,140,120,160,320,0,940
75253,210,140,120,160,320,320,1270
75254,160,140,160,160,160,0,780
75255,170,40,40,80,160,0,490
75256,210,160,160,160,0,0,690
75257,230,100,40,80,160,0,610
75258,160,100,120,160,320,0,860
75259,220,180,80,80,160,0,720
75260,210,80,80,160,0,0,530
75261,200,140,80,80,160,0,660
75262,190,100,160,160,160,0,770
75263,210,160,200,160,160,0,890
75264,190,100,80,160,160,0,690
75265,190,120,120,80,160,0,670
75266,190,140,120,0,0,0,450
75267,250,140,80,160,160,0,790
75268,190,60,80,80,160,0,570
75269,200,100,80,80,0,0,460
75270,170,120,120,80,0,0,490
75271,220,80,80,80,0,0,460
75272,240,140,80,0,0,0,460
75273,220,160,200,160,0,0,740
75274,180,120,80,0,0,0,380
75275,210,120,160,160,160,320,1130
75276,250,200,80,80,0,0,610
75277,170,140,120,80,160,0,670
75278,190,80,120,80,160,0,630
75279,210,120,40,0,0,0,370
75280,180,100,80,80,0,0,440
75281,190,120,80,80,0,0,470
75282,170,120,80,80,160,0,610
75283,210,120,40,0,0,0,370
75284,170,80,80,80,160,0,570
75285,180,140,160,160,320,0,960
75286,190,120,160,80,0,0,550
75287,190,120,80,80,160,0,630
75288,220,140,120,80,160,0,720
75289,200,100,120,160,160,0,740
75290,190,160,160,80,0,0,590
75291,220,140,160,80,0,0,600
75292,220,120,80,80,160,0,660
75293,210,80,80,80,160,0,610
75294,210,140,80,80,160,0,670
75295,240,120,80,0,0,0,440
75296,210,80,80,0,0,0,370
75297,170,140,80,0,0,0,390
75298,170,160,160,160,160,0,810
75299,200,160,120,80,160,0,720
75300,210,140,120,160,160,0,790
75301,170,100,80,80,0,0,430
75302,210,100,40,80,160,320,910
75303,200,200,240,80,0,0,720
75304,160,80,80,80,160,0,560
75305,210,140,160,160,160,0,830
75306,190,100,80,80,0,0,450
75307,180,140,80,80,160,0,640
75308,180,140,120,80,160,0,680
75309,190,160,80,0,0,0,430
75310,180,120,120,160,0,0,580
75311,210,100,80,80,0,0,470
75312,170,140,120,160,160,0,750
75313,210,100,120,160,160,0,750
75314,170,100,120,80,160,0,630
75315,160,80,160,0,0,0,400
75316,170,80,40,80,0,0,370
75317,200,80,80,0,0,0,360
75318,190,120,80,80,160,0,630
75319,200,120,80,0,0,0,400
75320,210,140,160,80,0,0,590
75321,200,140,80,80,0,0,500
75322,220,160,80,160,160,0,780
75323,220,80,120,160,0,0,580
75324,220,120,200,240,320,320,1420
75325,240,160,80,0,0,0,480
75326,240,120,120,160,320,0,960
75327,140,60,80,80,160,0,520
75328,180,60,0,0,0,0,240
75329,180,140,120,160,160,0,760
75330,190,60,80,160,160,320,970
75331,170,160,120,0,0,0,450
75332,160,60,80,160,160,0,620
75333,160,140,160,240,320,320,1340
75334,170,160,120,160,160,0,770
75335,200,120,120,80,160,0,680
75336,180,80,80,0,0,0,340
75337,200,140,200,160,320,320,1340
75338,190,160,120,160,0,0,630
75339,130,60,80,160,160,0,590
75340,230,100,120,240,160,0,850
75341,200,140,80,0,0,0,420
75342,200,140,120,160,160,0,780
75343,250,180,160,240,160,0,990
75344,220,160,120,80,160,320,1060
75345,160,100,120,160,160,0,700
75346,210,100,120,80,0,0,510
75347,190,160,120,160,160,0,790
75348,170,100,200,160,0,0,630
75349,230,160,160,240,320,320,1430
75350,180,60,80,160,320,320,1120
75351,170,140,120,80,160,320,990
75352,220,120,120,0,0,0,460
75353,180,120,160,160,160,0,780
75354,170,160,80,80,160,0,650
75355,150,40,0,0,0,0,190
75356,190,120,120,80,160,0,670
75357,190,140,120,160,160,0,770
75358,210,100,120,80,0,0,510
75359,160,140,120,80,160,0,660
75360,250,200,200,160,0,0,810
75361,190,120,80,0,0,0,390
75362,170,120,120,160,160,0,730
75363,180,140,80,0,0,0,400
75364,220,120,120,0,0,0,460
75365,210,200,160,80,160,320,1130
75366,180,120,40,80,0,0,420
75367,240,140,120,160,320,0,980
75368,220,140,80,80,160,0,680
75369,150,140,160,160,320,0,930
75370,180,160,160,160,0,0,660
75371,210,120,120,80,160,0,690
75372,160,120,80,0,0,0,360
75373,220,120,120,160,320,0,940
75374,200,120,200,160,160,320,1160
75375,170,180,80,0,0,0,430
75376,250,200,200,160,160,0,970
75377,210,160,160,320,320,0,1170
75378,190,120,80,160,320,0,870
75379,180,120,120,80,0,0,500
75380,200,80,0,0,0,0,280
75381,220,80,80,80,160,0,620
75382,200,120,120,80,160,0,680
75383,190,100,120,80,0,0,490
75384,180,160,80,80,160,0,660
75385,180,80,80,160,320,0,820
75386,210,100,40,0,0,0,350
75387,180,140,160,160,160,0,800
75388,180,120,120,160,320,0,900
75389,210,60,80,0,0,0,350
75390,170,120,120,0,0,0,410
75391,170,140,160,80,160,0,710
75392,220,120,120,160,160,0,780
75393,200,100,160,240,320,0,1020
75394,220,140,120,80,160,0,720
75395,180,120,80,80,160,0,620
75396,200,100,120,80,0,0,500
75397,180,140,120,80,0,0,520
75398,170,80,40,0,0,0,290
75399,150,100,120,160,160,320,1010
75400,210,100,120,160,160,320,1070
75401,220,120,120,80,0,0,540
75402,180,100,160,80,0,0,520
75403,220,80,80,0,0,0,380
75404,220,120,120,160,320,320,1260
75405,200,160,80,0,0,0,440
75406,160,60,80,0,0,0,300
75407,200,180,120,160,160,0,820
75408,190,140,120,0,0,0,450
75409,190,100,120,160,160,0,730
75410,190,120,160,160,160,0,790
75411,210,100,40,80,160,0,590
75412,200,140,160,80,0,0,580
75413,220,140,120,80,0,0,560
75414,230,120,80,0,0,0,430
75415,230,140,120,80,160,0,730
75416,230,140,160,160,160,0,850
75417,220,140,200,80,160,320,1120
75418,210,140,160,160,160,0,830
75419,250,60,80,160,160,320,1030
75420,210,100,120,80,160,0,670
75421,170,120,160,160,0,0,610
75422,220,120,80,0,0,0,420
75423,190,120,160,160,320,0,950
75424,220,100,40,80,160,0,600
75425,200,140,160,80,160,0,740
75426,160,100,80,0,0,0,340
75427,180,60,80,0,0,0,320
75428,180,180,160,80,160,0,760
75429,190,100,120,160,160,0,730
75430,170,80,40,0,0,0,290
75431,230,140,120,0,0,0,490
75432,180,100,80,0,0,0,360
75433,180,160,120,80,160,0,700
75434,220,120,80,80,160,0,660
75435,220,100,120,80,160,0,680
75436,160,140,40,0,0,0,340
75437,180,100,80,0,0,0,360
75438,190,160,80,0,0,0,430
75439,200,80,40,0,0,0,320
75440,200,120,80,0,0,0,400
75441,180,140,160,80,0,0,560
75442,240,140,120,80,160,0,740
75443,200,140,80,80,160,0,660
75444,220,100,120,160,0,0,600
75445,180,120,80,0,0,0,380
75446,210,120,200,160,160,0,850
75447,240,120,120,80,0,0,560
75448,200,80,80,160,160,0,680
75449,230,140,200,240,160,320,1290
75450,190,80,80,80,0,0,430
75451,170,100,40,0,0,0,310
75452,230,100,80,80,160,320,970
75453,210,120,160,160,160,0,810
75454,210,80,80,80,160,0,610
75455,210,160,200,160,160,0,890
75456,190,120,80,80,160,320,950
75457,220,160,200,160,320,320,1380
75458,190,140,120,160,160,320,1090
75459,190,40,40,80,0,0,350
75460,230,120,160,160,320,0,990
75461,220,180,200,80,160,0,840
75462,160,120,120,160,160,0,720
75463,220,120,80,160,160,0,740
75464,230,140,80,0,0,0,450
75465,240,100,160,160,160,0,820
75466,170,120,80,80,160,0,610
75467,240,120,120,80,160,0,720
75468,170,120,40,80,160,0,570
75469,260,180,200,80,160,320,1200
75470,200,60,80,80,160,0,580
75471,210,120,120,160,320,320,1250
75472,130,120,120,160,160,0,690
75473,220,160,80,80,160,0,700
75474,220,80,40,0,0,0,340
75475,220,200,200,240,320,0,1180
75476,160,140,120,160,160,320,1060
75477,190,160,120,160,0,0,630
75478,180,100,120,80,160,0,640
75479,200,140,160,160,160,0,820
75480,180,120,120,80,0,0,500
75481,180,120,120,80,160,0,660
75482,230,120,80,80,0,0,510
75483,190,100,80,80,0,0,450
75484,220,180,80,160,160,0,800
75485,220,120,120,0,0,0,460
75486,200,140,40,0,0,0,380
75487,190,80,80,80,0,0,430
75488,170,120,0,0,0,0,290
75489,230,160,80,0,0,0,470
75490,210,160,120,80,160,0,730
75491,170,140,40,0,0,0,350
75492,220,180,120,0,0,0,520
75493,210,140,120,80,160,0,710
75494,130,120,160,160,160,0,730
75495,150,120,40,0,0,0,310
75496,170,120,120,80,0,0,490
75497,170,140,160,80,0,0,550
75498,230,160,160,240,320,320,1430
75499,190,180,160,160,160,0,850
75500,210,120,160,0,0,0,490
75501,220,120,40,0,0,0,380
75502,210,140,120,80,160,0,710
75503,170,80,40,80,160,0,530
75504,220,100,80,80,160,0,640
75505,220,140,120,160,160,0,800
75506,180,60,40,80,160,0,520
75507,220,140,160,160,160,0,840
75508,170,80,0,0,0,0,250
75509,200,80,80,80,160,0,600
75510,260,120,40,0,0,0,420
75511,170,140,200,240,320,320,1390
75512,170,100,120,160,160,320,1030
75513,180,100,80,80,0,0,440
75514,230,140,160,80,0,0,610
75515,180,100,120,80,160,0,640
75516,190,140,200,160,0,0,690
75517,160,60,80,80,160,0,540
75518,250,120,160,80,0,0,610
75519,200,100,120,0,0,0,420
75520,190,180,200,160,0,0,730
75521,210,120,80,80,0,0,490
75522,210,120,40,80,0,0,450
75523,180,80,80,80,0,0,420
75524,200,120,120,80,0,0,520
75525,220,180,120,160,160,0,840
75526,150,60,120,160,160,0,650
75527,200,160,40,0,0,0,400
75528,190,100,40,80,0,0,410
75529,230,140,40,0,0,0,410
75530,190,160,200,160,320,0,1030
75531,200,140,200,160,160,0,860
75532,190,180,120,0,0,0,490
75533,240,160,120,160,320,0,1000
75534,150,120,160,240,160,0,830
75535,200,80,40,80,160,0,560
75536,220,160,80,80,0,0,540
75537,240,140,160,160,160,0,860
75538,160,100,160,240,160,0,820
75539,170,120,200,240,320,0,1050
75540,200,120,160,160,160,320,1120
75541,170,120,120,160,320,0,890
75542,190,100,120,80,160,320,970
75543,190,120,120,160,160,0,750
75544,210,100,160,240,160,0,870
75545,210,120,120,80,0,0,530
75546,160,80,80,0,0,0,320
75547,180,120,80,80,160,0,620
75548,170,80,40,0,0,0,290
75549,210,120,40,80,160,0,610
75550,210,120,120,160,160,0,770
75551,180,140,120,80,160,320,1000
75552,200,120,120,160,160,0,760
75553,200,200,240,160,160,0,960
75554,190,180,160,80,0,0,610
75555,180,60,80,0,0,0,320
75556,220,80,120,0,0,0,420
75557,210,100,120,160,160,0,750
75558,200,140,120,80,0,0,540
75559,170,100,40,80,160,0,550
75560,160,160,40,80,0,0,440
75561,220,140,160,80,160,0,760
75562,180,120,120,160,0,0,580
75563,180,160,80,80,0,0,500
75564,180,100,160,160,320,0,920
75565,190,100,80,160,160,320,1010
75566,250,120,120,80,160,0,730
75567,210,120,120,0,0,0,450
75568,160,80,80,80,0,0,400
75569,160,140,40,0,0,0,340
75570,200,80,80,160,160,0,680
75571,210,80,80,0,0,0,370
75572,210,140,160,160,160,0,830
75573,160,60,80,160,320,320,1100
75574,210,100,80,0,0,0,390
75575,190,140,200,160,160,0,850
75576,220,120,160,80,0,0,580
75577,200,120,40,80,160,0,600
75578,150,100,80,80,160,0,570
75579,190,80,120,160,160,0,710
75580,190,160,160,240,320,0,1070
75581,240,200,200,240,160,0,1040
75582,250,120,120,80,160,0,730
75583,200,160,80,0,0,0,440
75584,240,160,40,0,0,0,440
75585,210,100,160,160,320,320,1270
75586,170,120,200,160,320,0,970
75587,190,140,160,160,160,0,810
75588,230,160,120,80,160,0,750
75589,160,80,80,0,0,0,320
75590,160,180,160,80,160,0,740
75591,190,100,80,80,0,0,450
75592,200,160,200,80,0,0,640
75593,180,120,80,80,0,0,460
75594,230,160,80,80,160,0,710
75595,180,160,160,160,160,0,820
75596,190,160,160,80,160,0,750
75597,240,200,240,240,320,0,1240
75598,200,160,40,80,160,0,640
75599,200,140,80,80,160,0,660
75600,230,100,120,80,160,0,690
75601,190,180,120,160,160,0,810
75602,210,60,40,0,0,0,310
75603,180,80,40,80,160,0,540
75604,190,140,80,0,0,0,410
75605,210,100,160,160,320,320,1270
75606,190,160,200,160,320,320,1350
75607,160,80,80,0,0,0,320
75608,200,140,120,160,160,0,780
75609,150,120,160,80,0,0,510
75610,190,160,80,80,0,0,510
75611,190,100,40,80,160,0,570
75612,200,140,80,80,160,0,660
75613,210,120,80,160,160,0,730
75614,240,80,80,80,160,0,640
75615,200,120,80,0,0,0,400
75616,200,100,160,160,160,0,780
75617,190,140,160,160,320,0,970
75618,210,120,80,80,0,0,490
75619,190,100,80,0,0,0,370
75620,200,140,80,0,0,0,420
75621,220,160,120,80,160,0,740
75622,200,180,160,160,160,0,860
75623,210,160,160,240,320,0,1090
75624,190,100,160,160,320,0,930
75625,180,100,40,80,160,0,560
75626,200,180,200,160,160,0,900
75627,190,120,160,80,0,0,550
75628,200,100,80,80,0,0,460
75629,180,120,160,160,160,0,780
75630,230,100,40,0,0,0,370
75631,180,100,160,160,320,0,920
75632,180,120,80,80,160,0,620
75633,210,140,80,160,160,0,750
75634,160,160,160,160,320,0,960
75635,200,120,120,160,160,0,760
75636,210,180,80,160,160,0,790
75637,200,100,120,80,160,0,660
75638,180,120,80,160,160,0,700
75639,180,160,120,160,320,320,1260
75640,230,160,80,160,160,0,790
75641,150,120,160,240,160,0,830
75642,190,100,80,160,0,0,530
75643,230,60,80,80,160,0,610
75644,210,120,40,80,160,0,610
75645,150,100,160,80,160,0,650
75646,170,140,80,80,160,320,950
75647,220,100,120,80,0,0,520
75648,160,100,80,80,0,0,420
75649,200,160,200,240,160,0,960
75650,180,120,160,160,160,0,780
75651,200,120,80,80,160,0,640
75652,190,200,160,0,0,0,550
75653,210,160,80,0,0,0,450
75654,190,80,80,80,160,0,590
75655,200,80,80,80,0,0,440
75656,220,100,80,160,0,0,560
75657,190,100,40,0,0,0,330
75658,200,100,120,80,0,0,500
75659,200,120,160,160,160,0,800
75660,220,100,120,80,0,0,520
75661,210,80,80,80,160,0,610
75662,190,100,120,160,320,320,1210
75663,220,140,120,0,0,0,480
75664,170,100,120,80,160,0,630
75665,210,140,200,240,320,0,1110
75666,170,100,120,80,160,320,950
75667,200,80,80,80,0,0,440
75668,200,200,80,0,0,0,480
75669,210,100,120,240,320,0,990
75670,210,60,40,0,0,0,310
75671,170,60,80,80,160,0,550
75672,210,160,80,160,320,0,930
75673,190,120,120,80,0,0,510
75674,190,100,120,160,160,0,730
75675,200,100,0,0,0,0,300
75676,170,60,0,0,0,0,230
75677,210,100,80,160,160,0,710
75678,190,140,80,160,160,320,1050
75679,190,180,160,0,0,0,530
75680,180,80,160,160,0,0,580
75681,200,160,160,160,320,0,1000
75682,200,160,160,160,160,0,840
75683,210,140,40,0,0,0,390
75684,220,120,80,80,160,0,660
75685,190,120,160,160,160,0,790
75686,160,120,80,80,160,0,600
75687,220,120,120,160,320,320,1260
75688,210,140,120,80,0,0,550
75689,190,160,160,80,160,320,1070
75690,210,100,40,80,0,0,430
75691,150,120,80,80,160,0,590
75692,190,140,80,160,160,320,1050
75693,240,160,160,160,160,0,880
75694,210,100,40,80,0,0,430
75695,190,140,120,80,160,0,690
75696,190,120,80,80,0,0,470
75697,210,100,80,80,0,0,470
75698,240,100,120,80,0,0,540
75699,150,80,40,80,0,0,350
75700,210,100,80,80,160,320,950
75701,200,120,80,80,160,0,640
75702,220,120,120,160,160,0,780
75703,200,140,80,80,0,0,500
75704,200,120,80,80,0,0,480
75705,210,120,200,160,160,0,850
75706,170,100,160,160,160,0,750
75707,190,140,120,160,160,0,770
75708,180,100,160,160,320,0,920
75709,190,120,200,240,160,0,910
75710,180,160,160,160,160,0,820
75711,230,180,160,80,160,0,810
75712,180,160,120,80,0,0,540
75713,140,100,80,160,0,0,480
75714,180,100,120,160,160,0,720
75715,190,120,80,160,320,0,870
75716,210,80,40,80,0,0,410
75717,220,100,160,160,160,0,800
75718,230,160,160,80,160,0,790
75719,200,100,160,160,160,320,1100
75720,210,100,80,0,0,0,390
75721,200,120,160,0,0,0,480
75722,200,80,80,0,0,0,360
75723,230,140,80,0,0,0,450
75724,210,80,40,0,0,0,330
75725,210,80,40,0,0,0,330
75726,200,200,80,160,320,320,1280
75727,200,140,80,0,0,0,420
75728,200,140,160,240,160,0,900
75729,170,80,80,160,0,0,490
75730,180,80,40,80,160,0,540
75731,210,140,160,240,160,0,910
75732,200,200,160,0,0,0,560
75733,170,80,80,160,160,0,650
75734,180,80,40,80,160,0,540
75735,210,100,80,80,0,0,470
75736,190,140,200,160,320,0,1010
75737,150,100,160,160,0,0,570
75738,190,140,200,80,160,0,770
75739,190,100,40,0,0,0,330
75740,210,180,240,160,320,0,1110
75741,260,80,80,80,160,0,660
75742,230,160,80,160,160,0,790
75743,190,100,120,80,0,0,490
75744,210,100,160,160,160,0,790
75745,190,60,80,80,0,0,410
75746,190,100,120,240,160,0,810
75747,220,140,120,80,160,320,1040
75748,190,160,120,160,160,0,790
75749,150,100,80,80,160,0,570
75750,170,120,120,160,160,0,730
75751,150,120,160,160,160,0,750
75752,180,60,0,0,0,0,240
75753,240,160,160,160,160,0,880
75754,190,100,120,160,160,0,730
75755,180,140,160,80,160,0,720
75756,210,120,120,80,160,320,1010
75757,160,100,120,80,160,0,620
75758,180,100,80,80,0,0,440
75759,210,120,200,160,320,320,1330
75760,140,120,120,160,320,0,860
75761,180,60,80,160,320,0,800
75762,160,100,160,160,320,0,900
75763,170,120,120,0,0,0,410
75764,210,160,80,80,160,0,690
75765,150,140,120,160,160,0,730
75766,180,120,120,80,160,0,660
75767,230,200,120,0,0,0,550
75768,200,100,40,80,0,0,420
75769,210,100,0,0,0,0,310
75770,190,140,120,80,0,0,530
75771,190,120,120,80,160,320,990
75772,170,100,80,160,160,0,670
75773,220,120,40,0,0,0,380
75774,230,100,120,80,0,0,530
75775,150,120,120,160,320,0,870
75776,170,100,160,80,0,0,510
75777,190,80,80,80,160,0,590
75778,170,100,160,160,320,0,910
75779,140,100,80,0,0,0,320
75780,200,160,160,160,320,320,1320
75781,180,120,120,160,320,320,1220
75782,150,80,80,80,160,0,550
75783,230,160,120,160,160,0,830
75784,130,60,40,80,0,0,310
75785,200,120,40,80,0,0,440
75786,190,160,40,0,0,0,390
75787,210,120,120,80,160,0,690
75788,220,140,80,80,160,320,1000
75789,170,140,160,80,0,0,550
75790,210,120,80,80,160,0,650
75791,200,140,80,160,320,0,900
75792,210,80,160,160,160,320,1090
75793,210,160,160,160,320,0,1010
75794,200,120,80,80,160,0,640
75795,200,140,120,80,160,0,700
75796,180,140,120,160,320,0,920
75797,150,140,160,160,160,0,770
75798,190,160,160,160,160,0,830
75799,180,160,80,80,160,0,660
75800,190,120,80,0,0,0,390
75801,170,160,120,80,160,0,690
75802,170,120,120,160,160,0,730
75803,190,160,120,80,0,0,550
75804,190,100,160,160,0,0,610
75805,180,120,120,160,0,0,580
75806,200,160,160,240,160,0,920
75807,190,120,80,160,320,0,870
75808,210,180,160,80,160,0,790
75809,220,160,200,160,0,0,740
75810,220,120,80,0,0,0,420
75811,230,160,80,160,320,0,950
75812,210,80,40,0,0,0,330
75813,210,120,80,80,160,0,650
75814,190,100,40,80,0,0,410
75815,220,160,120,80,0,0,580
75816,240,180,200,160,0,0,780
75817,170,120,120,0,0,0,410
75818,190,120,120,160,160,0,750
75819,220,180,120,160,160,0,840
75820,220,100,80,80,160,0,640
75821,190,120,120,160,160,0,750
75822,190,100,160,160,0,0,610
75823,210,100,120,160,160,0,750
75824,180,100,80,80,160,0,600
75825,160,120,80,80,160,0,600
75826,170,140,120,80,0,0,510
75827,200,160,80,80,0,0,520
75828,220,180,120,80,0,0,600
75829,190,120,160,160,160,320,1110
75830,200,100,160,80,160,0,700
75831,200,100,80,80,0,0,460
75832,220,160,80,80,160,0,700
75833,250,160,160,160,320,0,1050
75834,280,120,200,240,0,0,840
75835,200,120,120,80,0,0,520
75836,210,140,200,240,160,0,950
75837,200,80,120,160,160,0,720
75838,160,100,80,80,160,0,580
75839,200,120,120,160,160,0,760
75840,210,120,80,80,160,0,650
75841,180,100,40,0,0,0,320
75842,180,140,160,160,160,0,800
75843,200,120,120,80,160,320,1000
75844,170,120,120,80,160,0,650
75845,220,140,120,160,160,320,1120
75846,240,120,200,240,160,320,1280
75847,220,140,40,80,0,0,480
75848,260,180,160,80,0,0,680
75849,180,140,120,80,0,0,520
75850,210,120,80,80,160,0,650
75851,180,120,120,80,160,0,660
75852,220,160,80,80,0,0,540
75853,140,120,160,80,160,320,980
75854,210,200,120,160,0,0,690
75855,200,100,80,80,160,0,620
75856,160,120,160,160,320,0,920
75857,190,80,80,80,160,0,590
75858,210,120,160,160,160,0,810
75859,180,120,120,80,160,0,660
75860,190,140,120,80,0,0,530
75861,190,100,40,80,160,0,570
75862,180,120,80,160,160,0,700
75863,230,80,80,0,0,0,390
75864,190,100,80,160,160,0,690
75865,200,100,160,160,320,0,940
75866,160,120,40,80,160,0,560
75867,210,160,160,0,0,0,530
75868,160,120,80,0,0,0,360
75869,200,140,160,80,160,0,740
75870,220,140,160,160,320,0,1000
75871,210,120,40,80,160,320,930
75872,190,160,80,0,0,0,430
75873,210,120,40,80,160,0,610
75874,230,160,80,0,0,0,470
75875,200,120,80,80,160,0,640
75876,240,140,160,80,0,0,620
75877,190,120,80,80,0,0,470
75878,210,120,80,80,0,0,490
75879,190,160,120,80,0,0,550
75880,190,120,80,80,160,0,630
75881,190,140,120,160,320,320,1250
75882,180,120,120,240,320,0,980
75883,200,140,80,80,160,0,660
75884,200,60,80,0,0,0,340
75885,150,120,80,80,0,0,430
75886,170,100,120,240,160,0,790
75887,200,60,40,0,0,0,300
75888,170,140,40,0,0,0,350
75889,190,80,40,0,0,0,310
75890,150,60,80,80,160,0,530
75891,190,160,160,160,160,320,1150
75892,170,60,40,0,0,0,270
75893,200,160,120,160,160,0,800
75894,190,140,240,160,160,320,1210
75895,220,140,120,80,160,320,1040
75896,210,140,160,80,160,320,1070
75897,200,120,200,160,0,0,680
75898,160,120,160,80,160,0,680
75899,190,80,120,80,0,0,470
75900,180,120,40,80,0,0,420
75901,220,140,160,160,0,0,680
75902,210,120,40,0,0,0,370
75903,230,160,160,0,0,0,550
75904,140,100,120,160,0,0,520
75905,230,140,160,160,320,320,1330
75906,200,140,120,160,160,0,780
75907,160,100,120,160,0,0,540
75908,170,160,80,0,0,0,410
75909,230,80,80,80,160,320,950
75910,160,140,120,80,0,0,500
75911,150,120,120,80,0,0,470
75912,210,140,120,80,160,0,710
75913,210,140,240,240,160,0,990
75914,210,100,80,80,160,0,630
75915,200,160,80,160,160,0,760
75916,200,120,160,240,320,0,1040
75917,220,100,160,160,160,0,800
75918,160,120,160,240,160,0,840
75919,200,120,120,80,160,0,680
75920,180,120,80,160,160,0,700
75921,180,100,160,160,160,0,760
75922,160,120,80,80,0,0,440
75923,190,80,80,80,160,0,590
75924,180,120,40,80,160,0,580
75925,200,100,160,160,160,0,780
75926,220,120,160,160,160,320,1140
75927,190,140,160,80,160,0,730
75928,210,160,160,160,160,320,1170
75929,190,60,80,160,0,0,490
75930,200,140,80,80,160,0,660
75931,180,120,120,160,0,0,580
75932,190,80,120,160,320,0,870
75933,190,120,80,80,160,0,630
75934,210,140,120,160,160,0,790
75935,140,60,40,80,160,0,480
75936,200,120,120,80,0,0,520
75937,160,140,120,160,320,0,900
75938,190,100,80,80,160,0,610
75939,200,180,200,80,160,0,820
75940,210,120,40,80,160,0,610
75941,230,120,120,240,160,0,870
75942,190,120,160,160,160,320,1110
75943,180,100,80,0,0,0,360
75944,200,120,80,0,0,0,400
75945,230,120,80,160,0,0,590
75946,190,140,40,80,160,0,610
75947,200,120,120,160,160,0,760
75948,200,100,80,0,0,0,380
75949,150,60,40,0,0,0,250
75950,240,160,120,80,0,0,600
75951,190,100,40,80,160,0,570
75952,220,80,80,0,0,0,380
75953,180,100,80,80,0,0,440
75954,230,80,80,80,160,0,630
75955,210,100,120,80,160,320,990
75956,150,120,120,160,160,0,710
75957,210,120,80,80,0,0,490
75958,180,120,160,80,0,0,540
75959,200,100,120,160,320,320,1220
75960,180,100,80,80,160,0,600
75961,150,120,160,160,320,0,910
75962,170,80,40,80,0,0,370
75963,180,120,80,80,0,0,460
75964,240,160,160,160,160,320,1200
75965,200,140,120,80,160,0,700
75966,230,120,120,160,160,0,790
75967,160,60,0,0,0,0,220
75968,190,80,120,240,160,320,1110
75969,210,100,40,80,0,0,430
75970,190,140,120,0,0,0,450
75971,200,100,120,160,160,0,740
75972,210,120,80,80,160,0,650
75973,200,140,40,0,0,0,380
75974,170,100,80,80,0,0,430
75975,160,120,40,0,0,0,320
75976,200,100,80,0,0,0,380
75977,200,120,40,0,0,0,360
75978,190,120,120,240,320,320,1310
75979,200,120,120,80,160,0,680
75980,150,160,80,80,160,320,950
75981,190,80,80,160,160,320,990
75982,200,120,160,80,160,0,720
75983,180,80,40,80,160,0,540
75984,200,160,120,0,0,0,480
75985,200,120,80,80,160,0,640
75986,220,140,80,160,0,0,600
75987,190,180,160,160,160,0,850
75988,170,140,120,80,160,0,670
75989,220,160,160,80,160,0,780
75990,190,160,200,0,0,0,550
75991,220,160,120,80,160,0,740
75992,190,140,120,80,0,0,530
75993,190,100,40,80,160,320,890
75994,190,180,200,240,160,0,970
75995,190,100,40,80,160,0,570
75996,170,120,80,0,0,0,370
75997,230,140,80,0,0,0,450
75998,200,160,80,80,160,0,680
75999,170,120,80,80,160,0,610
76000,220,120,120,80,160,320,1020
76001,220,180,120,80,160,0,760
76002,200,120,120,80,0,0,520
76003,190,80,80,160,160,0,670
76004,160,100,120,160,160,0,700
76005,210,120,120,240,0,0,690
76006,200,160,240,240,320,0,1160
76007,180,120,80,80,0,0,460
76008,220,160,80,80,0,0,540
76009,200,140,120,80,160,0,700
76010,210,160,120,160,160,0,810
76011,220,180,240,160,0,0,800
76012,200,140,80,0,0,0,420
76013,220,100,120,80,160,0,680
76014,170,140,120,0,0,0,430
76015,250,60,40,0,0,0,350
76016,210,160,200,240,160,320,1290
76017,220,160,80,160,320,0,940
76018,190,100,80,80,160,0,610
76019,180,100,80,0,0,0,360
76020,170,140,80,160,160,0,710
76021,260,60,80,0,0,0,400
76022,200,200,160,160,0,0,720
76023,210,100,80,80,160,0,630
76024,230,140,40,0,0,0,410
76025,230,120,80,0,0,0,430
76026,160,120,80,80,160,0,600
76027,200,120,80,0,0,0,400
76028,190,120,80,80,0,0,470
76029,170,180,160,160,320,320,1310
76030,250,120,80,80,160,0,690
76031,200,140,40,0,0,0,380
76032,170,100,120,80,0,0,470
76033,240,120,120,240,160,0,880
76034,190,100,120,80,160,320,970
76035,200,100,120,160,320,0,900
76036,180,100,40,80,160,0,560
76037,220,120,160,80,0,0,580
76038,190,80,40,80,0,0,390
76039,220,120,80,80,0,0,500
76040,200,180,120,160,160,0,820
76041,240,160,160,240,0,0,800
76042,170,60,80,0,0,0,310
76043,180,120,120,160,160,320,1060
76044,160,60,80,160,160,0,620
76045,220,80,80,80,160,0,620
76046,170,100,120,160,320,320,1190
76047,150,100,120,80,0,0,450
76048,170,100,120,80,0,0,470
76049,170,160,200,160,160,0,850
76050,140,140,40,0,0,0,320
76051,200,100,120,80,160,0,660
76052,190,120,120,160,160,320,1070
76053,170,100,80,80,160,0,590
76054,220,100,40,0,0,0,360
76055,220,100,40,0,0,0,360
76056,200,60,80,80,0,0,420
76057,190,100,160,0,0,0,450
76058,220,120,200,80,160,0,780
76059,200,140,160,80,0,0,580
76060,230,140,200,240,320,320,1450
76061,230,140,120,160,160,0,810
76062,210,140,80,160,160,0,750
76063,250,160,120,160,160,0,850
76064,230,120,120,160,160,0,790
76065,200,60,80,80,160,0,580
76066,210,100,40,80,0,0,430
76067,210,140,120,160,160,0,790
76068,210,100,160,80,160,0,710
76069,210,180,120,240,320,320,1390
76070,210,120,160,160,160,0,810
76071,170,160,120,80,0,0,530
76072,260,120,120,160,320,320,1300
76073,170,60,40,80,160,0,510
76074,190,160,200,80,160,0,790
76075,200,100,160,80,0,0,540
76076,220,60,80,80,0,0,440
76077,220,180,80,80,0,0,560
76078,180,100,40,0,0,0,320
76079,200,160,120,80,0,0,560
76080,240,100,120,240,320,0,1020
76081,190,120,120,160,160,0,750
76082,210,120,160,240,320,0,1050
76083,160,60,40,0,0,0,260
76084,220,100,0,0,0,0,320
76085,220,160,200,240,160,0,980
76086,190,120,160,240,160,0,870
76087,190,120,40,0,0,0,350
76088,150,80,120,80,0,0,430
76089,230,100,40,80,0,0,450
76090,210,140,120,80,0,0,550
76091,210,180,120,160,320,0,990
76092,230,100,80,80,160,0,650
76093,190,100,120,160,0,0,570
76094,160,80,80,160,160,320,960
76095,210,140,40,0,0,0,390
76096,170,140,120,160,0,0,590
76097,200,160,120,160,0,0,640
76098,190,100,160,80,0,0,530
76099,170,80,80,0,0,0,330
76100,180,80,80,80,0,0,420
76101,200,100,120,160,160,0,740
76102,170,120,80,160,160,0,690
76103,210,140,160,160,0,0,670
76104,150,120,80,80,160,320,910
76105,220,140,120,160,320,0,960
76106,230,120,200,160,160,0,870
76107,230,160,200,240,320,320,1470
76108,210,100,40,80,160,0,590
76109,170,120,40,80,160,0,570
76110,210,80,40,0,0,0,330
76111,180,140,120,80,160,0,680
76112,190,140,160,80,160,0,730
76113,210,180,160,80,0,0,630
76114,190,60,120,160,0,0,530
76115,170,100,120,160,320,320,1190
76116,170,120,120,80,160,0,650
76117,210,180,160,80,160,320,1110
76118,200,100,80,0,0,0,380
76119,180,80,120,80,160,0,620
76120,170,100,80,0,0,0,350
76121,200,140,80,80,0,0,500
76122,240,120,80,0,0,0,440
76123,140,80,80,0,0,0,300
76124,220,100,120,80,0,0,520
76125,150,80,120,80,160,0,590
76126,210,80,160,160,160,320,1090
76127,240,220,80,80,160,0,780
76128,230,80,120,80,0,0,510
76129,200,80,120,80,160,0,640
76130,160,120,120,0,0,0,400
76131,240,140,160,80,160,0,780
76132,190,80,120,80,160,0,630
76133,220,180,80,0,0,0,480
76134,230,120,120,240,160,0,870
76135,140,100,80,0,0,0,320
76136,220,220,40,0,0,0,480
76137,170,160,160,160,160,320,1130
76138,200,200,160,80,0,0,640
76139,180,100,160,80,160,0,680
76140,150,100,80,0,0,0,330
76141,220,140,40,80,0,0,480
76142,170,140,160,160,0,0,630
76143,210,120,80,0,0,0,410
76144,220,120,80,160,160,0,740
76145,180,60,80,80,160,320,880
76146,230,100,80,80,160,0,650
76147,220,160,120,160,160,320,1140
76148,220,80,80,80,160,0,620
76149,210,120,80,160,160,0,730
76150,190,200,120,160,160,320,1150
76151,190,120,80,80,0,0,470
76152,200,100,40,0,0,0,340
76153,170,160,120,80,0,0,530
76154,200,160,80,0,0,0,440
76155,200,160,160,160,160,0,840
76156,220,180,80,0,0,0,480
76157,190,140,80,160,160,0,730
76158,210,160,160,80,0,0,610
76159,190,160,160,160,160,320,1150
76160,170,120,160,160,160,320,1090
76161,170,100,80,160,320,0,830
76162,230,140,200,240,160,0,970
76163,210,100,120,160,320,0,910
76164,180,80,80,80,0,0,420
76165,170,100,80,160,0,0,510
76166,210,40,0,0,0,0,250
76167,170,40,40,80,0,0,330
76168,170,120,80,80,160,0,610
76169,210,100,120,0,0,0,430
76170,210,140,120,240,320,0,1030
76171,210,120,120,80,160,0,690
76172,160,160,160,160,160,0,800
76173,200,120,160,160,320,0,960
76174,170,140,160,0,0,0,470
76175,220,140,40,80,0,0,480
76176,180,120,80,80,0,0,460
76177,230,200,120,0,0,0,550
76178,210,200,120,0,0,0,530
76179,190,160,80,80,0,0,510
76180,190,120,80,80,0,0,470
76181,220,140,80,160,160,0,760
76182,220,140,160,240,160,0,920
76183,190,80,80,0,0,0,350
76184,220,140,160,240,160,0,920
76185,200,120,120,80,160,0,680
76186,180,100,120,0,0,0,400
76187,170,120,80,80,160,0,610
76188,210,140,120,0,0,0,470
76189,200,140,160,160,320,0,980
76190,190,100,40,80,0,0,410
76191,210,120,80,0,0,0,410
76192,210,100,120,80,0,0,510
76193,200,140,120,80,160,0,700
76194,220,220,160,160,160,0,920
76195,190,140,80,80,0,0,490
76196,200,100,120,80,160,0,660
76197,190,100,80,80,0,0,450
76198,240,120,160,240,160,0,920
76199,160,140,120,0,0,0,420
76200,210,120,80,80,160,0,650
76201,180,160,120,80,160,0,700
76202,200,80,160,80,0,0,520
76203,200,160,160,240,320,0,1080
76204,200,200,120,160,0,0,680
76205,190,100,80,0,0,0,370
76206,200,120,160,240,320,320,1360
76207,210,120,40,80,0,0,450
76208,190,80,40,0,0,0,310
76209,200,180,160,160,160,0,860
76210,200,140,120,80,160,0,700
76211,200,120,80,0,0,0,400
76212,170,120,120,160,0,0,570
76213,200,160,120,160,320,0,960
76214,250,200,120,80,160,0,810
76215,170,120,120,160,160,0,730
76216,230,160,80,160,160,0,790
76217,150,80,40,80,160,0,510
76218,210,120,160,160,320,320,1290
76219,210,160,120,160,160,0,810
76220,220,160,120,80,160,320,1060
76221,190,160,200,160,160,0,870
76222,180,160,120,80,160,0,700
76223,190,140,120,160,160,0,770
76224,190,120,120,160,160,0,750
76225,180,100,80,80,0,0,440
76226,180,60,80,80,160,320,880
76227,210,120,160,240,0,0,730
76228,210,140,160,160,320,320,1310
76229,180,140,80,0,0,0,400
76230,200,80,80,160,160,0,680
76231,220,80,80,160,160,320,1020
76232,220,100,80,160,160,0,720
76233,180,80,120,80,160,0,620
76234,180,80,80,80,160,0,580
76235,180,100,80,0,0,0,360
76236,170,100,40,80,160,0,550
76237,220,80,40,80,160,0,580
76238,190,100,120,80,160,320,970
76239,190,120,160,160,160,0,790
76240,230,100,120,160,320,0,930
76241,150,80,120,80,0,0,430
76242,240,120,80,0,0,0,440
76243,230,100,80,80,160,0,650
76244,210,120,80,80,160,320,970
76245,230,100,80,80,0,0,490
76246,240,140,80,160,160,0,780
76247,160,100,80,160,160,320,980
76248,200,140,120,240,320,0,1020
76249,180,80,40,0,0,0,300
76250,170,100,120,80,160,0,630
76251,190,140,160,80,0,0,570
76252,200,100,40,0,0,0,340
76253,170,80,80,80,160,0,570
76254,170,140,120,80,0,0,510
76255,210,140,120,160,0,0,630
76256,180,140,120,80,160,320,1000
76257,200,140,160,160,160,0,820
76258,150,100,80,80,160,0,570
76259,200,140,200,240,0,0,780
76260,200,140,120,240,160,320,1180
76261,220,180,200,160,160,0,920
76262,220,180,120,80,160,0,760
76263,170,160,80,160,160,320,1050
76264,200,120,120,80,160,0,680
76265,190,60,80,160,160,0,650
76266,220,60,80,80,160,0,600
76267,220,140,120,80,160,0,720
76268,230,100,80,160,0,0,570
76269,220,120,120,80,0,0,540
76270,220,220,120,80,0,0,640
76271,200,120,120,0,0,0,440
76272,180,100,160,80,160,0,680
76273,220,140,160,240,160,0,920
76274,210,160,80,80,160,0,690
76275,210,100,160,80,160,320,1030
76276,170,120,80,80,0,0,450
76277,170,60,40,80,0,0,350
76278,200,100,40,0,0,0,340
76279,190,80,80,0,0,0,350
76280,200,80,40,80,160,320,880
76281,190,120,80,80,160,0,630
76282,210,100,160,80,0,0,550
76283,210,120,160,160,160,0,810
76284,250,120,80,0,0,0,450
76285,180,140,120,160,160,0,760
76286,190,80,0,0,0,0,270
76287,170,120,80,80,160,320,930
76288,200,120,120,240,320,0,1000
76289,190,60,0,0,0,0,250
76290,190,100,120,0,0,0,410
76291,190,100,40,80,160,320,890
76292,180,140,40,0,0,0,360
76293,180,120,80,160,320,0,860
76294,230,80,80,80,160,0,630
76295,190,80,120,80,0,0,470
76296,180,100,120,80,160,320,960
76297,190,140,120,80,160,320,1010
76298,170,120,80,160,160,0,690
76299,220,120,120,80,160,0,700
76300,180,140,40,80,0,0,440
76301,200,120,120,80,0,0,520
76302,240,140,160,80,0,0,620
76303,240,160,80,0,0,0,480
76304,200,100,120,80,0,0,500
76305,220,100,120,80,160,320,1000
76306,250,80,120,80,160,0,690
76307,210,160,80,80,0,0,530
76308,210,80,80,80,160,0,610
76309,200,100,80,160,320,0,860
76310,220,140,160,80,0,0,600
76311,220,120,120,160,160,0,780
76312,260,80,0,0,0,0,340
76313,190,120,120,160,160,0,750
76314,220,200,40,0,0,0,460
76315,160,80,40,80,160,0,520
76316,200,120,40,80,0,0,440
76317,180,140,40,80,160,320,920
76318,200,80,80,0,0,0,360
76319,210,80,40,0,0,0,330
76320,260,180,80,80,0,0,600
76321,210,120,80,80,160,0,650
76322,210,140,80,160,0,0,590
76323,230,140,160,160,160,0,850
76324,190,120,160,160,0,0,630
76325,200,100,120,160,320,0,900
76326,220,140,80,80,0,0,520
76327,170,80,80,80,160,0,570
76328,200,80,40,0,0,0,320
76329,220,220,240,160,160,0,1000
76330,230,120,0,0,0,0,350
76331,230,220,80,80,160,0,770
76332,190,120,120,160,160,0,750
76333,190,120,160,0,0,0,470
76334,210,160,120,240,160,0,890
76335,160,120,40,0,0,0,320
76336,210,100,40,80,160,320,910
76337,190,140,120,0,0,0,450
76338,210,120,120,80,160,0,690
76339,200,140,160,80,0,0,580
76340,200,100,120,80,0,0,500
76341,220,140,120,80,160,320,1040
76342,190,160,80,80,160,0,670
76343,240,120,40,80,160,320,960
76344,180,120,40,80,160,0,580
76345,170,60,40,0,0,0,270
76346,130,120,160,160,160,0,730
76347,210,120,120,0,0,0,450
76348,190,60,0,0,0,0,250
76349,180,80,0,0,0,0,260
76350,220,120,120,80,160,0,700
76351,210,140,120,160,160,0,790
76352,140,60,80,80,0,0,360
76353,190,120,120,0,0,0,430
76354,180,120,120,80,160,0,660
76355,230,180,160,160,160,0,890
76356,250,140,80,0,0,0,470
76357,220,140,160,0,0,0,520
76358,200,140,120,0,0,0,460
76359,180,160,200,160,160,0,860
76360,200,100,80,160,320,320,1180
76361,160,140,160,80,160,320,1020
76362,190,160,160,160,160,0,830
76363,200,120,120,80,160,0,680
76364,220,180,80,80,160,0,720
76365,170,160,120,160,160,320,1090
76366,250,120,160,80,160,0,770
76367,210,160,120,0,0,0,490
76368,140,100,80,80,160,0,560
76369,170,140,200,240,320,320,1390
76370,220,80,40,80,0,0,420
76371,200,120,40,0,0,0,360
76372,190,140,120,80,160,0,690
76373,200,120,40,80,0,0,440
76374,170,100,80,80,160,0,590
76375,190,80,0,0,0,0,270
76376,220,180,160,160,160,0,880
76377,210,80,120,160,0,0,570
76378,210,160,120,80,0,0,570
76379,200,200,80,160,320,0,960
76380,230,120,80,0,0,0,430
76381,190,180,40,80,160,0,650
76382,190,120,120,80,160,0,670
76383,160,80,80,160,320,0,800
76384,200,120,80,80,160,0,640
76385,220,80,120,160,320,0,900
76386,180,80,40,80,0,0,380
76387,210,120,120,160,320,0,930
76388,200,140,80,160,320,0,900
76389,210,120,160,160,320,0,970
76390,220,200,160,240,160,0,980
76391,180,120,120,160,0,0,580
76392,200,140,160,160,320,0,980
76393,200,160,120,160,0,0,640
76394,190,100,80,0,0,0,370
76395,150,100,120,80,160,0,610
76396,180,160,280,240,320,0,1180
76397,200,80,40,0,0,0,320
76398,210,160,200,160,160,0,890
76399,220,160,160,80,160,0,780
76400,150,60,80,160,0,0,450
76401,180,80,0,0,0,0,260
76402,170,100,160,160,320,0,910
76403,170,180,120,80,0,0,550
76404,230,160,160,240,160,0,950
76405,190,140,40,0,0,0,370
76406,220,140,80,160,320,320,1240
76407,180,120,80,160,160,0,700
76408,210,120,40,0,0,0,370
76409,220,100,80,160,320,0,880
76410,140,120,120,80,160,0,620
76411,200,100,120,80,160,0,660
76412,190,140,40,80,160,0,610
76413,200,140,160,80,0,0,580
76414,190,140,120,80,0,0,530
76415,230,140,80,80,160,0,690
76416,210,60,80,0,0,0,350
76417,220,140,80,160,320,0,920
76418,190,100,40,0,0,0,330
76419,180,80,40,80,160,0,540
76420,190,120,160,160,0,0,630
76421,210,140,120,80,160,0,710
76422,210,160,160,160,320,0,1010
76423,190,100,80,0,0,0,370
76424,160,100,80,0,0,0,340
76425,200,80,40,80,160,0,560
76426,210,160,200,160,320,0,1050
76427,190,140,120,160,160,0,770
76428,190,140,80,0,0,0,410
76429,170,140,160,160,320,320,1270
76430,210,120,160,80,160,0,730
76431,200,140,120,0,0,0,460
76432,200,100,40,0,0,0,340
76433,200,180,160,80,0,0,620
76434,190,160,200,160,320,320,1350
76435,190,120,120,160,320,0,910
76436,180,120,120,0,0,0,420
76437,200,160,80,80,160,0,680
76438,180,140,160,240,160,0,880
76439,190,80,120,80,160,0,630
76440,230,180,160,240,320,0,1130
76441,210,120,120,80,0,0,530
76442,210,160,120,80,160,0,730
76443,220,100,80,160,160,0,720
76444,210,100,80,0,0,0,390
76445,230,100,80,80,160,0,650
76446,210,120,160,160,160,0,810
76447,150,80,80,160,160,320,950
76448,240,140,40,80,0,0,500
76449,170,140,160,160,160,0,790
76450,210,160,200,160,160,0,890
76451,190,120,120,160,160,320,1070
76452,220,120,120,80,0,0,540
76453,180,100,80,80,160,0,600
76454,210,100,80,0,0,0,390
76455,170,100,40,80,160,0,550
76456,210,80,80,80,160,320,930
76457,150,100,120,160,160,0,690
76458,250,160,160,80,160,0,810
76459,210,140,160,160,0,0,670
76460,170,120,120,160,160,0,730
76461,170,100,160,80,160,0,670
76462,180,80,120,80,160,0,620
76463,200,120,160,80,0,0,560
76464,200,140,120,160,160,0,780
76465,210,140,160,160,160,320,1150
76466,170,180,120,160,160,0,790
76467,160,120,120,160,320,0,880
76468,220,60,120,160,160,0,720
76469,210,100,120,80,0,0,510
76470,200,140,80,80,0,0,500
76471,220,140,120,80,160,0,720
76472,190,200,200,160,0,0,750
76473,210,140,80,0,0,0,430
76474,180,60,40,80,160,0,520
76475,190,120,120,80,0,0,510
76476,190,100,40,80,160,0,570
76477,200,80,120,80,0,0,480
76478,210,120,160,240,0,0,730
76479,220,160,80,80,160,0,700
76480,210,140,80,0,0,0,430
76481,190,160,80,80,160,0,670
76482,180,140,80,80,160,0,640
76483,190,120,120,80,0,0,510
76484,200,120,80,0,0,0,400
76485,180,120,80,80,160,0,620
76486,190,100,120,80,0,0,490
76487,190,140,80,80,0,0,490
76488,170,140,120,160,160,0,750
76489,210,160,160,80,0,0,610
76490,180,60,40,80,160,320,840
76491,210,180,200,240,320,0,1150
76492,240,140,160,80,160,320,1100
76493,190,140,40,80,160,320,930
76494,210,160,120,0,0,0,490
76495,190,120,80,0,0,0,390
76496,210,120,80,80,160,0,650
76497,160,120,80,80,0,0,440
76498,160,100,120,80,0,0,460
76499,220,100,80,160,160,0,720
76500,140,120,120,80,160,0,620
76501,220,120,80,80,0,0,500
76502,210,60,80,160,160,0,670
76503,200,140,120,80,160,0,700
76504,250,140,40,0,0,0,430
76505,150,80,120,0,0,0,350
76506,220,100,80,160,320,0,880
76507,170,140,120,80,160,320,990
76508,210,100,0,0,0,0,310
76509,210,200,160,160,160,0,890
76510,200,100,120,80,160,320,980
76511,200,160,120,80,160,0,720
76512,220,120,120,160,160,0,780
76513,180,100,120,80,160,0,640
76514,200,120,120,160,160,0,760
76515,200,140,200,160,320,0,1020
76516,210,100,120,160,320,0,910
76517,220,120,120,160,320,0,940
76518,220,80,80,80,0,0,460
76519,190,80,40,80,160,0,550
76520,170,160,80,0,0,0,410
76521,200,100,120,160,160,0,740
76522,160,140,120,160,0,0,580
76523,200,160,120,160,160,0,800
76524,220,160,160,240,320,0,1100
76525,230,160,120,0,0,0,510
76526,250,200,200,240,320,320,1530
76527,190,120,120,240,320,320,1310
76528,200,140,120,160,160,0,780
76529,200,120,80,80,160,0,640
76530,220,80,120,80,160,0,660
76531,210,160,120,80,160,0,730
76532,200,120,120,160,160,0,760
76533,200,80,40,0,0,0,320
76534,200,120,80,80,160,0,640
76535,180,140,80,0,0,0,400
76536,220,160,160,80,0,0,620
76537,160,120,80,0,0,0,360
76538,170,120,160,160,0,0,610
76539,230,180,40,80,0,0,530
76540,240,220,120,80,160,0,820
76541,160,180,200,160,320,320,1340
76542,210,100,80,0,0,0,390
76543,150,120,120,160,320,320,1190
76544,200,120,120,80,160,0,680
76545,210,180,160,240,320,0,1110
76546,200,100,120,80,160,0,660
76547,160,120,80,80,0,0,440
76548,210,120,160,80,160,0,730
76549,200,140,200,240,160,0,940
76550,190,140,80,0,0,0,410
76551,220,140,160,240,320,0,1080
76552,180,140,120,160,160,0,760
76553,200,80,160,160,320,0,920
76554,200,100,40,0,0,0,340
76555,200,100,80,80,0,0,460
76556,190,80,40,80,160,0,550
76557,180,140,160,240,0,0,720
76558,190,100,80,160,320,320,1170
76559,190,60,40,80,0,0,370
76560,190,80,40,0,0,0,310
76561,230,160,160,160,0,0,710
76562,200,100,80,80,0,0,460
76563,180,140,40,80,160,0,600
76564,200,100,160,240,0,0,700
76565,220,140,80,0,0,0,440
76566,220,140,80,80,160,0,680
76567,180,140,120,160,0,0,600
76568,140,120,200,80,160,0,700
76569,210,180,80,80,160,0,710
76570,190,120,80,80,0,0,470
76571,200,100,120,80,160,0,660
76572,190,100,80,80,160,0,610
76573,200,160,160,240,160,0,920
76574,190,140,120,80,160,320,1010
76575,200,140,120,160,160,0,780
76576,220,160,120,160,160,0,820
76577,260,140,80,80,0,0,560
76578,200,140,80,160,320,0,900
76579,250,140,120,80,160,0,750
76580,210,120,80,0,0,0,410
76581,200,60,80,80,160,320,900
76582,190,100,80,80,0,0,450
76583,200,120,120,160,160,0,760
76584,200,140,80,0,0,0,420
76585,240,120,80,0,0,0,440
76586,190,140,160,80,0,0,570
76587,170,40,0,0,0,0,210
76588,170,160,80,80,160,0,650
76589,200,140,120,160,0,0,620
76590,160,100,120,160,320,0,860
76591,210,160,160,240,160,0,930
76592,210,100,80,80,160,0,630
76593,160,160,120,0,0,0,440
76594,220,140,80,160,160,320,1080
76595,260,120,80,80,160,0,700
76596,200,100,120,160,160,0,740
76597,150,100,80,0,0,0,330
76598,170,60,40,0,0,0,270
76599,180,80,80,80,160,0,580
76600,240,180,160,80,160,0,820
76601,160,120,40,80,160,0,560
76602,170,140,120,80,160,0,670
76603,210,120,120,80,0,0,530
76604,160,120,160,0,0,0,440
76605,200,80,80,160,320,320,1160
76606,180,80,80,0,0,0,340
76607,190,120,80,0,0,0,390
76608,220,160,200,160,160,0,900
76609,180,120,160,240,160,320,1180
76610,200,120,200,160,160,0,840
76611,150,80,80,80,0,0,390
76612,200,180,160,80,0,0,620
76613,200,180,120,0,0,0,500
76614,210,200,160,0,0,0,570
76615,220,140,80,160,160,0,760
76616,180,80,40,0,0,0,300
76617,220,140,120,80,160,0,720
76618,190,120,80,80,160,0,630
76619,220,120,80,80,0,0,500
76620,200,120,120,80,0,0,520
76621,200,100,160,160,160,0,780
76622,190,120,40,0,0,0,350
76623,200,120,120,80,160,0,680
76624,230,140,80,0,0,0,450
76625,210,140,80,0,0,0,430
76626,200,120,120,80,0,0,520
76627,180,140,40,0,0,0,360
76628,170,120,120,80,0,0,490
76629,200,140,160,160,160,0,820
76630,220,140,80,80,0,0,520
76631,170,60,80,160,160,320,950
76632,180,100,120,80,160,0,640
76633,240,120,80,80,0,0,520
76634,150,100,40,0,0,0,290
76635,220,100,40,0,0,0,360
76636,180,120,120,80,160,0,660
76637,200,100,160,0,0,0,460
76638,210,100,40,0,0,0,350
76639,170,100,80,80,160,0,590
76640,200,120,0,0,0,0,320
76641,200,100,40,80,160,0,580
76642,250,140,40,0,0,0,430
76643,220,140,80,80,160,0,680
76644,160,80,80,160,320,320,1120
76645,210,100,120,160,160,0,750
76646,240,200,120,80,160,0,800
76647,190,60,40,80,160,0,530
76648,230,120,80,80,160,0,670
76649,190,160,160,240,160,0,910
76650,170,140,120,240,160,0,830
76651,180,80,120,160,320,320,1180
76652,180,100,80,80,0,0,440
76653,180,80,80,160,160,0,660
76654,190,120,80,160,320,320,1190
76655,200,180,200,80,160,0,820
76656,200,80,40,80,160,320,880
76657,180,140,160,240,160,0,880
76658,210,140,120,80,160,320,1030
76659,190,100,120,80,160,0,650
76660,200,160,40,0,0,0,400
76661,210,140,160,160,160,0,830
76662,220,200,80,160,160,0,820
76663,190,160,120,240,160,0,870
76664,180,100,40,0,0,0,320
76665,200,100,80,160,160,0,700
76666,210,100,80,80,0,0,470
76667,180,120,80,0,0,0,380
76668,230,120,120,160,320,0,950
76669,190,100,80,0,0,0,370
76670,230,160,160,160,160,0,870
76671,180,160,160,160,0,0,660
76672,220,120,80,160,160,0,740
76673,230,140,120,80,0,0,570
76674,170,140,160,80,160,0,710
76675,230,160,240,160,0,0,790
76676,190,140,160,160,320,320,1290
76677,190,120,40,0,0,0,350
76678,210,100,120,160,0,0,590
76679,220,100,80,0,0,0,400
76680,160,120,80,160,0,0,520
76681,140,80,80,160,320,0,780
76682,200,120,160,160,160,0,800
76683,220,80,80,160,160,0,700
76684,220,160,160,160,320,320,1340
76685,200,140,40,80,160,0,620
76686,180,160,200,0,0,0,540
76687,160,140,120,80,160,0,660
76688,190,140,120,80,0,0,530
76689,230,120,120,80,160,0,710
76690,180,100,80,80,160,320,920
76691,200,140,160,160,160,0,820
76692,200,100,40,0,0,0,340
76693,230,160,160,240,320,0,1110
76694,230,180,120,80,160,320,1090
76695,210,160,120,240,0,0,730
76696,170,120,160,160,320,320,1250
76697,180,140,80,160,0,0,560
76698,180,100,80,80,160,320,920
76699,190,100,120,80,160,0,650
76700,160,160,120,0,0,0,440
76701,170,160,160,240,160,0,890
76702,230,80,80,0,0,0,390
76703,190,160,120,160,160,0,790
76704,160,100,120,160,160,0,700
76705,190,100,40,0,0,0,330
76706,180,140,120,240,160,0,840
76707,200,140,80,80,160,0,660
76708,190,60,40,80,160,0,530
76709,190,160,80,80,0,0,510
76710,180,80,80,80,160,0,580
76711,220,60,80,80,160,0,600
76712,230,160,160,160,160,0,870
76713,210,120,120,80,160,0,690
76714,170,40,80,160,320,320,1090
76715,210,160,80,80,0,0,530
76716,190,140,160,240,160,0,890
76717,190,120,120,160,320,0,910
76718,200,100,120,80,160,320,980
76719,190,100,80,80,0,0,450
76720,170,160,160,0,0,0,490
76721,210,160,160,160,0,0,690
76722,200,160,120,80,160,0,720
76723,200,180,200,80,160,0,820
76724,160,80,120,160,320,0,840
76725,230,140,80,80,160,0,690
76726,210,140,160,160,160,0,830
76727,200,120,120,80,0,0,520
76728,220,80,80,80,160,320,940
76729,220,220,240,0,0,0,680
76730,230,180,120,0,0,0,530
76731,220,120,120,160,160,0,780
76732,220,160,160,160,160,0,860
76733,210,160,120,160,160,0,810
76734,170,140,120,80,0,0,510
76735,200,140,240,160,0,0,740
76736,190,120,80,80,0,0,470
76737,220,60,40,0,0,0,320
76738,180,160,160,160,160,320,1140
76739,170,120,80,0,0,0,370
76740,210,100,0,0,0,0,310
76741,180,80,80,80,160,0,580
76742,190,100,120,80,160,320,970
76743,200,100,160,80,0,0,540
76744,210,60,120,80,0,0,470
76745,240,160,80,80,160,0,720
76746,190,140,120,160,0,0,610
76747,230,120,80,80,160,0,670
76748,150,80,120,80,0,0,430
76749,200,100,80,160,0,0,540
76750,170,80,120,80,160,320,930
76751,190,80,40,80,0,0,390
76752,190,140,160,160,320,320,1290
76753,180,80,40,0,0,0,300
76754,190,140,120,160,320,0,930
76755,210,140,80,160,320,0,910
76756,180,160,160,80,160,0,740
76757,190,100,80,160,320,0,850
76758,220,120,80,80,0,0,500
76759,160,120,80,0,0,0,360
76760,210,100,40,0,0,0,350
76761,200,180,200,80,0,0,660
76762,220,160,80,0,0,0,460
76763,200,100,80,80,0,0,460
76764,210,120,120,160,320,0,930
76765,210,120,160,80,160,0,730
76766,230,100,120,80,160,0,690
76767,200,180,120,80,160,0,740
76768,180,140,80,160,160,0,720
76769,200,120,80,80,160,0,640
76770,180,120,160,160,0,0,620
76771,190,100,80,80,0,0,450
76772,170,120,160,160,320,0,930
76773,200,140,120,80,160,0,700
76774,190,60,0,0,0,0,250
76775,170,80,80,80,160,0,570
76776,190,80,40,80,0,0,390
76777,160,160,160,240,320,320,1360
76778,190,100,160,80,160,0,690
76779,190,120,120,80,0,0,510
76780,150,100,80,80,160,0,570
76781,170,140,120,160,320,320,1230
76782,240,160,120,160,0,0,680
76783,180,180,80,160,160,320,1080
76784,210,120,40,0,0,0,370
76785,170,100,80,0,0,0,350
76786,170,140,40,0,0,0,350
76787,190,80,0,0,0,0,270
76788,160,140,200,240,160,320,1220
76789,240,140,120,0,0,0,500
76790,210,100,80,80,160,0,630
76791,220,180,80,80,160,0,720
76792,200,160,80,160,160,320,1080
76793,240,140,160,80,160,320,1100
76794,220,160,160,80,160,320,1100
76795,200,120,120,80,160,0,680
76796,190,80,80,80,0,0,430
76797,190,140,120,160,160,0,770
76798,150,160,200,160,320,0,990
76799,210,100,40,80,0,0,430
76800,200,140,80,80,160,0,660
76801,190,120,80,160,320,0,870
76802,210,160,120,80,160,0,730
76803,210,160,120,80,160,0,730
76804,220,140,160,80,160,320,1080
76805,220,200,200,160,160,0,940
76806,210,100,120,160,160,320,1070
76807,200,180,80,80,160,0,700
76808,210,140,40,80,160,0,630
76809,210,140,160,80,0,0,590
76810,200,120,160,160,0,0,640
76811,170,120,80,80,160,0,610
76812,230,220,120,80,160,320,1130
76813,220,140,120,160,160,0,800
76814,220,100,40,0,0,0,360
76815,170,140,80,80,160,0,630
76816,170,100,120,160,160,0,710
76817,190,120,40,80,160,320,910
76818,170,80,80,80,160,0,570
76819,160,120,120,160,160,0,720
76820,180,120,200,240,320,0,1060
76821,180,100,120,80,160,320,960
76822,220,100,160,160,160,0,800
76823,230,100,80,80,0,0,490
76824,160,120,120,160,320,0,880
76825,210,120,120,80,160,0,690
76826,180,160,160,320,160,0,980
76827,200,80,80,0,0,0,360
76828,180,120,200,160,160,0,820
76829,230,140,120,240,320,320,1370
76830,220,180,200,160,160,0,920
76831,210,120,120,80,160,0,690
76832,210,140,80,160,320,0,910
76833,180,100,160,0,0,0,440
76834,200,100,0,0,0,0,300
76835,210,120,160,240,160,0,890
76836,210,120,80,80,160,0,650
76837,230,180,120,160,320,0,1010
76838,200,140,120,240,160,0,860
76839,180,100,0,0,0,0,280
76840,180,120,120,160,160,0,740
76841,220,120,120,0,0,0,460
76842,170,160,200,80,160,0,770
76843,230,100,160,160,160,0,810
76844,170,100,40,0,0,0,310
76845,210,160,120,80,0,0,570
76846,210,120,120,80,160,0,690
76847,220,120,120,80,0,0,540
76848,240,120,80,80,160,0,680
76849,170,80,40,80,160,0,530
76850,200,120,160,80,0,0,560
76851,130,80,80,80,160,0,530
76852,210,140,120,80,160,0,710
76853,190,160,80,0,0,0,430
76854,220,120,40,0,0,0,380
76855,180,120,80,160,160,0,700
76856,220,180,120,80,0,0,600
76857,220,160,120,80,160,0,740
76858,260,160,120,160,320,320,1340
76859,220,100,80,0,0,0,400
76860,210,120,160,160,160,0,810
76861,210,100,80,0,0,0,390
76862,200,100,120,0,0,0,420
76863,190,100,120,80,0,0,490
76864,180,100,120,0,0,0,400
76865,190,100,120,80,160,0,650
76866,160,100,160,0,0,0,420
76867,210,120,40,0,0,0,370
76868,210,120,160,160,160,0,810
76869,200,140,40,0,0,0,380
76870,180,100,80,0,0,0,360
76871,190,120,120,80,0,0,510
76872,230,100,80,80,0,0,490
76873,160,160,200,240,160,320,1240
76874,210,80,120,80,160,0,650
76875,180,140,120,160,160,0,760
76876,180,100,120,80,160,320,960
76877,200,60,40,0,0,0,300
76878,220,140,160,160,160,0,840
76879,160,140,120,160,160,0,740
76880,140,100,160,160,320,0,880
76881,170,100,40,0,0,0,310
76882,240,100,80,80,160,0,660
76883,210,60,0,0,0,0,270
76884,200,160,120,160,320,0,960
76885,200,120,80,80,0,0,480
76886,150,140,200,160,160,0,810
76887,180,140,80,80,0,0,480
76888,190,120,160,160,160,0,790
76889,200,100,80,80,0,0,460
76890,210,100,40,80,160,0,590
76891,220,100,40,80,160,0,600
76892,210,160,240,160,160,0,930
76893,200,100,80,80,160,320,940
76894,130,80,120,240,160,320,1050
76895,230,120,160,80,160,0,750
76896,190,100,120,160,320,0,890
76897,200,100,120,80,0,0,500
76898,230,140,200,80,160,0,810
76899,150,120,160,240,320,0,990
76900,180,160,120,160,160,0,780
76901,170,120,160,160,320,0,930
76902,260,140,120,0,0,0,520
76903,240,120,120,0,0,0,480
76904,130,120,120,160,160,0,690
76905,240,140,120,80,160,0,740
76906,190,80,40,0,0,0,310
76907,190,160,160,80,0,0,590
76908,150,100,120,80,160,0,610
76909,220,200,200,160,0,0,780
76910,190,140,120,80,160,0,690
76911,190,140,40,80,0,0,450
76912,170,100,80,80,160,0,590
76913,270,160,200,160,160,320,1270
76914,200,160,160,160,0,0,680
76915,200,140,80,80,0,0,500
76916,200,140,120,80,160,0,700
76917,190,120,0,0,0,0,310
76918,180,100,120,80,160,0,640
76919,140,120,120,160,160,0,700
76920,210,120,80,0,0,0,410
76921,240,60,40,80,160,0,580
76922,220,160,80,160,160,0,780
76923,200,100,120,160,0,0,580
76924,210,100,80,80,160,320,950
76925,180,80,120,80,160,0,620
76926,190,80,0,0,0,0,270
76927,190,100,120,160,0,0,570
76928,180,120,120,0,0,0,420
76929,140,100,200,80,160,0,680
76930,190,120,160,160,160,0,790
76931,190,160,240,320,320,320,1550
76932,200,120,80,80,160,0,640
76933,190,100,160,80,0,0,530
76934,200,120,80,80,160,0,640
76935,190,120,120,0,0,0,430
76936,170,160,160,80,160,0,730
76937,210,100,120,80,160,0,670
76938,140,120,120,160,160,0,700
76939,190,180,120,160,0,0,650
76940,160,140,80,0,0,0,380
76941,180,80,40,80,160,0,540
76942,190,140,40,80,160,0,610
76943,180,120,40,80,0,0,420
76944,190,120,40,80,160,0,590
76945,240,160,120,80,0,0,600
76946,200,120,120,80,0,0,520
76947,180,140,120,80,0,0,520
76948,210,140,120,80,0,0,550
76949,150,140,120,160,0,0,570
76950,200,140,160,80,160,0,740
76951,180,120,80,0,0,0,380
76952,170,80,40,80,160,0,530
76953,170,120,160,160,0,0,610
76954,170,100,120,160,160,0,710
76955,220,80,80,160,160,320,1020
76956,210,120,120,80,0,0,530
76957,190,140,120,0,0,0,450
76958,210,100,120,80,160,0,670
76959,190,80,120,160,160,0,710
76960,230,60,80,80,160,0,610
76961,190,140,80,160,320,320,1210
76962,260,120,80,80,160,0,700
76963,240,100,120,80,0,0,540
76964,220,180,120,80,160,0,760
76965,190,100,80,80,160,0,610
76966,250,140,80,0,0,0,470
76967,190,180,160,160,320,0,1010
76968,180,40,40,0,0,0,260
76969,220,160,120,80,160,0,740
76970,170,120,120,160,0,0,570
76971,180,180,160,160,160,0,840
76972,180,100,80,80,0,0,440
76973,220,140,160,80,160,0,760
76974,240,160,40,80,160,320,1000
76975,200,100,120,80,0,0,500
76976,150,60,80,80,160,0,530
76977,200,120,80,80,160,0,640
76978,220,120,80,80,0,0,500
76979,230,160,160,80,160,0,790
76980,200,120,120,160,160,0,760
76981,200,180,160,160,320,0,1020
76982,210,100,80,80,160,0,630
76983,240,100,40,80,0,0,460
76984,220,100,120,160,320,320,1240
76985,210,160,160,160,160,0,850
76986,210,140,0,0,0,0,350
76987,270,180,200,160,160,0,970
76988,180,140,0,0,0,0,320
76989,200,100,80,160,0,0,540
76990,180,200,80,80,0,0,540
76991,160,60,40,0,0,0,260
76992,200,120,200,160,0,0,680
76993,180,120,120,80,160,0,660
76994,160,80,80,0,0,0,320
76995,240,100,40,0,0,0,380
76996,170,160,160,80,0,0,570
76997,190,100,80,80,0,0,450
76998,170,120,40,80,0,0,410
76999,200,140,160,160,160,0,820
77000,170,120,80,80,160,0,610
77001,180,100,120,80,0,0,480
77002,170,80,80,80,0,0,410
77003,240,140,80,80,0,0,540
77004,170,120,120,160,320,0,890
77005,220,160,120,0,0,0,500
77006,230,140,160,160,0,0,690
77007,200,100,80,160,160,0,700
77008,180,100,120,80,160,0,640
77009,190,120,40,80,160,0,590
77010,180,140,40,0,0,0,360
77011,200,160,160,240,160,320,1240
77012,200,120,80,160,0,0,560
77013,200,120,120,80,160,0,680
77014,180,60,40,0,0,0,280
77015,210,140,120,160,160,0,790
77016,180,100,120,160,320,0,880
77017,210,140,160,160,0,0,670
77018,230,140,120,80,160,0,730
77019,200,160,80,160,320,0,920
77020,170,20,0,0,0,0,190
77021,200,200,120,80,160,320,1080
77022,190,100,80,160,160,320,1010
77023,200,140,120,0,0,0,460
77024,210,120,80,160,0,0,570
77025,180,100,40,0,0,0,320
77026,180,140,80,80,160,0,640
77027,220,200,160,80,160,0,820
77028,210,100,80,80,160,0,630
77029,220,100,80,0,0,0,400
77030,190,160,120,80,160,0,710
77031,210,160,120,160,160,0,810
77032,170,120,160,80,0,0,530
77033,230,80,80,80,0,0,470
77034,220,120,160,240,160,0,900
77035,210,120,120,80,160,0,690
77036,190,120,120,160,320,320,1230
77037,220,160,120,160,320,0,980
77038,210,100,120,160,0,0,590
77039,190,120,80,80,160,0,630
77040,170,80,40,0,0,0,290
77041,170,160,160,160,320,0,970
77042,180,140,160,160,160,0,800
77043,220,140,120,160,160,0,800
77044,190,80,80,160,320,320,1150
77045,180,140,120,0,0,0,440
77046,190,140,120,160,320,0,930
77047,140,80,40,80,160,0,500
77048,190,80,80,80,160,0,590
77049,190,200,120,160,160,0,830
77050,180,140,80,0,0,0,400
77051,210,160,80,160,160,320,1090
77052,200,140,80,80,0,0,500
77053,160,120,80,80,160,0,600
77054,200,80,120,160,0,0,560
77055,180,100,120,160,320,320,1200
77056,200,140,160,160,0,0,660
77057,220,160,120,160,320,0,980
77058,190,100,120,160,160,0,730
77059,200,100,80,80,160,0,620
77060,170,160,160,80,160,0,730
77061,220,120,80,160,160,0,740
77062,210,180,160,240,160,0,950
77063,230,160,120,160,160,320,1150
77064,150,160,160,80,0,0,550
77065,180,120,120,80,0,0,500
77066,210,160,200,160,160,0,890
77067,220,160,80,0,0,0,460
77068,240,100,40,0,0,0,380
77069,190,120,80,80,160,0,630
77070,180,120,120,0,0,0,420
77071,140,120,160,160,160,0,740
77072,220,120,120,160,0,0,620
77073,180,60,80,0,0,0,320
77074,190,80,40,80,0,0,390
77075,220,120,80,80,0,0,500
77076,200,80,120,80,0,0,480
77077,190,80,120,80,160,0,630
77078,160,140,120,80,0,0,500
77079,230,100,40,80,0,0,450
77080,210,80,120,80,0,0,490
77081,210,120,120,80,0,0,530
77082,190,140,120,80,0,0,530
77083,200,100,0,0,0,0,300
77084,180,100,40,80,160,0,560
77085,210,140,120,80,160,320,1030
77086,200,180,120,80,160,0,740
77087,180,120,120,160,160,0,740
77088,220,180,240,240,320,0,1200
77089,160,160,80,80,0,0,480
77090,220,60,80,0,0,0,360
77091,190,100,40,80,160,0,570
77092,210,100,160,160,160,320,1110
77093,160,80,80,80,160,0,560
77094,170,100,80,80,0,0,430
77095,170,180,120,160,160,0,790
77096,200,80,120,80,160,0,640
77097,170,120,120,80,0,0,490
77098,210,60,0,0,0,0,270
77099,240,100,80,160,160,320,1060
77100,180,140,160,240,160,0,880
77101,190,120,120,80,0,0,510
77102,160,80,120,80,160,0,600
77103,210,120,200,160,0,0,690
77104,190,120,80,80,160,0,630
77105,200,100,80,80,0,0,460
77106,250,160,160,80,0,0,650
77107,210,120,80,80,160,0,650
77108,210,140,80,160,320,0,910
77109,200,160,80,80,160,0,680
77110,130,60,80,80,160,320,830
77111,170,80,80,0,0,0,330
77112,170,100,80,80,160,0,590
77113,200,140,80,160,160,0,740
77114,230,160,40,0,0,0,430
77115,170,60,40,0,0,0,270
77116,210,100,80,0,0,0,390
77117,210,120,160,160,320,0,970
77118,200,140,160,160,160,0,820
77119,220,180,120,80,160,0,760
77120,200,160,80,80,0,0,520
77121,190,120,80,80,0,0,470
77122,240,160,160,80,160,0,800
77123,180,100,80,160,160,320,1000
77124,190,160,120,80,160,0,710
77125,190,140,120,80,160,0,690
77126,170,80,80,0,0,0,330
77127,210,60,80,80,160,0,590
77128,190,80,80,160,320,0,830
77129,190,140,120,80,160,0,690
77130,190,80,40,80,0,0,390
77131,230,160,200,160,320,0,1070
77132,210,140,160,160,320,0,990
77133,180,120,80,160,160,0,700
77134,180,80,40,80,160,320,860
77135,160,120,160,160,160,0,760
77136,170,120,120,80,160,0,650
77137,140,100,120,240,160,0,760
77138,190,100,40,80,160,0,570
77139,190,160,80,80,160,320,990
77140,200,100,80,160,160,0,700
77141,180,80,80,160,320,0,820
77142,180,140,80,80,160,0,640
77143,170,140,80,160,320,0,870
77144,230,120,80,160,160,0,750
77145,190,60,120,0,0,0,370
77146,160,120,80,80,160,0,600
77147,200,140,120,80,0,0,540
77148,230,120,200,160,160,0,870
77149,190,80,40,0,0,0,310
77150,180,100,160,240,160,0,840
77151,160,80,120,160,160,0,680
77152,200,100,80,0,0,0,380
77153,220,140,120,80,160,0,720
77154,230,180,80,80,160,0,730
77155,180,100,80,80,0,0,440
77156,210,120,120,160,160,0,770
77157,230,140,160,160,160,0,850
77158,200,120,160,160,160,0,800
77159,190,120,160,160,320,320,1270
77160,170,120,120,80,0,0,490
77161,200,100,80,0,0,0,380
77162,220,140,80,0,0,0,440
77163,160,80,80,80,160,0,560
77164,230,140,120,160,0,0,650
77165,210,200,160,80,160,320,1130
77166,180,80,120,80,0,0,460
77167,210,100,160,240,160,0,870
77168,230,100,40,0,0,0,370
77169,190,120,80,160,0,0,550
77170,260,120,0,0,0,0,380
77171,220,160,160,80,160,0,780
77172,200,120,80,80,160,320,960
77173,210,100,80,80,0,0,470
77174,180,160,80,0,0,0,420
77175,200,140,120,80,0,0,540
77176,210,140,120,80,160,0,710
77177,130,100,80,160,0,0,470
77178,210,140,80,80,160,0,670
77179,230,120,200,80,0,0,630
77180,170,140,120,0,0,0,430
77181,190,100,120,80,160,0,650
77182,210,140,120,160,160,0,790
77183,180,180,160,160,160,0,840
77184,200,120,80,80,0,0,480
77185,240,120,80,80,0,0,520
77186,190,80,80,80,160,0,590
77187,190,100,80,80,160,0,610
77188,190,100,160,160,160,0,770
77189,200,100,120,160,320,0,900
77190,250,120,80,80,160,0,690
77191,230,80,40,0,0,0,350
77192,220,160,160,240,160,0,940
77193,220,80,40,80,160,0,580
77194,180,180,160,80,0,0,600
77195,170,60,0,0,0,0,230
77196,200,120,80,160,0,0,560
77197,170,180,80,80,160,320,990
77198,190,180,80,80,160,0,690
77199,240,160,160,80,0,0,640
77200,190,120,40,80,160,0,590
77201,230,180,160,160,320,320,1370
77202,210,100,80,80,160,0,630
77203,180,120,80,80,0,0,460
77204,180,140,80,80,160,0,640
77205,210,100,40,80,0,0,430
77206,200,160,160,80,160,0,760
77207,180,120,80,0,0,0,380
77208,180,80,40,0,0,0,300
77209,200,160,80,0,0,0,440
77210,190,160,120,160,0,0,630
77211,170,120,80,80,0,0,450
77212,180,120,80,0,0,0,380
77213,220,140,160,80,0,0,600
77214,180,100,40,0,0,0,320
77215,250,120,80,80,160,0,690
77216,210,100,40,0,0,0,350
77217,200,80,80,160,160,0,680
77218,190,60,120,160,160,0,690
77219,190,80,120,80,160,0,630
77220,210,120,120,160,160,0,770
77221,190,120,160,160,320,320,1270
77222,200,140,80,160,160,0,740
77223,190,160,120,80,0,0,550
77224,240,100,40,0,0,0,380
77225,200,120,160,160,160,0,800
77226,190,60,80,80,0,0,410
77227,210,100,120,80,0,0,510
77228,130,80,80,80,0,0,370
77229,220,140,40,0,0,0,400
77230,220,100,80,160,320,0,880
77231,200,120,120,240,320,320,1320
77232,210,120,120,160,160,0,770
77233,200,180,120,160,320,0,980
77234,220,120,120,80,160,0,700
77235,190,160,120,80,0,0,550
77236,210,140,120,160,160,0,790
77237,200,140,120,240,160,0,860
77238,140,140,80,80,160,0,600
77239,250,160,160,80,160,0,810
77240,190,80,80,0,0,0,350
77241,200,100,120,160,160,0,740
77242,190,140,80,80,160,0,650
77243,170,120,80,160,160,320,1010
77244,210,100,200,160,160,320,1150
77245,180,140,120,160,160,0,760
77246,140,60,80,80,160,0,520
77247,220,120,160,240,320,0,1060
77248,170,160,160,80,160,0,730
77249,210,120,200,160,160,0,850
77250,210,160,80,80,160,0,690
77251,200,140,120,0,0,0,460
77252,190,120,80,80,160,0,630
77253,210,100,80,80,160,0,630
77254,180,100,40,80,160,0,560
77255,210,100,120,160,320,320,1230
77256,180,200,160,80,0,0,620
77257,190,100,80,80,160,0,610
77258,160,60,0,0,0,0,220
77259,200,140,80,80,0,0,500
77260,200,140,120,160,320,0,940
77261,220,100,120,160,160,0,760
77262,190,140,120,0,0,0,450
77263,180,100,120,240,320,0,960
77264,160,80,120,160,320,0,840
77265,180,80,80,80,160,320,900
77266,210,120,40,80,160,320,930
77267,200,120,160,160,160,0,800
77268,200,160,80,80,160,320,1000
77269,220,160,120,240,160,0,900
77270,190,60,120,80,0,0,450
77271,210,140,40,80,0,0,470
77272,190,200,80,80,160,0,710
77273,180,120,80,80,160,0,620
77274,210,160,160,80,160,0,770
77275,200,80,40,0,0,0,320
77276,180,180,160,240,160,320,1240
77277,220,140,120,240,160,0,880
77278,240,160,160,240,320,320,1440
77279,210,140,120,80,160,320,1030
77280,190,120,80,80,0,0,470
77281,190,140,120,160,0,0,610
77282,200,120,120,240,160,0,840
77283,210,100,80,80,0,0,470
77284,180,140,120,160,0,0,600
77285,220,200,160,80,0,0,660
77286,210,100,40,0,0,0,350
77287,200,120,120,80,160,0,680
77288,180,100,120,160,160,0,720
77289,200,100,40,80,160,0,580
77290,210,60,80,0,0,0,350
77291,200,100,80,0,0,0,380
77292,220,120,80,80,0,0,500
77293,190,120,120,80,160,0,670
77294,170,160,120,160,160,0,770
77295,170,140,200,160,160,0,830
77296,190,120,120,160,0,0,590
77297,200,160,160,240,320,320,1400
77298,220,140,120,160,320,0,960
77299,180,120,160,160,0,0,620
77300,210,80,160,80,160,0,690
77301,200,120,80,80,160,0,640
77302,180,120,160,240,160,0,860
77303,200,120,160,80,160,320,1040
77304,160,80,40,0,0,0,280
77305,180,160,80,80,160,0,660
77306,160,80,40,0,0,0,280
77307,170,140,120,160,320,0,910
77308,180,60,80,0,0,0,320
77309,180,100,80,80,160,320,920
77310,190,100,80,160,160,0,690
77311,230,100,120,80,0,0,530
77312,190,120,80,0,0,0,390
77313,170,160,80,80,160,0,650
77314,210,120,120,160,160,0,770
77315,120,140,120,80,160,0,620
77316,190,120,120,80,0,0,510
77317,240,100,160,240,160,0,900
77318,200,100,0,0,0,0,300
77319,180,120,80,0,0,0,380
77320,180,100,160,160,320,320,1240
77321,190,100,120,160,160,0,730
77322,230,100,120,80,0,0,530
77323,230,160,160,160,320,0,1030
77324,220,100,80,160,320,320,1200
77325,230,160,160,160,160,0,870
77326,170,120,160,80,160,0,690
77327,180,80,120,160,160,0,700
77328,170,100,80,80,160,0,590
77329,200,140,160,80,160,320,1060
77330,210,100,80,160,160,0,710
77331,170,80,120,0,0,0,370
77332,180,60,0,0,0,0,240
77333,170,80,40,0,0,0,290
77334,200,100,40,80,0,0,420
77335,180,200,120,80,0,0,580
77336,210,160,120,0,0,0,490
77337,170,100,80,80,0,0,430
77338,220,140,120,80,0,0,560
77339,190,160,200,240,160,0,950
77340,220,140,80,80,0,0,520
77341,190,60,40,80,0,0,370
77342,180,80,40,80,0,0,380
77343,220,100,80,80,0,0,480
77344,220,160,40,80,160,0,660
77345,220,100,120,80,160,0,680
77346,220,100,80,0,0,0,400
77347,200,160,160,320,160,0,1000
77348,190,80,80,80,160,0,590
77349,180,140,120,160,0,0,600
77350,210,140,160,80,160,0,750
77351,200,120,120,80,0,0,520
77352,160,100,160,160,320,320,1220
77353,200,140,120,160,0,0,620
77354,250,140,80,160,160,0,790
77355,180,100,200,160,160,0,800
77356,190,100,80,80,160,0,610
77357,220,120,120,160,160,0,780
77358,200,60,80,80,160,0,580
77359,180,160,120,0,0,0,460
77360,190,120,40,80,160,0,590
77361,200,80,120,80,160,0,640
77362,220,120,40,80,160,0,620
77363,210,100,80,160,160,0,710
77364,160,80,120,160,160,0,680
77365,190,160,120,80,160,0,710
77366,200,100,160,0,0,0,460
77367,190,100,40,80,160,0,570
77368,220,100,80,0,0,0,400
77369,210,100,80,160,160,0,710
77370,220,140,200,160,160,0,880
77371,190,80,120,160,160,0,710
77372,240,180,200,80,0,0,700
77373,180,160,120,80,0,0,540
77374,220,120,40,0,0,0,380
77375,150,120,80,80,160,0,590
77376,150,140,120,0,0,0,410
77377,170,80,80,160,320,320,1130
77378,180,120,120,80,0,0,500
77379,230,140,40,80,160,320,970
77380,200,100,120,160,0,0,580
77381,170,160,200,80,160,320,1090
77382,270,140,120,80,160,0,770
77383,210,140,120,80,160,320,1030
77384,190,140,160,160,160,0,810
77385,240,120,120,160,160,0,800
77386,210,100,40,80,160,0,590
77387,190,120,120,240,160,320,1150
77388,180,120,40,80,0,0,420
77389,140,100,120,160,0,0,520
77390,210,180,160,160,0,0,710
77391,170,100,120,240,160,0,790
77392,190,100,80,80,0,0,450
77393,210,140,40,0,0,0,390
77394,190,20,40,0,0,0,250
77395,190,140,120,80,0,0,530
77396,200,80,80,80,0,0,440
77397,200,100,40,0,0,0,340
77398,190,160,120,160,160,320,1110
77399,160,80,80,0,0,0,320
77400,160,140,40,0,0,0,340
77401,170,120,120,80,0,0,490
77402,250,200,240,320,0,0,1010
77403,200,120,80,80,0,0,480
77404,190,160,160,80,0,0,590
77405,210,160,160,160,160,0,850
77406,190,160,200,80,0,0,630
77407,170,100,80,0,0,0,350
77408,200,140,160,80,0,0,580
77409,210,160,40,0,0,0,410
77410,210,140,120,0,0,0,470
77411,240,160,160,160,160,0,880
77412,190,120,200,240,160,320,1230
77413,230,120,80,160,0,0,590
77414,210,120,120,240,320,0,1010
77415,200,100,40,80,160,320,900
77416,230,140,160,0,0,0,530
77417,190,140,200,160,160,320,1170
77418,190,100,80,160,320,0,850
77419,220,120,80,160,160,0,740
77420,170,80,80,160,0,0,490
77421,180,120,0,0,0,0,300
77422,190,60,40,80,160,0,530
77423,190,160,120,80,160,0,710
77424,180,120,160,240,160,320,1180
77425,220,100,120,160,160,0,760
77426,220,160,160,160,160,0,860
77427,220,60,120,240,160,0,800
77428,220,180,120,0,0,0,520
77429,190,100,120,240,320,320,1290
77430,210,100,160,240,160,0,870
77431,230,80,120,160,320,0,910
77432,220,120,160,0,0,0,500
77433,170,140,120,160,0,0,590
77434,200,140,200,160,0,0,700
77435,180,160,200,160,160,0,860
77436,200,60,120,80,160,0,620
77437,190,120,160,80,160,320,1030
77438,200,120,40,80,0,0,440
77439,240,180,200,240,320,0,1180
77440,190,140,120,160,0,0,610
77441,230,140,200,80,160,0,810
77442,160,80,40,0,0,0,280
77443,170,160,80,80,160,320,970
77444,220,120,160,160,160,0,820
77445,210,120,120,80,160,320,1010
77446,160,80,80,0,0,0,320
77447,190,140,160,80,0,0,570
77448,180,80,40,80,160,0,540
77449,240,80,40,0,0,0,360
77450,200,80,80,160,160,0,680
77451,190,100,80,80,160,0,610
77452,160,120,120,240,320,320,1280
77453,200,60,80,160,0,0,500
77454,210,100,120,160,320,320,1230
77455,210,60,0,0,0,0,270
77456,200,160,120,160,160,0,800
77457,230,120,80,0,0,0,430
77458,170,80,80,80,0,0,410
77459,190,160,120,160,320,0,950
77460,240,160,80,160,160,0,800
77461,180,80,40,80,160,0,540
77462,180,120,80,80,160,320,940
77463,190,80,40,80,160,0,550
77464,230,140,200,160,320,0,1050
77465,170,140,80,80,160,0,630
77466,220,140,160,80,160,0,760
77467,190,140,120,160,160,320,1090
77468,180,80,40,80,0,0,380
77469,180,120,80,80,0,0,460
77470,200,100,120,80,0,0,500
77471,200,80,40,0,0,0,320
77472,190,120,80,160,320,0,870
77473,170,140,40,0,0,0,350
77474,200,140,120,80,0,0,540
77475,170,80,80,160,160,320,970
77476,210,120,120,80,160,0,690
77477,250,180,120,80,160,320,1110
77478,200,180,120,160,160,0,820
77479,160,100,160,160,160,0,740
77480,210,120,80,80,0,0,490
77481,210,100,40,80,0,0,430
77482,200,180,120,80,160,0,740
77483,200,120,160,160,160,0,800
77484,190,120,80,160,160,320,1030
77485,180,100,160,160,320,0,920
77486,210,200,120,160,160,320,1170
77487,170,60,80,160,320,320,1110
77488,190,80,80,80,0,0,430
77489,230,140,200,240,160,320,1290
77490,190,160,120,160,320,320,1270
77491,190,140,160,160,320,0,970
77492,230,100,40,0,0,0,370
77493,220,140,120,80,0,0,560
77494,140,60,80,0,0,0,280
77495,230,120,200,160,160,0,870
77496,220,120,120,0,0,0,460
77497,240,140,40,0,0,0,420
77498,180,140,80,80,160,0,640
77499,200,60,40,0,0,0,300
77500,220,160,80,160,320,0,940
77501,220,220,200,0,0,0,640
77502,170,100,80,80,160,0,590
77503,160,60,80,80,160,320,860
77504,190,100,40,80,160,0,570
77505,170,80,40,0,0,0,290
77506,220,160,160,80,160,0,780
77507,180,140,120,80,160,0,680
77508,210,160,120,160,320,0,970
77509,200,80,80,0,0,0,360
77510,200,80,40,80,160,320,880
77511,160,100,160,240,160,0,820
77512,230,120,120,80,0,0,550
77513,200,120,80,160,160,0,720
77514,210,80,80,0,0,0,370
77515,200,120,80,80,0,0,480
77516,220,100,120,0,0,0,440
77517,160,120,80,80,160,0,600
77518,190,60,120,0,0,0,370
77519,200,120,120,0,0,0,440
77520,170,140,120,80,0,0,510
77521,220,140,120,160,320,320,1280
77522,170,60,80,160,160,320,950
77523,210,160,120,160,160,320,1130
77524,210,100,120,160,320,0,910
77525,150,120,40,80,160,0,550
77526,180,60,80,160,0,0,480
77527,180,100,120,80,0,0,480
77528,180,80,120,0,0,0,380
77529,230,180,120,80,160,0,770
77530,190,120,120,0,0,0,430
77531,220,80,120,0,0,0,420
77532,240,140,120,80,0,0,580
77533,220,140,120,160,320,0,960
77534,170,140,240,160,0,0,710
77535,250,120,160,240,320,320,1410
77536,240,120,40,80,0,0,480
77537,190,100,80,160,160,320,1010
77538,160,60,40,80,160,0,500
77539,210,160,120,0,0,0,490
77540,200,160,160,160,320,0,1000
77541,190,120,120,80,160,0,670
77542,180,100,120,160,0,0,560
77543,230,160,80,80,0,0,550
77544,220,80,40,80,160,0,580
77545,180,100,80,80,0,0,440
77546,190,100,80,80,160,0,610
77547,200,140,80,160,320,0,900
77548,210,80,80,160,320,0,850
77549,210,60,120,160,160,320,1030
77550,200,120,120,160,0,0,600
77551,190,100,120,80,0,0,490
77552,200,100,40,0,0,0,340
77553,160,100,80,160,320,320,1140
77554,160,120,80,0,0,0,360
77555,150,140,160,160,160,0,770
77556,180,160,160,160,160,0,820
77557,200,160,120,0,0,0,480
77558,220,120,120,0,0,0,460
77559,240,160,120,160,160,320,1160
77560,200,120,80,0,0,0,400
77561,210,140,120,80,160,0,710
77562,220,100,120,80,0,0,520
77563,220,100,80,80,160,0,640
77564,190,100,120,80,160,0,650
77565,160,60,40,0,0,0,260
77566,200,160,40,80,160,320,960
77567,180,120,120,80,160,0,660
77568,170,140,200,160,0,0,670
77569,190,120,120,80,160,0,670
77570,210,140,40,80,160,0,630
77571,200,80,80,80,160,0,600
77572,220,160,120,80,0,0,580
77573,150,80,120,80,160,0,590
77574,220,140,120,80,160,320,1040
77575,220,100,80,0,0,0,400
77576,210,140,0,0,0,0,350
77577,190,80,80,80,160,320,910
77578,190,100,40,80,160,320,890
77579,200,100,80,160,320,320,1180
77580,210,160,240,240,160,0,1010
77581,200,80,0,0,0,0,280
77582,190,120,120,80,0,0,510
77583,210,140,160,240,320,0,1070
77584,170,40,0,0,0,0,210
77585,200,140,160,80,0,0,580
77586,240,180,120,160,320,0,1020
77587,190,100,0,0,0,0,290
77588,180,140,160,240,0,0,720
77589,150,120,160,80,160,320,990
77590,210,140,120,160,320,0,950
77591,180,80,80,80,160,0,580
77592,220,100,80,160,160,0,720
77593,170,120,160,80,0,0,530
77594,220,180,120,0,0,0,520
77595,200,140,120,80,160,0,700
77596,230,160,80,0,0,0,470
77597,180,100,40,0,0,0,320
77598,230,140,200,80,160,0,810
77599,200,80,80,0,0,0,360
77600,190,80,120,160,160,0,710
77601,200,160,80,80,0,0,520
77602,150,20,40,0,0,0,210
77603,190,140,120,80,160,0,690
77604,200,140,80,0,0,0,420
77605,180,160,200,160,160,0,860
77606,160,100,120,80,0,0,460
77607,230,140,120,160,160,0,810
77608,180,120,120,160,160,0,740
77609,200,80,40,80,160,0,560
77610,210,160,160,160,160,0,850
77611,200,100,80,80,160,0,620
77612,140,60,80,80,0,0,360
77613,190,120,200,160,160,320,1150
77614,210,100,80,0,0,0,390
77615,130,80,80,80,160,0,530
77616,180,100,120,160,160,0,720
77617,210,100,120,160,160,0,750
77618,210,80,80,0,0,0,370
77619,200,220,200,160,0,0,780
77620,170,100,160,240,320,0,990
77621,190,120,120,80,160,0,670
77622,190,100,120,80,160,0,650
77623,210,140,80,80,0,0,510
77624,200,140,80,0,0,0,420
77625,140,60,40,80,160,0,480
77626,200,120,80,80,160,0,640
77627,180,140,200,240,160,320,1240
77628,180,20,40,80,0,0,320
77629,200,60,80,80,160,0,580
77630,200,120,160,160,0,0,640
77631,180,80,120,160,160,320,1020
77632,180,140,80,0,0,0,400
77633,150,60,80,80,160,0,530
77634,190,140,120,160,320,320,1250
77635,180,160,80,80,0,0,500
77636,220,100,120,80,160,320,1000
77637,190,100,160,240,320,320,1330
77638,190,100,120,160,0,0,570
77639,140,100,120,160,320,0,840
77640,170,100,80,0,0,0,350
77641,180,60,80,0,0,0,320
77642,190,140,120,80,0,0,530
77643,190,140,80,80,160,0,650
77644,200,100,80,160,0,0,540
77645,190,100,80,80,160,0,610
77646,200,120,40,80,160,0,600
77647,210,200,200,160,160,0,930
77648,220,80,120,80,0,0,500
77649,220,160,120,80,160,0,740
77650,210,140,120,160,160,320,1110
77651,130,120,120,160,0,0,530
77652,170,120,120,80,0,0,490
77653,200,140,120,160,320,320,1260
77654,160,80,0,0,0,0,240
77655,180,60,40,80,160,0,520
77656,180,100,80,80,160,0,600
77657,200,140,160,160,160,0,820
77658,200,120,80,80,160,0,640
77659,200,160,120,160,320,320,1280
77660,210,120,160,80,160,0,730
77661,180,140,120,80,160,0,680
77662,210,120,80,80,0,0,490
77663,200,100,80,80,160,0,620
77664,180,120,120,80,160,320,980
77665,190,140,80,80,0,0,490
77666,220,200,80,0,0,0,500
77667,220,160,80,0,0,0,460
77668,190,60,0,0,0,0,250
77669,200,160,160,80,160,0,760
77670,210,60,40,80,160,0,550
77671,180,120,120,160,320,0,900
77672,170,60,80,80,0,0,390
77673,140,60,120,80,160,320,880
77674,190,200,120,80,160,320,1070
77675,150,60,80,160,160,0,610
77676,190,140,200,240,160,0,930
77677,210,120,80,80,160,0,650
77678,220,100,120,160,0,0,600
77679,180,80,80,80,0,0,420
77680,200,120,120,160,160,320,1080
77681,200,120,0,0,0,0,320
77682,190,120,120,80,160,320,990
77683,190,100,120,80,0,0,490
77684,170,100,0,0,0,0,270
77685,150,100,200,240,160,0,850
77686,210,100,120,80,160,0,670
77687,210,80,160,80,0,0,530
77688,200,120,40,80,160,320,920
77689,200,80,120,80,160,0,640
77690,190,120,120,160,0,0,590
77691,200,200,80,80,160,320,1040
77692,220,80,80,0,0,0,380
77693,180,120,40,0,0,0,340
77694,240,180,160,160,160,0,900
77695,220,120,80,80,160,320,980
77696,180,140,120,160,160,320,1080
77697,170,140,200,0,0,0,510
77698,170,100,80,80,160,0,590
77699,200,160,80,80,0,0,520
77700,170,100,40,80,0,0,390
77701,210,120,160,0,0,0,490
77702,170,120,80,160,160,0,690
77703,200,120,80,80,160,320,960
77704,200,120,160,80,160,0,720
77705,160,100,120,160,320,0,860
77706,180,120,0,0,0,0,300
77707,220,100,80,80,160,0,640
77708,150,120,120,160,160,0,710
77709,210,60,120,240,160,0,790
77710,140,100,40,0,0,0,280
77711,200,120,160,160,320,320,1280
77712,190,140,160,240,320,320,1370
77713,210,120,80,80,0,0,490
77714,190,120,120,160,320,0,910
77715,220,160,200,0,0,0,580
77716,160,120,120,160,160,0,720
77717,230,100,160,160,160,0,810
77718,200,80,80,80,160,0,600
77719,230,100,80,80,160,0,650
77720,210,140,80,80,0,0,510
77721,190,140,120,160,320,320,1250
77722,210,160,80,0,0,0,450
77723,210,100,80,160,0,0,550
77724,180,120,80,80,0,0,460
77725,170,120,120,160,160,0,730
77726,190,80,80,0,0,0,350
77727,160,80,80,160,320,0,800
77728,170,100,120,80,160,0,630
77729,210,80,120,160,160,0,730
77730,210,120,80,0,0,0,410
77731,170,160,80,80,160,0,650
77732,170,120,120,80,0,0,490
77733,220,120,80,80,160,320,980
77734,180,100,40,80,160,320,880
77735,180,140,160,80,160,0,720
77736,220,80,80,0,0,0,380
77737,170,100,40,0,0,0,310
77738,240,160,160,80,0,0,640
77739,200,120,120,160,160,0,760
77740,170,100,120,160,0,0,550
77741,240,140,120,240,160,0,900
77742,180,120,80,80,160,0,620
77743,200,200,160,160,320,0,1040
77744,210,100,80,0,0,0,390
77745,190,140,120,160,160,0,770
77746,180,80,80,80,0,0,420
77747,200,100,80,160,160,320,1020
77748,190,140,160,80,0,0,570
77749,230,80,40,0,0,0,350
77750,170,120,120,80,160,0,650
77751,160,160,160,160,320,0,960
77752,200,120,160,160,320,0,960
77753,200,180,120,160,160,0,820
77754,160,140,80,80,0,0,460
77755,200,140,160,160,0,0,660
77756,180,100,120,160,160,320,1040
77757,240,80,40,80,160,0,600
77758,210,100,120,240,160,0,830
77759,190,80,40,80,160,0,550
77760,220,180,160,160,160,0,880
77761,180,140,120,160,160,0,760
77762,180,100,120,80,160,0,640
77763,170,160,120,160,160,0,770
77764,180,120,80,80,160,0,620
77765,180,120,80,80,0,0,460
77766,180,160,160,160,160,0,820
77767,180,140,80,0,0,0,400
77768,190,80,40,80,160,0,550
77769,150,120,80,80,160,320,910
77770,220,120,120,160,320,0,940
77771,180,120,160,160,160,320,1100
77772,230,160,80,80,160,0,710
77773,190,100,80,0,0,0,370
77774,160,100,80,80,0,0,420
77775,210,140,40,0,0,0,390
77776,230,100,120,80,0,0,530
77777,190,120,160,160,320,320,1270
77778,200,120,80,80,0,0,480
77779,200,120,80,80,0,0,480
77780,210,100,120,160,0,0,590
77781,220,120,80,80,0,0,500
77782,170,100,80,0,0,0,350
77783,210,140,120,0,0,0,470
77784,190,60,40,0,0,0,290
77785,200,60,120,160,160,0,700
77786,190,120,160,80,160,0,710
77787,210,120,120,0,0,0,450
77788,160,80,40,80,160,320,840
77789,210,140,120,160,160,320,1110
77790,220,140,160,80,160,0,760
77791,180,60,120,160,160,0,680
77792,210,100,120,80,0,0,510
77793,190,160,120,80,160,0,710
77794,170,180,200,160,160,0,870
77795,180,100,160,160,160,0,760
77796,210,140,120,80,160,320,1030
77797,200,140,40,0,0,0,380
77798,240,120,80,0,0,0,440
77799,190,120,160,80,160,0,710
77800,160,120,80,80,0,0,440
77801,190,60,80,0,0,0,330
77802,190,120,120,80,0,0,510
77803,200,140,80,160,160,0,740
77804,230,140,120,160,0,0,650
77805,160,120,80,80,0,0,440
77806,200,120,80,80,160,0,640
77807,170,100,80,80,160,0,590
77808,220,100,80,0,0,0,400
77809,210,160,120,160,320,0,970
77810,190,140,40,80,0,0,450
77811,240,200,120,160,320,0,1040
77812,190,100,120,80,160,0,650
77813,210,140,80,80,160,0,670
77814,170,140,160,160,160,0,790
77815,170,100,120,160,160,0,710
77816,240,160,80,80,0,0,560
77817,200,120,80,80,160,0,640
77818,200,120,120,80,160,0,680
77819,210,120,160,160,160,0,810
77820,200,140,160,160,160,0,820
77821,230,140,80,80,160,0,690
77822,170,120,160,160,0,0,610
77823,170,100,80,0,0,0,350
77824,180,180,160,160,160,0,840
77825,180,160,80,160,320,320,1220
77826,160,100,160,160,160,320,1060
77827,220,100,120,160,160,0,760
77828,200,80,120,160,160,0,720
77829,170,120,120,80,0,0,490
77830,190,100,160,80,160,320,1010
77831,220,140,120,80,160,0,720
77832,220,100,40,80,160,0,600
77833,200,120,80,80,0,0,480
77834,180,140,120,240,160,0,840
77835,220,120,160,160,160,0,820
77836,230,80,80,80,160,320,950
77837,240,120,80,0,0,0,440
77838,190,100,40,0,0,0,330
77839,200,140,80,80,160,0,660
77840,200,60,40,0,0,0,300
77841,200,120,120,80,160,0,680
77842,220,100,120,80,0,0,520
77843,200,120,80,0,0,0,400
77844,180,100,0,0,0,0,280
77845,190,100,80,160,160,0,690
77846,180,140,120,80,160,320,1000
77847,210,140,120,160,320,320,1270
77848,190,80,80,80,0,0,430
77849,200,160,160,240,0,0,760
77850,210,140,80,0,0,0,430
77851,200,120,120,80,0,0,520
77852,200,160,160,160,160,0,840
77853,210,80,120,80,160,320,970
77854,220,160,200,160,160,0,900
77855,240,120,40,80,160,0,640
77856,210,120,120,160,320,0,930
77857,190,120,120,0,0,0,430
77858,220,120,120,80,160,0,700
77859,180,60,80,80,160,0,560
77860,160,160,160,160,160,0,800
77861,160,120,120,80,160,0,640
77862,180,140,160,80,0,0,560
77863,180,140,120,80,160,0,680
77864,220,100,80,160,160,0,720
77865,180,160,120,160,160,320,1100
77866,230,200,120,80,0,0,630
77867,200,80,0,0,0,0,280
77868,190,140,160,160,160,0,810
77869,220,140,80,80,160,0,680
77870,240,160,120,160,160,0,840
77871,180,120,40,80,160,0,580
77872,220,120,80,80,0,0,500
77873,200,140,40,0,0,0,380
77874,220,140,80,80,0,0,520
77875,160,60,80,160,320,0,780
77876,210,80,0,0,0,0,290
77877,190,140,120,80,160,0,690
77878,180,140,160,80,0,0,560
77879,220,160,120,80,0,0,580
77880,200,120,40,80,0,0,440
77881,220,100,120,80,0,0,520
77882,180,80,120,240,0,0,620
77883,220,120,80,80,160,0,660
77884,180,160,160,240,160,0,900
77885,190,100,120,80,160,0,650
77886,210,140,160,160,160,0,830
77887,230,160,120,160,320,0,990
77888,220,100,0,0,0,0,320
77889,190,120,80,0,0,0,390
77890,220,140,80,0,0,0,440
77891,230,80,40,80,160,0,590
77892,160,120,120,80,160,0,640
77893,190,100,80,80,160,0,610
77894,240,120,80,160,160,320,1080
77895,180,120,0,0,0,0,300
77896,160,120,120,160,160,0,720
77897,180,80,80,80,160,0,580
77898,180,140,120,160,160,0,760
77899,160,120,120,0,0,0,400
77900,170,120,80,80,160,0,610
77901,220,140,40,80,160,0,640
77902,220,140,160,240,160,320,1240
77903,160,120,120,160,0,0,560
77904,200,80,80,80,0,0,440
77905,120,60,40,80,160,0,460
77906,240,160,120,160,160,0,840
77907,180,180,80,160,160,0,760
77908,220,140,160,160,320,320,1320
77909,200,140,160,80,0,0,580
77910,240,180,160,80,160,0,820
77911,180,80,80,80,160,0,580
77912,140,180,120,80,0,0,520
77913,170,180,120,80,0,0,550
77914,230,120,40,0,0,0,390
77915,180,140,120,80,160,0,680
77916,220,120,80,80,160,0,660
77917,210,120,120,80,160,0,690
77918,180,100,80,0,0,0,360
77919,180,160,80,80,160,0,660
77920,180,120,160,160,160,0,780
77921,190,140,80,80,0,0,490
77922,180,140,120,160,0,0,600
77923,180,100,80,160,160,320,1000
77924,160,100,80,160,160,0,660
77925,180,120,80,80,160,0,620
77926,210,160,40,0,0,0,410
77927,210,140,80,0,0,0,430
77928,210,140,120,160,160,0,790
77929,240,120,120,160,0,0,640
77930,200,120,160,240,160,0,880
77931,160,100,80,80,0,0,420
77932,200,160,120,0,0,0,480
77933,180,140,120,80,160,320,1000
77934,220,100,40,80,0,0,440
77935,230,80,80,80,160,0,630
77936,130,140,160,0,0,0,430
77937,200,100,80,160,160,0,700
77938,240,160,160,160,160,0,880
77939,180,120,80,160,0,0,540
77940,190,160,120,160,0,0,630
77941,220,120,80,160,160,0,740
77942,210,160,160,160,320,0,1010
77943,210,120,80,0,0,0,410
77944,150,160,160,80,160,0,710
77945,170,100,120,240,160,0,790
77946,200,120,80,80,160,0,640
77947,160,80,80,80,0,0,400
77948,200,120,120,80,160,0,680
77949,240,160,160,240,160,0,960
77950,210,140,120,80,160,0,710
77951,150,80,40,80,160,0,510
77952,200,120,160,240,160,0,880
77953,210,140,80,0,0,0,430
77954,200,160,120,160,160,320,1120
77955,170,120,120,80,160,0,650
77956,210,80,80,80,0,0,450
77957,160,60,120,160,0,0,500
77958,230,120,120,80,160,0,710
77959,190,120,200,160,160,0,830
77960,220,160,120,80,160,0,740
77961,210,140,120,80,0,0,550
77962,200,120,120,160,0,0,600
77963,210,200,120,80,160,0,770
77964,150,120,160,160,320,0,910
77965,210,140,120,240,0,0,710
77966,190,160,160,240,320,320,1390
77967,200,100,80,0,0,0,380
77968,200,140,160,80,160,0,740
77969,160,100,120,160,160,0,700
77970,180,140,120,80,0,0,520
77971,210,160,120,160,160,0,810
77972,200,60,40,0,0,0,300
77973,180,100,120,160,0,0,560
77974,180,60,40,80,0,0,360
77975,210,160,160,160,160,0,850
77976,180,100,80,80,0,0,440
77977,200,100,160,160,160,0,780
77978,160,100,120,160,320,0,860
77979,180,60,40,0,0,0,280
77980,250,160,80,80,0,0,570
77981,250,120,80,80,0,0,530
77982,180,80,120,160,160,0,700
77983,180,100,80,80,0,0,440
77984,180,120,120,160,160,0,740
77985,210,180,200,80,0,0,670
77986,200,60,40,0,0,0,300
77987,210,180,120,80,160,0,750
77988,230,180,120,80,160,0,770
77989,200,120,160,80,160,0,720
77990,200,180,160,0,0,0,540
77991,190,80,80,80,160,0,590
77992,220,80,80,80,160,0,620
77993,200,140,80,80,160,320,980
77994,210,160,120,160,160,0,810
77995,210,160,160,160,0,0,690
77996,190,120,120,240,320,0,990
77997,200,140,80,0,0,0,420
77998,180,100,120,80,0,0,480
77999,190,120,120,80,0,0,510
78000,210,160,120,160,160,320,1130
78001,210,100,80,160,160,0,710
78002,260,140,120,80,160,0,760
78003,190,160,160,80,160,0,750
78004,170,160,200,320,320,0,1170
78005,180,140,160,80,160,0,720
78006,160,140,160,240,160,0,860
78007,190,40,40,80,0,0,350
78008,230,140,120,160,320,320,1290
78009,170,140,120,160,320,0,910
78010,170,80,120,80,0,0,450
78011,170,80,120,80,160,0,610
78012,190,100,120,160,320,0,890
78013,200,100,120,80,160,320,980
78014,200,140,160,80,160,320,1060
78015,160,160,160,160,160,0,800
78016,190,100,80,0,0,0,370
78017,190,120,160,160,320,320,1270
78018,140,140,120,80,0,0,480
78019,220,60,40,80,160,0,560
78020,210,160,120,0,0,0,490
78021,220,100,80,80,160,0,640
78022,180,120,160,240,0,0,700
78023,190,120,160,240,320,320,1350
78024,180,120,160,80,160,0,700
78025,200,160,80,0,0,0,440
78026,220,160,80,0,0,0,460
78027,200,160,200,240,160,0,960
78028,200,160,80,0,0,0,440
78029,210,100,40,0,0,0,350
78030,190,140,80,160,160,0,730
78031,210,100,80,80,0,0,470
78032,210,140,120,0,0,0,470
78033,220,200,200,160,160,0,940
78034,190,120,80,0,0,0,390
78035,230,140,120,80,160,320,1050
78036,190,100,120,80,160,0,650
78037,180,120,40,80,0,0,420
78038,210,140,80,80,160,0,670
78039,210,80,80,160,160,0,690
78040,200,160,120,160,0,0,640
78041,190,140,160,160,160,0,810
78042,210,80,120,160,160,0,730
78043,180,100,120,160,160,0,720
78044,190,120,40,0,0,0,350
78045,230,160,40,80,160,0,670
78046,190,120,40,80,160,0,590
78047,210,120,160,240,160,0,890
78048,180,80,40,80,160,320,860
78049,140,120,40,80,0,0,380
78050,180,160,200,240,320,0,1100
78051,200,140,160,80,160,0,740
78052,220,140,160,0,0,0,520
78053,180,120,120,80,0,0,500
78054,210,80,40,80,160,0,570
78055,200,140,40,0,0,0,380
78056,200,140,120,160,320,320,1260
78057,220,140,120,80,160,0,720
78058,220,140,120,160,160,0,800
78059,190,120,120,160,0,0,590
78060,220,140,120,80,160,320,1040
78061,180,80,80,80,160,320,900
78062,200,140,160,160,320,0,980
78063,190,140,120,80,160,0,690
78064,230,120,120,160,160,0,790
78065,210,160,80,160,0,0,610
78066,190,140,80,0,0,0,410
78067,170,120,40,0,0,0,330
78068,150,80,80,0,0,0,310
78069,180,60,120,160,320,0,840
78070,190,140,120,160,160,320,1090
78071,200,100,120,160,0,0,580
78072,160,80,80,160,160,0,640
78073,190,140,120,160,320,320,1250
78074,230,100,120,0,0,0,450
78075,200,120,40,80,160,0,600
78076,200,80,40,80,160,0,560
78077,190,120,160,160,160,0,790
78078,180,100,80,80,0,0,440
78079,130,120,80,80,160,0,570
78080,150,140,120,80,0,0,490
78081,190,100,80,80,0,0,450
78082,220,140,120,160,0,0,640
78083,150,60,120,80,0,0,410
78084,210,80,40,0,0,0,330
78085,170,100,120,0,0,0,390
78086,170,120,120,160,320,0,890
78087,170,140,80,0,0,0,390
78088,170,160,120,160,160,0,770
78089,170,140,40,0,0,0,350
78090,190,160,160,160,0,0,670
78091,190,120,80,80,0,0,470
78092,170,100,40,0,0,0,310
78093,230,140,120,0,0,0,490
78094,160,100,120,160,0,0,540
78095,200,120,120,160,160,0,760
78096,220,120,80,80,0,0,500
78097,210,140,120,80,0,0,550
78098,200,140,160,160,320,320,1300
78099,220,100,80,80,160,320,960
78100,240,180,160,0,0,0,580
78101,250,120,40,80,160,0,650
78102,240,80,80,80,0,0,480
78103,220,80,80,160,0,0,540
78104,200,120,120,240,160,0,840
78105,200,100,80,160,160,0,700
78106,180,80,80,160,0,0,500
78107,170,100,120,160,160,0,710
78108,200,160,120,160,160,0,800
78109,220,120,80,160,320,0,900
78110,190,100,120,80,160,0,650
78111,160,180,80,80,160,320,980
78112,220,80,40,0,0,0,340
78113,170,140,40,80,160,0,590
78114,170,140,80,0,0,0,390
78115,220,140,80,160,160,0,760
78116,220,100,80,160,0,0,560
78117,250,240,160,160,160,0,970
78118,180,200,200,160,0,0,740
78119,210,200,120,80,160,0,770
78120,220,120,80,80,0,0,500
78121,180,100,120,240,320,0,960
78122,200,120,160,160,160,320,1120
78123,180,100,120,80,0,0,480
78124,180,100,120,80,160,0,640
78125,170,140,120,160,0,0,590
78126,220,80,120,240,320,320,1300
78127,200,160,80,0,0,0,440
78128,200,80,80,0,0,0,360
78129,180,80,80,80,160,0,580
78130,220,140,120,160,320,320,1280
78131,240,140,120,240,160,0,900
78132,200,120,80,80,0,0,480
78133,170,100,160,160,160,320,1070
78134,220,60,40,80,160,0,560
78135,210,100,80,0,0,0,390
78136,180,80,120,80,160,0,620
78137,190,140,160,80,160,0,730
78138,200,100,120,0,0,0,420
78139,230,160,200,160,160,0,910
78140,220,120,40,80,160,0,620
78141,220,160,160,160,160,0,860
78142,180,180,120,80,160,0,720
78143,220,120,40,0,0,0,380
78144,170,140,80,80,160,0,630
78145,220,160,120,160,0,0,660
78146,220,160,160,240,160,0,940
78147,200,120,80,80,0,0,480
78148,180,60,0,0,0,0,240
78149,210,80,120,0,0,0,410
78150,190,120,40,80,160,0,590
78151,180,120,120,80,0,0,500
78152,190,120,80,0,0,0,390
78153,200,160,120,240,320,0,1040
78154,170,80,80,80,0,0,410
78155,180,120,80,80,160,0,620
78156,200,140,80,80,0,0,500
78157,170,120,40,80,160,320,890
78158,200,160,120,80,160,0,720
78159,220,120,120,80,160,0,700
78160,210,180,160,160,160,0,870
78161,230,100,80,160,160,0,730
78162,230,200,120,160,320,320,1350
78163,220,120,120,160,160,0,780
78164,210,120,80,80,160,320,970
78165,190,100,120,160,160,0,730
78166,230,140,40,80,0,0,490
78167,220,180,120,160,160,0,840
78168,160,60,120,160,320,0,820
78169,180,140,80,0,0,0,400
78170,190,140,160,160,0,0,650
78171,190,100,80,0,0,0,370
78172,170,120,80,80,0,0,450
78173,180,100,40,80,0,0,400
78174,220,80,80,0,0,0,380
78175,170,80,40,0,0,0,290
78176,170,120,120,160,160,0,730
78177,150,60,40,80,0,0,330
78178,160,120,120,80,0,0,480
78179,190,140,120,80,0,0,530
78180,200,100,120,160,160,320,1060
78181,180,80,40,80,160,0,540
78182,150,40,80,0,0,0,270
78183,210,120,40,80,0,0,450
78184,190,100,80,80,0,0,450
78185,180,120,80,80,160,0,620
78186,200,140,160,0,0,0,500
78187,190,80,80,80,160,0,590
78188,190,120,160,160,160,0,790
78189,160,120,120,80,0,0,480
78190,170,140,120,160,160,0,750
78191,190,100,120,160,160,0,730
78192,220,140,200,160,320,0,1040
78193,210,120,40,80,0,0,450
78194,200,100,120,80,160,0,660
78195,180,120,80,80,160,0,620
78196,160,60,40,80,160,0,500
78197,190,140,160,160,160,0,810
78198,190,120,120,240,160,0,830
78199,250,140,160,160,0,0,710
78200,220,160,200,160,160,0,900
78201,160,120,120,80,160,0,640
78202,160,120,80,80,160,0,600
78203,220,140,160,160,160,0,840
78204,160,100,160,240,160,0,820
78205,170,140,40,0,0,0,350
78206,210,140,80,80,160,320,990
78207,230,180,240,240,320,320,1530
78208,150,160,80,160,160,0,710
78209,210,160,40,0,0,0,410
78210,220,120,120,240,160,0,860
78211,190,140,160,80,160,0,730
78212,210,120,40,0,0,0,370
78213,190,100,120,80,160,320,970
78214,180,80,40,80,160,0,540
78215,170,120,40,0,0,0,330
78216,220,160,160,160,320,0,1020
78217,260,180,120,160,0,0,720
78218,190,140,80,80,0,0,490
78219,260,140,120,160,0,0,680
78220,180,80,80,160,160,320,980
78221,210,140,120,240,160,0,870
78222,210,140,200,160,320,0,1030
78223,210,100,80,80,160,0,630
78224,170,80,80,80,160,0,570
78225,190,100,120,160,0,0,570
78226,220,160,120,160,320,0,980
78227,200,140,120,80,0,0,540
78228,140,100,80,160,160,320,960
78229,200,60,120,80,0,0,460
78230,180,120,160,80,0,0,540
78231,190,80,80,80,0,0,430
78232,200,120,0,0,0,0,320
78233,150,100,160,160,0,0,570
78234,170,80,80,160,160,0,650
78235,200,80,80,80,0,0,440
78236,220,180,120,160,160,0,840
78237,180,100,160,160,0,0,600
78238,190,140,40,80,160,0,610
78239,230,180,160,160,0,0,730
78240,170,160,80,80,160,0,650
78241,220,80,80,160,160,0,700
78242,220,160,120,80,0,0,580
78243,180,140,80,160,320,0,880
78244,180,100,80,0,0,0,360
78245,180,180,120,160,160,0,800
78246,200,120,80,0,0,0,400
78247,200,140,120,80,0,0,540
78248,220,140,160,160,160,0,840
78249,190,140,120,80,160,0,690
78250,220,140,120,160,0,0,640
78251,210,120,80,80,0,0,490
78252,240,140,120,160,160,0,820
78253,180,140,160,160,0,0,640
78254,230,160,160,240,320,0,1110
78255,210,100,40,80,160,0,590
78256,150,100,120,80,0,0,450
78257,220,120,120,80,160,0,700
78258,210,140,160,160,160,320,1150
78259,230,120,160,160,160,0,830
78260,210,120,120,240,320,0,1010
78261,240,100,40,80,0,0,460
78262,180,160,200,160,160,0,860
78263,190,120,120,240,160,0,830
78264,210,120,120,160,160,0,770
78265,150,120,120,80,160,320,950
78266,180,100,160,80,0,0,520
78267,180,60,40,80,160,0,520
78268,210,100,80,0,0,0,390
78269,240,180,80,80,0,0,580
78270,240,140,40,0,0,0,420
78271,210,120,80,80,0,0,490
78272,180,120,80,0,0,0,380
78273,190,100,120,80,0,0,490
78274,200,80,80,80,160,0,600
78275,210,100,80,160,320,0,870
78276,220,120,120,80,160,0,700
78277,200,120,80,0,0,0,400
78278,190,80,40,0,0,0,310
78279,220,180,80,160,0,0,640
78280,240,140,160,80,160,0,780
78281,210,60,120,240,320,320,1270
78282,220,140,40,80,160,0,640
78283,200,120,80,80,160,0,640
78284,240,120,80,160,0,0,600
78285,180,160,120,80,160,320,1020
78286,210,100,80,80,160,0,630
78287,190,100,80,80,0,0,450
78288,190,120,120,80,0,0,510
78289,160,100,120,160,0,0,540
78290,240,160,120,80,160,0,760
78291,220,180,120,80,160,0,760
78292,180,120,80,80,160,0,620
78293,190,160,80,80,160,0,670
78294,210,120,120,80,0,0,530
78295,210,120,120,160,0,0,610
78296,210,80,40,80,0,0,410
78297,190,120,120,160,0,0,590
78298,140,120,80,0,0,0,340
78299,230,80,80,0,0,0,390
78300,200,80,120,80,160,0,640
78301,220,140,120,160,0,0,640
78302,220,120,80,80,0,0,500
78303,190,100,80,0,0,0,370
78304,220,100,80,80,160,0,640
78305,210,100,80,0,0,0,390
78306,200,140,120,160,0,0,620
78307,170,80,120,240,160,0,770
78308,240,160,160,160,0,0,720
78309,200,120,160,160,0,0,640
78310,210,180,200,160,320,0,1070
78311,200,180,120,160,160,0,820
78312,220,140,80,160,320,320,1240
78313,220,180,200,240,160,0,1000
78314,180,100,40,0,0,0,320
78315,210,80,40,0,0,0,330
78316,200,160,120,160,160,0,800
78317,200,160,160,160,320,320,1320
78318,210,140,120,160,0,0,630
78319,180,100,120,80,0,0,480
78320,180,80,40,0,0,0,300
78321,180,60,120,80,0,0,440
78322,210,160,40,0,0,0,410
78323,190,140,120,80,0,0,530
78324,220,120,120,240,320,0,1020
78325,160,140,120,160,160,0,740
78326,200,160,120,240,320,0,1040
78327,190,100,160,240,160,0,850
78328,190,200,120,80,0,0,590
78329,220,200,120,80,160,0,780
78330,210,140,80,80,0,0,510
78331,220,180,120,80,160,0,760
78332,170,140,160,80,0,0,550
78333,210,140,200,80,160,0,790
78334,190,100,40,0,0,0,330
78335,200,140,160,240,160,0,900
78336,190,160,160,80,0,0,590
78337,200,140,160,160,320,0,980
78338,180,120,160,160,160,0,780
78339,190,160,160,240,320,320,1390
78340,180,120,40,80,0,0,420
78341,220,160,80,160,0,0,620
78342,200,120,120,80,160,0,680
78343,220,200,160,80,160,0,820
78344,200,80,120,0,0,0,400
78345,210,200,200,160,0,0,770
78346,240,180,120,80,160,0,780
78347,220,180,120,80,0,0,600
78348,220,140,160,0,0,0,520
78349,210,120,120,80,160,320,1010
78350,160,100,80,80,160,0,580
78351,160,120,160,160,160,0,760
78352,210,120,120,80,160,320,1010
78353,180,140,160,160,160,0,800
78354,230,160,160,160,320,320,1350
78355,190,100,120,160,160,0,730
78356,240,160,160,160,320,320,1360
78357,170,140,40,0,0,0,350
78358,220,120,160,160,320,0,980
78359,220,160,160,80,0,0,620
78360,170,100,120,160,160,0,710
78361,180,120,160,160,0,0,620
78362,210,160,120,160,160,0,810
78363,190,160,120,160,160,0,790
78364,220,120,80,80,160,0,660
78365,180,100,120,160,320,0,880
78366,190,120,120,80,160,0,670
78367,220,120,120,160,0,0,620
78368,230,120,80,0,0,0,430
78369,140,80,120,80,160,0,580
78370,180,80,40,80,0,0,380
78371,190,140,120,0,0,0,450
78372,200,160,80,80,0,0,520
78373,160,120,200,320,160,0,960
78374,200,140,160,160,160,320,1140
78375,220,120,160,160,320,320,1300
78376,160,140,160,80,160,320,1020
78377,180,160,160,240,0,0,740
78378,220,140,40,80,160,0,640
78379,180,100,160,0,0,0,440
78380,160,160,160,160,320,0,960
78381,190,120,40,0,0,0,350
78382,180,100,80,80,160,0,600
78383,210,120,160,0,0,0,490
78384,180,140,120,160,0,0,600
78385,170,120,200,80,160,0,730
78386,190,80,80,80,0,0,430
78387,230,100,80,160,160,320,1050
78388,220,160,160,80,0,0,620
78389,170,140,80,160,160,0,710
78390,180,100,160,240,0,0,680
78391,200,160,40,0,0,0,400
78392,170,100,80,160,0,0,510
78393,180,180,200,160,160,0,880
78394,210,160,120,80,0,0,570
78395,170,140,120,80,160,320,990
78396,210,140,160,240,160,0,910
78397,200,160,80,80,0,0,520
78398,180,120,80,0,0,0,380
78399,170,100,80,0,0,0,350
78400,210,120,40,0,0,0,370
78401,170,60,80,80,0,0,390
78402,200,140,160,240,160,0,900
78403,220,140,40,80,0,0,480
78404,180,120,120,0,0,0,420
78405,170,200,160,0,0,0,530
78406,190,160,120,0,0,0,470
78407,180,60,40,0,0,0,280
78408,200,100,160,240,320,0,1020
78409,190,180,160,160,0,0,690
78410,230,140,120,80,0,0,570
78411,230,100,120,160,0,0,610
78412,180,140,80,160,160,0,720
78413,230,120,160,240,160,320,1230
78414,200,100,120,160,0,0,580
78415,200,100,120,80,0,0,500
78416,220,200,160,160,0,0,740
78417,220,180,200,160,160,0,920
78418,260,180,80,0,0,0,520
78419,200,40,40,0,0,0,280
78420,180,120,80,80,0,0,460
78421,180,60,80,0,0,0,320
78422,210,140,120,0,0,0,470
78423,190,180,160,160,160,0,850
78424,220,100,120,240,160,320,1160
78425,150,60,40,80,160,320,810
78426,190,160,200,160,0,0,710
78427,190,100,120,160,160,0,730
78428,180,140,120,80,160,0,680
78429,240,100,120,80,160,0,700
78430,150,100,80,80,160,320,890
78431,200,180,80,0,0,0,460
78432,210,180,120,80,0,0,590
78433,200,140,80,160,0,0,580
78434,170,120,80,0,0,0,370
78435,180,160,120,80,0,0,540
78436,180,100,80,0,0,0,360
78437,230,80,80,80,160,0,630
78438,240,100,40,80,160,320,940
78439,200,100,120,80,160,0,660
78440,210,160,160,240,320,320,1410
78441,220,100,120,0,0,0,440
78442,180,60,40,80,160,320,840
78443,170,120,80,0,0,0,370
78444,220,100,80,0,0,0,400
78445,240,100,120,160,0,0,620
78446,190,120,80,80,0,0,470
78447,150,80,160,240,160,320,1110
78448,180,120,40,0,0,0,340
78449,200,120,40,0,0,0,360
78450,190,80,80,80,160,320,910
78451,180,120,80,160,320,0,860
78452,200,80,80,80,160,0,600
78453,170,100,120,80,160,0,630
78454,180,100,80,0,0,0,360
78455,170,140,40,80,160,320,910
78456,180,80,80,160,160,0,660
78457,180,100,120,240,160,0,800
78458,180,120,80,80,160,0,620
78459,220,140,160,80,0,0,600
78460,230,120,80,80,160,0,670
78461,200,120,120,160,0,0,600
78462,240,180,200,320,160,0,1100
78463,190,180,240,240,0,0,850
78464,200,120,120,80,160,0,680
78465,220,120,80,80,0,0,500
78466,170,120,120,160,160,320,1050
78467,180,140,120,160,320,320,1240
78468,210,100,120,80,0,0,510
78469,210,160,160,160,160,0,850
78470,150,80,80,80,160,0,550
78471,210,100,80,0,0,0,390
78472,200,160,200,240,320,0,1120
78473,220,160,80,0,0,0,460
78474,190,180,40,80,160,0,650
78475,170,100,120,160,0,0,550
78476,180,100,160,160,160,0,760
78477,180,140,120,160,160,0,760
78478,250,160,120,160,0,0,690
78479,140,100,160,160,160,0,720
78480,150,140,80,160,160,0,690
78481,210,160,120,80,0,0,570
78482,250,120,80,160,160,320,1090
78483,220,120,160,240,320,0,1060
78484,220,120,120,160,160,0,780
78485,220,160,80,80,160,320,1020
78486,180,60,40,0,0,0,280
78487,190,120,80,80,160,0,630
78488,150,120,120,160,160,0,710
78489,200,60,120,80,160,320,940
78490,200,160,200,160,320,320,1360
78491,230,140,80,160,160,0,770
78492,180,40,40,80,160,320,820
78493,170,120,40,80,160,0,570
78494,190,140,160,80,160,0,730
78495,210,220,120,80,160,0,790
78496,180,100,120,80,160,0,640
78497,200,80,0,0,0,0,280
78498,190,120,80,80,160,320,950
78499,190,60,40,0,0,0,290
78500,220,60,80,80,0,0,440
78501,190,100,120,160,160,0,730
78502,140,160,160,160,0,0,620
78503,230,140,120,0,0,0,490
78504,190,120,80,80,160,0,630
78505,230,160,160,80,0,0,630
78506,150,140,160,160,0,0,610
78507,190,80,120,80,0,0,470
78508,190,180,160,240,320,0,1090
78509,220,60,40,80,160,0,560
78510,170,120,120,160,320,320,1210
78511,180,120,120,160,0,0,580
78512,210,120,120,240,0,0,690
78513,200,120,120,80,160,0,680
78514,200,100,120,80,0,0,500
78515,180,140,40,80,160,0,600
78516,200,100,40,0,0,0,340
78517,160,100,40,0,0,0,300
78518,180,140,40,0,0,0,360
78519,210,100,80,160,160,0,710
78520,180,100,80,80,160,0,600
78521,230,100,160,80,160,0,730
78522,170,60,0,0,0,0,230
78523,200,200,120,160,320,0,1000
78524,200,140,80,160,0,0,580
78525,200,140,120,160,0,0,620
78526,160,120,80,80,160,0,600
78527,220,140,80,80,160,0,680
78528,230,80,40,0,0,0,350
78529,170,80,80,80,160,0,570
78530,190,100,80,80,160,0,610
78531,170,160,200,80,0,0,610
78532,160,140,80,160,160,0,700
78533,190,100,120,80,0,0,490
78534,210,140,120,80,160,0,710
78535,160,140,200,160,160,0,820
78536,230,140,40,80,160,0,650
78537,210,140,40,0,0,0,390
78538,210,140,80,160,160,0,750
78539,200,100,120,160,320,320,1220
78540,190,180,80,80,160,320,1010
78541,220,160,160,80,0,0,620
78542,180,140,160,160,0,0,640
78543,190,140,120,80,0,0,530
78544,210,140,120,80,160,0,710
78545,210,100,80,80,0,0,470
78546,230,140,120,80,0,0,570
78547,200,100,80,0,0,0,380
78548,230,160,160,160,320,0,1030
78549,210,180,40,0,0,0,430
78550,210,80,80,80,0,0,450
78551,230,100,160,160,160,0,810
78552,260,180,200,240,160,320,1360
78553,180,120,160,160,160,320,1100
78554,210,120,120,240,160,0,850
78555,230,120,120,240,160,0,870
78556,150,80,80,80,0,0,390
78557,160,100,40,0,0,0,300
78558,170,140,120,0,0,0,430
78559,170,100,160,320,160,0,910
78560,200,120,120,160,320,320,1240
78561,200,180,80,160,0,0,620
78562,170,120,120,160,160,0,730
78563,230,120,40,0,0,0,390
78564,180,100,120,80,0,0,480
78565,200,180,120,80,0,0,580
78566,170,100,80,80,0,0,430
78567,220,120,80,80,0,0,500
78568,170,160,120,80,160,0,690
78569,190,120,80,160,0,0,550
78570,200,120,160,160,160,0,800
78571,210,100,80,80,0,0,470
78572,130,120,80,0,0,0,330
78573,220,180,160,80,160,320,1120
78574,190,100,120,160,160,320,1050
78575,220,140,160,160,320,320,1320
78576,200,60,40,0,0,0,300
78577,240,140,120,80,160,0,740
78578,210,100,40,0,0,0,350
78579,200,120,80,160,0,0,560
78580,180,140,200,160,160,0,840
78581,200,80,80,80,0,0,440
78582,190,120,120,80,160,0,670
78583,170,100,40,80,160,0,550
78584,210,140,40,0,0,0,390
78585,230,160,80,0,0,0,470
78586,210,140,40,80,160,0,630
78587,180,120,160,80,0,0,540
78588,170,140,80,80,0,0,470
78589,210,120,80,0,0,0,410
78590,200,160,120,160,320,0,960
78591,230,140,40,80,160,0,650
78592,200,100,80,160,160,0,700
78593,190,120,40,0,0,0,350
78594,210,120,120,80,160,0,690
78595,200,140,120,80,160,320,1020
78596,230,100,160,0,0,0,490
78597,190,140,160,0,0,0,490
78598,150,100,40,0,0,0,290
78599,200,160,120,160,320,0,960
78600,190,160,200,80,0,0,630
78601,200,100,40,80,0,0,420
78602,150,80,120,80,160,0,590
78603,160,80,80,160,160,0,640
78604,200,120,120,240,160,0,840
78605,200,180,120,160,160,0,820
78606,160,140,160,160,0,0,620
78607,210,140,160,160,0,0,670
78608,180,120,80,0,0,0,380
78609,200,100,0,0,0,0,300
78610,170,100,80,0,0,0,350
78611,200,160,120,80,160,0,720
78612,190,120,40,0,0,0,350
78613,170,120,120,0,0,0,410
78614,180,180,200,160,160,0,880
78615,210,100,80,80,160,0,630
78616,170,60,120,240,160,0,750
78617,260,160,80,160,320,0,980
78618,190,100,40,80,160,0,570
78619,190,120,120,80,160,0,670
78620,190,100,80,160,320,0,850
78621,170,140,120,0,0,0,430
78622,200,160,160,240,320,0,1080
78623,180,80,40,80,0,0,380
78624,230,100,160,240,160,320,1210
78625,210,120,160,160,0,0,650
78626,250,140,160,160,0,0,710
78627,210,160,160,80,160,0,770
78628,160,100,120,0,0,0,380
78629,210,100,0,0,0,0,310
78630,230,200,120,0,0,0,550
78631,220,200,120,160,160,0,860
78632,200,120,80,80,160,320,960
78633,190,80,80,80,160,0,590
78634,220,160,160,240,320,320,1420
78635,200,160,160,160,320,0,1000
78636,150,120,160,240,160,0,830
78637,180,100,120,160,160,320,1040
78638,170,120,80,0,0,0,370
78639,220,200,120,80,160,0,780
78640,210,100,40,0,0,0,350
78641,190,160,40,80,0,0,470
78642,200,140,120,160,320,320,1260
78643,220,100,120,80,0,0,520
78644,230,120,40,0,0,0,390
78645,260,120,160,80,0,0,620
78646,210,120,160,160,320,0,970
78647,200,140,80,80,160,0,660
78648,210,140,80,160,160,0,750
78649,220,140,200,160,320,0,1040
78650,210,140,80,160,160,0,750
78651,190,100,120,80,160,0,650
78652,170,100,80,80,160,0,590
78653,190,80,40,80,0,0,390
78654,210,160,160,160,160,0,850
78655,220,120,120,80,160,0,700
78656,210,180,200,80,0,0,670
78657,190,160,120,0,0,0,470
78658,220,140,120,240,320,320,1360
78659,250,100,80,80,160,0,670
78660,200,100,160,160,0,0,620
78661,140,80,120,160,0,0,500
78662,180,80,40,0,0,0,300
78663,230,120,120,80,160,0,710
78664,180,80,40,80,160,0,540
78665,160,100,80,80,160,0,580
78666,200,140,80,160,160,320,1060
78667,190,120,40,80,160,0,590
78668,230,120,160,160,160,0,830
78669,160,100,120,80,160,0,620
78670,170,120,40,80,160,0,570
78671,160,140,120,80,0,0,500
78672,160,140,160,80,160,0,700
78673,200,120,120,160,160,0,760
78674,190,120,40,0,0,0,350
78675,190,120,80,160,160,0,710
78676,220,220,80,80,160,0,760
78677,160,80,160,80,0,0,480
78678,230,140,80,80,160,0,690
78679,170,80,80,80,0,0,410
78680,210,60,120,80,160,0,630
78681,200,160,80,0,0,0,440
78682,190,140,160,160,160,0,810
78683,180,140,40,0,0,0,360
78684,210,120,80,80,160,0,650
78685,180,140,120,80,160,0,680
78686,180,160,200,160,160,320,1180
78687,200,200,200,80,160,0,840
78688,190,140,160,80,0,0,570
78689,200,160,120,0,0,0,480
78690,210,160,120,80,0,0,570
78691,220,100,80,0,0,0,400
78692,210,80,40,80,0,0,410
78693,170,60,80,0,0,0,310
78694,170,140,160,80,0,0,550
78695,190,100,120,240,160,0,810
78696,230,140,40,80,0,0,490
78697,230,140,120,160,320,320,1290
78698,170,140,80,80,160,0,630
78699,190,120,80,80,0,0,470
78700,230,160,160,160,0,0,710
78701,210,120,40,0,0,0,370
78702,180,100,40,0,0,0,320
78703,200,120,80,80,160,0,640
78704,210,140,120,80,160,0,710
78705,210,120,80,80,160,0,650
78706,190,180,160,80,160,0,770
78707,180,160,80,80,0,0,500
78708,240,80,80,80,0,0,480
78709,200,80,40,80,160,0,560
78710,170,140,120,160,320,0,910
78711,220,120,120,0,0,0,460
78712,190,120,40,0,0,0,350
78713,200,100,80,80,160,0,620
78714,210,160,160,160,160,0,850
78715,180,120,80,0,0,0,380
78716,210,100,80,160,160,320,1030
78717,200,100,80,80,160,0,620
78718,170,120,120,80,0,0,490
78719,230,100,120,160,160,320,1090
78720,220,120,160,160,160,0,820
78721,170,120,120,160,0,0,570
78722,220,100,120,160,0,0,600
78723,200,100,80,80,160,0,620
78724,180,100,120,160,160,0,720
78725,180,160,80,80,0,0,500
78726,220,140,80,80,160,0,680
78727,180,120,120,160,320,0,900
78728,170,80,80,80,160,0,570
78729,180,140,120,80,160,0,680
78730,210,160,240,240,320,0,1170
78731,220,100,80,80,0,0,480
78732,170,80,40,80,160,0,530
78733,210,140,80,80,160,0,670
78734,160,80,80,0,0,0,320
78735,170,100,80,80,160,0,590
78736,190,120,120,160,160,320,1070
78737,210,140,40,80,0,0,470
78738,190,140,120,0,0,0,450
78739,170,80,80,80,0,0,410
78740,200,140,80,80,160,0,660
78741,170,120,120,80,160,0,650
78742,220,140,160,160,0,0,680
78743,190,120,40,80,160,0,590
78744,220,100,80,80,0,0,480
78745,180,100,80,0,0,0,360
78746,170,140,120,80,0,0,510
78747,200,100,160,240,160,0,860
78748,190,160,160,160,160,0,830
78749,210,120,160,160,160,320,1130
78750,180,80,120,160,160,0,700
78751,220,160,80,80,0,0,540
78752,190,180,120,80,160,0,730
78753,220,140,80,0,0,0,440
78754,240,140,160,80,160,320,1100
78755,190,120,40,80,160,0,590
78756,210,60,80,80,0,0,430
78757,190,120,160,240,160,320,1190
78758,220,140,200,160,160,0,880
78759,180,100,160,160,160,320,1080
78760,240,120,80,80,0,0,520
78761,210,160,120,160,160,0,810
78762,210,140,160,240,320,0,1070
78763,180,60,120,80,160,0,600
78764,210,140,80,0,0,0,430
78765,180,100,120,80,0,0,480
78766,190,100,120,240,320,0,970
78767,200,160,120,160,0,0,640
78768,200,140,120,80,160,320,1020
78769,190,100,40,80,160,0,570
78770,220,120,120,80,160,0,700
78771,180,120,120,0,0,0,420
78772,190,120,160,160,320,0,950
78773,210,120,80,80,0,0,490
78774,200,180,120,80,160,320,1060
78775,180,100,120,160,160,320,1040
78776,210,100,160,80,160,0,710
78777,250,160,40,80,160,0,690
78778,170,100,40,80,160,0,550
78779,200,100,120,160,160,0,740
78780,230,100,80,80,160,0,650
78781,180,120,120,160,160,0,740
78782,170,80,80,80,160,0,570
78783,230,180,160,0,0,0,570
78784,250,160,80,80,0,0,570
78785,200,100,120,80,0,0,500
78786,230,140,160,240,320,0,1090
78787,190,140,120,160,320,0,930
78788,220,180,160,80,0,0,640
78789,210,80,40,80,0,0,410
78790,120,100,80,80,160,320,860
78791,200,120,160,240,160,0,880
78792,220,100,80,160,160,0,720
78793,180,180,120,240,160,0,880
78794,240,140,160,160,320,320,1340
78795,200,80,80,160,160,0,680
78796,260,120,120,160,320,320,1300
78797,180,100,120,80,160,320,960
78798,210,160,160,160,0,0,690
78799,140,140,120,160,320,320,1200
78800,170,120,160,160,320,0,930
78801,230,160,80,80,160,0,710
78802,240,120,160,240,160,0,920
78803,210,120,160,160,320,320,1290
78804,150,100,40,80,160,320,850
78805,230,100,0,0,0,0,330
78806,140,80,80,80,160,0,540
78807,150,120,120,80,160,320,950
78808,210,160,160,80,0,0,610
78809,170,100,40,0,0,0,310
78810,170,120,80,80,0,0,450
78811,250,140,80,80,160,320,1030
78812,190,140,40,0,0,0,370
78813,160,120,80,80,160,320,920
78814,170,120,80,80,0,0,450
78815,190,120,80,80,160,0,630
78816,200,80,80,80,160,0,600
78817,190,80,80,80,0,0,430
78818,200,100,120,80,0,0,500
78819,160,80,120,80,0,0,440
78820,180,100,40,0,0,0,320
78821,160,80,80,80,160,320,880
78822,190,140,160,160,160,0,810
78823,200,100,120,160,160,320,1060
78824,230,180,160,80,0,0,650
78825,200,80,40,80,160,320,880
78826,190,140,120,80,160,0,690
78827,210,140,120,80,160,0,710
78828,180,120,40,0,0,0,340
78829,240,120,80,80,160,0,680
78830,170,160,160,80,0,0,570
78831,180,100,160,160,320,0,920
78832,170,80,160,240,320,320,1290
78833,180,120,40,80,160,0,580
78834,190,120,120,160,0,0,590
78835,180,100,120,160,160,0,720
78836,270,200,200,80,0,0,750
78837,180,120,80,160,160,0,700
78838,170,120,160,240,160,320,1170
78839,170,80,40,80,0,0,370
78840,170,160,120,160,160,0,770
78841,190,100,80,80,160,0,610
78842,220,120,120,160,160,0,780
78843,210,120,40,80,0,0,450
78844,240,100,40,0,0,0,380
78845,230,80,120,160,320,0,910
78846,230,100,80,0,0,0,410
78847,210,180,120,160,160,0,830
78848,160,80,80,80,160,0,560
78849,210,180,160,160,160,0,870
78850,230,120,80,80,160,0,670
78851,180,100,160,160,320,0,920
78852,200,120,80,80,160,0,640
78853,190,120,120,80,0,0,510
78854,190,120,80,160,320,0,870
78855,220,160,200,80,0,0,660
78856,150,100,80,80,160,320,890
78857,190,140,80,0,0,0,410
78858,170,120,160,0,0,0,450
78859,150,120,120,160,320,0,870
78860,190,100,80,0,0,0,370
78861,210,120,80,0,0,0,410
78862,200,160,40,80,0,0,480
78863,210,60,80,160,0,0,510
78864,260,200,160,240,160,0,1020
78865,180,140,0,0,0,0,320
78866,190,60,40,80,160,0,530
78867,240,200,120,80,0,0,640
78868,210,100,80,80,0,0,470
78869,220,120,80,160,160,0,740
78870,200,160,80,80,0,0,520
78871,190,100,120,80,0,0,490
78872,200,100,80,80,160,0,620
78873,170,160,80,0,0,0,410
78874,200,160,120,80,160,320,1040
78875,190,120,80,80,160,0,630
78876,220,60,40,0,0,0,320
78877,170,120,0,0,0,0,290
78878,200,80,120,160,160,320,1040
78879,220,120,120,160,320,0,940
78880,230,100,120,80,160,0,690
78881,200,140,200,80,160,320,1100
78882,200,100,160,160,160,0,780
78883,190,140,40,0,0,0,370
78884,200,160,120,80,160,320,1040
78885,170,100,120,160,160,320,1030
78886,210,180,80,80,0,0,550
78887,190,180,200,80,160,0,810
78888,190,80,80,80,160,0,590
78889,200,140,80,80,0,0,500
78890,160,100,80,80,0,0,420
78891,190,120,120,160,0,0,590
78892,190,100,120,0,0,0,410
78893,170,60,40,80,0,0,350
78894,220,60,40,80,0,0,400
78895,180,80,80,0,0,0,340
78896,180,140,120,160,160,0,760
78897,140,100,120,80,0,0,440
78898,210,120,120,160,320,0,930
78899,180,140,120,80,0,0,520
78900,190,160,120,160,160,0,790
78901,180,140,40,80,160,0,600
78902,190,160,120,80,0,0,550
78903,220,120,160,160,160,0,820
78904,180,120,80,80,0,0,460
78905,190,140,160,80,160,0,730
78906,210,140,80,160,0,0,590
78907,190,80,120,0,0,0,390
78908,230,120,80,160,0,0,590
78909,170,120,120,160,160,0,730
78910,200,60,80,80,0,0,420
78911,200,80,40,0,0,0,320
78912,220,160,120,160,320,320,1300
78913,180,100,120,80,0,0,480
78914,190,140,160,240,320,320,1370
78915,200,120,160,160,160,0,800
78916,190,140,80,160,160,0,730
78917,180,140,80,0,0,0,400
78918,170,80,120,160,160,320,1010
78919,200,140,80,160,320,0,900
78920,200,100,120,0,0,0,420
78921,200,140,80,80,0,0,500
78922,170,60,120,80,0,0,430
78923,240,80,120,80,160,0,680
78924,240,140,120,80,0,0,580
78925,180,100,120,80,0,0,480
78926,220,120,120,80,0,0,540
78927,260,140,120,80,0,0,600
78928,200,160,80,80,160,320,1000
78929,190,100,120,160,320,320,1210
78930,210,80,80,160,320,0,850
78931,190,120,120,160,160,0,750
78932,170,120,120,160,320,320,1210
78933,160,80,80,80,160,320,880
78934,190,100,80,80,0,0,450
78935,180,120,120,160,0,0,580
78936,170,140,40,80,160,0,590
78937,180,120,120,160,160,0,740
78938,190,200,160,160,0,0,710
78939,150,80,40,80,160,0,510
78940,220,120,80,80,0,0,500
78941,190,160,160,160,160,0,830
78942,210,80,120,80,160,0,650
78943,180,140,80,80,160,320,960
78944,200,140,160,80,160,0,740
78945,160,80,120,80,0,0,440
78946,180,120,160,80,160,0,700
78947,230,120,0,0,0,0,350
78948,190,160,200,160,320,0,1030
78949,200,140,120,160,0,0,620
78950,180,80,80,160,160,0,660
78951,200,140,80,0,0,0,420
78952,190,180,200,80,0,0,650
78953,180,100,120,80,160,320,960
78954,190,100,160,80,160,0,690
78955,200,160,120,80,0,0,560
78956,200,140,80,80,160,320,980
78957,230,100,120,160,160,0,770
78958,210,100,120,160,0,0,590
78959,200,120,160,160,320,0,960
78960,190,80,120,160,160,0,710
78961,210,180,160,80,160,0,790
78962,170,100,120,160,160,320,1030
78963,170,100,80,80,160,0,590
78964,210,120,120,160,320,0,930
78965,230,120,160,80,160,0,750
78966,190,120,160,240,0,0,710
78967,170,140,120,80,0,0,510
78968,170,100,40,80,0,0,390
78969,200,160,80,0,0,0,440
78970,190,80,80,80,160,320,910
78971,170,80,40,0,0,0,290
78972,220,160,120,0,0,0,500
78973,210,160,120,80,160,0,730
78974,210,160,160,160,160,0,850
78975,180,140,160,160,160,0,800
78976,170,80,40,0,0,0,290
78977,210,120,120,160,160,0,770
78978,250,100,80,80,160,0,670
78979,240,120,160,0,0,0,520
78980,190,120,80,80,160,0,630
78981,190,80,40,80,160,0,550
78982,220,120,40,0,0,0,380
78983,180,120,80,0,0,0,380
78984,140,80,40,80,160,0,500
78985,210,180,160,160,0,0,710
78986,170,100,40,0,0,0,310
78987,210,140,160,0,0,0,510
78988,180,140,120,160,160,0,760
78989,190,140,120,160,160,0,770
78990,210,80,80,0,0,0,370
78991,190,80,80,80,160,0,590
78992,230,140,200,240,160,0,970
78993,200,80,0,0,0,0,280
78994,170,80,80,160,160,0,650
78995,210,120,160,80,160,0,730
78996,190,100,200,80,160,0,730
78997,170,120,40,80,160,0,570
78998,200,100,80,80,0,0,460
78999,190,100,80,80,160,320,930
79000,160,140,160,0,0,0,460
79001,180,100,80,80,160,0,600
79002,230,100,80,80,160,0,650
79003,200,160,120,160,320,0,960
79004,180,120,160,160,160,0,780
79005,210,80,0,0,0,0,290
79006,190,140,80,160,160,0,730
79007,200,140,160,160,160,320,1140
79008,200,160,120,80,160,0,720
79009,240,140,200,160,320,0,1060
79010,200,120,80,0,0,0,400
79011,150,40,40,0,0,0,230
79012,180,120,120,80,160,0,660
79013,240,180,120,0,0,0,540
79014,190,140,120,80,0,0,530
79015,240,140,80,80,0,0,540
79016,170,120,80,0,0,0,370
79017,200,160,80,80,0,0,520
79018,250,160,80,80,0,0,570
79019,190,160,80,160,0,0,590
79020,210,140,80,160,160,0,750
79021,160,160,160,160,160,320,1120
79022,230,160,120,80,160,0,750
79023,140,80,40,80,160,0,500
79024,180,100,80,80,160,0,600
79025,190,160,80,160,320,0,910
79026,190,60,40,0,0,0,290
79027,230,160,40,80,160,0,670
79028,190,80,80,160,160,0,670
79029,260,120,120,240,160,0,900
79030,210,80,40,0,0,0,330
79031,200,140,80,80,0,0,500
79032,240,160,80,80,160,320,1040
79033,200,100,40,80,160,0,580
79034,220,160,120,160,160,0,820
79035,170,100,120,160,320,320,1190
79036,180,80,80,0,0,0,340
79037,170,120,120,160,320,0,890
79038,190,120,120,0,0,0,430
79039,200,100,80,160,320,320,1180
79040,170,160,160,160,160,0,810
79041,220,160,240,160,0,0,780
79042,220,180,40,80,0,0,520
79043,240,140,120,160,320,0,980
79044,250,100,120,0,0,0,470
79045,180,120,0,0,0,0,300
79046,220,100,80,0,0,0,400
79047,220,100,80,0,0,0,400
79048,220,160,160,160,0,0,700
79049,180,120,120,80,160,0,660
79050,220,180,160,160,160,0,880
79051,180,60,0,0,0,0,240
79052,140,120,200,240,160,0,860
79053,210,140,80,80,160,0,670
79054,210,180,160,80,160,0,790
79055,210,120,160,80,160,320,1050
79056,200,140,160,160,160,320,1140
79057,190,120,120,80,160,0,670
79058,190,140,80,80,0,0,490
79059,230,200,120,160,320,320,1350
79060,200,140,120,0,0,0,460
79061,190,120,160,80,160,0,710
79062,210,120,120,80,0,0,530
79063,170,100,80,80,160,0,590
79064,190,180,200,240,160,0,970
79065,180,140,80,0,0,0,400
79066,160,80,40,80,160,0,520
79067,180,100,80,0,0,0,360
79068,210,140,200,80,0,0,630
79069,210,140,120,160,160,0,790
79070,160,120,80,0,0,0,360
79071,190,120,120,80,160,320,990
79072,200,180,160,80,160,0,780
79073,200,160,160,80,160,0,760
79074,180,100,80,80,160,0,600
79075,200,160,120,80,160,0,720
79076,250,180,160,80,160,0,830
79077,200,120,120,80,0,0,520
79078,150,60,0,0,0,0,210
79079,190,100,80,80,160,0,610
79080,210,160,160,160,0,0,690
79081,150,80,80,0,0,0,310
79082,200,80,80,160,160,0,680
79083,150,100,160,0,0,0,410
79084,190,80,40,80,160,320,870
79085,210,60,0,0,0,0,270
79086,160,160,160,80,0,0,560
79087,260,160,120,240,320,0,1100
79088,260,200,120,160,160,0,900
79089,200,160,200,160,320,0,1040
79090,210,120,160,240,320,0,1050
79091,220,120,120,240,320,320,1340
79092,180,80,120,80,160,320,940
79093,180,100,80,160,160,0,680
79094,210,120,80,160,160,0,730
79095,160,120,80,80,0,0,440
79096,200,160,160,160,320,320,1320
79097,210,180,240,240,160,0,1030
79098,210,160,40,0,0,0,410
79099,190,140,120,160,0,0,610
79100,240,140,120,240,0,0,740
79101,170,120,120,80,160,0,650
79102,160,60,80,80,0,0,380
79103,150,120,0,0,0,0,270
79104,200,120,0,0,0,0,320
79105,180,140,200,160,320,0,1000
79106,170,100,120,240,320,0,950
79107,220,160,120,80,0,0,580
79108,220,180,120,80,160,0,760
79109,180,100,80,160,320,0,840
79110,200,160,200,160,160,0,880
79111,210,100,80,80,160,0,630
79112,140,140,120,80,160,0,640
79113,190,140,80,80,0,0,490
79114,220,120,120,160,160,0,780
79115,220,140,160,160,160,0,840
79116,170,100,80,160,0,0,510
79117,230,140,80,80,160,0,690
79118,180,140,120,240,320,320,1320
79119,180,100,120,80,160,0,640
79120,190,160,160,160,160,0,830
79121,200,120,200,80,0,0,600
79122,170,140,200,160,0,0,670
79123,200,120,40,0,0,0,360
79124,210,100,80,0,0,0,390
79125,220,160,80,80,0,0,540
79126,170,100,80,0,0,0,350
79127,190,120,40,80,160,0,590
79128,220,100,160,80,160,0,720
79129,180,20,40,80,0,0,320
79130,200,100,80,80,160,0,620
79131,200,140,120,160,160,0,780
79132,210,180,80,80,160,0,710
79133,180,120,80,0,0,0,380
79134,200,100,160,160,0,0,620
79135,210,120,120,80,0,0,530
79136,210,180,160,80,160,320,1110
79137,170,60,80,160,160,0,630
79138,220,140,120,80,0,0,560
79139,150,140,160,160,160,0,770
79140,210,140,160,80,0,0,590
79141,160,80,120,80,160,0,600
79142,150,120,120,0,0,0,390
79143,220,120,120,0,0,0,460
79144,230,100,120,0,0,0,450
79145,190,80,80,80,0,0,430
79146,180,160,120,160,320,0,940
79147,220,120,160,80,160,0,740
79148,220,140,80,80,160,0,680
79149,170,120,160,80,160,0,690
79150,220,80,80,80,160,0,620
79151,190,100,160,160,0,0,610
79152,170,100,120,160,160,0,710
79153,230,140,120,80,160,0,730
79154,180,140,80,0,0,0,400
79155,160,80,80,160,0,0,480
79156,170,120,80,0,0,0,370
79157,170,120,160,160,320,0,930
79158,230,160,160,160,160,0,870
79159,220,160,120,240,160,0,900
79160,180,120,160,160,160,0,780
79161,230,140,240,240,320,0,1170
79162,210,120,80,160,320,320,1210
79163,200,160,80,80,160,0,680
79164,180,140,160,240,320,320,1360
79165,180,100,120,240,160,0,800
79166,200,60,40,0,0,0,300
79167,170,140,240,160,160,0,870
79168,230,140,120,160,320,0,970
79169,170,120,80,160,320,0,850
79170,190,120,120,160,160,0,750
79171,240,140,80,80,0,0,540
79172,190,140,120,160,160,0,770
79173,170,140,120,160,320,0,910
79174,230,100,40,0,0,0,370
79175,190,100,80,80,0,0,450
79176,150,100,80,160,160,0,650
79177,210,80,120,0,0,0,410
79178,200,120,40,80,160,0,600
79179,180,180,160,80,0,0,600
79180,220,160,200,160,0,0,740
79181,260,120,80,80,0,0,540
79182,200,140,120,80,0,0,540
79183,180,100,80,80,160,0,600
79184,220,140,40,80,160,0,640
79185,160,100,80,80,160,0,580
79186,210,120,40,80,0,0,450
79187,170,140,120,80,0,0,510
79188,190,140,80,80,160,0,650
79189,180,140,160,80,0,0,560
79190,170,80,120,160,320,0,850
79191,210,120,120,160,0,0,610
79192,210,160,80,80,0,0,530
79193,210,140,80,80,160,0,670
79194,180,160,240,240,160,0,980
79195,220,160,200,240,160,320,1300
79196,200,140,120,80,0,0,540
79197,200,100,80,160,160,0,700
79198,180,120,120,0,0,0,420
79199,200,120,120,80,0,0,520
79200,210,100,120,240,160,0,830
79201,200,140,160,80,160,0,740
79202,170,60,80,0,0,0,310
79203,170,60,40,0,0,0,270
79204,170,160,120,80,160,0,690
79205,180,60,80,80,160,0,560
79206,190,140,160,0,0,0,490
79207,160,100,120,80,160,0,620
79208,190,140,120,80,160,0,690
79209,200,120,120,80,0,0,520
79210,220,120,160,240,320,0,1060
79211,180,80,120,80,160,0,620
79212,220,140,160,80,160,0,760
79213,190,140,120,80,0,0,530
79214,170,120,120,160,160,320,1050
79215,170,160,80,160,160,0,730
79216,180,160,80,80,0,0,500
79217,220,140,80,160,160,0,760
79218,220,140,120,80,0,0,560
79219,190,140,120,80,0,0,530
79220,260,140,80,0,0,0,480
79221,150,120,40,80,160,0,550
79222,190,100,80,80,0,0,450
79223,230,60,80,80,0,0,450
79224,230,140,120,0,0,0,490
79225,220,100,40,80,0,0,440
79226,190,100,80,80,0,0,450
79227,180,140,80,80,160,0,640
79228,210,140,200,0,0,0,550
79229,210,180,160,80,0,0,630
79230,230,160,120,160,0,0,670
79231,160,140,120,80,0,0,500
79232,230,180,120,80,160,0,770
79233,180,120,160,160,160,320,1100
79234,200,140,80,0,0,0,420
79235,220,100,0,0,0,0,320
79236,190,140,120,240,160,0,850
79237,200,180,80,80,0,0,540
79238,200,140,120,80,160,0,700
79239,150,80,80,80,0,0,390
79240,220,120,80,80,0,0,500
79241,180,140,160,160,160,0,800
79242,230,180,160,80,160,0,810
79243,200,140,40,80,0,0,460
79244,190,100,160,160,320,0,930
79245,170,120,160,80,0,0,530
79246,170,160,160,80,0,0,570
79247,200,100,120,80,160,0,660
79248,240,120,200,160,160,0,880
79249,230,120,120,160,160,0,790
79250,200,120,80,80,0,0,480
79251,160,80,40,0,0,0,280
79252,210,140,160,160,320,320,1310
79253,200,80,80,80,0,0,440
79254,200,120,40,0,0,0,360
79255,200,140,120,160,320,0,940
79256,240,80,120,80,160,320,1000
79257,210,140,120,80,160,0,710
79258,170,140,160,160,160,0,790
79259,210,80,80,80,0,0,450
79260,170,120,120,240,160,0,810
79261,210,120,80,160,160,0,730
79262,170,140,120,80,160,0,670
79263,230,180,120,160,0,0,690
79264,160,140,160,160,160,0,780
79265,200,100,80,80,160,320,940
79266,210,120,80,160,320,0,890
79267,210,80,80,80,160,0,610
79268,180,120,160,240,320,0,1020
79269,180,180,120,0,0,0,480
79270,190,80,80,80,0,0,430
79271,220,80,120,0,0,0,420
79272,200,160,120,0,0,0,480
79273,190,60,0,0,0,0,250
79274,210,80,80,160,320,0,850
79275,230,120,120,0,0,0,470
79276,240,140,120,0,0,0,500
79277,170,120,120,80,160,320,970
79278,220,160,200,80,160,320,1140
79279,200,40,40,0,0,0,280
79280,210,120,80,80,0,0,490
79281,210,140,160,160,0,0,670
79282,170,120,120,160,160,0,730
79283,200,80,80,0,0,0,360
79284,190,180,120,80,0,0,570
79285,210,120,200,160,160,0,850
79286,160,120,80,80,0,0,440
79287,200,100,40,80,160,320,900
79288,230,140,120,80,0,0,570
79289,160,160,160,240,160,0,880
79290,170,120,80,80,0,0,450
79291,210,120,0,0,0,0,330
79292,180,80,120,80,160,0,620
79293,200,160,80,0,0,0,440
79294,190,140,120,160,0,0,610
79295,210,100,80,0,0,0,390
79296,200,140,80,160,160,320,1060
79297,240,140,200,160,0,0,740
79298,210,140,120,80,160,0,710
79299,210,140,120,80,160,0,710
79300,180,120,160,160,0,0,620
79301,200,160,200,240,320,0,1120
79302,180,140,80,80,0,0,480
79303,250,140,120,80,160,320,1070
79304,220,140,80,80,160,320,1000
79305,190,100,80,80,160,320,930
79306,200,180,160,80,0,0,620
79307,220,80,80,0,0,0,380
79308,180,100,120,80,0,0,480
79309,210,120,200,160,160,0,850
79310,190,140,160,80,0,0,570
79311,190,80,120,0,0,0,390
79312,240,160,120,160,320,0,1000
79313,200,60,120,80,160,0,620
79314,210,140,80,80,160,0,670
79315,210,140,200,160,160,320,1190
79316,200,80,80,80,160,0,600
79317,180,80,80,0,0,0,340
79318,190,140,120,160,320,320,1250
79319,180,100,80,80,160,0,600
79320,210,140,120,0,0,0,470
79321,230,120,40,0,0,0,390
79322,190,160,120,160,320,320,1270
79323,150,100,120,80,0,0,450
79324,230,120,80,80,160,0,670
79325,210,140,160,80,0,0,590
79326,180,120,40,80,160,0,580
79327,190,140,40,80,160,0,610
79328,190,100,40,80,160,320,890
79329,220,100,120,80,160,0,680
79330,180,120,0,0,0,0,300
79331,190,80,80,160,320,320,1150
79332,240,120,160,240,320,320,1400
79333,170,140,120,80,160,320,990
79334,160,100,80,160,160,0,660
79335,260,100,120,160,160,0,800
79336,220,120,120,0,0,0,460
79337,220,100,40,80,0,0,440
79338,190,140,80,80,160,0,650
79339,150,100,120,160,320,0,850
79340,220,120,120,0,0,0,460
79341,170,120,160,80,0,0,530
79342,210,100,160,240,0,0,710
79343,190,200,200,80,160,0,830
79344,200,80,40,80,160,0,560
79345,210,100,120,160,160,0,750
79346,200,80,40,80,160,0,560
79347,200,80,80,80,160,0,600
79348,210,120,160,0,0,0,490
79349,180,140,80,80,160,0,640
79350,220,120,80,80,160,0,660
79351,200,100,40,0,0,0,340
79352,200,180,120,80,160,0,740
79353,240,100,40,0,0,0,380
79354,170,140,160,160,0,0,630
79355,220,120,120,160,0,0,620
79356,170,140,160,160,160,0,790
79357,220,140,160,160,160,320,1160
79358,190,140,160,160,0,0,650
79359,230,160,160,80,160,0,790
79360,230,80,80,0,0,0,390
79361,240,140,160,80,160,0,780
79362,230,140,80,160,160,0,770
79363,180,120,160,80,160,0,700
79364,200,60,40,0,0,0,300
79365,210,120,120,80,160,320,1010
79366,210,140,160,80,160,0,750
79367,180,120,80,0,0,0,380
79368,220,140,120,240,320,320,1360
79369,170,180,120,0,0,0,470
79370,170,100,80,160,160,0,670
79371,250,180,160,80,160,0,830
79372,190,100,120,240,320,320,1290
79373,190,80,80,0,0,0,350
79374,170,160,80,80,160,0,650
79375,190,100,120,80,160,0,650
79376,220,160,120,160,160,0,820
79377,190,140,120,80,160,320,1010
79378,210,120,160,80,0,0,570
79379,210,100,80,80,160,0,630
79380,160,160,80,80,160,0,640
79381,180,80,120,80,160,0,620
79382,200,120,120,240,320,320,1320
79383,190,140,160,160,0,0,650
79384,180,140,120,80,160,0,680
79385,190,120,40,80,160,0,590
79386,210,140,0,0,0,0,350
79387,190,140,120,80,0,0,530
79388,230,120,80,0,0,0,430
79389,210,120,160,160,0,0,650
79390,200,120,40,0,0,0,360
79391,200,120,120,80,160,320,1000
79392,200,160,80,160,0,0,600
79393,160,120,120,80,160,0,640
79394,180,80,80,80,160,320,900
79395,200,140,120,160,320,0,940
79396,160,120,160,80,160,0,680
79397,190,100,120,80,160,0,650
79398,180,140,120,240,160,320,1160
79399,180,100,80,0,0,0,360
79400,210,120,80,80,160,0,650
79401,190,120,120,160,320,320,1230
79402,160,60,40,80,160,0,500
79403,200,100,160,160,160,0,780
79404,220,80,80,80,160,0,620
79405,190,80,80,0,0,0,350
79406,180,80,80,80,0,0,420
79407,180,140,80,0,0,0,400
79408,210,100,80,80,0,0,470
79409,150,120,200,80,0,0,550
79410,160,80,40,80,160,0,520
79411,200,60,40,80,160,0,540
79412,210,100,120,160,320,0,910
79413,180,140,120,160,160,0,760
79414,250,180,200,160,160,0,950
79415,180,140,240,160,160,320,1200
79416,200,120,160,160,0,0,640
79417,170,100,120,80,160,0,630
79418,190,100,120,160,160,0,730
79419,230,120,120,0,0,0,470
79420,200,80,120,80,0,0,480
79421,220,80,80,80,160,0,620
79422,170,100,0,0,0,0,270
79423,200,60,80,80,0,0,420
79424,190,120,120,160,160,0,750
79425,240,140,120,160,160,320,1140
79426,170,80,80,80,160,0,570
79427,220,180,120,160,160,320,1160
79428,190,160,240,80,160,0,830
79429,210,220,120,240,0,0,790
79430,190,160,120,160,0,0,630
79431,220,80,80,0,0,0,380
79432,170,120,160,80,160,320,1010
79433,240,80,40,0,0,0,360
79434,180,120,80,0,0,0,380
79435,190,140,120,160,160,0,770
79436,190,120,80,80,0,0,470
79437,180,140,120,160,0,0,600
79438,220,140,120,0,0,0,480
79439,210,200,120,160,320,320,1330
79440,210,140,120,160,160,320,1110
79441,230,100,160,160,160,0,810
79442,170,80,120,80,0,0,450
79443,180,160,120,160,320,0,940
79444,240,180,200,160,320,0,1100
79445,190,140,200,160,320,320,1330
79446,210,200,200,240,160,0,1010
79447,170,140,160,80,0,0,550
79448,190,60,80,80,0,0,410
79449,180,180,200,0,0,0,560
79450,140,100,40,0,0,0,280
79451,190,100,80,80,160,0,610
79452,180,180,160,240,320,320,1400
79453,190,60,120,160,320,0,850
79454,200,120,160,240,160,320,1200
79455,230,140,80,80,160,0,690
79456,210,80,40,80,160,0,570
79457,150,80,120,80,160,320,910
79458,200,160,80,80,0,0,520
79459,220,120,40,80,0,0,460
79460,180,120,120,160,160,320,1060
79461,210,120,240,80,160,0,810
79462,220,120,160,80,0,0,580
79463,220,120,80,0,0,0,420
79464,200,200,120,0,0,0,520
79465,180,140,120,0,0,0,440
79466,190,80,40,0,0,0,310
79467,230,200,120,160,0,0,710
79468,250,180,200,160,160,0,950
79469,200,120,120,80,160,0,680
79470,180,120,80,160,160,320,1020
79471,180,100,120,80,160,0,640
79472,170,120,160,160,0,0,610
79473,190,120,120,80,160,320,990
79474,190,80,80,80,0,0,430
79475,230,180,160,160,160,0,890
79476,190,100,120,160,0,0,570
79477,230,140,80,0,0,0,450
79478,150,80,160,80,160,320,950
79479,180,100,0,0,0,0,280
79480,190,120,80,0,0,0,390
79481,200,140,80,80,160,0,660
79482,170,100,160,240,160,0,830
79483,230,100,120,240,320,320,1330
79484,180,120,160,160,160,0,780
79485,170,120,120,80,160,320,970
79486,150,100,80,160,160,0,650
79487,230,140,80,160,160,320,1090
79488,180,100,120,160,0,0,560
79489,190,140,120,160,160,0,770
79490,230,160,160,160,320,0,1030
79491,210,140,160,80,160,320,1070
79492,190,100,120,80,160,0,650
79493,170,140,80,160,160,320,1030
79494,190,140,160,160,160,0,810
79495,230,80,0,0,0,0,310
79496,200,160,80,80,160,0,680
79497,210,140,160,80,160,0,750
79498,220,160,80,80,160,0,700
79499,200,140,120,80,0,0,540
79500,220,140,120,160,320,320,1280
79501,250,140,80,80,0,0,550
79502,190,100,40,80,160,0,570
79503,160,40,0,0,0,0,200
79504,200,120,120,80,160,0,680
79505,190,100,120,80,160,320,970
79506,180,120,160,80,160,320,1020
79507,220,120,40,80,0,0,460
79508,200,140,80,80,160,0,660
79509,200,120,80,160,0,0,560
79510,200,80,40,80,160,0,560
79511,190,100,120,80,0,0,490
79512,190,100,160,160,160,0,770
79513,180,140,80,160,320,0,880
79514,210,140,120,80,0,0,550
79515,210,100,80,80,0,0,470
79516,210,80,80,80,0,0,450
79517,180,140,160,160,160,0,800
79518,190,120,120,80,160,320,990
79519,200,140,120,80,160,0,700
79520,210,120,80,80,160,0,650
79521,220,180,160,160,160,320,1200
79522,200,120,80,80,160,320,960
79523,190,100,120,0,0,0,410
79524,170,120,120,160,160,0,730
79525,190,100,120,80,160,0,650
79526,220,140,160,80,0,0,600
79527,190,80,80,0,0,0,350
79528,180,100,120,160,160,0,720
79529,200,160,80,80,160,0,680
79530,170,140,120,80,160,0,670
79531,220,180,120,80,160,0,760
79532,200,180,80,0,0,0,460
79533,200,100,80,0,0,0,380
79534,220,80,120,80,0,0,500
79535,180,100,120,160,160,0,720
79536,240,200,120,160,320,0,1040
79537,200,180,200,160,320,320,1380
79538,180,140,120,160,160,0,760
79539,220,100,0,0,0,0,320
79540,180,80,40,0,0,0,300
79541,230,120,120,160,160,0,790
79542,170,140,240,160,320,320,1350
79543,220,120,80,80,0,0,500
79544,200,80,40,0,0,0,320
79545,220,160,200,80,0,0,660
79546,160,60,80,160,320,320,1100
79547,240,120,0,0,0,0,360
79548,180,100,80,80,160,0,600
79549,220,160,160,160,0,0,700
79550,230,140,160,160,0,0,690
79551,180,160,120,160,0,0,620
79552,170,60,80,80,0,0,390
79553,220,120,160,160,160,320,1140
79554,180,140,120,80,160,0,680
79555,170,140,200,160,160,0,830
79556,190,180,160,240,320,0,1090
79557,170,100,80,80,0,0,430
79558,210,80,160,240,320,0,1010
79559,180,160,0,0,0,0,340
79560,240,100,80,0,0,0,420
79561,190,80,80,80,160,0,590
79562,130,120,120,80,160,0,610
79563,200,140,120,80,0,0,540
79564,170,100,120,160,0,0,550
79565,160,120,120,80,160,0,640
79566,190,100,80,80,160,320,930
79567,230,80,40,0,0,0,350
79568,190,140,160,80,0,0,570
79569,210,140,120,80,0,0,550
79570,160,120,120,160,160,0,720
79571,180,120,80,80,0,0,460
79572,170,120,40,80,0,0,410
79573,200,140,120,160,320,0,940
79574,200,140,120,80,0,0,540
79575,180,100,120,80,160,320,960
79576,210,140,120,80,0,0,550
79577,230,160,80,80,160,0,710
79578,190,180,200,160,160,0,890
79579,170,100,80,160,160,0,670
79580,190,120,160,160,160,0,790
79581,210,160,80,80,0,0,530
79582,190,100,80,80,0,0,450
79583,170,20,40,80,160,0,470
79584,250,180,240,240,320,0,1230
79585,210,160,120,80,0,0,570
79586,210,80,40,80,160,0,570
79587,210,120,80,0,0,0,410
79588,190,160,120,80,160,320,1030
79589,180,140,120,80,0,0,520
79590,220,100,80,80,160,320,960
79591,190,140,160,160,160,0,810
79592,210,160,120,240,160,0,890
79593,190,140,120,160,0,0,610
79594,210,100,120,160,160,0,750
79595,170,140,40,80,0,0,430
79596,190,80,80,80,160,320,910
79597,170,140,80,160,320,0,870
79598,200,120,80,0,0,0,400
79599,180,100,80,80,160,0,600
79600,190,120,120,160,0,0,590
79601,190,120,160,240,160,0,870
79602,200,140,40,0,0,0,380
79603,210,120,80,0,0,0,410
79604,230,80,120,80,0,0,510
79605,180,180,120,160,160,0,800
79606,170,120,120,80,0,0,490
79607,200,140,40,80,160,320,940
79608,230,180,160,80,0,0,650
79609,220,160,120,160,160,0,820
79610,220,120,80,80,0,0,500
79611,210,140,120,80,0,0,550
79612,180,100,80,160,320,0,840
79613,200,120,160,240,320,0,1040
79614,160,140,80,80,0,0,460
79615,160,40,40,80,160,0,480
79616,220,120,80,0,0,0,420
79617,180,140,160,80,160,0,720
79618,210,100,120,80,160,0,670
79619,200,140,120,80,160,320,1020
79620,180,80,80,0,0,0,340
79621,220,160,80,80,0,0,540
79622,180,80,120,80,160,0,620
79623,210,180,40,80,160,0,670
79624,210,200,120,80,0,0,610
79625,190,160,80,0,0,0,430
79626,190,60,120,80,160,0,610
79627,170,180,80,80,160,0,670
79628,180,100,120,160,160,0,720
79629,210,140,200,240,320,0,1110
79630,230,180,160,160,320,0,1050
79631,190,160,120,160,320,0,950
79632,200,140,80,80,160,0,660
79633,200,120,160,0,0,0,480
79634,160,140,120,80,0,0,500
79635,180,120,120,80,0,0,500
79636,190,120,120,160,320,0,910
79637,190,120,200,160,320,320,1310
79638,220,120,40,0,0,0,380
79639,170,60,40,0,0,0,270
79640,160,60,80,80,0,0,380
79641,180,120,120,160,160,0,740
79642,210,40,0,0,0,0,250
79643,200,140,80,0,0,0,420
79644,200,120,120,160,160,0,760
79645,230,120,80,160,160,0,750
79646,180,140,240,240,320,0,1120
79647,210,160,160,160,160,0,850
79648,180,120,160,160,160,0,780
79649,190,160,80,160,320,0,910
79650,190,120,40,0,0,0,350
79651,190,140,80,0,0,0,410
79652,230,160,40,0,0,0,430
79653,200,100,80,80,0,0,460
79654,210,120,160,80,160,0,730
79655,210,120,80,80,160,0,650
79656,170,100,120,0,0,0,390
79657,220,100,0,0,0,0,320
79658,190,140,120,160,160,0,770
79659,170,100,40,80,160,0,550
79660,200,120,120,160,320,0,920
79661,200,140,40,0,0,0,380
79662,150,80,0,0,0,0,230
79663,230,140,80,80,0,0,530
79664,210,160,120,160,160,0,810
79665,170,80,80,80,160,0,570
79666,210,100,160,160,160,0,790
79667,160,140,120,80,160,0,660
79668,190,100,120,160,320,0,890
79669,200,140,160,160,160,320,1140
79670,180,120,80,80,0,0,460
79671,200,140,120,160,320,320,1260
79672,200,80,40,80,0,0,400
79673,190,80,120,80,0,0,470
79674,210,140,120,80,0,0,550
79675,200,100,80,80,0,0,460
79676,190,100,120,0,0,0,410
79677,190,140,160,160,160,0,810
79678,200,160,80,0,0,0,440
79679,210,100,40,80,160,320,910
79680,190,140,200,80,160,0,770
79681,160,120,120,0,0,0,400
79682,200,200,200,160,320,0,1080
79683,210,180,160,80,160,0,790
79684,160,120,160,160,160,0,760
79685,210,120,40,80,160,0,610
79686,200,100,120,80,160,0,660
79687,140,80,120,240,320,0,900
79688,210,60,120,80,160,0,630
79689,190,100,40,80,160,0,570
79690,210,100,160,160,320,320,1270
79691,220,160,200,80,160,0,820
79692,200,120,40,80,0,0,440
79693,160,100,120,80,160,0,620
79694,170,100,80,80,160,320,910
79695,210,100,120,160,160,0,750
79696,220,160,200,80,0,0,660
79697,230,80,40,0,0,0,350
79698,190,140,120,160,160,0,770
79699,220,160,120,160,320,0,980
79700,210,60,80,80,0,0,430
79701,170,120,40,80,160,320,890
79702,190,160,200,240,160,320,1270
79703,180,140,120,80,160,0,680
79704,220,140,160,160,160,0,840
79705,180,120,40,0,0,0,340
79706,200,120,80,80,160,0,640
79707,180,100,40,0,0,0,320
79708,210,100,120,80,160,0,670
79709,240,120,120,80,160,0,720
79710,190,120,120,160,160,0,750
79711,180,100,120,80,0,0,480
79712,170,120,160,80,160,0,690
79713,190,60,40,80,0,0,370
79714,230,140,120,160,320,0,970
79715,200,160,80,80,160,0,680
79716,220,100,80,80,0,0,480
79717,170,120,160,160,160,320,1090
79718,210,120,80,80,160,0,650
79719,210,140,120,80,160,320,1030
79720,220,140,80,0,0,0,440
79721,180,160,160,160,160,0,820
79722,190,80,80,80,160,320,910
79723,210,200,200,80,0,0,690
79724,170,100,80,80,0,0,430
79725,180,100,40,80,160,320,880
79726,220,100,120,80,160,0,680
79727,190,140,120,160,160,320,1090
79728,190,180,120,160,160,320,1130
79729,190,80,80,80,160,0,590
79730,200,140,160,240,320,0,1060
79731,210,140,80,0,0,0,430
79732,170,180,120,160,320,320,1270
79733,210,100,80,80,160,320,950
79734,170,120,120,160,320,0,890
79735,170,100,80,0,0,0,350
79736,170,80,40,80,160,0,530
79737,170,120,120,160,160,0,730
79738,210,100,40,0,0,0,350
79739,210,80,80,80,0,0,450
79740,200,120,40,0,0,0,360
79741,200,140,120,80,0,0,540
79742,190,100,120,160,160,0,730
79743,210,140,200,240,160,0,950
79744,200,140,120,80,0,0,540
79745,190,60,80,160,160,0,650
79746,190,160,120,160,320,0,950
79747,190,140,120,160,160,0,770
79748,200,160,120,0,0,0,480
79749,220,120,160,80,160,0,740
79750,200,140,80,0,0,0,420
79751,230,140,120,160,320,0,970
79752,250,180,160,160,160,0,910
79753,200,80,40,0,0,0,320
79754,200,120,80,80,160,320,960
79755,190,160,120,80,160,0,710
79756,210,100,80,160,160,0,710
79757,180,120,160,160,320,0,940
79758,210,100,120,160,320,0,910
79759,210,140,120,80,160,0,710
79760,210,180,120,160,160,0,830
79761,220,140,160,160,160,0,840
79762,180,100,120,160,320,0,880
79763,210,140,120,160,320,0,950
79764,210,120,120,160,160,0,770
79765,230,100,40,0,0,0,370
79766,230,140,160,80,0,0,610
79767,230,200,120,160,160,320,1190
79768,200,160,120,80,160,0,720
79769,170,140,80,80,160,0,630
79770,170,140,120,160,320,0,910
79771,250,200,160,80,0,0,690
79772,180,20,0,0,0,0,200
79773,200,60,80,160,320,320,1140
79774,160,60,80,80,160,0,540
79775,220,80,80,160,160,0,700
79776,220,100,160,160,160,0,800
79777,200,120,120,80,160,0,680
79778,200,120,40,0,0,0,360
79779,200,100,80,80,0,0,460
79780,180,100,120,0,0,0,400
79781,220,120,120,80,0,0,540
79782,190,120,120,160,160,320,1070
79783,190,100,80,80,160,0,610
79784,170,160,200,160,320,320,1330
79785,190,160,120,0,0,0,470
79786,190,180,200,160,160,0,890
79787,180,80,160,160,160,0,740
79788,190,120,80,80,160,0,630
79789,180,120,80,80,0,0,460
79790,200,120,80,80,160,0,640
79791,220,180,120,160,0,0,680
79792,200,120,120,160,320,320,1240
79793,170,80,40,0,0,0,290
79794,180,180,80,80,0,0,520
79795,200,160,0,0,0,0,360
79796,170,140,80,80,160,320,950
79797,180,100,160,240,160,0,840
79798,210,160,160,160,160,0,850
79799,230,140,80,160,160,0,770
79800,230,120,80,160,320,0,910
79801,170,100,80,0,0,0,350
79802,210,120,80,80,0,0,490
79803,250,100,0,0,0,0,350
79804,210,120,80,80,0,0,490
79805,150,160,160,160,160,320,1110
79806,200,120,120,80,0,0,520
79807,200,100,40,0,0,0,340
79808,240,160,160,160,320,0,1040
79809,150,100,120,160,160,0,690
79810,210,120,80,80,0,0,490
79811,150,100,80,80,160,0,570
79812,230,180,200,240,0,0,850
79813,150,60,80,80,0,0,370
79814,190,140,160,160,160,0,810
79815,220,100,120,80,0,0,520
79816,150,120,80,0,0,0,350
79817,170,100,80,160,160,320,990
79818,190,120,120,160,320,0,910
79819,230,120,120,160,160,0,790
79820,180,180,160,80,0,0,600
79821,220,140,80,0,0,0,440
79822,240,160,160,160,160,320,1200
79823,220,100,40,80,160,0,600
79824,170,140,160,0,0,0,470
79825,180,140,120,160,0,0,600
79826,230,120,160,240,160,0,910
79827,230,120,80,80,0,0,510
79828,150,80,80,0,0,0,310
79829,230,160,80,80,0,0,550
79830,150,100,160,160,160,0,730
79831,170,80,40,80,160,0,530
79832,230,200,160,160,160,0,910
79833,230,160,80,160,0,0,630
79834,230,160,80,80,0,0,550
79835,210,80,40,80,0,0,410
79836,200,120,160,80,160,0,720
79837,220,60,120,80,0,0,480
79838,240,160,120,80,160,0,760
79839,210,140,120,160,160,0,790
79840,210,160,80,80,160,0,690
79841,190,180,200,80,0,0,650
79842,190,80,120,160,160,0,710
79843,210,180,160,0,0,0,550
79844,200,120,120,80,160,0,680
79845,190,120,120,240,160,0,830
79846,200,140,160,160,160,0,820
79847,180,100,40,80,160,0,560
79848,180,180,200,160,160,0,880
79849,180,20,40,80,160,0,480
79850,200,140,120,80,160,320,1020
79851,230,120,80,80,160,0,670
79852,150,120,40,80,0,0,390
79853,150,80,80,80,160,320,870
79854,190,140,120,0,0,0,450
79855,180,180,160,80,160,0,760
79856,160,60,80,0,0,0,300
79857,190,100,160,0,0,0,450
79858,210,180,160,160,160,0,870
79859,210,100,40,80,0,0,430
79860,190,140,80,80,160,0,650
79861,200,160,200,160,160,0,880
79862,210,100,160,160,320,0,950
79863,190,100,120,240,160,0,810
79864,240,180,80,80,160,0,740
79865,220,80,80,0,0,0,380
79866,150,120,120,240,160,0,790
79867,220,140,40,80,0,0,480
79868,220,120,80,0,0,0,420
79869,160,60,40,0,0,0,260
79870,180,80,120,160,160,0,700
79871,240,180,80,160,320,320,1300
79872,170,140,120,240,0,0,670
79873,240,100,80,80,160,320,980
79874,210,120,80,80,160,0,650
79875,210,80,80,160,320,320,1170
79876,200,100,80,80,160,320,940
79877,210,160,120,160,0,0,650
79878,190,100,80,80,160,0,610
79879,180,140,120,80,160,0,680
79880,230,180,120,160,160,0,850
79881,150,100,120,80,160,0,610
79882,170,120,40,0,0,0,330
79883,250,120,40,0,0,0,410
79884,190,100,120,160,320,0,890
79885,180,160,160,0,0,0,500
79886,180,140,120,80,0,0,520
79887,210,100,40,80,160,0,590
79888,190,120,80,160,160,0,710
79889,200,160,120,160,160,0,800
79890,200,120,120,80,160,0,680
79891,200,120,80,80,160,0,640
79892,200,140,160,160,320,0,980
79893,190,120,120,80,0,0,510
79894,190,140,160,80,0,0,570
79895,190,120,80,160,320,320,1190
79896,250,140,0,0,0,0,390
79897,200,120,40,80,160,0,600
79898,230,140,160,160,160,0,850
79899,170,140,120,160,160,320,1070
79900,210,140,120,80,0,0,550
79901,200,140,80,80,160,0,660
79902,200,140,160,240,320,0,1060
79903,220,140,160,240,160,320,1240
79904,170,160,80,0,0,0,410
79905,210,140,160,160,160,0,830
79906,190,160,80,0,0,0,430
79907,200,120,40,80,160,0,600
79908,200,180,120,160,160,320,1140
79909,220,100,120,0,0,0,440
79910,160,100,120,80,160,0,620
79911,210,120,120,240,160,320,1170
79912,200,100,80,80,160,0,620
79913,230,120,120,160,320,0,950
79914,210,140,120,80,160,0,710
79915,190,140,120,80,160,0,690
79916,210,80,120,160,160,0,730
79917,170,120,120,80,160,320,970
79918,190,160,80,80,160,0,670
79919,220,100,80,160,160,0,720
79920,170,140,0,0,0,0,310
79921,180,160,120,160,0,0,620
79922,230,140,120,0,0,0,490
79923,250,160,80,160,160,0,810
79924,250,100,80,80,160,0,670
79925,220,40,80,80,160,0,580
79926,160,80,80,80,160,0,560
79927,220,200,120,80,0,0,620
79928,180,200,80,0,0,0,460
79929,190,100,40,0,0,0,330
79930,190,100,160,240,160,0,850
79931,190,100,80,160,160,0,690
79932,190,160,120,160,320,320,1270
79933,180,100,120,80,160,320,960
79934,220,120,120,80,160,0,700
79935,180,80,80,80,160,0,580
79936,150,100,80,80,160,320,890
79937,190,100,80,0,0,0,370
79938,200,120,120,80,160,0,680
79939,200,140,120,160,0,0,620
79940,170,140,40,80,160,320,910
79941,190,100,160,80,160,0,690
79942,240,160,120,0,0,0,520
79943,200,120,120,240,160,0,840
79944,170,100,120,80,0,0,470
79945,210,160,120,160,160,320,1130
79946,210,120,120,240,320,0,1010
79947,170,80,80,160,160,0,650
79948,170,120,80,80,160,0,610
79949,170,40,40,80,160,0,490
79950,200,120,160,160,160,0,800
79951,210,100,120,80,160,0,670
79952,190,100,40,0,0,0,330
79953,170,120,120,240,160,0,810
79954,250,140,160,160,160,0,870
79955,190,140,80,80,0,0,490
79956,180,120,80,80,160,0,620
79957,190,180,40,80,160,320,970
79958,160,80,80,80,160,0,560
79959,200,100,80,80,0,0,460
79960,190,100,160,160,160,0,770
79961,200,100,120,80,160,0,660
79962,220,80,80,80,0,0,460
79963,240,120,120,240,160,0,880
79964,190,140,160,160,160,0,810
79965,200,120,40,80,160,0,600
79966,230,180,40,0,0,0,450
79967,180,120,160,160,160,0,780
79968,180,120,160,0,0,0,460
79969,150,120,120,160,160,0,710
79970,200,80,0,0,0,0,280
79971,200,180,120,240,160,0,900
79972,210,160,200,0,0,0,570
79973,230,80,40,80,160,0,590
79974,210,100,80,80,0,0,470
79975,220,140,40,80,160,0,640
79976,170,100,80,80,160,0,590
79977,220,120,80,80,160,320,980
79978,180,100,80,80,0,0,440
79979,200,120,80,160,320,0,880
79980,220,140,160,80,160,0,760
79981,160,140,160,160,160,320,1100
79982,200,120,120,160,160,320,1080
79983,200,120,80,160,160,0,720
79984,170,100,80,160,320,320,1150
79985,200,140,160,160,160,0,820
79986,200,120,40,80,160,320,920
79987,190,80,40,80,160,0,550
79988,140,120,120,160,160,0,700
79989,240,140,200,160,320,320,1380
79990,210,140,120,160,160,0,790
79991,150,120,120,160,160,0,710
79992,230,160,160,80,160,0,790
79993,200,120,40,80,0,0,440
79994,220,160,120,160,320,0,980
79995,230,160,160,160,160,0,870
79996,160,60,120,80,160,0,580
79997,220,180,160,160,160,320,1200
79998,190,80,40,0,0,0,310
79999,200,140,200,240,160,320,1260
80000,190,60,80,160,320,0,810
80001,180,100,160,80,160,0,680
80002,210,160,160,160,320,0,1010
80003,150,60,80,80,160,320,850
80004,230,140,120,80,0,0,570
80005,190,80,120,240,320,320,1270
80006,200,160,160,240,320,320,1400
80007,190,160,120,80,160,320,1030
80008,190,140,120,80,160,0,690
80009,170,100,120,160,160,0,710
80010,230,120,120,80,160,0,710
80011,230,160,160,160,320,0,1030
80012,150,160,160,80,0,0,550
80013,160,80,80,80,160,0,560
80014,190,80,80,80,160,0,590
80015,190,120,120,0,0,0,430
80016,200,120,0,0,0,0,320
80017,200,140,120,80,160,0,700
80018,170,80,120,80,160,0,610
80019,200,120,120,160,160,0,760
80020,230,160,120,160,0,0,670
80021,210,100,120,160,320,320,1230
80022,180,80,120,160,160,0,700
80023,210,160,120,80,0,0,570
80024,200,60,80,80,0,0,420
80025,210,100,160,80,0,0,550
80026,180,120,80,80,0,0,460
80027,200,100,40,0,0,0,340
80028,220,140,120,80,160,0,720
80029,240,100,120,0,0,0,460
80030,190,60,120,80,0,0,450
80031,220,100,80,80,160,0,640
80032,200,160,40,80,0,0,480
80033,180,160,80,80,160,0,660
80034,200,200,160,80,160,0,800
80035,170,100,40,80,160,0,550
80036,190,120,120,80,0,0,510
80037,190,60,40,80,160,0,530
80038,210,100,120,160,160,0,750
80039,170,80,120,160,320,320,1170
80040,190,120,80,0,0,0,390
80041,220,120,40,80,0,0,460
80042,200,120,80,160,160,320,1040
80043,210,120,80,80,160,0,650
80044,210,140,160,80,160,320,1070
80045,170,120,160,240,320,320,1330
80046,220,100,80,0,0,0,400
80047,230,140,80,0,0,0,450
80048,190,60,40,0,0,0,290
80049,230,100,80,0,0,0,410
80050,220,140,160,80,160,320,1080
80051,170,160,160,80,160,320,1050
80052,190,160,200,80,0,0,630
80053,200,120,0,0,0,0,320
80054,200,120,120,160,160,320,1080
80055,160,120,120,80,0,0,480
80056,220,160,120,80,160,0,740
80057,190,100,120,80,160,0,650
80058,230,140,160,160,160,0,850
80059,190,140,80,80,160,0,650
80060,160,120,160,160,320,0,920
80061,210,140,160,80,160,0,750
80062,160,120,40,80,160,0,560
80063,170,140,120,160,160,0,750
80064,200,140,120,160,160,0,780
80065,170,120,80,0,0,0,370
80066,190,120,160,240,160,0,870
80067,180,80,120,80,160,0,620
80068,200,140,120,160,160,0,780
80069,190,120,120,160,160,320,1070
80070,210,100,80,0,0,0,390
80071,210,120,80,80,0,0,490
80072,190,100,80,0,0,0,370
80073,200,120,120,160,320,0,920
80074,220,120,80,0,0,0,420
80075,190,60,120,160,160,0,690
80076,210,180,80,160,160,0,790
80077,220,140,160,80,160,320,1080
80078,200,80,40,80,0,0,400
80079,200,100,120,80,160,320,980
80080,230,160,120,80,0,0,590
80081,190,80,120,160,320,320,1190
80082,190,80,80,80,0,0,430
80083,180,100,160,160,0,0,600
80084,150,160,200,160,320,320,1310
80085,200,120,40,0,0,0,360
80086,210,160,160,80,0,0,610
80087,160,140,120,160,160,320,1060
80088,210,140,200,160,160,0,870
80089,220,160,120,160,320,0,980
80090,200,80,120,80,0,0,480
80091,210,140,120,0,0,0,470
80092,210,180,80,80,160,320,1030
80093,230,140,160,160,160,0,850
80094,220,200,160,160,320,0,1060
80095,210,120,160,160,0,0,650
80096,190,100,120,80,160,320,970
80097,250,140,120,80,160,0,750
80098,200,140,120,160,160,0,780
80099,230,160,200,240,160,0,990
80100,200,120,120,0,0,0,440
80101,180,80,120,80,0,0,460
80102,180,100,120,160,320,320,1200
80103,150,100,120,160,0,0,530
80104,200,120,120,160,160,320,1080
80105,170,100,80,160,0,0,510
80106,190,80,120,0,0,0,390
80107,180,140,80,80,0,0,480
80108,220,60,0,0,0,0,280
80109,210,140,120,160,0,0,630
80110,180,120,160,80,0,0,540
80111,200,100,80,0,0,0,380
80112,210,80,120,160,320,320,1210
80113,210,100,40,0,0,0,350
80114,240,80,40,0,0,0,360
80115,240,140,40,0,0,0,420
80116,170,80,40,0,0,0,290
80117,180,100,160,80,160,0,680
80118,180,80,120,160,320,0,860
80119,200,120,120,240,320,0,1000
80120,180,100,120,160,160,0,720
80121,170,100,40,0,0,0,310
80122,190,140,80,0,0,0,410
80123,200,120,160,80,160,0,720
80124,210,120,80,80,160,0,650
80125,200,140,120,80,160,320,1020
80126,200,120,160,80,0,0,560
80127,180,80,40,80,0,0,380
80128,220,140,160,160,160,0,840
80129,200,100,40,0,0,0,340
80130,190,160,120,160,320,0,950
80131,200,100,120,160,160,0,740
80132,230,160,120,80,160,0,750
80133,150,140,120,80,160,0,650
80134,200,100,40,80,160,0,580
80135,190,140,80,0,0,0,410
80136,200,120,40,80,160,0,600
80137,190,100,80,80,160,0,610
80138,200,80,120,80,160,0,640
80139,190,140,160,160,160,0,810
80140,210,80,40,0,0,0,330
80141,190,140,80,0,0,0,410
80142,230,120,80,0,0,0,430
80143,190,160,120,0,0,0,470
80144,200,140,40,80,160,320,940
80145,230,140,160,80,160,0,770
80146,180,180,80,80,160,0,680
80147,190,100,200,80,0,0,570
80148,210,180,160,0,0,0,550
80149,200,80,0,0,0,0,280
80150,170,140,120,160,320,0,910
80151,210,160,120,160,320,0,970
80152,160,60,40,80,160,0,500
80153,180,200,80,0,0,0,460
80154,180,120,160,80,0,0,540
80155,180,80,40,0,0,0,300
80156,220,140,80,160,160,0,760
80157,230,140,80,80,0,0,530
80158,180,140,200,160,0,0,680
80159,150,60,80,160,160,0,610
80160,190,180,160,0,0,0,530
80161,210,140,120,80,160,0,710
80162,160,80,120,80,0,0,440
80163,190,160,120,160,160,0,790
80164,220,100,160,80,0,0,560
80165,210,160,40,0,0,0,410
80166,210,120,40,80,160,0,610
80167,220,120,80,0,0,0,420
80168,190,140,80,80,160,320,970
80169,220,100,120,160,160,0,760
80170,190,100,40,80,160,0,570
80171,220,120,120,80,160,0,700
80172,220,140,120,240,320,0,1040
80173,140,20,0,0,0,0,160
80174,230,100,80,80,160,320,970
80175,180,160,120,160,160,0,780
80176,170,120,160,240,160,0,850
80177,180,80,80,80,160,0,580
80178,170,100,80,80,160,0,590
80179,190,140,160,80,0,0,570
80180,190,120,80,80,160,0,630
80181,190,100,120,160,160,0,730
80182,220,140,120,160,160,0,800
80183,200,120,160,80,0,0,560
80184,170,160,160,160,0,0,650
80185,220,100,120,160,160,320,1080
80186,190,140,120,0,0,0,450
80187,170,40,80,160,160,0,610
80188,220,120,120,80,160,0,700
80189,180,160,120,240,160,0,860
80190,180,80,80,160,320,320,1140
80191,220,140,40,0,0,0,400
80192,220,100,160,80,0,0,560
80193,190,140,120,80,160,0,690
80194,200,120,160,160,320,320,1280
80195,220,140,120,160,320,320,1280
80196,130,80,0,0,0,0,210
80197,190,140,200,240,320,0,1090
80198,160,100,120,0,0,0,380
80199,210,80,80,80,160,0,610
80200,170,80,40,80,0,0,370
80201,160,80,80,0,0,0,320
80202,210,120,120,160,160,320,1090
80203,200,140,160,160,0,0,660
80204,220,140,120,160,0,0,640
80205,240,160,80,160,160,0,800
80206,150,120,80,80,160,0,590
80207,160,100,120,80,160,0,620
80208,200,160,160,80,0,0,600
80209,190,180,160,80,160,0,770
80210,220,140,120,160,0,0,640
80211,170,160,200,160,320,0,1010
80212,220,220,160,160,160,0,920
80213,200,200,200,160,0,0,760
80214,210,180,200,80,160,0,830
80215,180,140,120,160,160,0,760
80216,160,120,120,240,320,320,1280
80217,180,180,160,80,160,0,760
80218,150,100,80,80,160,320,890
80219,230,140,160,80,0,0,610
80220,190,80,120,160,160,320,1030
80221,230,160,160,160,0,0,710
80222,160,140,80,80,160,320,940
80223,220,180,120,80,0,0,600
80224,200,160,120,80,0,0,560
80225,160,120,120,160,160,0,720
80226,250,80,40,0,0,0,370
80227,190,80,80,0,0,0,350
80228,190,140,120,160,160,0,770
80229,180,100,80,80,160,320,920
80230,160,80,40,0,0,0,280
80231,170,120,80,0,0,0,370
80232,220,120,80,80,160,0,660
80233,210,140,200,80,160,0,790
80234,160,160,160,80,0,0,560
80235,170,140,120,160,320,320,1230
80236,180,80,40,0,0,0,300
80237,210,100,80,0,0,0,390
80238,180,80,40,80,160,320,860
80239,200,120,80,80,160,0,640
80240,180,160,120,160,160,0,780
80241,170,120,80,80,0,0,450
80242,200,180,160,160,160,0,860
80243,220,120,120,80,160,0,700
80244,180,120,120,0,0,0,420
80245,230,140,120,160,160,0,810
80246,170,140,120,80,160,0,670
80247,210,200,120,0,0,0,530
80248,210,60,80,80,160,320,910
80249,180,120,80,80,160,0,620
80250,190,160,200,80,160,0,790
80251,260,140,160,80,0,0,640
80252,230,120,80,160,160,0,750
80253,160,160,120,80,160,0,680
80254,200,160,160,0,0,0,520
80255,180,120,200,160,160,320,1140
80256,220,140,160,160,320,320,1320
80257,190,120,80,0,0,0,390
80258,190,100,80,160,0,0,530
80259,210,120,80,0,0,0,410
80260,220,100,40,80,0,0,440
80261,210,120,120,0,0,0,450
80262,200,120,160,160,160,0,800
80263,190,120,200,80,160,0,750
80264,210,140,80,80,160,0,670
80265,230,140,40,80,0,0,490
80266,220,140,80,0,0,0,440
80267,200,140,120,80,160,320,1020
80268,180,140,80,80,160,0,640
80269,220,120,160,240,320,320,1380
80270,200,160,160,160,0,0,680
80271,220,120,80,80,160,320,980
80272,180,60,120,160,320,0,840
80273,190,140,160,160,160,320,1130
80274,210,100,80,160,160,0,710
80275,170,100,80,0,0,0,350
80276,210,100,80,80,160,0,630
80277,180,120,80,80,160,0,620
80278,210,140,200,240,0,0,790
80279,200,160,80,80,0,0,520
80280,200,160,120,160,160,0,800
80281,180,80,40,80,0,0,380
80282,200,120,40,80,0,0,440
80283,210,120,120,160,0,0,610
80284,210,140,160,160,160,0,830
80285,170,100,120,80,0,0,470
80286,190,140,80,80,0,0,490
80287,210,60,40,0,0,0,310
80288,200,100,120,160,160,0,740
80289,190,100,120,80,160,0,650
80290,210,160,80,0,0,0,450
80291,240,100,120,80,0,0,540
80292,220,80,80,80,160,0,620
80293,200,120,160,80,160,0,720
80294,210,140,80,80,160,0,670
80295,190,140,80,160,320,0,890
80296,170,60,80,0,0,0,310
80297,180,140,160,160,0,0,640
80298,190,180,120,160,160,0,810
80299,230,160,80,80,160,0,710
80300,150,60,0,0,0,0,210
80301,160,100,80,80,0,0,420
80302,190,100,120,240,320,0,970
80303,180,80,40,0,0,0,300
80304,180,100,80,80,160,0,600
80305,190,180,160,240,320,0,1090
80306,210,60,80,80,0,0,430
80307,220,120,80,80,160,0,660
80308,200,140,120,160,160,0,780
80309,200,80,80,80,0,0,440
80310,170,120,120,80,0,0,490
80311,180,100,40,0,0,0,320
80312,210,140,120,80,0,0,550
80313,180,160,160,80,160,320,1060
80314,220,80,0,0,0,0,300
80315,150,140,160,240,320,0,1010
80316,200,80,120,160,0,0,560
80317,180,60,0,0,0,0,240
80318,190,100,40,80,0,0,410
80319,190,80,120,80,160,0,630
80320,190,140,80,0,0,0,410
80321,180,80,80,80,0,0,420
80322,180,140,160,160,320,0,960
80323,180,40,40,0,0,0,260
80324,180,120,120,160,0,0,580
80325,200,80,40,80,0,0,400
80326,160,100,80,80,160,0,580
80327,200,120,120,0,0,0,440
80328,190,80,80,80,160,0,590
80329,210,80,80,80,160,0,610
80330,170,80,40,0,0,0,290
80331,200,120,40,80,0,0,440
80332,190,140,120,80,160,0,690
80333,200,80,120,0,0,0,400
80334,190,140,80,80,0,0,490
80335,220,160,120,240,0,0,740
80336,170,140,80,160,160,0,710
80337,210,100,40,0,0,0,350
80338,170,100,40,80,0,0,390
80339,180,120,120,160,320,0,900
80340,220,140,160,160,320,0,1000
80341,180,80,40,80,160,0,540
80342,180,140,80,80,160,0,640
80343,180,100,120,160,160,0,720
80344,190,100,120,80,0,0,490
80345,230,200,160,80,160,0,830
80346,190,180,80,80,160,320,1010
80347,170,100,120,80,0,0,470
80348,210,100,40,80,160,0,590
80349,150,60,80,80,160,0,530
80350,190,120,80,80,0,0,470
80351,190,180,0,0,0,0,370
80352,250,120,120,80,0,0,570
80353,190,100,80,160,160,320,1010
80354,200,180,80,80,0,0,540
80355,210,160,160,160,320,320,1330
80356,190,80,40,80,160,0,550
80357,210,180,120,80,0,0,590
80358,170,140,200,240,0,0,750
80359,140,100,120,80,0,0,440
80360,210,180,160,80,160,0,790
80361,170,180,160,160,320,0,990
80362,190,100,120,80,160,0,650
80363,250,80,80,0,0,0,410
80364,210,80,40,80,0,0,410
80365,220,100,0,0,0,0,320
80366,230,100,160,240,160,0,890
80367,190,180,160,80,160,0,770
80368,210,140,80,0,0,0,430
80369,210,100,80,160,320,0,870
80370,200,120,80,80,0,0,480
80371,220,140,40,80,0,0,480
80372,180,160,120,80,0,0,540
80373,170,100,160,80,0,0,510
80374,200,100,80,0,0,0,380
80375,210,180,80,80,0,0,550
80376,190,120,80,0,0,0,390
80377,180,120,120,160,160,0,740
80378,180,140,160,160,0,0,640
80379,190,160,120,80,160,0,710
80380,160,100,80,160,320,320,1140
80381,190,120,160,160,160,0,790
80382,170,140,80,80,160,0,630
80383,220,220,160,160,160,0,920
80384,210,140,120,80,0,0,550
80385,220,140,80,0,0,0,440
80386,230,120,120,0,0,0,470
80387,180,160,120,160,160,0,780
80388,240,140,160,80,160,0,780
80389,220,80,80,0,0,0,380
80390,190,80,160,160,0,0,590
80391,190,120,80,0,0,0,390
80392,160,120,80,80,160,0,600
80393,210,120,120,160,320,320,1250
80394,190,120,80,80,160,0,630
80395,200,180,120,80,160,320,1060
80396,170,60,80,80,160,0,550
80397,160,100,120,80,0,0,460
80398,200,100,120,80,160,0,660
80399,160,120,120,160,320,320,1200
80400,240,80,40,0,0,0,360
80401,230,180,120,80,0,0,610
80402,190,100,80,0,0,0,370
80403,180,120,120,240,320,320,1300
80404,190,160,120,160,320,0,950
80405,190,60,80,80,160,0,570
80406,210,100,80,80,0,0,470
80407,180,80,120,80,160,0,620
80408,220,120,120,80,0,0,540
80409,180,60,40,80,160,0,520
80410,210,100,120,160,0,0,590
80411,220,180,120,160,160,0,840
80412,190,120,120,80,160,0,670
80413,200,160,200,160,320,0,1040
80414,210,140,80,160,160,320,1070
80415,230,160,120,160,160,0,830
80416,210,220,200,160,320,320,1430
80417,190,140,80,80,0,0,490
80418,200,140,160,80,160,0,740
80419,260,120,80,80,160,0,700
80420,160,120,160,80,0,0,520
80421,190,120,80,160,0,0,550
80422,200,160,120,160,160,0,800
80423,160,120,0,0,0,0,280
80424,200,100,40,80,160,0,580
80425,200,160,160,80,160,0,760
80426,250,140,120,160,160,320,1150
80427,190,120,80,80,160,0,630
80428,230,120,200,160,160,0,870
80429,210,120,120,160,0,0,610
80430,210,120,120,80,0,0,530
80431,210,140,120,80,160,320,1030
80432,210,160,160,240,320,320,1410
80433,230,200,80,160,160,320,1150
80434,200,80,80,80,0,0,440
80435,220,140,80,160,160,0,760
80436,220,80,80,160,320,0,860
80437,190,100,120,80,160,0,650
80438,150,80,40,0,0,0,270
80439,210,100,80,0,0,0,390
80440,190,140,80,160,320,0,890
80441,200,100,120,80,160,0,660
80442,220,180,160,160,160,0,880
80443,210,120,40,0,0,0,370
80444,190,60,80,160,320,320,1130
80445,240,160,80,80,160,0,720
80446,170,100,80,80,0,0,430
80447,180,60,40,80,160,0,520
80448,230,160,120,240,320,0,1070
80449,220,120,80,80,0,0,500
80450,230,140,80,80,0,0,530
80451,140,100,80,0,0,0,320
80452,240,140,160,160,160,0,860
80453,190,120,120,0,0,0,430
80454,180,140,80,80,160,0,640
80455,190,120,80,80,0,0,470
80456,200,40,40,80,0,0,360
80457,200,140,120,160,320,0,940
80458,140,80,40,80,160,0,500
80459,210,180,120,80,160,320,1070
80460,200,100,120,160,0,0,580
80461,190,100,120,80,0,0,490
80462,160,120,160,160,320,320,1240
80463,190,180,160,160,160,320,1170
80464,180,60,40,80,0,0,360
80465,160,120,120,0,0,0,400
80466,190,120,120,160,160,0,750
80467,190,140,80,160,160,0,730
80468,200,160,160,80,160,0,760
80469,220,100,160,160,0,0,640
80470,220,120,80,80,160,0,660
80471,210,100,80,80,160,320,950
80472,180,100,80,160,320,320,1160
80473,200,60,0,0,0,0,260
80474,180,120,80,160,0,0,540
80475,220,200,120,80,160,0,780
80476,230,200,160,80,160,320,1150
80477,190,180,120,80,0,0,570
80478,220,120,40,80,0,0,460
80479,180,180,120,160,160,0,800
80480,210,100,120,160,160,0,750
80481,190,120,120,80,160,320,990
80482,190,60,120,80,0,0,450
80483,190,100,80,80,160,0,610
80484,190,140,120,240,320,320,1330
80485,220,180,120,160,160,320,1160
80486,190,100,120,160,0,0,570
80487,180,100,120,80,0,0,480
80488,250,160,40,0,0,0,450
80489,200,200,160,80,0,0,640
80490,240,140,40,0,0,0,420
80491,160,100,120,160,160,0,700
80492,210,140,160,80,160,0,750
80493,190,100,160,240,160,0,850
80494,190,140,120,80,160,0,690
80495,180,80,120,80,0,0,460
80496,200,100,80,0,0,0,380
80497,180,140,200,240,320,320,1400
80498,160,120,80,80,0,0,440
80499,170,120,80,0,0,0,370
80500,220,140,160,80,0,0,600
80501,210,100,120,160,0,0,590
80502,190,140,120,80,0,0,530
80503,210,140,200,160,160,320,1190
80504,210,100,80,0,0,0,390
80505,190,120,160,240,320,0,1030
80506,210,120,120,240,320,320,1330
80507,180,140,120,80,0,0,520
80508,190,80,120,160,320,0,870
80509,190,120,160,160,160,0,790
80510,210,60,120,160,0,0,550
80511,170,120,120,80,0,0,490
80512,220,80,80,80,160,0,620
80513,150,120,80,80,0,0,430
80514,210,160,160,240,320,320,1410
80515,170,80,120,160,160,0,690
80516,170,160,40,80,0,0,450
80517,190,120,200,80,0,0,590
80518,180,100,80,160,160,0,680
80519,220,120,160,240,0,0,740
80520,200,160,80,80,160,0,680
80521,210,120,120,80,0,0,530
80522,190,120,120,80,160,0,670
80523,200,140,120,80,0,0,540
80524,180,60,120,160,160,320,1000
80525,200,140,0,0,0,0,340
80526,210,120,120,240,160,0,850
80527,200,120,40,80,160,0,600
80528,180,60,40,0,0,0,280
80529,170,100,80,0,0,0,350
80530,220,80,120,160,160,0,740
80531,220,140,80,0,0,0,440
80532,180,160,120,80,160,0,700
80533,210,180,160,80,160,0,790
80534,190,140,80,80,160,320,970
80535,190,140,160,80,0,0,570
80536,230,120,80,80,0,0,510
80537,230,140,120,160,160,320,1130
80538,190,60,120,80,160,0,610
80539,230,120,200,160,160,320,1190
80540,190,100,80,0,0,0,370
80541,160,140,120,80,0,0,500
80542,220,100,80,160,0,0,560
80543,220,160,160,160,160,0,860
80544,180,120,80,0,0,0,380
80545,200,120,200,160,160,0,840
80546,180,100,120,160,160,0,720
80547,160,80,120,160,160,0,680
80548,210,120,40,80,0,0,450
80549,220,120,120,160,160,0,780
80550,200,140,120,240,320,320,1340
80551,270,160,40,80,0,0,550
80552,220,120,80,80,0,0,500
80553,200,100,40,0,0,0,340
80554,180,140,160,160,160,0,800
80555,150,120,120,160,160,0,710
80556,240,140,120,240,160,0,900
80557,200,140,40,80,160,320,940
80558,210,160,160,240,320,0,1090
80559,170,140,160,80,160,0,710
80560,170,80,40,0,0,0,290
80561,210,140,80,160,160,0,750
80562,210,140,40,80,0,0,470
80563,210,120,160,80,0,0,570
80564,220,140,80,0,0,0,440
80565,190,80,80,0,0,0,350
80566,200,160,160,80,0,0,600
80567,210,100,40,80,160,0,590
80568,210,80,80,80,0,0,450
80569,180,140,120,80,0,0,520
80570,190,100,160,240,320,320,1330
80571,200,140,200,240,160,320,1260
80572,200,140,160,240,160,0,900
80573,200,100,80,80,0,0,460
80574,190,160,80,80,0,0,510
80575,220,140,120,80,0,0,560
80576,160,100,120,80,160,0,620
80577,170,80,160,240,160,0,810
80578,170,100,160,160,0,0,590
80579,170,100,40,0,0,0,310
80580,170,100,80,160,320,0,830
80581,240,120,80,160,160,0,760
80582,200,120,80,0,0,0,400
80583,160,80,80,80,0,0,400
80584,200,80,80,80,0,0,440
80585,220,180,120,80,160,0,760
80586,160,100,120,240,320,0,940
80587,220,100,120,160,160,0,760
80588,140,60,120,160,320,320,1120
80589,180,120,80,80,160,0,620
80590,220,80,80,0,0,0,380
80591,160,100,160,160,320,320,1220
80592,220,140,160,160,320,0,1000
80593,180,100,80,80,160,0,600
80594,180,180,200,160,160,0,880
80595,210,100,120,80,160,320,990
80596,200,80,80,80,0,0,440
80597,240,160,160,160,160,0,880
80598,170,140,80,80,160,0,630
80599,170,100,160,240,0,0,670
80600,170,140,120,80,160,0,670
80601,210,160,40,0,0,0,410
80602,150,40,80,80,0,0,350
80603,170,80,40,80,160,0,530
80604,180,80,40,80,0,0,380
80605,160,80,80,80,0,0,400
80606,190,100,120,160,160,0,730
80607,220,160,40,0,0,0,420
80608,200,80,80,80,160,0,600
80609,180,120,80,80,160,320,940
80610,230,100,120,0,0,0,450
80611,190,80,80,0,0,0,350
80612,160,120,80,80,0,0,440
80613,190,140,80,0,0,0,410
80614,190,100,80,80,160,0,610
80615,210,60,80,160,160,0,670
80616,200,120,160,0,0,0,480
80617,220,160,200,240,160,0,980
80618,230,120,120,160,0,0,630
80619,230,100,120,80,160,0,690
80620,210,100,80,80,160,320,950
80621,200,100,120,80,0,0,500
80622,200,180,160,160,160,0,860
80623,140,140,120,80,0,0,480
80624,190,120,40,80,160,0,590
80625,180,100,120,160,0,0,560
80626,170,80,0,0,0,0,250
80627,200,140,120,160,160,0,780
80628,210,80,160,160,160,320,1090
80629,160,100,80,80,160,0,580
80630,250,140,120,160,160,0,830
80631,190,80,40,80,160,0,550
80632,180,100,120,160,0,0,560
80633,180,80,40,80,0,0,380
80634,170,120,80,0,0,0,370
80635,220,120,80,80,160,0,660
80636,200,160,80,160,0,0,600
80637,210,120,160,80,160,0,730
80638,210,120,160,160,160,0,810
80639,220,140,160,80,160,0,760
80640,170,160,80,80,160,0,650
80641,200,80,120,160,320,0,880
80642,210,120,120,80,160,320,1010
80643,180,120,40,0,0,0,340
80644,180,140,120,80,160,0,680
80645,180,100,120,160,320,0,880
80646,210,100,80,80,160,0,630
80647,160,80,120,160,0,0,520
80648,210,160,160,80,160,320,1090
80649,130,160,120,0,0,0,410
80650,200,80,0,0,0,0,280
80651,230,180,120,80,0,0,610
80652,180,140,120,80,160,0,680
80653,210,200,80,0,0,0,490
80654,180,100,120,80,160,0,640
80655,170,40,80,160,160,0,610
80656,190,80,80,80,0,0,430
80657,200,120,40,80,0,0,440
80658,210,160,160,160,0,0,690
80659,190,80,40,80,160,0,550
80660,210,80,40,80,160,0,570
80661,220,140,160,160,0,0,680
80662,230,200,120,160,160,0,870
80663,180,140,160,160,0,0,640
80664,240,140,120,240,160,0,900
80665,210,120,80,0,0,0,410
80666,160,100,160,160,160,0,740
80667,190,80,0,0,0,0,270
80668,170,120,120,240,160,0,810
80669,210,120,80,80,0,0,490
80670,210,160,120,160,160,320,1130
80671,230,100,80,80,160,0,650
80672,190,80,120,80,0,0,470
80673,210,100,120,80,160,0,670
80674,190,80,80,160,160,0,670
80675,180,160,160,160,160,0,820
80676,190,160,160,160,160,0,830
80677,170,140,160,160,160,0,790
80678,180,100,80,0,0,0,360
80679,240,180,120,0,0,0,540
80680,230,140,120,0,0,0,490
80681,170,100,40,80,0,0,390
80682,210,160,160,80,0,0,610
80683,250,160,160,160,160,0,890
80684,220,100,80,160,320,0,880
80685,200,80,120,80,160,0,640
80686,200,200,120,80,0,0,600
80687,190,120,160,80,160,0,710
80688,220,120,120,80,160,0,700
80689,200,140,120,160,160,0,780
80690,220,180,80,160,0,0,640
80691,200,120,160,80,0,0,560
80692,200,80,120,160,0,0,560
80693,200,120,80,80,160,0,640
80694,200,160,160,160,160,0,840
80695,260,120,120,0,0,0,500
80696,180,80,120,160,160,320,1020
80697,200,140,160,80,160,0,740
80698,160,20,0,0,0,0,180
80699,170,140,160,160,160,0,790
80700,160,160,40,80,160,0,600
80701,170,140,120,0,0,0,430
80702,230,140,200,0,0,0,570
80703,230,140,80,160,160,0,770
80704,220,180,120,80,160,0,760
80705,230,80,120,240,160,0,830
80706,210,140,80,80,0,0,510
80707,210,80,80,160,320,320,1170
80708,210,160,120,160,160,0,810
80709,200,120,80,160,160,0,720
80710,190,160,200,240,160,0,950
80711,210,120,120,160,320,0,930
80712,200,80,40,80,160,0,560
80713,230,140,120,80,160,0,730
80714,180,140,80,160,160,0,720
80715,220,100,40,80,160,0,600
80716,190,100,120,160,160,320,1050
80717,190,120,120,240,160,0,830
80718,250,160,240,80,0,0,730
80719,210,120,40,80,160,0,610
80720,190,120,120,160,160,0,750
80721,170,100,40,80,160,320,870
80722,200,140,120,160,160,0,780
80723,200,120,120,80,160,0,680
80724,180,120,40,80,0,0,420
80725,170,100,120,240,320,320,1270
80726,180,60,40,80,0,0,360
80727,220,140,160,240,320,320,1400
80728,210,120,160,160,0,0,650
80729,190,100,120,160,0,0,570
80730,230,140,160,160,160,0,850
80731,190,120,120,80,0,0,510
80732,210,120,0,0,0,0,330
80733,160,100,80,0,0,0,340
80734,210,80,40,0,0,0,330
80735,210,160,80,80,160,0,690
80736,190,100,120,160,0,0,570
80737,190,140,160,0,0,0,490
80738,180,140,120,240,320,0,1000
80739,170,120,80,160,160,320,1010
80740,170,140,160,80,0,0,550
80741,250,140,80,80,160,0,710
80742,160,80,120,80,0,0,440
80743,220,160,120,80,160,0,740
80744,180,80,40,80,0,0,380
80745,180,120,80,0,0,0,380
80746,190,120,160,80,160,0,710
80747,160,120,80,80,0,0,440
80748,230,120,120,80,160,0,710
80749,210,100,80,80,0,0,470
80750,190,100,120,80,0,0,490
80751,190,120,120,80,160,0,670
80752,230,120,120,160,160,0,790
80753,200,100,120,80,160,0,660
80754,200,160,160,160,160,0,840
80755,210,160,80,160,160,0,770
80756,130,140,200,160,160,0,790
80757,240,160,80,160,160,320,1120
80758,200,140,120,160,160,0,780
80759,200,80,120,0,0,0,400
80760,220,180,120,160,160,0,840
80761,210,100,80,80,160,0,630
80762,240,200,120,0,0,0,560
80763,190,100,120,80,0,0,490
80764,170,160,40,0,0,0,370
80765,180,80,40,80,160,0,540
80766,180,100,80,80,160,320,920
80767,170,80,80,80,0,0,410
80768,210,140,160,80,0,0,590
80769,210,160,160,80,160,0,770
80770,160,120,160,160,160,320,1080
80771,230,160,80,160,160,0,790
80772,220,60,40,80,160,0,560
80773,160,100,80,80,160,320,900
80774,200,40,40,80,160,0,520
80775,210,100,120,80,160,0,670
80776,200,80,80,80,160,320,920
80777,180,200,240,240,320,0,1180
80778,210,100,40,0,0,0,350
80779,180,140,80,0,0,0,400
80780,210,160,120,80,160,0,730
80781,200,60,40,80,160,0,540
80782,190,120,160,80,160,320,1030
80783,250,180,200,320,160,0,1110
80784,180,100,200,160,320,0,960
80785,220,140,120,80,160,0,720
80786,210,120,80,0,0,0,410
80787,190,160,200,80,160,0,790
80788,260,140,160,80,0,0,640
80789,190,120,120,160,160,0,750
80790,190,120,160,160,160,0,790
80791,190,120,80,0,0,0,390
80792,210,160,200,160,160,0,890
80793,170,120,120,160,160,0,730
80794,200,180,160,0,0,0,540
80795,210,40,40,80,160,0,530
80796,150,140,120,80,0,0,490
80797,170,120,160,160,320,0,930
80798,230,120,120,160,0,0,630
80799,220,120,160,240,320,0,1060
80800,200,160,80,80,0,0,520
80801,150,120,120,0,0,0,390
80802,230,140,40,0,0,0,410
80803,220,120,80,80,160,0,660
80804,180,100,80,80,160,0,600
80805,180,180,120,240,160,0,880
80806,200,140,120,80,160,0,700
80807,210,60,40,0,0,0,310
80808,200,120,80,0,0,0,400
80809,190,160,160,0,0,0,510
80810,180,160,200,240,0,0,780
80811,230,140,160,160,0,0,690
80812,180,100,200,160,0,0,640
80813,220,100,80,80,0,0,480
80814,210,120,120,80,0,0,530
80815,160,120,120,0,0,0,400
80816,180,120,80,0,0,0,380
80817,180,160,160,160,160,0,820
80818,210,120,120,160,160,320,1090
80819,220,160,120,160,0,0,660
80820,190,200,200,160,160,0,910
80821,160,140,160,240,320,0,1020
80822,190,120,80,160,320,0,870
80823,210,120,40,80,160,0,610
80824,230,160,200,240,160,0,990
80825,230,160,120,160,320,0,990
80826,190,160,160,80,160,0,750
80827,190,100,120,80,0,0,490
80828,220,180,120,160,160,0,840
80829,230,80,80,80,160,0,630
80830,230,140,80,160,0,0,610
80831,190,140,80,0,0,0,410
80832,170,140,160,160,160,320,1110
80833,210,140,40,0,0,0,390
80834,180,60,40,0,0,0,280
80835,160,80,120,80,160,0,600
80836,200,120,120,80,160,0,680
80837,230,120,160,160,160,0,830
80838,190,140,160,160,160,0,810
80839,200,140,80,160,160,0,740
80840,190,100,40,0,0,0,330
80841,190,80,40,0,0,0,310
80842,220,100,40,0,0,0,360
80843,170,120,160,240,320,320,1330
80844,240,120,80,80,160,0,680
80845,180,120,160,240,160,0,860
80846,150,100,80,160,320,320,1130
80847,190,80,80,80,160,0,590
80848,180,120,80,80,0,0,460
80849,190,140,80,80,0,0,490
80850,170,140,80,160,320,0,870
80851,160,60,80,80,160,0,540
80852,190,100,40,80,160,0,570
80853,190,120,160,160,0,0,630
80854,210,80,0,0,0,0,290
80855,190,100,160,160,0,0,610
80856,240,120,120,0,0,0,480
80857,240,120,120,160,160,0,800
80858,190,180,120,0,0,0,490
80859,170,140,160,80,0,0,550
80860,230,140,120,160,160,0,810
80861,250,180,160,160,320,0,1070
80862,180,180,120,80,160,320,1040
80863,200,120,200,80,160,320,1080
80864,170,120,160,160,0,0,610
80865,200,120,160,80,160,0,720
80866,190,80,120,240,160,0,790
80867,180,120,160,160,160,0,780
80868,180,60,80,160,160,0,640
80869,170,100,120,160,160,320,1030
80870,190,160,200,240,320,320,1430
80871,220,100,80,80,0,0,480
80872,210,140,120,160,160,0,790
80873,200,120,40,0,0,0,360
80874,200,100,80,160,160,0,700
80875,210,160,120,80,160,0,730
80876,210,140,160,160,320,0,990
80877,160,100,40,80,0,0,380
80878,150,80,40,80,160,0,510
80879,210,220,200,160,160,0,950
80880,190,160,160,160,160,0,830
80881,220,160,160,240,320,320,1420
80882,160,80,120,0,0,0,360
80883,180,80,0,0,0,0,260
80884,170,120,80,0,0,0,370
80885,250,140,80,80,160,0,710
80886,180,140,80,160,320,0,880
80887,160,160,120,80,0,0,520
80888,130,100,40,0,0,0,270
80889,190,100,80,80,0,0,450
80890,220,120,40,0,0,0,380
80891,240,120,80,80,160,0,680
80892,220,100,120,80,160,0,680
80893,200,140,80,80,0,0,500
80894,190,100,120,160,0,0,570
80895,180,120,120,80,0,0,500
80896,220,180,160,80,160,0,800
80897,220,120,160,160,160,0,820
80898,220,140,120,80,0,0,560
80899,190,140,80,80,0,0,490
80900,190,140,80,80,160,0,650
80901,190,140,120,80,0,0,530
80902,230,140,40,0,0,0,410
80903,210,120,40,0,0,0,370
80904,210,60,80,160,160,0,670
80905,200,140,120,160,160,0,780
80906,210,200,160,80,0,0,650
80907,230,120,80,80,160,0,670
80908,170,120,160,240,320,320,1330
80909,220,120,40,0,0,0,380
80910,190,140,120,240,160,0,850
80911,190,100,80,160,0,0,530
80912,240,60,80,80,0,0,460
80913,220,160,200,240,160,320,1300
80914,140,100,80,0,0,0,320
80915,210,160,40,80,160,0,650
80916,160,120,160,160,0,0,600
80917,200,100,120,0,0,0,420
80918,200,80,40,0,0,0,320
80919,220,240,120,0,0,0,580
80920,210,140,120,80,0,0,550
80921,240,120,160,160,160,0,840
80922,180,120,120,160,320,320,1220
80923,180,80,160,80,160,0,660
80924,190,180,40,80,160,320,970
80925,220,60,40,80,160,0,560
80926,170,140,200,240,320,0,1070
80927,210,80,120,160,320,0,890
80928,190,100,120,0,0,0,410
80929,190,100,80,160,0,0,530
80930,210,160,160,80,0,0,610
80931,210,140,40,0,0,0,390
80932,180,120,120,80,160,0,660
80933,170,120,160,160,160,0,770
80934,180,120,80,80,160,0,620
80935,170,180,160,240,160,0,910
80936,220,80,0,0,0,0,300
80937,230,140,120,80,0,0,570
80938,180,140,80,80,0,0,480
80939,200,120,120,160,160,0,760
80940,180,160,80,80,0,0,500
80941,200,140,120,80,160,0,700
80942,170,120,120,80,160,0,650
80943,170,120,80,0,0,0,370
80944,220,80,120,160,160,320,1060
80945,210,120,80,80,160,320,970
80946,210,120,120,80,0,0,530
80947,170,140,120,160,320,0,910
80948,200,120,120,0,0,0,440
80949,180,120,80,0,0,0,380
80950,200,120,200,240,160,0,920
80951,160,120,200,240,160,0,880
80952,220,140,80,80,160,0,680
80953,140,80,40,0,0,0,260
80954,190,140,120,80,0,0,530
80955,220,120,40,80,160,0,620
80956,210,60,40,0,0,0,310
80957,180,180,160,160,160,0,840
80958,190,140,80,160,160,320,1050
80959,190,120,120,80,160,0,670
80960,240,100,120,160,320,0,940
80961,220,180,160,80,0,0,640
80962,180,60,120,80,160,320,920
80963,240,160,80,80,160,0,720
80964,210,180,200,240,320,0,1150
80965,190,160,120,80,160,0,710
80966,210,100,80,80,160,0,630
80967,190,140,160,0,0,0,490
80968,240,100,120,160,0,0,620
80969,200,120,120,80,160,320,1000
80970,190,160,80,80,0,0,510
80971,200,120,80,80,160,0,640
80972,210,100,80,80,160,0,630
80973,220,200,120,80,0,0,620
80974,180,140,80,80,160,0,640
80975,210,160,120,160,160,320,1130
80976,190,80,80,80,160,0,590
80977,190,140,160,240,160,0,890
80978,240,140,120,0,0,0,500
80979,190,180,160,240,0,0,770
80980,180,100,80,160,0,0,520
80981,240,140,200,80,160,0,820
80982,200,140,80,0,0,0,420
80983,160,120,200,160,160,0,800
80984,210,120,160,240,160,0,890
80985,210,120,80,80,160,0,650
80986,160,100,40,0,0,0,300
80987,210,140,120,80,0,0,550
80988,240,120,120,160,0,0,640
80989,200,140,160,160,160,0,820
80990,160,100,40,0,0,0,300
80991,210,120,80,0,0,0,410
80992,190,80,40,80,0,0,390
80993,210,80,120,80,160,320,970
80994,200,80,80,80,0,0,440
80995,160,160,160,160,0,0,640
80996,210,120,120,0,0,0,450
80997,170,20,40,80,160,0,470
80998,190,140,160,160,320,320,1290
80999,240,160,80,80,160,0,720
81000,180,140,200,160,320,0,1000
81001,170,120,200,80,160,0,730
81002,230,200,120,80,0,0,630
81003,200,100,40,0,0,0,340
81004,180,140,160,160,160,0,800
81005,180,120,160,160,320,320,1260
81006,220,140,120,80,160,320,1040
81007,190,180,80,0,0,0,450
81008,220,140,120,0,0,0,480
81009,230,180,120,240,320,0,1090
81010,170,60,40,0,0,0,270
81011,230,140,80,160,160,0,770
81012,180,120,120,80,160,320,980
81013,180,120,160,160,160,0,780
81014,180,120,120,80,160,320,980
81015,220,140,120,160,320,0,960
81016,230,140,160,160,0,0,690
81017,210,120,120,80,160,0,690
81018,210,120,120,160,160,0,770
81019,220,80,0,0,0,0,300
81020,160,120,40,0,0,0,320
81021,210,180,80,0,0,0,470
81022,170,140,200,240,160,320,1230
81023,230,120,200,160,160,0,870
81024,210,100,120,160,160,0,750
81025,170,140,120,160,160,0,750
81026,160,160,200,240,160,0,920
81027,240,180,80,80,160,0,740
81028,220,140,160,160,0,0,680
81029,220,120,120,160,320,320,1260
81030,190,120,80,0,0,0,390
81031,210,180,120,80,0,0,590
81032,200,120,200,240,160,0,920
81033,220,160,120,80,160,0,740
81034,210,80,80,0,0,0,370
81035,180,60,0,0,0,0,240
81036,190,140,120,80,160,320,1010
81037,160,100,40,80,160,0,540
81038,180,100,120,160,160,320,1040
81039,240,160,120,0,0,0,520
81040,170,100,120,80,160,0,630
81041,140,120,160,160,160,0,740
81042,210,140,120,160,320,320,1270
81043,160,60,40,0,0,0,260
81044,210,140,160,80,0,0,590
81045,230,160,120,80,160,0,750
81046,190,160,160,160,320,0,990
81047,240,100,0,0,0,0,340
81048,200,140,160,80,160,0,740
81049,220,100,120,160,160,0,760
81050,180,40,0,0,0,0,220
81051,170,140,80,80,160,0,630
81052,200,120,120,80,0,0,520
81053,160,100,0,0,0,0,260
81054,190,160,80,0,0,0,430
81055,170,120,160,240,0,0,690
81056,210,200,80,80,0,0,570
81057,200,140,160,160,160,0,820
81058,160,100,40,0,0,0,300
81059,210,80,80,0,0,0,370
81060,200,100,120,0,0,0,420
81061,210,120,120,80,0,0,530
81062,190,160,120,80,160,320,1030
81063,170,120,40,0,0,0,330
81064,180,140,80,80,160,0,640
81065,210,120,40,80,160,0,610
81066,220,80,40,0,0,0,340
81067,230,120,40,80,160,0,630
81068,230,120,40,80,160,0,630
81069,220,140,120,80,160,0,720
81070,210,120,40,0,0,0,370
81071,200,80,0,0,0,0,280
81072,220,160,40,0,0,0,420
81073,200,120,120,160,160,320,1080
81074,160,100,160,80,160,320,980
81075,180,60,80,80,160,0,560
81076,190,100,120,160,160,0,730
81077,190,100,80,0,0,0,370
81078,200,120,40,80,160,0,600
81079,230,200,160,160,160,0,910
81080,200,120,80,0,0,0,400
81081,200,120,120,160,0,0,600
81082,180,140,120,0,0,0,440
81083,180,120,120,160,160,0,740
81084,190,120,120,240,160,0,830
81085,200,160,200,160,160,0,880
81086,190,120,80,160,320,0,870
81087,230,80,160,80,160,0,710
81088,240,120,160,240,160,0,920
81089,160,80,120,80,160,0,600
81090,190,100,40,80,0,0,410
81091,170,100,80,80,160,0,590
81092,180,100,80,160,320,0,840
81093,150,80,120,80,0,0,430
81094,180,140,160,160,0,0,640
81095,200,120,120,80,160,0,680
81096,200,140,120,160,160,0,780
81097,190,100,40,80,160,0,570
81098,170,140,160,0,0,0,470
81099,230,100,80,0,0,0,410
81100,160,100,120,160,320,320,1180
81101,210,100,80,160,160,0,710
81102,180,120,160,80,160,0,700
81103,190,100,80,160,320,0,850
81104,230,180,120,240,160,0,930
81105,200,120,120,80,0,0,520
81106,190,120,120,160,0,0,590
81107,200,100,80,80,160,0,620
81108,200,120,120,80,0,0,520
81109,170,100,40,80,160,0,550
81110,180,140,40,0,0,0,360
81111,210,160,40,80,160,0,650
81112,190,140,160,80,160,0,730
81113,190,180,80,0,0,0,450
81114,160,120,120,80,160,0,640
81115,150,100,120,80,160,0,610
81116,180,140,160,80,0,0,560
81117,180,140,0,0,0,0,320
81118,200,160,160,240,320,0,1080
81119,200,160,120,80,160,0,720
81120,170,60,0,0,0,0,230
81121,240,140,160,0,0,0,540
81122,210,140,80,80,0,0,510
81123,170,120,80,80,160,320,930
81124,210,100,40,80,0,0,430
81125,230,120,120,0,0,0,470
81126,170,140,120,160,160,0,750
81127,180,80,40,80,160,0,540
81128,210,160,80,80,160,0,690
81129,190,120,40,0,0,0,350
81130,170,80,40,0,0,0,290
81131,220,80,80,80,160,320,940
81132,210,140,160,80,160,0,750
81133,170,100,40,0,0,0,310
81134,200,100,120,80,160,0,660
81135,180,140,160,160,0,0,640
81136,170,80,120,240,320,0,930
81137,210,120,120,160,0,0,610
81138,170,120,120,80,0,0,490
81139,190,140,120,80,160,0,690
81140,220,160,200,240,320,0,1140
81141,180,140,160,160,160,0,800
81142,190,140,120,160,160,0,770
81143,240,140,80,80,160,0,700
81144,190,180,160,80,0,0,610
81145,180,80,80,160,160,0,660
81146,190,140,160,80,160,0,730
81147,170,120,160,80,0,0,530
81148,200,140,80,0,0,0,420
81149,200,140,160,160,160,0,820
81150,210,100,120,80,160,320,990
81151,190,80,120,160,160,0,710
81152,240,140,120,160,320,320,1300
81153,170,140,160,80,160,0,710
81154,190,80,120,80,160,320,950
81155,200,120,80,0,0,0,400
81156,180,100,80,160,160,0,680
81157,160,120,120,80,160,0,640
81158,220,100,120,80,0,0,520
81159,210,160,120,240,320,0,1050
81160,180,60,40,80,160,320,840
81161,230,160,160,0,0,0,550
81162,170,160,120,80,160,0,690
81163,180,120,80,80,0,0,460
81164,210,120,80,80,160,320,970
81165,160,120,120,80,160,0,640
81166,230,160,120,160,160,0,830
81167,160,80,40,80,160,0,520
81168,230,100,80,80,160,0,650
81169,250,160,80,160,0,0,650
81170,200,160,80,0,0,0,440
81171,190,160,240,80,160,320,1150
81172,220,60,120,160,160,0,720
81173,200,100,80,80,160,0,620
81174,190,100,40,80,160,320,890
81175,190,100,120,160,320,320,1210
81176,210,160,200,160,320,0,1050
81177,210,160,160,160,320,320,1330
81178,180,100,80,0,0,0,360
81179,160,60,0,0,0,0,220
81180,230,140,160,160,160,320,1170
81181,210,120,80,0,0,0,410
81182,230,140,160,80,160,0,770
81183,200,120,40,0,0,0,360
81184,220,100,40,0,0,0,360
81185,160,60,80,160,160,0,620
81186,210,100,80,80,0,0,470
81187,150,100,120,160,320,0,850
81188,190,100,120,160,160,320,1050
81189,250,100,120,240,160,0,870
81190,190,160,120,240,160,0,870
81191,220,160,200,240,160,320,1300
81192,200,100,120,80,160,0,660
81193,220,200,160,80,0,0,660
81194,230,140,160,80,160,0,770
81195,200,160,160,240,320,320,1400
81196,220,140,160,80,160,0,760
81197,200,120,120,80,0,0,520
81198,180,120,80,80,160,0,620
81199,160,100,80,80,0,0,420
81200,170,140,120,160,0,0,590
81201,190,100,80,80,0,0,450
81202,210,140,120,80,0,0,550
81203,230,120,80,80,160,320,990
81204,190,160,160,80,160,320,1070
81205,180,120,160,160,160,0,780
81206,210,160,80,0,0,0,450
81207,220,120,40,0,0,0,380
81208,230,140,40,80,160,0,650
81209,170,100,120,0,0,0,390
81210,180,100,120,80,0,0,480
81211,180,100,80,0,0,0,360
81212,220,180,80,80,0,0,560
81213,210,160,120,80,0,0,570
81214,220,120,80,80,160,0,660
81215,200,120,120,160,160,0,760
81216,180,80,80,160,320,320,1140
81217,240,160,120,160,160,320,1160
81218,140,60,80,160,320,0,760
81219,210,120,120,160,320,320,1250
81220,200,200,80,0,0,0,480
81221,190,100,120,80,160,320,970
81222,170,80,80,160,160,0,650
81223,150,60,80,80,160,0,530
81224,210,160,160,80,0,0,610
81225,210,120,120,80,160,0,690
81226,230,180,200,80,160,0,850
81227,170,100,160,0,0,0,430
81228,200,120,40,80,160,320,920
81229,180,80,120,80,0,0,460
81230,190,140,120,80,0,0,530
81231,200,200,120,80,160,0,760
81232,220,120,160,80,0,0,580
81233,200,140,80,80,0,0,500
81234,200,120,160,160,0,0,640
81235,220,140,200,160,160,0,880
81236,230,200,160,80,0,0,670
81237,250,140,0,0,0,0,390
81238,230,200,120,80,0,0,630
81239,200,100,80,80,160,0,620
81240,210,100,40,0,0,0,350
81241,180,140,160,160,320,0,960
81242,200,60,80,0,0,0,340
81243,180,140,80,80,160,0,640
81244,220,160,160,160,160,0,860
81245,180,120,120,160,320,0,900
81246,220,120,160,160,320,0,980
81247,160,120,80,80,160,0,600
81248,150,100,120,160,0,0,530
81249,180,80,80,80,160,320,900
81250,200,120,160,0,0,0,480
81251,200,140,120,80,0,0,540
81252,220,100,40,80,160,0,600
81253,210,140,120,80,0,0,550
81254,180,120,160,80,0,0,540
81255,150,160,120,160,320,0,910
81256,180,160,120,160,0,0,620
81257,190,80,40,80,0,0,390
81258,230,160,120,80,160,0,750
81259,150,120,40,0,0,0,310
81260,180,100,120,80,160,0,640
81261,180,160,120,160,160,0,780
81262,230,120,120,160,0,0,630
81263,160,120,80,160,320,320,1160
81264,180,80,120,160,160,320,1020
81265,190,80,120,80,0,0,470
81266,190,120,160,160,320,320,1270
81267,190,100,40,0,0,0,330
81268,190,120,160,160,320,320,1270
81269,170,120,40,0,0,0,330
81270,160,120,80,80,160,0,600
81271,180,140,80,80,160,0,640
81272,180,100,80,80,160,0,600
81273,170,160,120,0,0,0,450
81274,170,100,120,160,0,0,550
81275,200,140,80,80,160,320,980
81276,200,200,160,160,320,0,1040
81277,110,80,80,80,160,0,510
81278,160,160,80,80,0,0,480
81279,210,60,40,0,0,0,310
81280,220,160,160,80,160,0,780
81281,170,120,80,80,0,0,450
81282,230,160,200,160,160,0,910
81283,230,100,80,80,160,0,650
81284,200,220,160,80,160,0,820
81285,180,120,160,240,160,0,860
81286,170,120,80,160,320,320,1170
81287,210,180,160,0,0,0,550
81288,190,100,80,160,160,0,690
81289,170,120,80,80,0,0,450
81290,180,100,40,80,160,0,560
81291,160,80,120,80,0,0,440
81292,220,140,120,80,160,0,720
81293,210,100,120,80,0,0,510
81294,220,120,160,80,160,0,740
81295,190,140,80,160,0,0,570
81296,220,120,80,80,160,0,660
81297,190,120,120,160,160,0,750
81298,210,100,80,0,0,0,390
81299,170,140,200,160,160,320,1150
81300,190,80,120,80,0,0,470
81301,180,100,80,80,160,0,600
81302,190,120,160,80,160,0,710
81303,180,120,120,160,320,0,900
81304,200,180,120,80,160,0,740
81305,230,120,200,240,160,0,950
81306,200,80,40,80,160,0,560
81307,180,100,40,80,160,0,560
81308,190,160,160,0,0,0,510
81309,190,80,80,0,0,0,350
81310,170,140,200,0,0,0,510
81311,190,60,80,80,160,0,570
81312,180,60,80,160,160,0,640
81313,220,100,120,160,160,0,760
81314,230,140,160,160,0,0,690
81315,230,200,120,80,0,0,630
81316,180,140,120,160,160,0,760
81317,200,120,80,80,160,320,960
81318,200,100,80,160,320,0,860
81319,220,80,120,160,160,0,740
81320,160,180,120,80,0,0,540
81321,210,160,120,80,160,0,730
81322,210,100,120,0,0,0,430
81323,170,60,80,80,160,0,550
81324,220,180,120,0,0,0,520
81325,200,140,160,80,0,0,580
81326,210,120,120,160,160,0,770
81327,190,140,120,80,160,0,690
81328,160,120,120,160,160,0,720
81329,210,180,120,80,160,320,1070
81330,220,120,120,160,160,320,1100
81331,210,140,120,0,0,0,470
81332,170,140,120,80,160,0,670
81333,180,120,80,0,0,0,380
81334,220,140,40,0,0,0,400
81335,180,100,120,240,320,320,1280
81336,190,140,120,160,0,0,610
81337,210,80,80,160,320,0,850
81338,210,100,80,80,160,0,630
81339,190,40,0,0,0,0,230
81340,190,140,120,240,320,0,1010
81341,180,100,120,80,160,0,640
81342,220,160,160,160,320,320,1340
81343,180,120,40,0,0,0,340
81344,220,120,120,160,160,0,780
81345,170,140,40,80,0,0,430
81346,200,140,160,160,320,320,1300
81347,180,80,80,80,160,0,580
81348,230,100,80,80,0,0,490
81349,230,120,40,0,0,0,390
81350,220,160,160,80,160,0,780
81351,200,100,80,80,0,0,460
81352,230,180,80,160,320,0,970
81353,200,100,80,80,160,0,620
81354,240,220,120,160,160,0,900
81355,190,80,120,160,160,320,1030
81356,180,140,80,0,0,0,400
81357,250,220,200,80,0,0,750
81358,180,120,160,160,0,0,620
81359,180,160,80,80,160,0,660
81360,170,100,80,80,160,0,590
81361,210,60,40,80,160,320,870
81362,230,160,160,0,0,0,550
81363,230,100,40,80,160,0,610
81364,200,120,120,80,160,320,1000
81365,210,120,120,80,0,0,530
81366,180,120,160,0,0,0,460
81367,210,160,120,80,0,0,570
81368,210,120,80,80,0,0,490
81369,190,60,80,80,160,0,570
81370,180,120,120,80,160,0,660
81371,190,140,120,0,0,0,450
81372,190,120,80,160,160,0,710
81373,230,140,120,80,160,0,730
81374,220,140,40,80,160,0,640
81375,200,100,80,0,0,0,380
81376,230,120,40,80,160,0,630
81377,240,160,240,160,160,320,1280
81378,210,160,80,0,0,0,450
81379,160,100,80,0,0,0,340
81380,190,120,80,0,0,0,390
81381,220,120,80,160,160,0,740
81382,170,120,120,0,0,0,410
81383,200,100,120,80,0,0,500
81384,200,120,120,160,0,0,600
81385,210,140,160,0,0,0,510
81386,150,120,40,0,0,0,310
81387,200,120,120,80,160,0,680
81388,200,160,160,80,0,0,600
81389,190,80,80,80,160,0,590
81390,220,180,200,160,0,0,760
81391,180,80,40,0,0,0,300
81392,140,80,40,80,160,0,500
81393,230,180,160,160,0,0,730
81394,200,120,120,160,160,0,760
81395,210,120,80,160,160,320,1050
81396,160,80,80,0,0,0,320
81397,230,120,160,80,160,0,750
81398,170,80,80,0,0,0,330
81399,210,180,0,0,0,0,390
81400,200,140,80,80,0,0,500
81401,220,180,120,80,0,0,600
81402,200,120,120,80,160,0,680
81403,210,100,160,80,160,0,710
81404,160,160,120,160,320,320,1240
81405,200,120,120,240,160,0,840
81406,210,140,160,0,0,0,510
81407,230,180,160,80,0,0,650
81408,190,100,80,0,0,0,370
81409,170,80,0,0,0,0,250
81410,170,100,80,160,160,0,670
81411,220,140,120,0,0,0,480
81412,200,180,200,160,320,0,1060
81413,200,120,80,80,0,0,480
81414,170,160,80,80,160,0,650
81415,210,40,40,0,0,0,290
81416,250,140,40,0,0,0,430
81417,220,160,120,80,0,0,580
81418,210,120,80,80,160,0,650
81419,200,140,40,80,160,0,620
81420,220,140,160,240,320,0,1080
81421,210,40,40,0,0,0,290
81422,220,180,160,80,160,0,800
81423,150,100,120,160,0,0,530
81424,200,120,80,0,0,0,400
81425,220,180,120,80,160,0,760
81426,170,60,80,80,160,0,550
81427,180,120,160,80,160,0,700
81428,180,100,120,80,0,0,480
81429,200,100,80,80,160,0,620
81430,220,80,40,0,0,0,340
81431,210,140,80,80,160,0,670
81432,160,80,80,0,0,0,320
81433,220,140,80,160,160,0,760
81434,180,100,160,240,160,0,840
81435,220,200,120,160,160,0,860
81436,210,80,160,160,160,0,770
81437,220,140,160,80,160,0,760
81438,200,160,160,240,160,0,920
81439,200,120,80,80,160,0,640
81440,180,80,80,80,160,320,900
81441,170,100,80,80,160,320,910
81442,190,120,120,80,0,0,510
81443,190,140,80,80,160,0,650
81444,170,160,40,0,0,0,370
81445,190,160,160,160,320,0,990
81446,190,180,80,160,160,0,770
81447,190,120,120,80,160,0,670
81448,180,140,160,0,0,0,480
81449,180,200,80,0,0,0,460
81450,170,120,120,80,160,0,650
81451,190,120,120,80,160,320,990
81452,200,120,120,160,160,0,760
81453,230,160,80,80,160,320,1030
81454,200,80,80,160,160,320,1000
81455,220,100,80,80,160,0,640
81456,200,140,120,0,0,0,460
81457,230,120,120,160,160,320,1110
81458,180,100,120,160,0,0,560
81459,180,120,80,160,320,0,860
81460,200,180,120,160,0,0,660
81461,230,140,80,160,0,0,610
81462,210,100,40,80,0,0,430
81463,200,160,160,80,0,0,600
81464,220,160,200,240,320,0,1140
81465,180,120,80,160,160,0,700
81466,210,100,80,0,0,0,390
81467,250,140,160,160,160,0,870
81468,160,120,80,0,0,0,360
81469,110,60,120,160,160,0,610
81470,210,100,120,80,0,0,510
81471,240,180,200,160,320,0,1100
81472,190,140,160,160,320,0,970
81473,140,100,120,80,160,0,600
81474,210,120,160,160,160,0,810
81475,180,80,80,80,160,0,580
81476,160,80,80,80,160,0,560
81477,210,100,40,80,160,0,590
81478,190,140,120,160,160,320,1090
81479,190,140,80,80,0,0,490
81480,190,180,120,160,320,0,970
81481,200,140,120,160,160,320,1100
81482,190,120,120,160,160,0,750
81483,230,140,160,160,160,0,850
81484,160,100,80,80,0,0,420
81485,190,160,160,160,160,0,830
81486,210,120,120,240,320,0,1010
81487,230,200,200,160,160,0,950
81488,160,80,80,80,160,0,560
81489,250,100,120,80,0,0,550
81490,200,160,120,80,160,0,720
81491,170,120,80,160,0,0,530
81492,200,100,40,0,0,0,340
81493,230,160,160,160,160,0,870
81494,220,140,160,160,0,0,680
81495,210,100,80,80,160,0,630
81496,200,140,200,240,320,0,1100
81497,210,80,120,160,160,0,730
81498,210,140,160,80,160,0,750
81499,160,140,160,160,160,0,780
81500,250,120,80,160,0,0,610
81501,160,140,120,0,0,0,420
81502,170,120,120,160,160,0,730
81503,140,60,80,80,0,0,360
81504,170,200,120,160,160,320,1130
81505,190,160,120,80,160,0,710
81506,160,140,120,80,160,0,660
81507,190,100,120,160,160,0,730
81508,190,80,120,80,0,0,470
81509,190,140,80,160,320,0,890
81510,150,80,80,80,160,320,870
81511,170,140,160,160,160,0,790
81512,190,120,120,80,160,0,670
81513,220,160,160,160,320,0,1020
81514,210,140,160,160,0,0,670
81515,180,160,200,80,0,0,620
81516,230,160,240,160,160,0,950
81517,220,120,120,160,160,0,780
81518,220,160,120,240,160,0,900
81519,180,120,160,160,160,0,780
81520,200,60,40,0,0,0,300
81521,240,120,200,80,0,0,640
81522,180,80,120,80,0,0,460
81523,200,120,160,80,160,320,1040
81524,190,120,120,0,0,0,430
81525,220,180,120,80,0,0,600
81526,220,140,120,80,160,0,720
81527,160,80,40,80,0,0,360
81528,250,120,160,80,0,0,610
81529,230,160,120,0,0,0,510
81530,200,160,160,160,320,320,1320
81531,190,100,80,160,160,0,690
81532,160,180,160,160,160,320,1140
81533,140,80,80,80,0,0,380
81534,220,160,80,80,160,0,700
81535,180,60,80,160,320,320,1120
81536,140,120,160,160,0,0,580
81537,210,40,80,80,0,0,410
81538,160,120,40,0,0,0,320
81539,190,120,40,80,160,0,590
81540,280,200,160,240,0,0,880
81541,170,140,120,160,160,0,750
81542,210,140,160,160,160,0,830
81543,230,160,160,80,0,0,630
81544,190,160,80,80,160,320,990
81545,180,120,80,160,160,320,1020
81546,190,140,120,80,0,0,530
81547,190,100,160,160,160,320,1090
81548,180,100,120,80,160,0,640
81549,220,80,40,0,0,0,340
81550,170,120,120,0,0,0,410
81551,190,80,120,160,320,320,1190
81552,180,60,80,80,0,0,400
81553,190,120,80,80,160,320,950
81554,180,120,80,80,160,0,620
81555,200,160,160,160,0,0,680
81556,200,100,120,80,0,0,500
81557,230,100,40,0,0,0,370
81558,160,140,80,80,0,0,460
81559,210,160,80,80,0,0,530
81560,230,100,40,0,0,0,370
81561,230,100,80,80,0,0,490
81562,190,120,80,80,160,0,630
81563,180,120,120,80,0,0,500
81564,220,160,80,160,320,0,940
81565,200,100,120,160,0,0,580
81566,230,160,160,160,320,320,1350
81567,180,100,80,0,0,0,360
81568,200,120,120,80,160,0,680
81569,170,140,40,80,160,0,590
81570,200,140,80,160,160,320,1060
81571,190,180,120,80,0,0,570
81572,240,140,160,80,0,0,620
81573,220,100,160,0,0,0,480
81574,220,100,80,0,0,0,400
81575,170,140,120,160,160,0,750
81576,210,100,120,0,0,0,430
81577,210,80,80,80,0,0,450
81578,210,140,80,80,160,0,670
81579,200,100,120,80,160,0,660
81580,190,120,120,160,160,0,750
81581,200,120,120,240,160,0,840
81582,230,120,120,80,0,0,550
81583,220,140,40,80,0,0,480
81584,230,120,80,80,160,0,670
81585,180,120,120,160,320,0,900
81586,220,100,160,160,160,0,800
81587,150,80,80,80,160,0,550
81588,190,60,40,80,160,0,530
81589,200,120,80,80,160,320,960
81590,200,60,40,80,0,0,380
81591,210,120,120,80,0,0,530
81592,240,140,160,80,160,0,780
81593,210,100,120,160,320,0,910
81594,190,80,80,160,0,0,510
81595,190,60,80,80,0,0,410
81596,190,160,40,0,0,0,390
81597,190,100,120,160,160,0,730
81598,200,160,80,80,0,0,520
81599,210,100,40,0,0,0,350
81600,210,160,160,160,160,0,850
81601,190,120,200,240,160,0,910
81602,170,80,80,80,0,0,410
81603,220,160,80,0,0,0,460
81604,190,120,80,160,0,0,550
81605,210,120,80,0,0,0,410
81606,210,80,40,0,0,0,330
81607,200,160,120,160,160,0,800
81608,190,180,80,160,160,0,770
81609,180,140,120,160,0,0,600
81610,190,120,160,160,160,0,790
81611,200,80,80,80,0,0,440
81612,230,100,0,0,0,0,330
81613,220,160,120,160,0,0,660
81614,220,140,0,0,0,0,360
81615,190,140,120,160,160,0,770
81616,170,160,200,160,160,0,850
81617,230,100,120,160,0,0,610
81618,200,180,120,0,0,0,500
81619,250,140,160,160,320,0,1030
81620,230,140,120,160,320,0,970
81621,230,60,40,0,0,0,330
81622,220,140,160,240,160,0,920
81623,220,100,80,160,320,0,880
81624,240,180,160,80,160,0,820
81625,220,80,40,0,0,0,340
81626,200,80,80,80,160,0,600
81627,200,60,80,0,0,0,340
81628,170,120,160,160,160,0,770
81629,250,140,160,160,160,320,1190
81630,210,140,80,80,160,0,670
81631,180,140,160,240,320,0,1040
81632,210,100,160,240,160,0,870
81633,180,100,80,80,0,0,440
81634,200,120,160,160,0,0,640
81635,200,140,40,80,160,0,620
81636,190,100,80,80,0,0,450
81637,180,120,120,160,320,0,900
81638,200,80,80,80,160,0,600
81639,190,40,40,80,160,0,510
81640,170,120,120,80,160,0,650
81641,190,180,160,240,160,0,930
81642,190,120,120,80,160,0,670
81643,220,100,80,160,320,320,1200
81644,220,140,40,80,160,0,640
81645,150,60,80,160,320,0,770
81646,160,80,80,0,0,0,320
81647,180,140,160,160,320,0,960
81648,220,120,160,160,160,320,1140
81649,190,120,120,160,320,320,1230
81650,160,120,80,80,160,0,600
81651,190,120,80,160,320,0,870
81652,190,120,80,160,160,0,710
81653,220,140,80,160,320,320,1240
81654,210,200,80,0,0,0,490
81655,190,120,40,80,160,0,590
81656,230,100,80,80,160,0,650
81657,190,120,120,80,160,0,670
81658,160,140,120,160,160,320,1060
81659,250,160,120,240,320,320,1410
81660,200,140,120,80,0,0,540
81661,220,80,80,0,0,0,380
81662,210,140,120,0,0,0,470
81663,230,180,200,80,160,0,850
81664,210,100,40,0,0,0,350
81665,150,120,40,80,160,0,550
81666,180,100,80,160,160,320,1000
81667,210,140,120,160,0,0,630
81668,190,160,160,160,160,0,830
81669,210,120,120,160,160,320,1090
81670,250,160,120,160,160,320,1170
81671,240,120,40,80,0,0,480
81672,200,160,160,160,320,320,1320
81673,200,140,160,80,0,0,580
81674,150,100,120,80,160,320,930
81675,220,120,120,80,160,0,700
81676,200,120,120,80,160,0,680
81677,200,120,80,160,160,0,720
81678,200,100,80,80,160,0,620
81679,140,140,80,0,0,0,360
81680,210,140,160,240,160,0,910
81681,190,100,120,80,0,0,490
81682,220,80,80,160,0,0,540
81683,200,100,80,80,160,0,620
81684,200,100,80,80,160,0,620
81685,190,100,80,80,0,0,450
81686,210,200,120,240,160,0,930
81687,170,140,80,80,160,0,630
81688,170,140,160,80,0,0,550
81689,210,80,80,80,160,320,930
81690,250,160,120,160,160,0,850
81691,190,160,160,80,160,0,750
81692,210,160,160,240,160,0,930
81693,170,60,0,0,0,0,230
81694,230,180,160,80,160,0,810
81695,180,120,80,80,160,0,620
81696,190,180,120,160,160,0,810
81697,190,140,40,80,160,0,610
81698,180,120,80,80,160,0,620
81699,220,120,120,160,160,320,1100
81700,200,140,120,80,0,0,540
81701,210,120,80,80,0,0,490
81702,210,160,160,80,160,0,770
81703,210,140,160,160,160,0,830
81704,210,160,200,80,160,0,810
81705,230,180,40,80,160,0,690
81706,210,80,120,160,160,0,730
81707,260,160,40,80,160,320,1020
81708,180,80,120,160,160,0,700
81709,200,120,160,160,160,0,800
81710,210,120,200,160,0,0,690
81711,250,140,80,0,0,0,470
81712,190,140,200,240,320,0,1090
81713,200,120,120,80,0,0,520
81714,170,100,80,160,0,0,510
81715,140,100,120,80,0,0,440
81716,150,120,160,160,0,0,590
81717,230,140,120,80,0,0,570
81718,160,120,120,160,160,0,720
81719,220,140,160,160,320,320,1320
81720,210,140,80,80,160,320,990
81721,220,100,40,0,0,0,360
81722,180,100,40,0,0,0,320
81723,140,100,120,160,160,0,680
81724,210,120,120,0,0,0,450
81725,180,120,80,0,0,0,380
81726,200,120,160,160,160,0,800
81727,200,140,120,240,160,0,860
81728,220,200,120,80,160,0,780
81729,210,120,160,80,160,0,730
81730,180,100,160,160,160,0,760
81731,240,140,80,80,0,0,540
81732,220,180,80,80,0,0,560
81733,190,100,80,80,160,0,610
81734,190,120,80,80,0,0,470
81735,210,160,160,240,320,320,1410
81736,180,140,80,80,160,320,960
81737,190,180,120,160,0,0,650
81738,190,120,160,80,160,320,1030
81739,240,60,40,80,0,0,420
81740,180,100,80,80,0,0,440
81741,200,140,120,80,160,0,700
81742,180,120,40,80,160,0,580
81743,190,120,120,240,320,0,990
81744,190,80,40,0,0,0,310
81745,170,160,80,80,160,320,970
81746,170,120,40,0,0,0,330
81747,200,120,120,240,160,0,840
81748,210,120,120,80,160,0,690
81749,180,140,160,160,160,0,800
81750,160,120,120,160,320,320,1200
81751,180,140,120,160,160,0,760
81752,170,100,120,80,160,320,950
81753,210,120,40,80,0,0,450
81754,220,100,80,0,0,0,400
81755,180,120,120,80,160,0,660
81756,160,60,80,160,160,0,620
81757,170,120,80,80,160,0,610
81758,200,160,160,160,160,320,1160
81759,180,120,80,0,0,0,380
81760,160,120,0,0,0,0,280
81761,200,160,80,0,0,0,440
81762,190,80,120,80,160,0,630
81763,200,100,80,160,0,0,540
81764,140,60,40,0,0,0,240
81765,260,140,40,80,160,0,680
81766,220,140,120,160,320,0,960
81767,180,120,80,80,0,0,460
81768,220,120,120,80,160,0,700
81769,170,120,80,0,0,0,370
81770,190,140,160,240,160,0,890
81771,220,160,80,80,0,0,540
81772,230,60,0,0,0,0,290
81773,180,160,160,160,0,0,660
81774,160,100,120,80,0,0,460
81775,200,80,80,80,0,0,440
81776,240,160,80,160,160,320,1120
81777,210,100,80,160,160,0,710
81778,180,80,40,80,160,0,540
81779,180,100,80,80,0,0,440
81780,170,80,120,80,160,0,610
81781,220,80,80,160,160,0,700
81782,230,160,80,80,160,0,710
81783,210,100,120,80,160,320,990
81784,190,120,160,80,160,0,710
81785,150,60,80,80,160,0,530
81786,190,140,200,160,0,0,690
81787,190,100,80,80,160,320,930
81788,200,100,0,0,0,0,300
81789,170,180,160,240,320,0,1070
81790,200,120,160,80,160,320,1040
81791,230,160,80,80,160,0,710
81792,250,140,40,0,0,0,430
81793,220,140,160,80,160,0,760
81794,220,140,120,80,0,0,560
81795,240,80,80,160,160,0,720
81796,160,140,80,80,160,0,620
81797,230,200,200,0,0,0,630
81798,220,120,80,0,0,0,420
81799,200,100,40,80,160,0,580
81800,200,180,160,240,320,0,1100
81801,200,80,120,160,320,0,880
81802,210,140,120,80,160,0,710
81803,190,160,120,80,160,320,1030
81804,190,160,120,160,320,320,1270
81805,200,80,80,80,160,0,600
81806,180,140,80,160,160,0,720
81807,180,120,120,160,160,0,740
81808,160,140,120,80,160,320,980
81809,180,40,80,160,320,0,780
81810,160,120,40,80,160,0,560
81811,150,140,80,160,320,320,1170
81812,210,120,120,80,0,0,530
81813,180,60,80,80,0,0,400
81814,190,160,120,160,160,0,790
81815,180,100,120,160,0,0,560
81816,230,80,80,0,0,0,390
81817,220,200,200,80,0,0,700
81818,190,60,40,0,0,0,290
81819,190,100,160,160,160,0,770
81820,160,80,80,160,0,0,480
81821,150,80,40,0,0,0,270
81822,230,100,160,80,0,0,570
81823,200,120,120,80,160,0,680
81824,190,80,120,160,160,0,710
81825,190,140,80,80,160,0,650
81826,200,120,80,0,0,0,400
81827,180,180,120,240,320,0,1040
81828,200,120,80,80,160,0,640
81829,200,120,80,80,160,0,640
81830,170,120,80,80,0,0,450
81831,190,120,80,80,0,0,470
81832,190,60,120,80,160,0,610
81833,170,120,80,0,0,0,370
81834,220,160,120,80,160,0,740
81835,160,80,160,160,320,0,880
81836,230,80,80,0,0,0,390
81837,190,120,120,80,160,0,670
81838,190,100,80,80,160,0,610
81839,200,180,120,80,0,0,580
81840,160,100,80,80,160,0,580
81841,200,140,0,0,0,0,340
81842,210,120,160,240,320,320,1370
81843,220,120,120,80,160,0,700
81844,260,140,80,80,0,0,560
81845,170,140,80,80,160,0,630
81846,200,120,120,80,160,0,680
81847,220,140,160,160,160,0,840
81848,170,100,120,160,160,0,710
81849,220,180,120,160,160,0,840
81850,220,180,200,240,0,0,840
81851,170,100,160,80,160,0,670
81852,220,140,120,80,0,0,560
81853,170,120,80,0,0,0,370
81854,240,200,160,240,160,0,1000
81855,170,100,120,80,160,0,630
81856,190,80,0,0,0,0,270
81857,200,100,80,160,320,0,860
81858,220,140,120,80,0,0,560
81859,220,120,80,160,0,0,580
81860,180,80,120,160,320,320,1180
81861,160,160,160,80,160,0,720
81862,240,120,80,80,0,0,520
81863,200,100,120,80,160,0,660
81864,160,140,160,0,0,0,460
81865,160,80,120,160,160,0,680
81866,160,100,120,80,160,0,620
81867,190,60,80,80,0,0,410
81868,220,180,240,160,0,0,800
81869,200,80,80,160,320,320,1160
81870,190,140,120,0,0,0,450
81871,190,120,120,80,160,0,670
81872,180,180,120,0,0,0,480
81873,190,100,40,0,0,0,330
81874,200,120,120,0,0,0,440
81875,210,120,80,80,160,0,650
81876,210,120,80,80,160,0,650
81877,220,80,80,80,0,0,460
81878,200,160,120,0,0,0,480
81879,220,180,160,160,160,0,880
81880,210,80,120,160,0,0,570
81881,200,120,200,80,0,0,600
81882,230,140,120,80,160,0,730
81883,190,100,80,160,0,0,530
81884,230,140,200,240,160,0,970
81885,210,140,80,80,0,0,510
81886,210,140,80,0,0,0,430
81887,200,120,80,80,0,0,480
81888,200,40,0,0,0,0,240
81889,200,140,120,80,0,0,540
81890,200,140,160,160,0,0,660
81891,190,120,160,160,160,0,790
81892,180,160,120,80,160,0,700
81893,160,100,160,160,160,0,740
81894,180,140,120,160,160,0,760
81895,190,120,120,80,160,0,670
81896,200,80,40,80,160,0,560
81897,150,60,0,0,0,0,210
81898,180,160,80,80,0,0,500
81899,190,100,40,80,160,320,890
81900,200,100,120,160,0,0,580
81901,210,120,120,80,160,0,690
81902,260,120,160,80,0,0,620
81903,190,100,40,80,0,0,410
81904,180,160,200,320,160,0,1020
81905,220,140,120,80,160,0,720
81906,170,140,120,160,0,0,590
81907,180,120,120,80,0,0,500
81908,180,60,0,0,0,0,240
81909,190,120,40,80,0,0,430
81910,220,140,40,0,0,0,400
81911,190,160,80,80,0,0,510
81912,190,140,120,240,0,0,690
81913,190,140,160,160,160,0,810
81914,220,100,120,80,160,0,680
81915,150,100,80,80,160,0,570
81916,180,120,160,160,160,0,780
81917,220,120,80,80,160,0,660
81918,200,100,120,80,160,0,660
81919,190,60,80,80,0,0,410
81920,180,60,0,0,0,0,240
81921,160,100,80,80,160,0,580
81922,180,140,120,80,0,0,520
81923,170,120,80,80,160,0,610
81924,170,140,80,80,160,0,630
81925,150,160,160,80,0,0,550
81926,180,100,120,160,320,0,880
81927,180,160,120,160,320,0,940
81928,190,140,120,0,0,0,450
81929,200,140,40,80,160,0,620
81930,220,140,160,240,160,0,920
81931,220,60,40,80,160,0,560
81932,240,180,160,80,160,0,820
81933,220,120,80,0,0,0,420
81934,180,60,120,160,320,0,840
81935,190,180,40,0,0,0,410
81936,200,140,120,80,160,0,700
81937,180,140,80,80,160,0,640
81938,220,120,120,80,160,0,700
81939,190,100,120,160,0,0,570
81940,200,100,120,160,160,0,740
81941,200,120,80,160,320,0,880
81942,210,160,200,80,0,0,650
81943,170,60,40,80,0,0,350
81944,170,100,120,160,160,0,710
81945,240,120,120,0,0,0,480
81946,210,100,120,80,160,0,670
81947,240,120,120,160,160,0,800
81948,210,140,120,80,0,0,550
81949,230,160,80,0,0,0,470
81950,180,180,120,160,160,0,800
81951,190,100,120,160,160,0,730
81952,210,180,120,80,160,0,750
81953,250,120,40,80,160,320,970
81954,190,160,80,80,160,320,990
81955,220,180,120,160,160,0,840
81956,210,140,80,80,160,0,670
81957,240,100,0,0,0,0,340
81958,160,80,120,80,160,0,600
81959,170,140,120,0,0,0,430
81960,160,80,40,0,0,0,280
81961,130,80,120,80,160,0,570
81962,180,100,80,80,160,0,600
81963,210,20,40,80,160,0,510
81964,180,100,80,80,160,0,600
81965,160,100,120,160,160,0,700
81966,190,120,80,160,160,0,710
81967,210,140,80,80,160,0,670
81968,220,80,40,80,0,0,420
81969,180,140,40,0,0,0,360
81970,220,180,240,160,160,0,960
81971,180,100,0,0,0,0,280
81972,190,100,80,0,0,0,370
81973,240,140,120,80,160,0,740
81974,220,160,160,80,160,0,780
81975,210,140,40,0,0,0,390
81976,180,140,160,160,320,0,960
81977,190,140,0,0,0,0,330
81978,170,120,120,80,160,0,650
81979,200,140,120,80,160,0,700
81980,190,100,80,80,160,0,610
81981,160,160,80,160,0,0,560
81982,230,60,120,80,160,0,650
81983,210,80,40,0,0,0,330
81984,260,80,80,0,0,0,420
81985,210,120,120,240,160,0,850
81986,170,160,80,80,160,0,650
81987,250,140,80,80,0,0,550
81988,150,120,80,160,0,0,510
81989,150,120,200,240,160,0,870
81990,190,140,160,80,0,0,570
81991,180,200,160,240,320,0,1100
81992,200,140,120,160,160,320,1100
81993,190,100,80,80,160,0,610
81994,170,100,80,80,160,0,590
81995,200,100,80,0,0,0,380
81996,240,120,120,80,0,0,560
81997,150,60,80,80,0,0,370
81998,210,120,80,0,0,0,410
81999,220,140,80,80,160,0,680
82000,230,180,160,160,160,0,890
82001,180,100,160,160,160,0,760
82002,200,120,160,160,320,320,1280
82003,210,120,40,0,0,0,370
82004,190,140,120,80,0,0,530
82005,190,80,80,80,0,0,430
82006,190,120,160,80,160,0,710
82007,190,120,40,80,0,0,430
82008,210,120,160,80,160,0,730
82009,180,100,120,160,0,0,560
82010,110,100,120,80,0,0,410
82011,220,100,120,80,0,0,520
82012,200,120,160,80,160,320,1040
82013,160,100,120,160,160,0,700
82014,190,160,240,240,320,320,1470
82015,200,160,200,160,0,0,720
82016,220,140,160,80,160,0,760
82017,180,120,80,80,160,320,940
82018,220,200,200,240,0,0,860
82019,240,160,80,80,160,0,720
82020,180,120,80,80,160,320,940
82021,200,120,120,240,160,0,840
82022,190,120,120,80,160,0,670
82023,220,160,160,80,160,0,780
82024,190,160,80,80,160,0,670
82025,170,100,80,80,160,0,590
82026,200,120,80,80,0,0,480
82027,220,80,80,160,0,0,540
82028,180,100,200,160,160,0,800
82029,220,100,40,80,160,0,600
82030,220,180,200,160,160,0,920
82031,170,140,120,80,160,0,670
82032,170,100,80,0,0,0,350
82033,200,100,40,80,160,0,580
82034,210,120,120,80,160,0,690
82035,250,140,80,80,0,0,550
82036,220,120,120,160,160,320,1100
82037,200,160,120,160,320,0,960
82038,180,100,80,160,160,0,680
82039,230,180,160,80,160,0,810
82040,160,60,40,80,160,0,500
82041,220,120,160,160,160,0,820
82042,200,180,120,160,320,0,980
82043,170,100,80,0,0,0,350
82044,190,160,120,80,0,0,550
82045,210,140,160,160,320,0,990
82046,210,140,160,160,0,0,670
82047,210,180,200,240,320,320,1470
82048,230,140,160,160,160,0,850
82049,180,60,80,0,0,0,320
82050,190,160,120,80,0,0,550
82051,170,140,200,80,0,0,590
82052,230,160,160,160,160,0,870
82053,160,120,120,80,0,0,480
82054,170,140,160,160,0,0,630
82055,210,120,120,80,0,0,530
82056,230,120,120,160,160,0,790
82057,240,120,80,80,0,0,520
82058,240,180,240,160,320,0,1140
82059,230,120,120,80,160,0,710
82060,190,140,80,80,0,0,490
82061,190,140,120,80,0,0,530
82062,230,140,160,160,160,0,850
82063,200,160,80,160,320,0,920
82064,190,200,80,80,160,0,710
82065,190,140,200,160,0,0,690
82066,210,140,120,0,0,0,470
82067,180,140,120,80,160,0,680
82068,210,60,80,80,160,0,590
82069,170,100,80,80,160,0,590
82070,180,160,200,160,320,0,1020
82071,190,140,120,80,160,0,690
82072,200,100,80,80,160,0,620
82073,220,120,120,80,160,0,700
82074,210,140,200,240,0,0,790
82075,200,180,160,160,320,0,1020
82076,200,120,40,80,160,0,600
82077,140,180,120,80,160,0,680
82078,170,80,160,240,320,0,970
82079,180,140,120,80,0,0,520
82080,170,120,40,0,0,0,330
82081,220,140,120,80,160,0,720
82082,200,80,120,80,0,0,480
82083,210,160,160,80,160,0,770
82084,170,100,80,0,0,0,350
82085,220,120,120,0,0,0,460
82086,210,140,80,80,160,0,670
82087,200,160,160,80,160,0,760
82088,200,180,200,0,0,0,580
82089,250,220,80,80,160,0,790
82090,200,80,160,0,0,0,440
82091,220,80,80,160,320,0,860
82092,240,120,160,80,0,0,600
82093,180,120,120,80,0,0,500
82094,150,80,120,160,0,0,510
82095,150,60,0,0,0,0,210
82096,200,80,80,80,0,0,440
82097,160,80,120,160,0,0,520
82098,210,120,120,160,0,0,610
82099,190,80,0,0,0,0,270
82100,190,120,160,160,160,0,790
82101,180,120,120,80,0,0,500
82102,200,120,40,80,160,320,920
82103,220,200,160,160,160,320,1220
82104,200,120,40,80,160,0,600
82105,170,120,40,80,160,0,570
82106,210,100,120,160,320,320,1230
82107,180,140,120,160,160,0,760
82108,190,120,160,80,0,0,550
82109,180,140,120,80,160,0,680
82110,240,120,120,80,160,0,720
82111,170,100,80,160,160,0,670
82112,170,80,120,80,0,0,450
82113,160,80,80,80,160,0,560
82114,170,120,160,160,320,0,930
82115,180,140,80,0,0,0,400
82116,210,40,40,80,160,0,530
82117,180,100,40,80,160,0,560
82118,210,120,160,240,160,0,890
82119,180,100,120,80,0,0,480
82120,210,80,160,240,160,0,850
82121,190,80,120,160,160,0,710
82122,240,100,40,0,0,0,380
82123,160,100,80,0,0,0,340
82124,180,160,40,80,160,0,620
82125,180,120,160,160,160,320,1100
82126,220,140,160,160,160,0,840
82127,220,140,120,80,160,0,720
82128,230,140,0,0,0,0,370
82129,150,100,120,0,0,0,370
82130,180,140,80,80,160,0,640
82131,220,160,120,160,160,0,820
82132,200,80,80,160,160,0,680
82133,160,60,40,0,0,0,260
82134,210,140,160,160,320,320,1310
82135,220,180,160,80,0,0,640
82136,210,180,160,160,320,320,1350
82137,190,140,160,160,160,0,810
82138,180,120,120,0,0,0,420
82139,180,100,80,0,0,0,360
82140,180,140,80,0,0,0,400
82141,200,120,120,160,160,0,760
82142,180,100,40,80,160,0,560
82143,180,140,200,240,0,0,760
82144,200,160,160,160,160,0,840
82145,220,160,80,0,0,0,460
82146,220,120,120,0,0,0,460
82147,180,120,80,160,160,320,1020
82148,210,160,120,160,160,0,810
82149,200,140,120,80,160,0,700
82150,200,180,200,160,160,0,900
82151,200,80,80,80,160,0,600
82152,190,80,80,160,0,0,510
82153,200,140,80,160,160,0,740
82154,170,140,200,240,320,0,1070
82155,180,60,80,0,0,0,320
82156,180,100,160,160,0,0,600
82157,200,120,40,0,0,0,360
82158,230,140,120,160,160,0,810
82159,200,120,160,240,320,320,1360
82160,170,120,120,160,160,0,730
82161,180,160,160,160,0,0,660
82162,180,180,80,0,0,0,440
82163,180,120,120,80,160,0,660
82164,210,140,80,0,0,0,430
82165,220,140,160,160,160,0,840
82166,160,120,40,80,0,0,400
82167,160,100,120,160,160,0,700
82168,200,120,80,80,160,320,960
82169,140,140,200,80,160,0,720
82170,200,160,120,80,160,0,720
82171,170,140,120,160,160,0,750
82172,200,140,160,80,0,0,580
82173,230,120,160,160,160,0,830
82174,220,120,80,80,0,0,500
82175,200,140,0,0,0,0,340
82176,190,120,120,80,160,0,670
82177,220,140,0,0,0,0,360
82178,220,180,200,80,160,320,1160
82179,210,120,80,80,160,0,650
82180,220,100,120,240,160,0,840
82181,190,180,160,80,160,0,770
82182,200,80,80,0,0,0,360
82183,170,80,80,80,160,0,570
82184,220,80,80,160,0,0,540
82185,220,160,120,80,160,0,740
82186,230,180,160,80,160,0,810
82187,240,140,80,0,0,0,460
82188,220,140,120,80,160,0,720
82189,240,180,160,0,0,0,580
82190,160,100,80,80,160,0,580
82191,200,180,200,160,160,0,900
82192,210,200,80,0,0,0,490
82193,180,140,160,240,320,320,1360
82194,170,80,80,80,160,0,570
82195,230,120,120,160,0,0,630
82196,160,100,80,160,160,0,660
82197,220,180,200,80,0,0,680
82198,210,140,120,80,0,0,550
82199,170,140,80,80,160,0,630
82200,240,100,40,80,0,0,460
82201,210,140,120,80,160,320,1030
82202,190,100,0,0,0,0,290
82203,170,100,120,160,160,0,710
82204,190,100,80,80,160,0,610
82205,190,80,40,80,0,0,390
82206,220,140,80,0,0,0,440
82207,200,140,80,80,160,0,660
82208,200,140,80,80,0,0,500
82209,180,160,160,80,0,0,580
82210,210,140,120,160,160,0,790
82211,200,120,80,160,0,0,560
82212,220,140,160,160,160,0,840
82213,190,140,160,240,160,0,890
82214,180,80,40,0,0,0,300
82215,200,120,80,80,0,0,480
82216,190,120,120,80,0,0,510
82217,230,180,80,80,0,0,570
82218,210,80,80,80,0,0,450
82219,160,100,80,80,160,320,900
82220,190,120,120,240,320,0,990
82221,140,80,0,0,0,0,220
82222,190,120,80,80,160,0,630
82223,190,140,120,80,0,0,530
82224,220,100,80,80,0,0,480
82225,190,160,80,0,0,0,430
82226,200,160,120,160,320,320,1280
82227,180,100,120,160,160,0,720
82228,170,160,120,240,320,0,1010
82229,200,160,80,0,0,0,440
82230,220,100,80,160,160,0,720
82231,220,120,120,160,160,0,780
82232,220,180,160,160,320,0,1040
82233,210,160,80,80,160,0,690
82234,190,100,40,0,0,0,330
82235,210,120,80,80,0,0,490
82236,180,100,120,80,160,0,640
82237,190,100,0,0,0,0,290
82238,220,100,120,160,320,320,1240
82239,190,120,80,80,160,0,630
82240,210,80,0,0,0,0,290
82241,210,160,160,80,160,0,770
82242,220,120,120,240,160,0,860
82243,220,100,80,0,0,0,400
82244,200,180,160,80,0,0,620
82245,180,120,120,160,160,320,1060
82246,190,80,80,0,0,0,350
82247,160,160,80,80,160,320,960
82248,190,140,80,80,0,0,490
82249,190,120,80,80,160,0,630
82250,250,160,160,160,160,0,890
82251,210,160,80,0,0,0,450
82252,210,120,120,80,160,320,1010
82253,250,140,160,160,160,0,870
82254,200,160,120,160,160,0,800
82255,200,100,80,80,160,0,620
82256,190,120,40,0,0,0,350
82257,210,100,80,0,0,0,390
82258,220,120,120,80,160,0,700
82259,200,120,40,80,160,0,600
82260,200,140,80,160,320,0,900
82261,220,100,120,80,0,0,520
82262,210,160,120,240,160,0,890
82263,230,120,80,80,0,0,510
82264,170,80,80,160,160,0,650
82265,160,100,80,160,320,0,820
82266,190,80,40,80,0,0,390
82267,240,180,120,80,0,0,620
82268,230,140,120,160,160,0,810
82269,190,140,80,160,320,0,890
82270,140,120,200,160,160,0,780
82271,190,120,80,160,160,0,710
82272,180,100,120,0,0,0,400
82273,200,100,80,160,0,0,540
82274,180,140,80,160,320,0,880
82275,180,120,120,80,0,0,500
82276,200,140,120,80,160,320,1020
82277,200,120,120,160,320,0,920
82278,210,120,160,240,320,320,1370
82279,200,120,120,80,160,0,680
82280,190,160,200,160,320,0,1030
82281,230,80,40,80,160,0,590
82282,180,80,40,0,0,0,300
82283,210,80,120,0,0,0,410
82284,230,100,40,0,0,0,370
82285,200,160,80,80,0,0,520
82286,200,100,160,240,160,0,860
82287,170,160,120,80,0,0,530
82288,150,140,120,80,160,0,650
82289,190,180,160,160,320,0,1010
82290,210,120,40,80,160,0,610
82291,200,120,120,240,160,0,840
82292,230,120,80,80,0,0,510
82293,190,140,120,240,0,0,690
82294,170,120,120,80,160,0,650
82295,200,140,200,80,160,0,780
82296,170,120,80,160,0,0,530
82297,170,120,120,80,160,0,650
82298,200,80,40,0,0,0,320
82299,220,120,120,80,0,0,540
82300,220,120,40,0,0,0,380
82301,210,120,80,160,320,0,890
82302,210,180,120,160,320,0,990
82303,220,160,80,80,160,0,700
82304,180,140,160,80,0,0,560
82305,250,180,160,160,160,320,1230
82306,190,60,80,160,160,0,650
82307,200,160,160,80,0,0,600
82308,200,120,120,80,160,0,680
82309,210,140,120,80,160,0,710
82310,190,100,0,0,0,0,290
82311,180,120,80,80,160,320,940
82312,150,100,160,160,160,320,1050
82313,190,100,80,80,160,0,610
82314,180,120,120,240,160,320,1140
82315,180,140,160,160,0,0,640
82316,190,120,160,160,160,0,790
82317,190,120,80,80,160,0,630
82318,190,120,40,80,160,0,590
82319,110,80,80,80,0,0,350
82320,220,160,120,80,160,0,740
82321,190,100,80,160,320,320,1170
82322,160,60,40,80,160,0,500
82323,200,140,120,80,0,0,540
82324,220,100,40,80,160,0,600
82325,200,120,120,160,320,0,920
82326,180,140,160,160,320,0,960
82327,200,160,200,160,160,0,880
82328,160,100,120,80,160,0,620
82329,170,120,120,0,0,0,410
82330,180,120,120,80,160,0,660
82331,200,140,80,80,0,0,500
82332,200,120,120,0,0,0,440
82333,220,160,160,80,160,0,780
82334,190,120,120,80,0,0,510
82335,180,120,80,80,160,0,620
82336,220,80,80,0,0,0,380
82337,210,60,40,0,0,0,310
82338,170,180,240,160,320,0,1070
82339,180,120,40,80,160,320,900
82340,200,120,40,0,0,0,360
82341,200,100,120,160,160,0,740
82342,170,80,120,240,160,0,770
82343,230,140,120,160,160,320,1130
82344,210,140,160,0,0,0,510
82345,160,80,120,80,0,0,440
82346,200,140,160,240,160,0,900
82347,170,140,120,80,0,0,510
82348,200,80,120,160,160,320,1040
82349,200,120,120,80,160,0,680
82350,180,80,80,80,160,0,580
82351,170,120,40,80,0,0,410
82352,210,100,40,80,160,0,590
82353,220,100,80,0,0,0,400
82354,200,100,80,0,0,0,380
82355,170,80,160,80,0,0,490
82356,190,120,40,0,0,0,350
82357,240,140,120,80,0,0,580
82358,170,80,120,160,160,0,690
82359,170,140,120,160,160,0,750
82360,150,80,80,80,160,0,550
82361,170,140,80,80,0,0,470
82362,190,140,80,0,0,0,410
82363,190,140,120,80,0,0,530
82364,210,140,120,240,160,320,1190
82365,230,120,120,160,160,0,790
82366,160,140,80,80,160,0,620
82367,170,80,40,0,0,0,290
82368,160,120,200,80,160,0,720
82369,210,120,160,240,320,0,1050
82370,200,100,160,160,320,320,1260
82371,210,80,120,80,0,0,490
82372,170,80,40,80,160,0,530
82373,180,60,80,160,320,0,800
82374,210,140,40,0,0,0,390
82375,190,100,80,0,0,0,370
82376,230,120,80,160,160,0,750
82377,190,60,80,80,160,320,890
82378,200,160,200,240,160,0,960
82379,200,80,120,160,160,0,720
82380,210,80,80,80,160,0,610
82381,180,160,120,80,160,0,700
82382,150,100,120,80,0,0,450
82383,230,120,160,0,0,0,510
82384,230,160,160,80,160,0,790
82385,190,160,80,80,160,0,670
82386,190,120,120,80,0,0,510
82387,170,100,80,160,160,320,990
82388,220,100,80,80,0,0,480
82389,220,120,120,160,320,0,940
82390,180,100,120,80,160,0,640
82391,190,100,80,160,0,0,530
82392,210,80,40,80,160,0,570
82393,180,100,40,0,0,0,320
82394,220,140,80,80,0,0,520
82395,240,100,80,80,0,0,500
82396,160,100,160,160,320,0,900
82397,200,120,40,0,0,0,360
82398,180,100,160,160,320,0,920
82399,230,120,80,160,160,0,750
82400,230,140,80,80,160,0,690
82401,200,120,80,80,160,320,960
82402,220,160,120,80,0,0,580
82403,230,60,40,80,0,0,410
82404,170,100,120,80,160,0,630
82405,180,80,80,160,320,0,820
82406,210,100,80,80,160,0,630
82407,230,100,80,80,160,320,970
82408,210,60,120,160,160,0,710
82409,200,60,40,0,0,0,300
82410,220,140,160,160,0,0,680
82411,180,140,200,160,320,320,1320
82412,170,140,80,80,160,0,630
82413,210,140,120,160,320,0,950
82414,180,140,160,80,0,0,560
82415,180,80,40,80,160,0,540
82416,250,140,120,80,0,0,590
82417,180,80,120,240,160,320,1100
82418,210,120,120,80,160,0,690
82419,220,100,40,0,0,0,360
82420,210,60,40,80,160,320,870
82421,210,80,120,240,160,0,810
82422,190,80,120,80,0,0,470
82423,210,120,160,160,160,0,810
82424,220,140,160,240,160,0,920
82425,180,160,120,160,0,0,620
82426,210,140,80,160,0,0,590
82427,230,120,160,80,160,320,1070
82428,200,180,160,240,160,320,1260
82429,190,140,80,0,0,0,410
82430,230,80,80,160,320,0,870
82431,210,100,160,240,160,320,1190
82432,170,100,120,80,160,320,950
82433,210,100,120,80,0,0,510
82434,190,80,80,160,160,0,670
82435,240,120,40,80,160,0,640
82436,170,80,80,160,0,0,490
82437,210,160,160,80,0,0,610
82438,150,100,120,80,0,0,450
82439,170,140,120,160,160,0,750
82440,220,120,160,80,160,320,1060
82441,170,100,120,0,0,0,390
82442,200,120,120,0,0,0,440
82443,160,100,40,80,160,320,860
82444,200,160,120,80,0,0,560
82445,220,120,120,80,160,0,700
82446,170,120,80,80,160,0,610
82447,190,100,80,0,0,0,370
82448,200,140,160,80,160,320,1060
82449,230,120,80,80,160,0,670
82450,260,120,200,80,160,0,820
82451,200,180,120,160,160,0,820
82452,230,100,200,80,160,320,1090
82453,160,180,160,160,320,0,980
82454,180,140,160,80,0,0,560
82455,180,140,80,160,160,0,720
82456,200,80,80,80,0,0,440
82457,210,100,80,0,0,0,390
82458,210,120,40,80,0,0,450
82459,180,140,120,160,0,0,600
82460,170,100,0,0,0,0,270
82461,150,80,120,160,320,0,830
82462,180,60,0,0,0,0,240
82463,180,120,80,160,320,0,860
82464,200,140,120,160,160,0,780
82465,200,160,120,80,0,0,560
82466,200,140,120,0,0,0,460
82467,180,160,160,160,160,0,820
82468,210,100,80,0,0,0,390
82469,210,160,120,80,0,0,570
82470,200,80,120,80,0,0,480
82471,180,120,40,0,0,0,340
82472,140,140,40,0,0,0,320
82473,210,200,160,80,0,0,650
82474,220,120,120,80,160,320,1020
82475,170,120,120,80,160,0,650
82476,200,100,120,80,160,0,660
82477,190,140,160,240,320,0,1050
82478,200,100,120,160,160,320,1060
82479,150,40,80,80,160,320,830
82480,190,140,160,240,320,0,1050
82481,190,120,120,160,0,0,590
82482,190,120,120,0,0,0,430
82483,200,100,80,160,160,0,700
82484,180,140,80,160,320,0,880
82485,140,160,40,80,0,0,420
82486,210,140,160,80,160,0,750
82487,210,160,200,80,160,0,810
82488,220,140,80,80,0,0,520
82489,130,60,40,0,0,0,230
82490,200,100,160,80,0,0,540
82491,170,80,80,160,320,0,810
82492,210,100,80,160,320,320,1190
82493,190,120,80,80,0,0,470
82494,210,220,160,80,160,0,830
82495,160,100,120,80,0,0,460
82496,190,60,0,0,0,0,250
82497,190,80,120,0,0,0,390
82498,190,140,160,80,160,0,730
82499,220,140,120,0,0,0,480
82500,210,140,80,80,0,0,510
82501,200,100,80,80,0,0,460
82502,220,120,120,160,160,0,780
82503,170,100,120,80,0,0,470
82504,200,100,120,80,160,320,980
82505,200,100,80,0,0,0,380
82506,230,160,200,160,160,0,910
82507,160,100,0,0,0,0,260
82508,220,200,200,160,160,0,940
82509,240,180,120,160,0,0,700
82510,200,160,200,160,160,0,880
82511,200,120,160,160,160,0,800
82512,200,80,80,0,0,0,360
82513,180,120,120,160,160,0,740
82514,210,120,120,80,0,0,530
82515,180,140,80,0,0,0,400
82516,220,120,200,240,320,320,1420
82517,200,80,40,80,0,0,400
82518,150,80,40,80,0,0,350
82519,190,80,80,0,0,0,350
82520,180,80,120,160,160,320,1020
82521,190,140,160,160,0,0,650
82522,160,120,120,80,160,0,640
82523,230,140,160,80,160,0,770
82524,200,120,80,80,160,320,960
82525,210,100,40,80,160,0,590
82526,170,80,80,80,0,0,410
82527,180,100,80,160,320,0,840
82528,250,100,80,80,160,320,990
82529,190,120,80,160,320,320,1190
82530,210,180,120,160,320,0,990
82531,210,120,160,240,160,320,1210
82532,220,100,80,80,160,0,640
82533,200,140,240,80,160,0,820
82534,160,80,40,80,0,0,360
82535,230,140,80,80,160,320,1010
82536,190,80,120,80,160,0,630
82537,140,80,80,80,160,0,540
82538,170,160,120,0,0,0,450
82539,150,80,80,0,0,0,310
82540,200,140,160,240,160,0,900
82541,210,120,120,80,0,0,530
82542,220,120,120,160,160,0,780
82543,190,160,120,240,160,0,870
82544,190,60,80,160,160,0,650
82545,220,160,80,80,160,0,700
82546,210,140,120,160,0,0,630
82547,210,100,80,80,160,0,630
82548,210,140,120,80,0,0,550
82549,190,120,120,240,160,0,830
82550,170,100,120,160,320,0,870
82551,180,140,120,80,0,0,520
82552,220,200,80,0,0,0,500
82553,150,140,160,160,160,0,770
82554,170,100,160,160,320,320,1230
82555,180,100,0,0,0,0,280
82556,230,160,160,160,0,0,710
82557,200,160,160,80,0,0,600
82558,220,120,120,160,160,320,1100
82559,170,120,80,80,160,0,610
82560,220,80,0,0,0,0,300
82561,180,100,80,80,0,0,440
82562,180,140,0,0,0,0,320
82563,210,120,80,80,160,0,650
82564,180,140,80,80,0,0,480
82565,190,140,120,0,0,0,450
82566,190,40,0,0,0,0,230
82567,180,60,40,80,160,0,520
82568,230,80,120,160,160,0,750
82569,190,100,120,240,0,0,650
82570,190,160,40,80,160,0,630
82571,180,80,0,0,0,0,260
82572,200,140,160,160,160,320,1140
82573,200,120,40,0,0,0,360
82574,260,80,40,80,160,0,620
82575,200,100,80,80,160,0,620
82576,200,140,120,160,160,0,780
82577,170,120,160,160,0,0,610
82578,160,100,80,80,160,0,580
82579,180,100,80,160,160,0,680
82580,210,100,80,0,0,0,390
82581,240,160,80,80,160,0,720
82582,240,120,120,80,160,0,720
82583,210,120,200,240,320,320,1410
82584,190,120,80,80,160,320,950
82585,230,180,200,240,320,320,1490
82586,190,120,40,80,0,0,430
82587,180,80,80,80,160,0,580
82588,200,120,40,80,160,0,600
82589,190,140,120,160,320,0,930
82590,190,180,160,80,160,0,770
82591,240,100,80,80,0,0,500
82592,160,100,160,80,0,0,500
82593,210,140,80,160,0,0,590
82594,180,180,80,80,0,0,520
82595,170,160,160,240,0,0,730
82596,210,80,80,80,160,0,610
82597,190,120,120,160,160,320,1070
82598,210,100,120,80,160,0,670
82599,220,200,160,80,0,0,660
82600,200,80,160,160,160,0,760
82601,190,100,80,0,0,0,370
82602,150,80,120,80,0,0,430
82603,190,140,80,0,0,0,410
82604,190,140,120,80,0,0,530
82605,210,80,40,0,0,0,330
82606,200,180,240,160,160,0,940
82607,220,200,120,80,160,0,780
82608,170,140,80,80,0,0,470
82609,190,80,40,0,0,0,310
82610,200,120,80,0,0,0,400
82611,170,80,160,160,320,0,890
82612,150,140,160,160,320,320,1250
82613,200,120,40,80,160,0,600
82614,220,140,120,0,0,0,480
82615,170,80,40,80,0,0,370
82616,170,160,200,80,0,0,610
82617,190,120,160,160,160,0,790
82618,200,180,160,80,0,0,620
82619,170,60,40,80,160,0,510
82620,150,80,0,0,0,0,230
82621,200,80,80,160,160,320,1000
82622,180,120,80,160,160,0,700
82623,200,160,120,80,160,0,720
82624,220,120,120,0,0,0,460
82625,200,100,120,0,0,0,420
82626,180,120,160,160,0,0,620
82627,190,100,80,0,0,0,370
82628,190,100,40,80,160,0,570
82629,210,160,80,160,320,0,930
82630,230,120,80,80,160,0,670
82631,210,100,80,80,160,0,630
82632,200,180,200,240,320,320,1460
82633,150,120,120,160,320,0,870
82634,200,140,120,240,160,0,860
82635,170,120,120,0,0,0,410
82636,170,120,80,0,0,0,370
82637,180,60,80,80,160,0,560
82638,210,100,160,80,0,0,550
82639,220,120,80,160,0,0,580
82640,170,160,160,160,160,0,810
82641,190,100,120,0,0,0,410
82642,210,180,120,80,160,0,750
82643,200,140,80,80,160,320,980
82644,190,120,80,160,160,320,1030
82645,200,120,80,80,0,0,480
82646,210,140,80,160,160,0,750
82647,190,120,120,80,0,0,510
82648,220,180,200,240,160,0,1000
82649,180,180,80,80,160,0,680
82650,200,100,160,80,160,0,700
82651,150,60,40,0,0,0,250
82652,170,60,80,80,0,0,390
82653,230,140,80,160,160,0,770
82654,190,60,40,0,0,0,290
82655,220,180,200,240,320,0,1160
82656,200,80,40,80,160,0,560
82657,220,140,120,80,160,0,720
82658,190,160,120,160,320,0,950
82659,190,100,40,80,0,0,410
82660,180,100,40,80,160,0,560
82661,250,180,160,80,160,0,830
82662,180,100,80,80,0,0,440
82663,170,140,160,240,320,0,1030
82664,190,60,40,80,160,0,530
82665,180,120,120,80,160,0,660
82666,190,120,80,0,0,0,390
82667,150,140,120,80,160,0,650
82668,220,160,160,80,0,0,620
82669,250,160,160,0,0,0,570
82670,160,100,120,160,160,0,700
82671,180,120,80,0,0,0,380
82672,150,140,80,80,160,0,610
82673,200,100,120,160,160,0,740
82674,190,160,200,80,160,0,790
82675,210,120,40,80,160,0,610
82676,180,100,120,80,160,0,640
82677,220,160,160,0,0,0,540
82678,200,120,160,80,0,0,560
82679,190,100,160,160,160,0,770
82680,220,100,80,160,320,0,880
82681,190,100,80,80,160,0,610
82682,180,60,80,80,0,0,400
82683,180,120,120,160,160,0,740
82684,200,120,120,80,160,0,680
82685,190,140,120,240,160,0,850
82686,200,160,120,80,0,0,560
82687,230,140,120,80,160,0,730
82688,190,120,80,80,160,0,630
82689,200,60,120,80,0,0,460
82690,180,120,120,80,0,0,500
82691,180,100,120,160,160,0,720
82692,190,120,160,160,320,0,950
82693,190,120,40,0,0,0,350
82694,230,120,80,80,160,320,990
82695,200,40,0,0,0,0,240
82696,160,120,80,80,160,0,600
82697,190,180,120,160,0,0,650
82698,220,120,40,0,0,0,380
82699,210,180,200,80,160,0,830
82700,210,140,160,160,320,0,990
82701,200,120,40,0,0,0,360
82702,190,100,160,80,160,320,1010
82703,210,120,160,80,160,320,1050
82704,220,140,160,160,0,0,680
82705,230,140,80,160,160,0,770
82706,220,100,40,80,160,0,600
82707,170,100,80,0,0,0,350
82708,180,140,80,0,0,0,400
82709,220,180,200,240,160,320,1320
82710,180,80,80,80,160,0,580
82711,180,80,80,160,160,320,980
82712,190,140,120,80,160,0,690
82713,170,120,40,80,160,0,570
82714,200,120,160,160,160,0,800
82715,190,80,40,80,160,0,550
82716,200,80,120,240,160,0,800
82717,220,120,40,0,0,0,380
82718,220,200,200,160,160,0,940
82719,190,120,80,80,0,0,470
82720,220,160,160,240,320,0,1100
82721,190,140,80,160,320,0,890
82722,210,120,120,80,160,0,690
82723,200,160,120,80,160,0,720
82724,190,120,160,80,0,0,550
82725,200,180,160,0,0,0,540
82726,170,100,80,80,160,0,590
82727,220,120,160,80,160,320,1060
82728,190,60,40,0,0,0,290
82729,220,80,160,160,160,0,780
82730,170,140,80,80,160,0,630
82731,210,80,120,160,320,0,890
82732,220,140,80,80,0,0,520
82733,170,80,80,80,160,0,570
82734,190,120,200,240,320,0,1070
82735,140,120,120,160,320,0,860
82736,210,120,120,80,160,0,690
82737,190,140,80,160,160,0,730
82738,220,160,120,0,0,0,500
82739,190,100,80,160,320,320,1170
82740,200,160,160,160,0,0,680
82741,250,160,120,80,160,0,770
82742,230,140,80,0,0,0,450
82743,230,200,240,160,160,0,990
82744,220,160,160,160,0,0,700
82745,180,80,80,0,0,0,340
82746,160,100,120,80,0,0,460
82747,190,120,120,160,160,320,1070
82748,210,80,40,80,160,0,570
82749,230,160,160,160,160,0,870
82750,200,200,120,160,320,0,1000
82751,140,120,160,160,160,0,740
82752,210,160,200,240,320,0,1130
82753,230,80,80,0,0,0,390
82754,190,100,80,80,160,320,930
82755,200,80,120,160,320,320,1200
82756,180,140,120,80,0,0,520
82757,250,180,120,160,320,0,1030
82758,200,100,120,160,160,0,740
82759,200,120,80,160,160,320,1040
82760,170,120,0,0,0,0,290
82761,180,40,40,80,0,0,340
82762,240,120,160,80,0,0,600
82763,200,140,120,80,0,0,540
82764,200,120,40,80,160,0,600
82765,150,80,120,160,160,0,670
82766,180,120,40,80,160,0,580
82767,190,140,80,80,160,0,650
82768,180,140,120,160,160,320,1080
82769,230,120,120,160,160,320,1110
82770,200,140,160,160,160,0,820
82771,230,160,120,160,320,0,990
82772,200,60,0,0,0,0,260
82773,220,160,120,160,0,0,660
82774,220,140,80,0,0,0,440
82775,190,120,80,80,0,0,470
82776,240,140,120,160,320,0,980
82777,200,100,40,0,0,0,340
82778,210,120,120,160,320,320,1250
82779,200,80,40,80,160,0,560
82780,230,200,160,160,0,0,750
82781,190,140,160,160,160,320,1130
82782,190,160,160,160,320,320,1310
82783,190,120,120,240,0,0,670
82784,160,160,40,0,0,0,360
82785,210,160,160,160,160,0,850
82786,180,100,40,0,0,0,320
82787,190,140,120,160,320,320,1250
82788,190,160,80,0,0,0,430
82789,120,100,80,80,160,0,540
82790,170,100,40,0,0,0,310
82791,230,80,40,0,0,0,350
82792,210,100,80,0,0,0,390
82793,210,120,120,160,160,320,1090
82794,180,100,120,240,320,0,960
82795,190,60,80,0,0,0,330
82796,260,140,40,80,0,0,520
82797,190,80,120,160,160,320,1030
82798,210,160,120,160,160,0,810
82799,230,80,0,0,0,0,310
82800,170,100,80,160,0,0,510
82801,200,80,40,0,0,0,320
82802,210,120,40,80,160,0,610
82803,230,100,160,160,320,320,1290
82804,200,100,80,0,0,0,380
82805,200,160,40,80,0,0,480
82806,200,140,160,80,160,0,740
82807,220,140,120,80,160,320,1040
82808,210,100,80,160,0,0,550
82809,160,80,120,160,320,320,1160
82810,220,100,80,80,0,0,480
82811,190,60,80,160,160,0,650
82812,200,120,160,0,0,0,480
82813,170,100,80,160,320,320,1150
82814,210,160,120,160,160,0,810
82815,200,140,200,80,160,320,1100
82816,170,140,80,80,160,0,630
82817,210,140,80,80,160,320,990
82818,210,120,120,80,0,0,530
82819,230,120,80,160,160,0,750
82820,230,120,120,160,160,0,790
82821,160,100,80,80,0,0,420
82822,200,140,80,80,160,0,660
82823,240,160,80,80,160,0,720
82824,190,120,80,80,0,0,470
82825,180,100,120,240,320,0,960
82826,210,120,80,80,160,320,970
82827,190,160,160,160,0,0,670
82828,170,80,80,80,0,0,410
82829,170,120,120,80,160,0,650
82830,230,120,120,80,160,0,710
82831,240,140,80,160,0,0,620
82832,190,140,40,80,160,0,610
82833,200,120,120,80,160,320,1000
82834,200,120,80,80,0,0,480
82835,210,140,80,160,160,320,1070
82836,230,120,80,160,160,0,750
82837,230,200,80,80,160,320,1070
82838,190,80,120,80,160,0,630
82839,250,120,120,160,160,320,1130
82840,220,160,80,80,160,0,700
82841,200,120,80,80,160,0,640
82842,220,160,120,160,0,0,660
82843,240,120,160,160,320,320,1320
82844,180,160,160,240,320,0,1060
82845,160,100,120,0,0,0,380
82846,220,100,80,80,0,0,480
82847,160,100,120,80,160,0,620
82848,230,160,120,0,0,0,510
82849,190,80,80,160,320,0,830
82850,180,80,40,80,160,0,540
82851,220,180,120,80,160,0,760
82852,190,160,200,160,320,320,1350
82853,190,120,120,240,160,0,830
82854,200,120,80,0,0,0,400
82855,240,120,120,80,0,0,560
82856,230,180,200,160,0,0,770
82857,180,120,120,0,0,0,420
82858,170,80,160,160,160,0,730
82859,150,100,160,80,160,320,970
82860,260,180,120,160,160,320,1200
82861,210,120,80,80,160,0,650
82862,180,120,80,80,0,0,460
82863,230,120,120,80,0,0,550
82864,220,140,80,80,160,0,680
82865,260,160,40,80,160,320,1020
82866,190,140,160,80,160,0,730
82867,200,120,80,0,0,0,400
82868,220,40,40,80,160,0,540
82869,180,140,120,80,0,0,520
82870,220,160,160,160,320,0,1020
82871,210,140,120,0,0,0,470
82872,210,140,80,160,160,0,750
82873,190,120,120,80,160,0,670
82874,180,120,120,80,160,320,980
82875,170,100,40,80,0,0,390
82876,220,120,40,80,160,0,620
82877,190,120,40,80,160,0,590
82878,210,120,120,160,0,0,610
82879,180,180,80,80,160,0,680
82880,180,120,80,80,0,0,460
82881,280,180,160,160,160,320,1260
82882,170,120,40,80,0,0,410
82883,200,200,120,0,0,0,520
82884,200,140,120,160,160,0,780
82885,230,160,200,80,160,0,830
82886,210,140,80,0,0,0,430
82887,180,100,0,0,0,0,280
82888,190,140,120,160,160,0,770
82889,200,140,160,80,0,0,580
82890,170,120,160,240,160,320,1170
82891,180,80,160,80,160,0,660
82892,210,140,120,160,160,0,790
82893,220,100,80,160,160,0,720
82894,230,140,40,80,160,320,970
82895,120,140,160,160,160,0,740
82896,200,140,160,80,0,0,580
82897,190,80,40,0,0,0,310
82898,170,80,80,80,0,0,410
82899,210,220,160,160,320,0,1070
82900,240,180,120,80,160,0,780
82901,190,80,40,0,0,0,310
82902,190,100,120,240,160,0,810
82903,220,180,80,0,0,0,480
82904,210,100,40,80,160,0,590
82905,200,160,80,0,0,0,440
82906,190,160,120,80,0,0,550
82907,190,100,40,80,160,0,570
82908,190,160,80,80,160,0,670
82909,180,140,40,80,160,320,920
82910,190,180,120,160,160,0,810
82911,190,120,120,80,160,0,670
82912,180,120,80,80,0,0,460
82913,160,140,200,240,160,0,900
82914,220,160,200,240,160,0,980
82915,180,140,0,0,0,0,320
82916,190,120,80,80,0,0,470
82917,180,100,80,80,160,0,600
82918,190,160,80,160,320,0,910
82919,200,180,160,160,160,320,1180
82920,170,120,120,80,0,0,490
82921,180,140,80,80,0,0,480
82922,210,120,120,80,160,0,690
82923,190,60,80,80,160,320,890
82924,210,140,160,160,160,320,1150
82925,170,100,80,0,0,0,350
82926,220,120,80,0,0,0,420
82927,170,100,160,160,160,0,750
82928,220,140,160,160,160,0,840
82929,240,100,160,160,0,0,660
82930,170,140,120,80,160,0,670
82931,210,80,80,0,0,0,370
82932,210,80,40,80,160,0,570
82933,200,100,120,160,160,320,1060
82934,220,100,80,80,160,0,640
82935,190,140,160,240,320,0,1050
82936,170,120,80,0,0,0,370
82937,210,160,120,80,0,0,570
82938,230,160,80,80,160,320,1030
82939,200,100,80,80,160,0,620
82940,240,80,80,160,160,320,1040
82941,190,120,120,0,0,0,430
82942,230,100,80,80,0,0,490
82943,200,120,120,160,320,0,920
82944,210,120,80,80,160,0,650
82945,190,100,80,80,0,0,450
82946,220,220,120,80,0,0,640
82947,170,100,80,0,0,0,350
82948,200,140,160,240,320,0,1060
82949,210,100,120,80,0,0,510
82950,170,120,80,80,160,0,610
82951,230,100,40,0,0,0,370
82952,190,140,160,80,0,0,570
82953,190,140,80,0,0,0,410
82954,210,120,120,80,0,0,530
82955,220,80,40,80,160,0,580
82956,180,180,160,160,320,0,1000
82957,180,80,120,160,160,0,700
82958,200,140,120,160,160,0,780
82959,220,80,80,80,160,0,620
82960,160,80,40,80,0,0,360
82961,200,80,80,80,0,0,440
82962,210,120,120,160,160,0,770
82963,220,180,120,160,320,320,1320
82964,220,160,160,80,160,0,780
82965,200,160,120,80,160,0,720
82966,220,180,120,160,160,0,840
82967,190,180,80,80,160,0,690
82968,250,200,160,240,160,0,1010
82969,190,100,80,80,0,0,450
82970,170,120,160,0,0,0,450
82971,200,120,0,0,0,0,320
82972,170,80,120,80,160,0,610
82973,210,120,120,80,160,0,690
82974,180,140,160,80,160,0,720
82975,190,120,160,80,0,0,550
82976,160,140,40,80,160,0,580
82977,210,160,120,80,160,0,730
82978,230,120,80,80,0,0,510
82979,200,140,160,80,160,0,740
82980,210,160,160,240,0,0,770
82981,230,80,120,240,160,0,830
82982,200,100,80,80,160,0,620
82983,180,100,80,80,0,0,440
82984,210,160,120,160,160,0,810
82985,170,120,160,80,0,0,530
82986,200,140,160,0,0,0,500
82987,170,120,80,160,160,0,690
82988,150,80,40,0,0,0,270
82989,230,80,80,80,0,0,470
82990,210,140,120,160,0,0,630
82991,200,140,80,80,160,0,660
82992,240,160,120,80,0,0,600
82993,200,100,80,160,160,0,700
82994,210,140,120,160,160,0,790
82995,180,100,120,160,160,0,720
82996,220,140,160,160,320,320,1320
82997,210,140,160,160,320,0,990
82998,170,140,80,80,0,0,470
82999,160,120,40,0,0,0,320
83000,200,120,120,80,160,0,680
83001,220,140,160,240,320,0,1080
83002,190,160,200,160,160,0,870
83003,200,160,120,80,160,0,720
83004,250,100,80,0,0,0,430
83005,200,120,120,160,160,0,760
83006,220,120,80,80,160,0,660
83007,180,140,80,160,320,320,1200
83008,250,160,40,0,0,0,450
83009,140,120,120,80,0,0,460
83010,200,140,80,80,160,0,660
83011,200,140,80,80,0,0,500
83012,160,100,120,80,160,0,620
83013,140,80,0,0,0,0,220
83014,200,100,80,0,0,0,380
83015,130,100,40,80,160,320,830
83016,220,180,200,80,0,0,680
83017,150,100,160,240,160,0,810
83018,220,160,160,160,160,320,1180
83019,210,100,120,160,160,0,750
83020,190,100,120,80,0,0,490
83021,230,120,80,80,160,0,670
83022,160,80,80,80,160,0,560
83023,160,100,80,0,0,0,340
83024,210,80,80,80,0,0,450
83025,210,200,160,160,160,0,890
83026,180,80,120,80,160,320,940
83027,180,100,120,0,0,0,400
83028,220,120,120,160,320,0,940
83029,180,140,120,80,160,0,680
83030,240,140,120,80,0,0,580
83031,210,120,120,0,0,0,450
83032,200,80,80,80,0,0,440
83033,170,80,120,240,160,0,770
83034,220,120,120,160,160,0,780
83035,190,120,80,0,0,0,390
83036,170,140,80,0,0,0,390
83037,150,120,160,160,160,320,1070
83038,170,120,160,160,320,0,930
83039,190,160,80,0,0,0,430
83040,210,180,120,80,0,0,590
83041,190,140,120,160,320,0,930
83042,250,120,0,0,0,0,370
83043,230,140,160,240,320,320,1410
83044,190,100,80,80,0,0,450
83045,160,100,40,80,160,320,860
83046,170,60,40,80,160,0,510
83047,180,120,80,160,160,0,700
83048,190,100,80,160,320,0,850
83049,240,120,80,0,0,0,440
83050,180,100,160,240,320,320,1320
83051,200,140,80,80,0,0,500
83052,160,80,40,0,0,0,280
83053,190,140,120,160,160,0,770
83054,200,80,120,160,320,320,1200
83055,180,120,120,160,160,320,1060
83056,220,120,80,80,160,0,660
83057,240,120,120,80,160,0,720
83058,180,120,200,160,160,0,820
83059,170,140,120,80,160,0,670
83060,200,120,80,80,160,0,640
83061,170,100,80,0,0,0,350
83062,210,120,120,80,0,0,530
83063,180,80,160,240,160,0,820
83064,180,120,80,80,160,0,620
83065,210,180,120,80,0,0,590
83066,230,200,200,80,160,0,870
83067,190,160,80,0,0,0,430
83068,210,180,160,160,320,0,1030
83069,200,140,120,80,0,0,540
83070,210,100,80,80,0,0,470
83071,230,80,120,160,0,0,590
83072,230,160,80,80,0,0,550
83073,180,80,80,160,160,0,660
83074,210,80,80,80,160,0,610
83075,200,140,160,160,320,320,1300
83076,170,140,120,80,0,0,510
83077,170,100,120,80,160,0,630
83078,190,120,80,80,0,0,470
83079,210,80,40,0,0,0,330
83080,170,180,120,80,160,320,1030
83081,220,140,120,80,0,0,560
83082,180,140,120,80,0,0,520
83083,200,100,40,80,0,0,420
83084,160,100,120,80,160,0,620
83085,190,100,120,160,320,320,1210
83086,190,120,200,240,320,320,1390
83087,190,120,120,160,160,0,750
83088,180,120,160,160,0,0,620
83089,220,100,0,0,0,0,320
83090,210,100,0,0,0,0,310
83091,220,80,80,80,160,0,620
83092,210,60,80,80,160,0,590
83093,140,120,120,160,0,0,540
83094,240,120,120,80,160,0,720
83095,210,140,120,160,0,0,630
83096,220,140,80,160,160,0,760
83097,220,80,40,0,0,0,340
83098,170,100,80,0,0,0,350
83099,200,140,160,160,160,0,820
83100,220,220,80,160,320,0,1000
83101,190,80,40,0,0,0,310
83102,190,100,120,240,320,320,1290
83103,200,100,80,160,160,0,700
83104,240,120,80,160,160,0,760
83105,160,100,120,160,160,320,1020
83106,170,140,40,80,0,0,430
83107,170,80,80,80,160,0,570
83108,220,100,0,0,0,0,320
83109,220,140,160,160,160,320,1160
83110,170,60,80,0,0,0,310
83111,170,120,80,160,160,0,690
83112,170,140,120,80,160,0,670
83113,210,140,160,160,160,0,830
83114,230,140,80,80,160,320,1010
83115,180,80,120,0,0,0,380
83116,170,80,0,0,0,0,250
83117,200,120,160,240,160,0,880
83118,190,180,40,80,160,320,970
83119,200,140,120,80,0,0,540
83120,170,140,120,80,0,0,510
83121,180,120,40,0,0,0,340
83122,220,140,120,160,160,0,800
83123,190,120,120,80,160,0,670
83124,220,80,40,0,0,0,340
83125,210,120,0,0,0,0,330
83126,200,120,120,160,0,0,600
83127,140,140,80,80,0,0,440
83128,220,140,160,160,160,0,840
83129,230,80,80,160,320,320,1190
83130,190,60,80,80,160,0,570
83131,140,80,120,160,0,0,500
83132,180,140,120,160,0,0,600
83133,220,120,80,80,160,320,980
83134,210,140,200,160,0,0,710
83135,210,80,80,80,0,0,450
83136,180,100,80,80,160,0,600
83137,190,120,40,80,160,0,590
83138,150,80,80,80,160,0,550
83139,190,120,80,160,320,0,870
83140,190,180,40,80,160,0,650
83141,210,140,160,160,0,0,670
83142,210,100,40,80,0,0,430
83143,210,180,80,80,160,320,1030
83144,190,120,80,80,0,0,470
83145,220,140,120,80,160,0,720
83146,170,140,80,80,160,320,950
83147,230,120,120,160,0,0,630
83148,200,140,80,0,0,0,420
83149,210,160,160,160,0,0,690
83150,170,60,40,0,0,0,270
83151,210,140,120,160,160,0,790
83152,210,100,80,80,0,0,470
83153,190,140,160,160,0,0,650
83154,210,140,120,160,160,0,790
83155,190,80,40,80,0,0,390
83156,180,100,80,80,160,320,920
83157,230,140,120,80,0,0,570
83158,180,100,160,240,160,0,840
83159,210,80,80,0,0,0,370
83160,200,160,200,80,160,0,800
83161,170,100,120,80,160,0,630
83162,190,80,80,80,0,0,430
83163,180,120,120,160,320,320,1220
83164,200,120,120,160,160,0,760
83165,190,80,40,80,160,0,550
83166,220,140,200,240,160,0,960
83167,170,100,120,160,0,0,550
83168,200,100,120,160,0,0,580
83169,160,120,120,80,160,0,640
83170,150,60,40,0,0,0,250
83171,200,140,120,160,160,0,780
83172,210,80,40,80,0,0,410
83173,190,100,80,0,0,0,370
83174,240,100,120,160,160,0,780
83175,210,120,120,160,320,320,1250
83176,200,160,120,160,160,0,800
83177,210,100,40,80,160,0,590
83178,210,180,160,160,0,0,710
83179,200,120,80,160,320,0,880
83180,210,60,80,0,0,0,350
83181,160,40,0,0,0,0,200
83182,150,100,160,240,160,0,810
83183,190,140,200,160,0,0,690
83184,160,140,120,160,160,0,740
83185,190,120,120,0,0,0,430
83186,210,200,120,80,160,320,1090
83187,200,120,120,80,160,0,680
83188,180,100,120,160,160,0,720
83189,210,120,80,160,320,0,890
83190,190,140,120,80,160,320,1010
83191,150,100,160,80,160,0,650
83192,210,80,80,160,320,0,850
83193,220,160,40,80,0,0,500
83194,180,80,40,0,0,0,300
83195,170,120,80,160,160,0,690
83196,150,60,80,0,0,0,290
83197,190,120,160,240,160,0,870
83198,200,140,160,80,160,0,740
83199,190,120,120,160,320,320,1230
83200,210,140,120,160,160,0,790
83201,170,100,120,80,160,320,950
83202,170,120,40,80,160,0,570
83203,190,140,80,80,0,0,490
83204,240,140,160,240,160,0,940
83205,180,160,80,80,0,0,500
83206,180,160,80,160,320,0,900
83207,190,140,80,80,0,0,490
83208,210,240,240,160,160,320,1330
83209,220,100,40,80,160,0,600
83210,180,140,160,160,160,0,800
83211,160,80,40,0,0,0,280
83212,200,140,160,80,160,320,1060
83213,210,100,120,160,0,0,590
83214,180,80,80,160,0,0,500
83215,200,100,120,160,160,0,740
83216,190,120,120,160,320,320,1230
83217,220,120,120,80,160,0,700
83218,210,120,40,0,0,0,370
83219,220,80,160,80,0,0,540
83220,170,100,120,160,0,0,550
83221,200,120,200,160,160,0,840
83222,170,80,0,0,0,0,250
83223,170,100,120,80,160,0,630
83224,180,140,160,80,0,0,560
83225,200,160,120,80,160,0,720
83226,240,200,80,80,160,320,1080
83227,180,200,120,160,160,0,820
83228,230,120,80,80,160,0,670
83229,140,80,80,80,160,0,540
83230,230,140,80,80,160,0,690
83231,200,140,120,80,0,0,540
83232,170,100,120,160,160,0,710
83233,160,120,80,0,0,0,360
83234,140,120,40,80,0,0,380
83235,210,120,80,80,160,0,650
83236,180,100,120,80,0,0,480
83237,200,100,160,80,160,320,1020
83238,140,120,160,160,320,320,1220
83239,180,100,80,80,160,0,600
83240,210,140,40,0,0,0,390
83241,200,120,120,160,320,0,920
83242,200,200,200,160,160,0,920
83243,180,160,160,160,0,0,660
83244,160,80,160,160,320,0,880
83245,200,80,80,0,0,0,360
83246,190,100,120,160,160,0,730
83247,250,180,120,80,160,0,790
83248,200,180,120,160,320,0,980
83249,220,180,200,160,160,0,920
83250,200,120,160,160,160,0,800
83251,160,100,80,0,0,0,340
83252,250,160,120,0,0,0,530
83253,220,100,80,80,160,0,640
83254,190,60,80,160,0,0,490
83255,180,120,80,80,160,0,620
83256,200,100,40,0,0,0,340
83257,200,120,80,160,160,0,720
83258,210,120,160,80,160,0,730
83259,180,120,120,160,160,0,740
83260,210,100,80,0,0,0,390
83261,170,80,120,80,160,0,610
83262,180,160,160,160,160,0,820
83263,160,120,80,80,0,0,440
83264,240,160,160,160,160,0,880
83265,200,100,120,160,160,0,740
83266,210,120,200,160,320,320,1330
83267,200,120,160,240,160,0,880
83268,160,60,80,160,160,0,620
83269,160,140,120,160,320,0,900
83270,160,100,80,80,0,0,420
83271,150,60,80,0,0,0,290
83272,180,120,120,80,0,0,500
83273,220,120,80,0,0,0,420
83274,220,160,80,160,0,0,620
83275,190,120,40,80,160,0,590
83276,170,140,160,240,160,0,870
83277,150,80,120,160,160,0,670
83278,190,80,80,80,160,0,590
83279,150,80,40,80,160,0,510
83280,190,140,80,0,0,0,410
83281,190,160,80,0,0,0,430
83282,180,100,120,80,0,0,480
83283,220,100,80,80,160,0,640
83284,200,160,80,0,0,0,440
83285,180,180,160,160,160,320,1160
83286,200,160,120,160,160,0,800
83287,230,100,80,80,160,0,650
83288,200,80,120,80,0,0,480
83289,250,120,120,80,160,0,730
83290,200,80,40,80,0,0,400
83291,200,160,120,240,320,320,1360
83292,190,160,200,240,160,0,950
83293,220,140,120,160,0,0,640
83294,220,140,120,0,0,0,480
83295,180,120,120,80,160,0,660
83296,210,180,120,80,160,320,1070
83297,150,100,80,80,0,0,410
83298,160,80,80,80,160,0,560
83299,200,120,40,0,0,0,360
83300,230,140,120,80,160,0,730
83301,220,120,80,80,0,0,500
83302,250,140,40,0,0,0,430
83303,200,120,80,160,320,320,1200
83304,190,120,120,160,160,0,750
83305,190,120,120,0,0,0,430
83306,190,140,160,160,160,320,1130
83307,180,140,120,0,0,0,440
83308,200,120,120,80,160,0,680
83309,200,120,160,80,0,0,560
83310,170,100,120,80,160,0,630
83311,240,140,120,160,0,0,660
83312,180,120,80,80,0,0,460
83313,180,80,80,0,0,0,340
83314,220,180,200,0,0,0,600
83315,210,100,120,80,160,0,670
83316,180,120,120,160,320,320,1220
83317,200,140,80,80,160,320,980
83318,160,100,120,80,0,0,460
83319,190,140,160,0,0,0,490
83320,160,60,120,160,160,0,660
83321,200,120,80,160,0,0,560
83322,210,120,160,240,160,0,890
83323,190,180,160,80,160,320,1090
83324,200,120,120,80,0,0,520
83325,160,140,120,0,0,0,420
83326,200,140,120,80,0,0,540
83327,190,120,40,0,0,0,350
83328,180,80,120,80,0,0,460
83329,180,80,0,0,0,0,260
83330,200,80,120,160,160,320,1040
83331,220,80,40,80,0,0,420
83332,190,120,120,80,0,0,510
83333,250,140,160,240,0,0,790
83334,150,140,160,160,160,0,770
83335,180,140,120,160,0,0,600
83336,210,80,80,0,0,0,370
83337,160,100,80,80,160,0,580
83338,190,120,40,0,0,0,350
83339,230,100,80,0,0,0,410
83340,210,220,200,80,0,0,710
83341,170,120,160,160,0,0,610
83342,190,120,160,80,0,0,550
83343,220,120,120,160,320,0,940
83344,210,100,80,80,160,0,630
83345,230,160,160,80,160,320,1110
83346,160,120,80,160,160,0,680
83347,200,160,120,80,160,0,720
83348,200,140,200,160,160,0,860
83349,220,120,120,80,0,0,540
83350,220,160,160,160,160,0,860
83351,210,100,120,160,320,0,910
83352,210,140,160,80,0,0,590
83353,180,80,80,160,160,0,660
83354,180,100,120,160,0,0,560
83355,240,160,160,80,160,320,1120
83356,220,120,160,80,160,0,740
83357,240,80,120,160,0,0,600
83358,190,120,80,0,0,0,390
83359,190,120,120,80,0,0,510
83360,160,80,80,160,160,0,640
83361,210,100,120,80,0,0,510
83362,210,120,80,160,160,0,730
83363,230,120,80,80,0,0,510
83364,210,160,120,80,160,0,730
83365,190,60,80,80,0,0,410
83366,210,200,160,80,160,0,810
83367,170,160,80,0,0,0,410
83368,180,80,80,80,0,0,420
83369,190,140,120,240,320,320,1330
83370,190,100,80,0,0,0,370
83371,210,100,120,160,160,0,750
83372,240,160,200,160,160,0,920
83373,200,120,80,80,160,0,640
83374,220,120,40,80,0,0,460
83375,210,120,160,240,160,0,890
83376,220,180,80,0,0,0,480
83377,180,80,120,80,0,0,460
83378,220,140,160,160,160,0,840
83379,150,100,160,80,160,0,650
83380,180,140,120,80,160,0,680
83381,170,100,120,160,320,0,870
83382,180,120,120,0,0,0,420
83383,180,120,120,160,160,0,740
83384,200,120,80,80,0,0,480
83385,180,140,80,80,0,0,480
83386,210,140,120,80,160,0,710
83387,170,120,80,0,0,0,370
83388,190,100,80,160,160,0,690
83389,180,140,120,160,0,0,600
83390,190,120,200,0,0,0,510
83391,160,100,120,160,0,0,540
83392,220,160,40,80,160,320,980
83393,180,100,120,80,0,0,480
83394,190,100,120,240,320,320,1290
83395,180,140,80,160,320,0,880
83396,240,100,120,80,0,0,540
83397,150,100,120,80,160,0,610
83398,170,160,160,160,160,0,810
83399,200,80,120,80,0,0,480
83400,190,120,120,80,0,0,510
83401,250,140,120,80,160,0,750
83402,170,140,120,80,0,0,510
83403,170,120,160,0,0,0,450
83404,190,140,160,0,0,0,490
83405,240,140,160,160,320,0,1020
83406,180,100,80,160,320,0,840
83407,220,180,80,0,0,0,480
83408,200,140,120,160,320,320,1260
83409,180,40,0,0,0,0,220
83410,180,120,120,0,0,0,420
83411,170,60,40,80,160,0,510
83412,210,40,0,0,0,0,250
83413,210,120,80,0,0,0,410
83414,210,160,120,80,0,0,570
83415,200,100,80,0,0,0,380
83416,200,100,0,0,0,0,300
83417,190,140,160,80,0,0,570
83418,190,100,80,160,0,0,530
83419,210,140,160,240,320,320,1390
83420,230,120,120,160,160,0,790
83421,210,120,80,160,0,0,570
83422,210,80,40,80,160,0,570
83423,220,120,40,0,0,0,380
83424,210,140,80,160,160,0,750
83425,180,160,120,80,160,0,700
83426,180,100,80,80,160,320,920
83427,190,120,160,160,320,0,950
83428,190,160,120,80,160,0,710
83429,200,100,80,160,320,320,1180
83430,200,40,80,80,160,0,560
83431,200,160,120,160,160,0,800
83432,160,100,80,160,160,0,660
83433,190,100,120,160,320,320,1210
83434,220,120,120,0,0,0,460
83435,190,140,120,80,160,0,690
83436,200,120,120,80,160,0,680
83437,230,120,80,80,160,320,990
83438,210,160,120,80,160,0,730
83439,250,180,160,80,0,0,670
83440,220,120,120,80,0,0,540
83441,160,100,0,0,0,0,260
83442,180,140,120,240,160,0,840
83443,210,160,200,240,160,320,1290
83444,190,80,40,80,0,0,390
83445,190,120,80,0,0,0,390
83446,180,180,120,80,160,0,720
83447,230,180,120,80,160,320,1090
83448,170,80,120,0,0,0,370
83449,160,120,160,160,160,0,760
83450,190,120,120,80,0,0,510
83451,210,140,120,160,160,0,790
83452,130,120,160,160,160,0,730
83453,200,120,160,160,320,0,960
83454,230,160,160,160,160,0,870
83455,200,120,40,80,160,320,920
83456,220,180,160,80,160,0,800
83457,200,80,40,80,160,0,560
83458,190,200,40,0,0,0,430
83459,190,140,80,0,0,0,410
83460,190,60,80,160,320,0,810
83461,200,120,0,0,0,0,320
83462,200,120,0,0,0,0,320
83463,190,140,120,160,0,0,610
83464,210,60,80,80,160,0,590
83465,190,120,80,80,160,0,630
83466,200,80,40,80,160,0,560
83467,200,180,120,0,0,0,500
83468,190,180,80,0,0,0,450
83469,220,100,80,80,0,0,480
83470,230,120,120,80,160,0,710
83471,220,120,120,0,0,0,460
83472,180,180,160,80,160,320,1080
83473,180,80,80,80,160,320,900
83474,230,140,40,80,0,0,490
83475,210,100,200,240,160,0,910
83476,210,120,80,0,0,0,410
83477,200,40,40,0,0,0,280
83478,190,120,160,160,320,0,950
83479,210,180,120,160,160,0,830
83480,170,200,120,80,160,0,730
83481,160,100,80,0,0,0,340
83482,190,120,80,0,0,0,390
83483,230,120,80,80,160,0,670
83484,200,140,160,240,320,320,1380
83485,190,120,120,160,160,0,750
83486,170,80,40,80,0,0,370
83487,210,140,40,80,160,0,630
83488,230,140,40,0,0,0,410
83489,180,140,160,160,0,0,640
83490,200,160,40,0,0,0,400
83491,220,180,160,160,320,0,1040
83492,220,120,80,80,160,320,980
83493,190,180,200,80,0,0,650
83494,140,120,120,160,320,0,860
83495,210,120,40,0,0,0,370
83496,200,140,120,80,160,0,700
83497,180,60,120,80,0,0,440
83498,200,60,80,80,160,0,580
83499,170,80,0,0,0,0,250
83500,180,140,40,0,0,0,360
83501,190,100,80,0,0,0,370
83502,220,140,80,0,0,0,440
83503,270,180,160,240,320,320,1490
83504,190,100,120,160,320,0,890
83505,190,140,80,160,320,0,890
83506,220,160,80,80,160,320,1020
83507,170,100,80,80,160,0,590
83508,230,120,40,80,160,0,630
83509,210,160,120,160,0,0,650
83510,240,160,80,80,160,0,720
83511,200,160,160,240,160,0,920
83512,220,180,120,0,0,0,520
83513,200,140,80,80,160,320,980
83514,170,120,120,160,160,0,730
83515,200,140,120,80,0,0,540
83516,210,140,40,80,160,0,630
83517,170,80,40,80,160,0,530
83518,110,80,120,160,320,320,1110
83519,220,140,120,160,160,0,800
83520,170,100,40,0,0,0,310
83521,230,80,80,80,160,320,950
83522,210,180,160,80,160,0,790
83523,180,80,120,80,160,0,620
83524,230,200,80,80,160,0,750
83525,180,140,160,80,0,0,560
83526,150,80,40,80,160,0,510
83527,190,100,120,240,160,0,810
83528,220,200,200,240,160,0,1020
83529,220,100,80,80,160,320,960
83530,200,60,40,80,160,0,540
83531,250,140,120,80,0,0,590
83532,170,140,80,80,160,0,630
83533,180,140,120,80,160,0,680
83534,190,100,120,80,0,0,490
83535,180,60,80,160,320,0,800
83536,200,140,120,160,160,0,780
83537,180,140,120,160,160,0,760
83538,160,120,80,80,0,0,440
83539,180,160,120,80,0,0,540
83540,220,120,80,0,0,0,420
83541,210,120,160,160,160,0,810
83542,170,100,120,240,160,0,790
83543,200,120,120,80,0,0,520
83544,230,220,200,160,160,0,970
83545,220,120,120,160,320,0,940
83546,200,100,80,80,0,0,460
83547,200,120,40,0,0,0,360
83548,190,160,120,160,160,0,790
83549,210,160,120,160,160,0,810
83550,190,140,160,160,160,0,810
83551,220,160,40,0,0,0,420
83552,210,140,160,0,0,0,510
83553,190,60,80,80,160,320,890
83554,220,120,160,160,0,0,660
83555,200,160,120,160,160,0,800
83556,180,140,200,160,320,0,1000
83557,170,100,120,160,0,0,550
83558,220,120,120,160,320,0,940
83559,160,160,160,0,0,0,480
83560,230,160,160,160,160,0,870
83561,190,160,160,0,0,0,510
83562,200,120,40,0,0,0,360
83563,260,200,120,80,160,0,820
83564,180,120,120,160,160,0,740
83565,170,120,120,80,160,0,650
83566,240,160,160,80,0,0,640
83567,150,100,160,160,160,0,730
83568,180,100,120,160,160,0,720
83569,220,100,80,0,0,0,400
83570,200,80,80,160,160,0,680
83571,210,120,80,160,0,0,570
83572,170,220,200,160,160,0,910
83573,210,120,80,80,160,0,650
83574,150,100,80,160,0,0,490
83575,180,160,160,80,0,0,580
83576,220,160,160,160,160,0,860
83577,160,120,160,240,160,320,1160
83578,150,120,120,80,160,0,630
83579,210,120,160,160,0,0,650
83580,220,160,160,240,160,0,940
83581,120,40,40,0,0,0,200
83582,150,120,80,80,160,0,590
83583,230,100,120,160,160,0,770
83584,170,200,160,80,0,0,610
83585,210,120,120,160,160,320,1090
83586,220,140,40,80,0,0,480
83587,200,100,120,80,160,0,660
83588,220,120,120,80,0,0,540
83589,220,120,160,80,0,0,580
83590,190,140,80,80,160,0,650
83591,170,140,120,240,320,0,990
83592,190,120,160,240,160,0,870
83593,230,180,40,0,0,0,450
83594,220,140,80,80,160,0,680
83595,190,140,80,0,0,0,410
83596,180,60,40,80,160,0,520
83597,210,180,120,160,160,320,1150
83598,250,120,160,240,160,0,930
83599,200,120,80,0,0,0,400
83600,200,60,0,0,0,0,260
83601,180,120,80,80,160,0,620
83602,200,160,240,240,160,0,1000
83603,180,80,40,80,0,0,380
83604,220,160,120,160,320,320,1300
83605,240,100,160,160,0,0,660
83606,220,160,40,80,0,0,500
83607,210,120,120,80,160,0,690
83608,210,120,120,160,160,320,1090
83609,180,100,80,80,160,0,600
83610,220,120,120,160,320,0,940
83611,230,140,120,160,160,0,810
83612,180,100,120,160,320,0,880
83613,220,120,80,160,160,0,740
83614,230,160,120,80,0,0,590
83615,180,80,80,80,0,0,420
83616,170,140,160,80,0,0,550
83617,210,120,120,160,320,0,930
83618,230,120,120,80,160,0,710
83619,170,100,40,0,0,0,310
83620,240,200,120,160,160,0,880
83621,180,120,40,80,160,320,900
83622,220,180,160,160,0,0,720
83623,190,120,80,160,0,0,550
83624,170,100,120,160,160,0,710
83625,220,160,120,160,160,320,1140
83626,220,220,160,160,160,0,920
83627,180,40,40,0,0,0,260
83628,230,140,160,160,0,0,690
83629,230,220,160,160,0,0,770
83630,160,80,80,160,160,0,640
83631,230,120,120,160,0,0,630
83632,210,120,120,160,320,0,930
83633,180,120,120,160,320,320,1220
83634,220,140,120,0,0,0,480
83635,220,180,80,160,320,0,960
83636,210,60,120,160,160,0,710
83637,170,120,80,80,160,0,610
83638,250,100,40,80,160,0,630
83639,190,120,80,0,0,0,390
83640,180,140,40,0,0,0,360
83641,180,160,80,0,0,0,420
83642,200,120,160,80,160,0,720
83643,250,180,120,80,160,0,790
83644,210,100,80,160,160,0,710
83645,180,80,40,80,160,0,540
83646,160,80,40,80,160,0,520
83647,160,120,160,160,0,0,600
83648,190,140,120,160,160,0,770
83649,220,80,40,80,0,0,420
83650,230,180,40,0,0,0,450
83651,170,120,120,160,160,0,730
83652,180,180,240,240,160,0,1000
83653,200,100,80,0,0,0,380
83654,190,120,160,0,0,0,470
83655,220,120,120,80,0,0,540
83656,160,120,120,80,0,0,480
83657,210,140,160,160,160,0,830
83658,210,160,200,80,160,0,810
83659,210,40,40,0,0,0,290
83660,190,100,80,80,160,0,610
83661,220,160,160,80,0,0,620
83662,170,140,80,80,0,0,470
83663,170,80,120,160,320,0,850
83664,170,80,120,80,160,0,610
83665,220,140,160,80,160,0,760
83666,170,120,200,240,160,0,890
83667,230,140,200,240,160,320,1290
83668,200,160,80,80,160,0,680
83669,170,80,120,0,0,0,370
83670,160,120,120,80,160,0,640
83671,210,120,160,80,0,0,570
83672,170,160,120,240,320,0,1010
83673,250,180,120,160,160,0,870
83674,160,60,40,80,160,0,500
83675,190,160,120,80,160,0,710
83676,230,100,120,80,0,0,530
83677,210,120,80,160,160,0,730
83678,180,120,80,80,160,0,620
83679,180,80,40,0,0,0,300
83680,190,80,40,0,0,0,310
83681,230,140,80,80,160,320,1010
83682,140,140,80,80,0,0,440
83683,200,140,80,80,160,0,660
83684,150,100,40,80,160,0,530
83685,230,100,80,160,160,0,730
83686,200,160,160,80,160,0,760
83687,160,120,40,80,160,0,560
83688,230,160,120,160,320,320,1310
83689,190,140,200,80,0,0,610
83690,180,160,120,80,160,0,700
83691,160,80,80,160,160,0,640
83692,180,160,120,240,160,0,860
83693,240,160,120,160,160,0,840
83694,220,120,240,160,0,0,740
83695,190,80,160,80,160,0,670
83696,210,120,120,240,160,0,850
83697,220,120,80,80,160,0,660
83698,230,120,120,160,320,0,950
83699,230,120,120,160,160,320,1110
83700,150,100,160,160,160,0,730
83701,180,160,160,80,160,0,740
83702,180,140,80,160,0,0,560
83703,220,60,40,80,160,0,560
83704,130,80,160,240,160,0,770
83705,160,100,120,80,160,0,620
83706,200,160,200,160,320,0,1040
83707,160,120,120,160,160,0,720
83708,220,160,80,0,0,0,460
83709,170,80,40,0,0,0,290
83710,170,80,80,80,0,0,410
83711,180,120,120,160,160,0,740
83712,210,120,40,80,0,0,450
83713,200,100,80,160,160,0,700
83714,190,180,200,80,160,0,810
83715,180,60,80,0,0,0,320
83716,200,120,160,160,320,0,960
83717,180,100,80,80,0,0,440
83718,200,160,160,80,160,0,760
83719,150,100,120,160,320,0,850
83720,170,180,120,160,160,0,790
83721,190,120,120,80,0,0,510
83722,190,80,40,0,0,0,310
83723,220,140,200,240,160,0,960
83724,220,100,120,160,160,0,760
83725,230,160,120,160,160,0,830
83726,210,120,200,240,160,0,930
83727,210,80,40,80,160,0,570
83728,190,100,40,80,160,320,890
83729,190,60,40,80,160,0,530
83730,210,180,80,0,0,0,470
83731,200,100,80,80,0,0,460
83732,200,120,200,160,160,0,840
83733,210,100,120,0,0,0,430
83734,180,100,160,240,160,320,1160
83735,180,100,120,80,160,320,960
83736,190,140,200,160,160,0,850
83737,190,140,80,80,0,0,490
83738,190,160,160,160,160,0,830
83739,170,80,80,80,160,0,570
83740,210,120,80,80,160,320,970
83741,180,180,160,160,160,0,840
83742,190,100,120,160,160,320,1050
83743,190,140,80,80,0,0,490
83744,210,180,160,80,160,0,790
83745,190,140,120,160,0,0,610
83746,190,100,80,160,160,0,690
83747,210,120,40,80,160,0,610
83748,180,100,80,0,0,0,360
83749,200,80,80,160,0,0,520
83750,210,100,0,0,0,0,310
83751,180,120,80,160,320,0,860
83752,240,140,80,0,0,0,460
83753,220,160,160,160,320,0,1020
83754,200,80,80,160,160,0,680
83755,160,120,80,80,160,0,600
83756,240,160,160,80,0,0,640
83757,220,80,120,80,0,0,500
83758,210,100,120,160,0,0,590
83759,230,180,160,240,160,0,970
83760,180,160,120,160,0,0,620
83761,220,120,120,80,0,0,540
83762,180,120,120,80,160,320,980
83763,170,140,160,240,320,0,1030
83764,220,120,80,80,0,0,500
83765,230,160,240,160,320,0,1110
83766,170,100,40,0,0,0,310
83767,210,120,120,80,160,0,690
83768,190,120,120,160,0,0,590
83769,230,160,80,160,160,0,790
83770,150,100,80,80,0,0,410
83771,210,140,120,80,0,0,550
83772,230,80,40,80,0,0,430
83773,190,120,120,80,0,0,510
83774,210,60,40,80,160,0,550
83775,210,140,120,160,160,320,1110
83776,170,120,80,80,0,0,450
83777,190,60,120,0,0,0,370
83778,210,80,40,0,0,0,330
83779,170,120,160,240,0,0,690
83780,210,140,80,80,160,320,990
83781,150,120,160,80,160,0,670
83782,210,140,80,0,0,0,430
83783,210,160,120,0,0,0,490
83784,200,140,120,80,0,0,540
83785,190,120,120,0,0,0,430
83786,190,140,120,80,160,0,690
83787,180,140,40,80,0,0,440
83788,180,100,120,0,0,0,400
83789,210,100,120,80,160,320,990
83790,180,100,160,160,320,0,920
83791,190,100,120,80,160,0,650
83792,170,100,120,160,160,0,710
83793,200,140,80,80,160,0,660
83794,210,140,160,160,160,0,830
83795,190,120,80,0,0,0,390
83796,130,100,0,0,0,0,230
83797,180,80,40,0,0,0,300
83798,230,120,120,160,160,0,790
83799,220,180,200,80,0,0,680
83800,190,100,120,160,0,0,570
83801,240,120,0,0,0,0,360
83802,210,160,160,80,160,0,770
83803,200,120,120,80,160,0,680
83804,210,100,40,80,160,0,590
83805,190,140,120,160,0,0,610
83806,180,100,160,0,0,0,440
83807,200,120,120,80,0,0,520
83808,180,80,120,160,160,320,1020
83809,180,100,160,80,0,0,520
83810,220,160,120,160,160,0,820
83811,210,120,80,80,160,0,650
83812,200,100,80,80,0,0,460
83813,210,120,120,160,320,320,1250
83814,190,140,120,0,0,0,450
83815,140,80,120,160,0,0,500
83816,210,160,160,160,320,0,1010
83817,150,60,0,0,0,0,210
83818,200,180,160,240,0,0,780
83819,170,80,80,80,160,0,570
83820,200,160,120,0,0,0,480
83821,200,140,160,80,160,0,740
83822,170,120,80,80,160,0,610
83823,180,160,80,80,160,0,660
83824,230,140,120,160,320,0,970
83825,200,140,120,80,0,0,540
83826,250,160,160,160,160,0,890
83827,230,140,160,240,0,0,770
83828,170,120,120,80,0,0,490
83829,200,40,80,80,0,0,400
83830,210,140,120,80,0,0,550
83831,160,60,40,80,0,0,340
83832,200,120,120,160,0,0,600
83833,190,120,120,160,320,0,910
83834,180,80,40,80,160,0,540
83835,190,180,200,80,160,0,810
83836,130,40,80,80,0,0,330
83837,180,100,40,80,160,0,560
83838,170,160,160,160,160,0,810
83839,150,80,80,0,0,0,310
83840,230,120,160,160,0,0,670
83841,170,180,200,240,320,320,1430
83842,230,120,120,160,320,320,1270
83843,190,100,120,160,320,0,890
83844,200,140,120,160,320,320,1260
83845,200,120,160,80,160,0,720
83846,210,180,160,160,320,320,1350
83847,190,180,160,0,0,0,530
83848,180,180,160,160,160,0,840
83849,220,160,120,80,160,0,740
83850,180,80,80,80,0,0,420
83851,230,120,80,0,0,0,430
83852,170,100,40,0,0,0,310
83853,200,160,200,160,160,0,880
83854,230,180,120,80,0,0,610
83855,190,100,120,160,320,320,1210
83856,220,120,120,160,160,320,1100
83857,190,140,80,160,160,0,730
83858,190,180,160,160,160,0,850
83859,220,180,200,160,320,0,1080
83860,220,180,120,0,0,0,520
83861,230,140,120,80,160,0,730
83862,200,80,120,160,160,0,720
83863,180,140,120,80,160,0,680
83864,230,180,200,240,160,320,1330
83865,230,120,80,0,0,0,430
83866,200,140,120,80,0,0,540
83867,230,140,200,80,0,0,650
83868,170,120,120,160,0,0,570
83869,170,40,80,160,320,0,770
83870,160,120,80,80,160,0,600
83871,240,180,120,80,160,0,780
83872,210,140,80,0,0,0,430
83873,230,180,120,160,320,0,1010
83874,230,140,120,240,160,0,890
83875,250,160,120,80,0,0,610
83876,230,160,120,80,160,0,750
83877,220,140,80,80,0,0,520
83878,200,120,120,80,160,0,680
83879,200,100,160,160,320,0,940
83880,190,180,40,0,0,0,410
83881,230,160,80,80,160,0,710
83882,250,160,80,0,0,0,490
83883,210,140,80,80,0,0,510
83884,170,140,160,80,0,0,550
83885,200,60,80,160,160,320,980
83886,180,160,120,80,0,0,540
83887,190,60,40,0,0,0,290
83888,200,100,120,160,0,0,580
83889,200,140,80,80,0,0,500
83890,220,120,160,80,160,320,1060
83891,170,80,80,80,160,0,570
83892,230,160,120,80,160,0,750
83893,250,160,200,80,160,0,850
83894,190,140,80,0,0,0,410
83895,160,100,120,160,160,320,1020
83896,170,140,120,80,160,0,670
83897,200,100,0,0,0,0,300
83898,190,120,40,80,160,0,590
83899,160,140,80,80,160,320,940
83900,180,140,80,80,0,0,480
83901,200,80,0,0,0,0,280
83902,190,80,40,0,0,0,310
83903,180,100,80,80,160,320,920
83904,200,180,120,160,320,0,980
83905,160,120,80,0,0,0,360
83906,180,140,160,160,0,0,640
83907,210,100,120,80,160,0,670
83908,180,100,80,0,0,0,360
83909,200,140,120,160,320,0,940
83910,200,120,80,160,160,0,720
83911,190,100,120,80,160,0,650
83912,180,200,200,160,160,0,900
83913,230,80,80,0,0,0,390
83914,220,100,40,0,0,0,360
83915,220,140,120,0,0,0,480
83916,190,80,80,80,160,0,590
83917,190,100,80,0,0,0,370
83918,150,60,40,80,160,0,490
83919,210,120,40,80,160,320,930
83920,180,120,160,160,160,0,780
83921,210,160,120,80,0,0,570
83922,160,160,240,160,160,0,880
83923,230,140,40,80,160,0,650
83924,230,200,80,0,0,0,510
83925,240,120,120,80,160,0,720
83926,140,100,40,80,0,0,360
83927,210,120,40,80,160,0,610
83928,200,120,0,0,0,0,320
83929,220,120,160,160,320,0,980
83930,180,120,120,160,160,0,740
83931,230,80,80,80,160,0,630
83932,180,100,160,160,0,0,600
83933,220,100,80,160,160,0,720
83934,220,100,120,160,320,0,920
83935,210,120,80,80,160,0,650
83936,180,140,160,160,320,320,1280
83937,200,160,160,160,160,0,840
83938,240,180,160,160,160,0,900
83939,210,140,120,80,160,0,710
83940,210,100,120,80,0,0,510
83941,200,80,120,80,160,0,640
83942,180,100,120,80,160,0,640
83943,230,160,40,0,0,0,430
83944,200,100,40,0,0,0,340
83945,210,120,120,160,0,0,610
83946,180,100,120,160,0,0,560
83947,180,100,80,80,160,0,600
83948,210,160,160,320,0,0,850
83949,200,60,40,80,0,0,380
83950,190,120,80,80,160,0,630
83951,190,180,160,160,320,0,1010
83952,190,160,160,160,0,0,670
83953,250,160,80,80,160,0,730
83954,190,100,120,160,0,0,570
83955,200,160,160,80,160,0,760
83956,180,60,80,80,160,0,560
83957,200,140,120,80,0,0,540
83958,230,120,0,0,0,0,350
83959,220,100,80,160,160,320,1040
83960,180,100,80,80,160,320,920
83961,180,160,80,80,160,320,980
83962,180,120,80,0,0,0,380
83963,160,60,80,160,160,0,620
83964,200,100,120,0,0,0,420
83965,170,180,200,160,0,0,710
83966,210,120,40,80,160,320,930
83967,190,100,80,160,160,0,690
83968,200,60,40,80,160,320,860
83969,170,100,40,80,0,0,390
83970,180,160,120,160,0,0,620
83971,130,100,200,240,320,0,990
83972,190,60,40,0,0,0,290
83973,230,160,160,160,160,0,870
83974,170,160,200,160,160,0,850
83975,200,140,40,80,0,0,460
83976,190,160,160,80,160,0,750
83977,200,120,80,0,0,0,400
83978,150,120,160,0,0,0,430
83979,220,120,160,160,160,320,1140
83980,210,140,120,160,320,0,950
83981,170,140,80,80,0,0,470
83982,200,160,200,160,0,0,720
83983,210,120,80,80,160,0,650
83984,150,60,40,80,0,0,330
83985,250,120,160,80,160,0,770
83986,150,60,120,160,160,0,650
83987,180,80,80,80,0,0,420
83988,220,160,160,80,0,0,620
83989,200,100,80,160,160,0,700
83990,160,100,80,80,160,0,580
83991,250,160,80,0,0,0,490
83992,200,140,120,80,0,0,540
83993,180,140,160,160,320,0,960
83994,160,100,80,80,0,0,420
83995,180,120,160,240,320,320,1340
83996,210,180,160,0,0,0,550
83997,190,160,160,160,160,0,830
83998,210,100,40,0,0,0,350
83999,220,140,160,80,160,320,1080
84000,210,80,40,0,0,0,330
84001,160,100,160,160,160,0,740
84002,210,80,80,80,160,0,610
84003,200,160,160,80,160,320,1080
84004,180,140,160,160,160,0,800
84005,230,180,160,80,160,0,810
84006,180,80,120,240,320,320,1260
84007,200,180,80,80,160,0,700
84008,190,120,120,160,160,0,750
84009,180,160,120,240,320,320,1340
84010,190,180,80,80,0,0,530
84011,160,120,120,0,0,0,400
84012,170,140,160,240,320,0,1030
84013,190,60,40,0,0,0,290
84014,170,60,80,0,0,0,310
84015,220,100,80,80,0,0,480
84016,180,60,0,0,0,0,240
84017,160,120,0,0,0,0,280
84018,210,160,160,160,160,320,1170
84019,170,100,120,240,320,320,1270
84020,190,100,120,160,160,0,730
84021,180,140,160,80,0,0,560
84022,220,20,40,80,0,0,360
84023,210,100,80,160,160,0,710
84024,170,100,40,80,160,320,870
84025,180,100,120,80,160,0,640
84026,170,80,120,0,0,0,370
84027,170,140,120,160,160,320,1070
84028,200,180,120,0,0,0,500
84029,190,100,120,160,160,0,730
84030,170,100,120,80,0,0,470
84031,220,120,40,0,0,0,380
84032,110,100,80,160,160,0,610
84033,160,120,80,160,160,0,680
84034,220,180,80,80,0,0,560
84035,240,140,160,160,0,0,700
84036,170,120,120,80,160,0,650
84037,230,140,120,0,0,0,490
84038,230,140,120,80,160,0,730
84039,170,140,120,240,320,320,1310
84040,210,140,120,80,0,0,550
84041,250,160,80,0,0,0,490
84042,220,100,120,80,160,0,680
84043,200,140,160,80,160,320,1060
84044,170,120,80,80,160,0,610
84045,190,120,80,80,160,0,630
84046,200,120,120,160,320,0,920
84047,190,140,120,160,160,0,770
84048,200,180,80,80,0,0,540
84049,170,160,160,160,160,0,810
84050,220,140,120,160,160,0,800
84051,210,100,120,80,0,0,510
84052,210,140,120,160,160,320,1110
84053,170,80,80,160,160,320,970
84054,230,160,120,80,160,0,750
84055,180,140,120,160,160,0,760
84056,210,120,160,240,160,0,890
84057,190,140,200,240,320,0,1090
84058,180,80,80,80,160,0,580
84059,210,80,80,160,320,320,1170
84060,190,120,120,80,160,0,670
84061,160,100,80,0,0,0,340
84062,220,100,120,0,0,0,440
84063,250,140,80,80,0,0,550
84064,150,120,40,0,0,0,310
84065,200,140,120,0,0,0,460
84066,230,160,40,0,0,0,430
84067,220,100,80,0,0,0,400
84068,210,140,120,160,320,320,1270
84069,230,140,40,0,0,0,410
84070,190,60,40,80,160,0,530
84071,220,160,160,160,160,0,860
84072,200,160,80,80,160,0,680
84073,170,80,120,80,160,0,610
84074,210,100,40,80,160,0,590
84075,250,180,120,80,0,0,630
84076,270,200,160,80,0,0,710
84077,220,120,120,0,0,0,460
84078,160,120,80,0,0,0,360
84079,210,160,80,80,160,0,690
84080,170,140,120,160,0,0,590
84081,210,100,120,0,0,0,430
84082,210,100,80,0,0,0,390
84083,190,100,120,160,160,0,730
84084,170,120,160,160,160,0,770
84085,190,80,80,80,0,0,430
84086,200,140,120,160,160,0,780
84087,180,100,160,160,160,0,760
84088,230,140,120,80,0,0,570
84089,200,140,120,160,0,0,620
84090,180,120,40,0,0,0,340
84091,180,140,80,0,0,0,400
84092,240,120,80,80,0,0,520
84093,170,120,120,240,160,0,810
84094,180,120,80,80,160,0,620
84095,190,140,120,240,320,320,1330
84096,190,80,80,160,160,320,990
84097,210,80,40,0,0,0,330
84098,220,160,80,80,160,320,1020
84099,170,140,120,160,0,0,590
84100,170,120,120,80,0,0,490
84101,210,120,80,0,0,0,410
84102,200,120,120,160,160,0,760
84103,170,100,80,80,0,0,430
84104,200,120,80,80,160,0,640
84105,200,140,40,0,0,0,380
84106,230,160,160,160,320,0,1030
84107,200,140,80,80,0,0,500
84108,190,80,40,80,160,0,550
84109,170,60,80,160,320,0,790
84110,170,100,160,80,0,0,510
84111,160,80,40,80,160,320,840
84112,220,60,120,80,160,0,640
84113,210,200,160,160,160,0,890
84114,180,100,80,0,0,0,360
84115,180,100,120,160,160,0,720
84116,160,80,80,80,160,0,560
84117,200,160,120,160,160,320,1120
84118,240,120,0,0,0,0,360
84119,220,140,120,80,160,0,720
84120,200,140,80,80,160,0,660
84121,190,120,80,160,160,0,710
84122,230,180,120,160,160,0,850
84123,160,100,80,80,0,0,420
84124,200,140,80,80,0,0,500
84125,250,100,80,80,160,320,990
84126,220,160,120,160,160,0,820
84127,230,100,40,0,0,0,370
84128,200,140,160,160,0,0,660
84129,210,100,160,160,160,0,790
84130,210,140,80,80,0,0,510
84131,160,100,80,160,160,0,660
84132,200,120,40,0,0,0,360
84133,220,140,80,0,0,0,440
84134,190,100,120,80,160,320,970
84135,210,120,80,160,160,320,1050
84136,230,120,120,80,0,0,550
84137,190,140,80,80,160,320,970
84138,210,100,80,80,160,0,630
84139,170,100,40,80,160,0,550
84140,200,180,160,80,160,0,780
84141,220,120,160,80,160,0,740
84142,170,100,80,80,0,0,430
84143,230,160,80,80,0,0,550
84144,150,80,120,160,0,0,510
84145,240,220,120,80,0,0,660
84146,210,120,120,80,160,0,690
84147,200,180,160,160,160,0,860
84148,180,160,120,80,0,0,540
84149,200,120,160,80,160,0,720
84150,150,100,40,80,160,0,530
84151,210,120,120,160,320,0,930
84152,200,100,40,0,0,0,340
84153,180,120,80,80,160,0,620
84154,140,60,80,160,160,0,600
84155,180,40,40,80,160,0,500
84156,210,160,160,240,320,0,1090
84157,230,140,120,0,0,0,490
84158,170,40,80,80,160,0,530
84159,190,120,80,80,0,0,470
84160,200,120,80,0,0,0,400
84161,170,140,160,160,160,0,790
84162,160,120,120,0,0,0,400
84163,190,100,80,160,160,0,690
84164,230,160,160,80,160,0,790
84165,240,120,120,80,160,0,720
84166,160,120,80,80,160,0,600
84167,190,140,80,80,0,0,490
84168,200,100,80,160,160,0,700
84169,250,140,80,160,160,0,790
84170,190,160,120,160,320,0,950
84171,200,160,120,80,0,0,560
84172,180,60,120,160,160,0,680
84173,210,100,40,80,160,0,590
84174,220,120,80,160,320,0,900
84175,200,120,120,80,160,320,1000
84176,180,120,160,80,0,0,540
84177,210,180,120,80,160,0,750
84178,180,80,80,80,0,0,420
84179,200,60,40,80,160,320,860
84180,210,120,40,80,160,0,610
84181,210,120,120,0,0,0,450
84182,230,80,80,80,0,0,470
84183,230,160,120,80,160,320,1070
84184,170,120,120,80,160,0,650
84185,190,120,120,160,320,0,910
84186,190,120,80,0,0,0,390
84187,190,120,160,80,0,0,550
84188,210,140,200,0,0,0,550
84189,230,80,40,80,0,0,430
84190,200,100,40,80,160,0,580
84191,170,100,200,160,160,0,790
84192,210,100,40,80,160,320,910
84193,180,100,0,0,0,0,280
84194,210,140,120,80,160,0,710
84195,260,120,120,240,320,0,1060
84196,180,120,120,80,160,0,660
84197,190,60,80,0,0,0,330
84198,180,100,40,80,160,320,880
84199,210,180,160,0,0,0,550
84200,210,180,80,160,320,320,1270
84201,200,100,120,160,0,0,580
84202,200,160,160,160,160,0,840
84203,230,160,120,80,160,0,750
84204,190,140,120,160,160,0,770
84205,220,200,200,80,160,0,860
84206,210,80,80,80,160,0,610
84207,180,60,40,0,0,0,280
84208,200,140,120,240,160,0,860
84209,210,140,160,160,320,0,990
84210,130,140,120,160,160,0,710
84211,220,100,80,160,160,320,1040
84212,190,60,0,0,0,0,250
84213,210,180,160,80,0,0,630
84214,170,120,120,160,0,0,570
84215,190,140,80,160,160,0,730
84216,210,120,80,80,160,0,650
84217,170,140,160,80,0,0,550
84218,200,140,80,80,160,0,660
84219,220,100,40,80,0,0,440
84220,230,140,120,80,0,0,570
84221,150,120,160,160,320,320,1230
84222,200,160,160,160,0,0,680
84223,180,80,80,80,160,0,580
84224,220,140,120,160,160,0,800
84225,220,120,160,160,0,0,660
84226,260,160,160,80,0,0,660
84227,250,80,80,80,160,0,650
84228,220,100,120,160,0,0,600
84229,180,140,200,240,160,0,920
84230,220,140,40,80,160,0,640
84231,220,180,160,80,160,0,800
84232,200,100,80,160,320,0,860
84233,180,140,160,240,160,0,880
84234,210,120,160,80,0,0,570
84235,200,100,120,160,320,0,900
84236,190,60,0,0,0,0,250
84237,190,60,80,0,0,0,330
84238,200,180,200,80,160,320,1140
84239,210,160,120,160,0,0,650
84240,200,120,120,80,160,0,680
84241,210,100,80,160,320,320,1190
84242,180,180,160,160,160,320,1160
84243,180,120,80,80,0,0,460
84244,220,160,200,160,0,0,740
84245,210,120,80,160,160,0,730
84246,170,100,120,80,160,320,950
84247,230,160,160,160,0,0,710
84248,200,120,120,80,0,0,520
84249,230,120,40,0,0,0,390
84250,210,100,40,0,0,0,350
84251,200,120,80,160,160,0,720
84252,210,160,120,160,0,0,650
84253,170,100,120,80,0,0,470
84254,220,180,160,160,160,0,880
84255,190,100,120,160,0,0,570
84256,170,120,160,80,0,0,530
84257,220,120,80,80,160,0,660
84258,210,120,120,160,160,0,770
84259,170,140,120,240,320,0,990
84260,210,160,160,160,320,0,1010
84261,180,120,160,80,0,0,540
84262,210,120,40,80,160,0,610
84263,190,80,80,80,160,320,910
84264,210,140,40,80,0,0,470
84265,210,100,80,0,0,0,390
84266,200,140,120,160,160,0,780
84267,170,140,120,80,0,0,510
84268,200,160,80,80,0,0,520
84269,170,120,80,80,0,0,450
84270,170,40,80,0,0,0,290
84271,200,140,200,160,160,0,860
84272,230,100,80,80,0,0,490
84273,180,160,120,160,320,0,940
84274,190,180,120,160,160,0,810
84275,190,160,240,240,320,0,1150
84276,200,120,80,80,0,0,480
84277,230,120,200,160,160,320,1190
84278,190,120,120,80,160,0,670
84279,180,120,80,80,0,0,460
84280,190,200,120,80,160,0,750
84281,150,120,200,80,160,0,710
84282,180,140,160,160,160,0,800
84283,170,100,80,80,160,0,590
84284,200,140,80,0,0,0,420
84285,220,120,120,80,0,0,540
84286,170,100,40,0,0,0,310
84287,150,140,160,160,160,0,770
84288,190,80,80,80,0,0,430
84289,150,140,80,80,0,0,450
84290,140,140,160,240,160,0,840
84291,170,100,160,80,160,0,670
84292,200,100,120,160,160,0,740
84293,180,80,80,0,0,0,340
84294,200,80,0,0,0,0,280
84295,210,160,160,80,160,0,770
84296,200,100,80,80,0,0,460
84297,140,100,120,80,0,0,440
84298,200,140,40,0,0,0,380
84299,190,140,120,160,160,0,770
84300,200,140,160,80,160,0,740
84301,210,120,120,80,160,0,690
84302,240,180,120,80,160,0,780
84303,220,140,120,80,160,0,720
84304,140,100,120,80,160,0,600
84305,210,140,80,80,160,0,670
84306,240,180,160,240,0,0,820
84307,170,140,160,240,160,320,1190
84308,190,140,160,80,160,320,1050
84309,190,140,80,80,0,0,490
84310,180,100,80,160,0,0,520
84311,190,160,80,80,0,0,510
84312,190,120,80,80,160,0,630
84313,150,100,120,160,320,0,850
84314,210,160,160,80,0,0,610
84315,220,80,80,160,320,0,860
84316,200,120,80,80,160,0,640
84317,180,120,80,80,160,0,620
84318,210,140,120,240,320,0,1030
84319,190,120,120,160,320,0,910
84320,220,120,160,160,160,0,820
84321,160,80,160,160,320,0,880
84322,210,120,120,80,160,0,690
84323,240,180,120,80,160,320,1100
84324,180,100,40,0,0,0,320
84325,170,140,200,80,0,0,590
84326,200,100,80,80,160,0,620
84327,230,140,120,160,160,0,810
84328,210,140,80,80,160,0,670
84329,190,160,120,160,160,320,1110
84330,200,160,80,80,0,0,520
84331,160,140,80,160,0,0,540
84332,240,160,80,80,0,0,560
84333,190,140,120,80,160,0,690
84334,230,160,160,80,0,0,630
84335,250,100,120,0,0,0,470
84336,160,100,80,80,160,320,900
84337,180,120,80,160,160,0,700
84338,180,80,80,80,160,0,580
84339,190,120,80,80,160,0,630
84340,260,220,40,80,0,0,600
84341,170,140,160,160,0,0,630
84342,170,140,160,160,160,320,1110
84343,200,120,40,0,0,0,360
84344,200,180,120,80,0,0,580
84345,240,200,200,0,0,0,640
84346,160,100,80,160,0,0,500
84347,200,120,120,80,160,320,1000
84348,190,160,160,80,160,0,750
84349,150,100,80,80,160,0,570
84350,190,100,120,80,160,0,650
84351,190,100,120,0,0,0,410
84352,190,120,160,80,160,0,710
84353,220,180,200,240,160,0,1000
84354,200,120,120,80,160,0,680
84355,210,120,120,80,160,0,690
84356,190,140,160,160,160,0,810
84357,180,100,80,80,160,0,600
84358,210,160,120,80,160,0,730
84359,190,140,120,80,160,0,690
84360,190,100,40,80,160,0,570
84361,200,140,80,80,160,0,660
84362,170,60,80,0,0,0,310
84363,150,120,80,80,160,0,590
84364,220,120,80,80,0,0,500
84365,230,100,40,80,160,0,610
84366,210,200,160,240,320,320,1450
84367,190,100,40,0,0,0,330
84368,180,120,160,80,160,0,700
84369,180,100,80,80,160,0,600
84370,170,40,40,80,0,0,330
84371,200,140,80,80,160,0,660
84372,220,100,120,80,160,0,680
84373,160,100,80,160,160,0,660
84374,200,100,80,160,160,0,700
84375,210,80,80,80,0,0,450
84376,210,100,160,160,0,0,630
84377,170,140,80,80,160,0,630
84378,180,140,120,80,160,0,680
84379,200,120,120,160,160,0,760
84380,220,120,160,160,0,0,660
84381,210,140,80,0,0,0,430
84382,220,140,120,80,0,0,560
84383,170,80,80,160,320,0,810
84384,190,100,120,80,0,0,490
84385,170,160,240,160,0,0,730
84386,200,140,160,240,160,0,900
84387,210,120,120,80,160,0,690
84388,190,80,80,0,0,0,350
84389,220,140,80,80,160,320,1000
84390,210,100,120,80,0,0,510
84391,190,100,120,80,0,0,490
84392,210,140,160,160,160,0,830
84393,160,80,40,0,0,0,280
84394,210,160,160,160,0,0,690
84395,190,40,0,0,0,0,230
84396,170,160,160,160,0,0,650
84397,210,80,120,80,160,0,650
84398,170,80,80,80,0,0,410
84399,220,140,80,80,160,0,680
84400,240,140,40,0,0,0,420
84401,170,100,40,80,0,0,390
84402,200,120,120,160,320,320,1240
84403,210,80,80,80,0,0,450
84404,200,200,160,160,0,0,720
84405,160,100,0,0,0,0,260
84406,170,100,120,0,0,0,390
84407,190,60,0,0,0,0,250
84408,180,140,80,80,0,0,480
84409,180,120,80,80,0,0,460
84410,180,100,120,0,0,0,400
84411,210,80,120,240,320,0,970
84412,190,100,80,0,0,0,370
84413,200,60,80,80,160,320,900
84414,210,80,80,80,160,320,930
84415,230,100,120,80,160,0,690
84416,220,160,120,160,160,320,1140
84417,180,180,80,0,0,0,440
84418,230,160,120,160,160,0,830
84419,200,100,120,0,0,0,420
84420,220,120,80,0,0,0,420
84421,200,140,120,240,320,0,1020
84422,200,80,40,80,0,0,400
84423,180,160,80,80,0,0,500
84424,190,120,120,80,160,0,670
84425,220,120,160,160,160,0,820
84426,200,120,120,160,160,0,760
84427,190,80,40,0,0,0,310
84428,210,160,160,160,160,0,850
84429,210,160,120,80,0,0,570
84430,180,100,120,160,160,0,720
84431,230,60,80,80,160,0,610
84432,230,120,120,80,0,0,550
84433,190,100,0,0,0,0,290
84434,200,200,200,160,160,0,920
84435,180,100,80,0,0,0,360
84436,190,120,120,80,0,0,510
84437,180,140,40,80,0,0,440
84438,190,60,40,80,0,0,370
84439,220,140,40,80,160,0,640
84440,200,180,120,0,0,0,500
84441,220,160,160,240,160,320,1260
84442,220,140,80,80,160,0,680
84443,200,180,120,0,0,0,500
84444,140,60,80,80,0,0,360
84445,200,160,200,160,320,0,1040
84446,210,100,120,80,0,0,510
84447,200,80,40,80,160,0,560
84448,210,120,120,0,0,0,450
84449,240,160,120,80,160,0,760
84450,180,160,120,0,0,0,460
84451,160,160,240,160,160,0,880
84452,210,120,80,80,160,0,650
84453,200,120,40,80,160,0,600
84454,190,80,40,0,0,0,310
84455,180,100,120,160,160,320,1040
84456,170,120,120,160,160,0,730
84457,200,140,120,160,320,0,940
84458,170,120,120,240,320,0,970
84459,160,100,40,0,0,0,300
84460,190,80,80,80,160,0,590
84461,200,80,120,80,160,0,640
84462,220,180,120,160,0,0,680
84463,230,100,120,80,0,0,530
84464,200,140,160,160,160,0,820
84465,230,160,120,80,0,0,590
84466,210,100,120,80,0,0,510
84467,210,160,160,240,0,0,770
84468,240,140,120,160,160,0,820
84469,220,120,120,160,160,0,780
84470,150,120,80,160,0,0,510
84471,190,120,80,80,160,320,950
84472,170,120,120,160,320,0,890
84473,180,120,160,80,160,320,1020
84474,190,80,80,160,160,320,990
84475,160,160,160,80,160,0,720
84476,230,200,200,80,160,0,870
84477,200,80,80,80,160,0,600
84478,220,160,160,240,160,0,940
84479,190,120,120,80,0,0,510
84480,200,100,160,240,320,320,1340
84481,170,120,80,160,0,0,530
84482,220,140,40,80,160,0,640
84483,190,120,80,80,160,320,950
84484,170,160,160,80,0,0,570
84485,190,160,200,80,160,0,790
84486,200,120,80,80,0,0,480
84487,210,80,120,80,160,0,650
84488,180,120,80,160,160,0,700
84489,170,160,160,160,0,0,650
84490,230,80,40,80,160,0,590
84491,170,100,80,160,160,320,990
84492,190,220,240,240,320,320,1530
84493,180,100,40,0,0,0,320
84494,180,160,120,80,160,0,700
84495,200,100,120,80,160,320,980
84496,190,80,120,80,160,0,630
84497,230,100,80,80,160,320,970
84498,170,160,160,160,160,320,1130
84499,220,180,240,160,160,0,960
84500,200,120,120,80,0,0,520
84501,160,120,200,240,160,0,880
84502,210,60,120,80,0,0,470
84503,170,180,80,80,160,0,670
84504,220,120,160,0,0,0,500
84505,220,80,80,80,0,0,460
84506,240,80,120,80,160,320,1000
84507,210,120,120,0,0,0,450
84508,250,140,120,160,160,0,830
84509,200,100,80,160,0,0,540
84510,220,80,120,160,160,0,740
84511,220,120,80,160,0,0,580
84512,200,140,120,80,160,0,700
84513,190,160,80,80,0,0,510
84514,190,180,200,160,0,0,730
84515,180,140,40,0,0,0,360
84516,180,180,120,80,0,0,560
84517,250,160,80,0,0,0,490
84518,150,120,160,80,0,0,510
84519,220,120,80,80,0,0,500
84520,200,140,160,80,160,0,740
84521,250,180,120,80,160,320,1110
84522,190,100,80,0,0,0,370
84523,190,140,160,240,320,0,1050
84524,180,160,80,80,0,0,500
84525,180,100,80,80,0,0,440
84526,170,160,80,80,0,0,490
84527,220,60,0,0,0,0,280
84528,190,140,80,80,0,0,490
84529,200,140,120,80,0,0,540
84530,210,140,120,80,160,0,710
84531,210,180,160,240,0,0,790
84532,170,160,120,160,320,0,930
84533,200,180,80,0,0,0,460
84534,230,140,120,160,160,320,1130
84535,190,160,120,80,160,0,710
84536,200,180,120,240,0,0,740
84537,210,140,40,80,160,0,630
84538,180,140,80,80,160,0,640
84539,220,80,0,0,0,0,300
84540,160,140,40,0,0,0,340
84541,200,60,40,0,0,0,300
84542,210,120,80,0,0,0,410
84543,190,100,40,80,0,0,410
84544,190,80,160,0,0,0,430
84545,140,100,120,160,320,0,840
84546,220,120,120,160,160,320,1100
84547,170,140,120,160,160,0,750
84548,150,60,80,0,0,0,290
84549,170,100,80,80,160,320,910
84550,160,120,40,80,160,0,560
84551,200,160,160,0,0,0,520
84552,200,100,120,160,0,0,580
84553,180,120,80,80,160,0,620
84554,190,140,160,160,160,0,810
84555,170,140,120,0,0,0,430
84556,270,180,160,80,160,0,850
84557,220,120,40,80,160,0,620
84558,220,140,160,160,160,0,840
84559,150,100,40,0,0,0,290
84560,150,100,40,0,0,0,290
84561,200,120,160,80,160,0,720
84562,180,120,0,0,0,0,300
84563,170,100,80,80,0,0,430
84564,180,80,40,80,0,0,380
84565,180,100,160,240,160,0,840
84566,180,120,120,80,160,0,660
84567,230,180,80,0,0,0,490
84568,240,120,160,160,160,0,840
84569,170,80,40,0,0,0,290
84570,150,120,80,80,0,0,430
84571,210,140,80,0,0,0,430
84572,180,120,160,80,0,0,540
84573,210,80,80,160,160,320,1010
84574,180,140,200,80,0,0,600
84575,210,100,80,80,160,0,630
84576,200,80,40,0,0,0,320
84577,190,120,80,80,160,0,630
84578,190,160,120,160,160,0,790
84579,170,100,120,160,0,0,550
84580,180,80,160,160,160,0,740
84581,190,100,80,80,160,0,610
84582,190,140,80,0,0,0,410
84583,170,140,120,160,160,0,750
84584,200,140,120,160,320,0,940
84585,200,80,80,160,0,0,520
84586,190,120,120,0,0,0,430
84587,200,120,120,0,0,0,440
84588,150,80,120,80,0,0,430
84589,180,100,120,160,160,0,720
84590,250,120,80,0,0,0,450
84591,180,100,120,80,0,0,480
84592,200,100,120,80,0,0,500
84593,220,140,160,160,320,320,1320
84594,200,160,160,160,320,0,1000
84595,240,120,80,80,0,0,520
84596,190,140,120,160,160,0,770
84597,210,120,120,160,160,320,1090
84598,190,200,240,240,320,0,1190
84599,190,60,80,0,0,0,330
84600,210,120,80,80,0,0,490
84601,190,160,120,80,0,0,550
84602,190,80,120,80,0,0,470
84603,200,160,160,160,160,0,840
84604,210,100,40,80,0,0,430
84605,150,140,120,160,160,0,730
84606,160,60,40,0,0,0,260
84607,180,120,80,80,160,0,620
84608,230,200,160,160,160,320,1230
84609,190,120,80,80,160,0,630
84610,200,140,40,80,0,0,460
84611,190,120,200,160,160,0,830
84612,180,80,0,0,0,0,260
84613,190,120,80,80,160,0,630
84614,200,160,120,160,320,0,960
84615,200,120,40,80,160,0,600
84616,200,120,120,160,0,0,600
84617,210,140,120,80,160,0,710
84618,250,160,120,80,160,0,770
84619,180,160,160,160,0,0,660
84620,190,120,160,160,0,0,630
84621,190,140,80,80,160,0,650
84622,190,120,120,80,160,320,990
84623,180,60,0,0,0,0,240
84624,190,80,120,80,160,0,630
84625,180,60,40,0,0,0,280
84626,190,120,0,0,0,0,310
84627,200,140,40,80,0,0,460
84628,190,140,160,160,320,320,1290
84629,180,140,120,80,160,0,680
84630,210,120,80,80,160,0,650
84631,220,180,160,160,0,0,720
84632,180,140,80,160,320,320,1200
84633,200,140,80,0,0,0,420
84634,180,120,120,80,0,0,500
84635,170,140,80,80,0,0,470
84636,230,120,80,160,160,0,750
84637,230,120,160,240,320,320,1390
84638,230,80,80,0,0,0,390
84639,200,100,120,80,0,0,500
84640,220,200,160,160,160,0,900
84641,220,140,160,80,160,0,760
84642,190,120,120,160,160,0,750
84643,220,100,120,80,0,0,520
84644,220,120,80,160,320,0,900
84645,190,120,160,160,160,0,790
84646,200,140,160,80,160,0,740
84647,170,120,80,0,0,0,370
84648,180,120,120,80,160,0,660
84649,200,140,120,80,160,0,700
84650,210,140,120,80,160,0,710
84651,190,120,120,240,160,0,830
84652,200,40,40,0,0,0,280
84653,240,160,120,80,0,0,600
84654,210,120,200,160,160,0,850
84655,210,140,120,160,160,320,1110
84656,210,120,80,160,160,0,730
84657,200,100,40,80,0,0,420
84658,170,80,40,80,0,0,370
84659,170,140,160,80,160,320,1030
84660,240,160,160,160,0,0,720
84661,160,80,120,0,0,0,360
84662,160,60,80,0,0,0,300
84663,230,120,120,160,160,320,1110
84664,240,160,160,160,160,0,880
84665,210,120,160,160,320,0,970
84666,210,140,160,160,160,0,830
84667,160,100,120,160,160,0,700
84668,190,140,120,80,160,0,690
84669,190,140,40,80,0,0,450
84670,210,120,160,80,160,320,1050
84671,190,120,40,0,0,0,350
84672,200,140,120,240,320,320,1340
84673,200,100,40,80,160,0,580
84674,200,120,80,80,0,0,480
84675,160,120,80,80,160,320,920
84676,210,140,80,80,160,320,990
84677,200,140,120,80,160,0,700
84678,180,180,120,160,160,0,800
84679,200,140,160,240,160,0,900
84680,160,140,160,240,160,0,860
84681,200,80,80,0,0,0,360
84682,200,100,120,0,0,0,420
84683,190,120,40,0,0,0,350
84684,230,140,120,160,160,0,810
84685,230,100,80,80,160,0,650
84686,180,140,80,160,160,0,720
84687,190,120,80,160,160,320,1030
84688,150,80,80,80,160,0,550
84689,170,100,80,80,160,0,590
84690,230,180,120,80,0,0,610
84691,230,140,80,80,0,0,530
84692,160,160,200,80,160,0,760
84693,180,140,120,80,160,0,680
84694,170,120,80,80,160,320,930
84695,220,100,120,160,0,0,600
84696,180,120,80,80,0,0,460
84697,180,120,80,160,160,0,700
84698,230,140,40,0,0,0,410
84699,180,120,160,160,320,0,940
84700,190,140,120,240,160,0,850
84701,230,120,80,80,0,0,510
84702,230,160,160,0,0,0,550
84703,190,180,200,160,160,0,890
84704,160,160,160,80,160,0,720
84705,200,140,160,160,160,0,820
84706,170,120,120,80,0,0,490
84707,190,80,40,80,160,0,550
84708,210,120,120,0,0,0,450
84709,230,120,120,0,0,0,470
84710,170,100,120,160,320,0,870
84711,170,80,120,80,0,0,450
84712,190,120,80,0,0,0,390
84713,180,100,40,80,160,0,560
84714,240,140,160,160,0,0,700
84715,190,80,40,0,0,0,310
84716,190,140,120,80,160,0,690
84717,190,140,80,80,160,0,650
84718,140,100,160,160,160,320,1040
84719,200,160,120,80,0,0,560
84720,220,160,160,160,320,320,1340
84721,220,140,120,80,160,0,720
84722,200,160,200,240,320,0,1120
84723,210,160,160,80,0,0,610
84724,190,120,120,80,160,0,670
84725,200,140,80,80,160,0,660
84726,190,140,120,160,160,0,770
84727,180,160,160,80,160,0,740
84728,190,140,200,160,320,0,1010
84729,190,120,80,0,0,0,390
84730,210,120,160,80,160,320,1050
84731,210,200,160,80,160,0,810
84732,180,140,40,0,0,0,360
84733,210,140,160,160,160,0,830
84734,250,160,160,160,160,0,890
84735,220,140,160,80,160,0,760
84736,220,160,120,80,160,0,740
84737,250,140,120,0,0,0,510
84738,160,60,40,80,160,320,820
84739,190,160,80,80,160,0,670
84740,200,140,80,80,160,0,660
84741,170,140,160,160,320,0,950
84742,200,160,120,80,0,0,560
84743,190,100,120,80,0,0,490
84744,190,120,40,80,160,320,910
84745,190,100,120,80,160,320,970
84746,200,160,40,80,160,320,960
84747,180,80,120,160,160,0,700
84748,230,100,120,0,0,0,450
84749,200,120,80,80,0,0,480
84750,200,140,160,240,160,0,900
84751,190,120,80,0,0,0,390
84752,180,120,160,240,160,0,860
84753,250,140,120,160,160,0,830
84754,220,200,160,160,320,0,1060
84755,220,140,160,80,0,0,600
84756,210,160,120,80,160,320,1050
84757,240,220,200,80,160,320,1220
84758,210,140,40,80,0,0,470
84759,220,120,40,0,0,0,380
84760,160,40,80,160,160,0,600
84761,240,140,120,80,160,0,740
84762,230,140,120,160,320,0,970
84763,180,120,0,0,0,0,300
84764,200,160,40,80,0,0,480
84765,230,120,120,160,320,0,950
84766,170,120,120,80,0,0,490
84767,230,140,160,160,320,0,1010
84768,180,120,120,0,0,0,420
84769,190,120,80,0,0,0,390
84770,130,80,40,80,0,0,330
84771,170,140,160,160,160,0,790
84772,180,100,120,80,160,0,640
84773,210,120,120,240,160,0,850
84774,190,60,40,0,0,0,290
84775,220,180,200,80,0,0,680
84776,170,100,120,160,160,0,710
84777,220,140,120,80,0,0,560
84778,260,100,80,80,160,0,680
84779,230,160,120,80,0,0,590
84780,190,140,160,80,160,0,730
84781,190,180,160,160,160,0,850
84782,220,140,160,160,160,320,1160
84783,190,60,40,0,0,0,290
84784,180,120,40,0,0,0,340
84785,190,140,120,160,160,0,770
84786,150,140,80,80,0,0,450
84787,200,140,120,160,0,0,620
84788,200,140,80,0,0,0,420
84789,170,160,160,0,0,0,490
84790,220,100,120,80,160,0,680
84791,190,120,80,80,0,0,470
84792,190,80,80,160,160,0,670
84793,200,160,160,0,0,0,520
84794,200,140,80,160,0,0,580
84795,210,80,80,80,160,320,930
84796,190,120,120,160,320,320,1230
84797,160,120,120,160,160,0,720
84798,170,80,40,0,0,0,290
84799,170,80,80,80,0,0,410
84800,160,140,120,160,320,320,1220
84801,170,140,40,0,0,0,350
84802,220,100,120,160,160,0,760
84803,200,80,80,80,160,0,600
84804,230,140,160,240,320,0,1090
84805,170,120,160,240,0,0,690
84806,190,140,80,80,0,0,490
84807,220,140,80,160,160,0,760
84808,240,160,120,160,160,0,840
84809,190,100,80,160,160,0,690
84810,180,140,80,80,160,0,640
84811,200,120,120,240,320,0,1000
84812,150,120,80,80,160,0,590
84813,230,120,80,0,0,0,430
84814,200,140,80,80,0,0,500
84815,200,100,80,80,0,0,460
84816,220,160,200,160,160,0,900
84817,200,120,120,160,320,0,920
84818,220,160,120,240,320,0,1060
84819,170,120,160,80,0,0,530
84820,230,120,120,160,0,0,630
84821,200,140,160,160,0,0,660
84822,190,80,40,80,160,0,550
84823,200,100,40,80,0,0,420
84824,150,60,40,80,160,0,490
84825,210,100,120,0,0,0,430
84826,210,100,80,80,0,0,470
84827,210,100,80,160,160,0,710
84828,170,160,40,0,0,0,370
84829,180,100,120,160,320,0,880
84830,210,120,40,0,0,0,370
84831,210,160,200,320,320,320,1530
84832,200,100,40,80,160,0,580
84833,210,140,120,80,160,0,710
84834,190,120,160,80,160,0,710
84835,190,100,80,0,0,0,370
84836,160,140,160,240,160,0,860
84837,160,100,120,160,160,320,1020
84838,220,180,200,240,160,0,1000
84839,170,120,160,160,160,0,770
84840,200,100,0,0,0,0,300
84841,180,80,80,0,0,0,340
84842,220,80,80,80,0,0,460
84843,190,120,120,0,0,0,430
84844,230,140,80,0,0,0,450
84845,190,80,80,80,160,0,590
84846,190,120,120,160,320,320,1230
84847,200,120,40,80,0,0,440
84848,210,140,120,160,160,320,1110
84849,190,100,80,80,0,0,450
84850,220,180,120,80,160,0,760
84851,210,160,200,240,160,0,970
84852,220,120,120,0,0,0,460
84853,170,160,160,160,160,0,810
84854,190,40,40,80,0,0,350
84855,120,120,120,80,160,0,600
84856,220,100,80,160,0,0,560
84857,200,120,80,80,0,0,480
84858,200,120,120,160,0,0,600
84859,230,120,160,80,160,0,750
84860,180,100,80,0,0,0,360
84861,130,120,120,0,0,0,370
84862,180,160,200,240,0,0,780
84863,220,120,40,0,0,0,380
84864,210,160,200,160,160,320,1210
84865,200,160,160,240,160,0,920
84866,170,100,80,80,160,0,590
84867,220,100,40,80,160,0,600
84868,220,220,160,80,160,0,840
84869,230,100,80,0,0,0,410
84870,160,80,80,80,160,320,880
84871,170,140,80,80,160,0,630
84872,230,120,80,80,0,0,510
84873,220,120,160,160,320,0,980
84874,210,200,160,80,160,0,810
84875,180,200,200,80,160,0,820
84876,210,160,160,80,0,0,610
84877,180,120,80,80,0,0,460
84878,170,80,80,160,160,320,970
84879,210,120,120,160,0,0,610
84880,210,140,0,0,0,0,350
84881,190,120,160,160,320,320,1270
84882,220,160,120,80,160,0,740
84883,210,100,120,0,0,0,430
84884,180,140,40,80,160,0,600
84885,190,160,120,0,0,0,470
84886,200,120,120,160,160,0,760
84887,170,120,120,80,160,0,650
84888,160,60,40,0,0,0,260
84889,210,140,120,160,160,320,1110
84890,190,140,80,80,0,0,490
84891,190,180,80,160,160,0,770
84892,200,120,80,80,0,0,480
84893,230,180,200,80,160,0,850
84894,190,120,120,80,160,0,670
84895,220,100,40,0,0,0,360
84896,170,140,80,80,160,0,630
84897,190,140,80,80,160,320,970
84898,190,100,80,160,160,0,690
84899,190,140,160,80,160,0,730
84900,230,220,280,80,0,0,810
84901,250,160,160,160,160,0,890
84902,220,100,80,80,0,0,480
84903,180,140,40,0,0,0,360
84904,230,100,120,80,160,0,690
84905,190,100,160,160,320,0,930
84906,220,100,0,0,0,0,320
84907,190,160,40,0,0,0,390
84908,220,100,120,80,0,0,520
84909,200,80,120,160,0,0,560
84910,190,140,160,80,0,0,570
84911,230,180,200,240,160,0,1010
84912,180,140,120,0,0,0,440
84913,200,180,120,80,0,0,580
84914,200,200,80,80,0,0,560
84915,150,100,120,80,0,0,450
84916,240,120,80,80,160,320,1000
84917,190,60,80,80,160,0,570
84918,210,140,80,80,160,0,670
84919,170,80,80,80,0,0,410
84920,190,80,120,160,160,320,1030
84921,180,120,80,80,0,0,460
84922,160,100,80,80,160,0,580
84923,160,140,120,160,160,0,740
84924,200,160,200,160,160,320,1200
84925,190,140,160,240,320,320,1370
84926,180,100,160,160,160,0,760
84927,190,120,80,0,0,0,390
84928,180,160,160,160,160,0,820
84929,230,160,160,240,320,0,1110
84930,170,140,80,160,320,0,870
84931,210,140,120,80,0,0,550
84932,210,100,80,80,160,0,630
84933,180,140,80,80,160,0,640
84934,210,160,200,160,320,0,1050
84935,180,140,120,160,320,0,920
84936,210,140,80,0,0,0,430
84937,160,40,0,0,0,0,200
84938,210,180,200,240,0,0,830
84939,160,100,160,240,320,320,1300
84940,220,160,80,160,160,320,1100
84941,210,100,80,80,0,0,470
84942,170,120,120,80,0,0,490
84943,190,100,80,80,0,0,450
84944,180,160,120,160,0,0,620
84945,190,140,120,80,160,0,690
84946,210,120,120,160,320,0,930
84947,150,140,160,240,320,0,1010
84948,200,140,120,80,160,0,700
84949,160,120,160,240,320,320,1320
84950,190,100,120,160,320,0,890
84951,200,120,160,80,0,0,560
84952,210,120,120,160,320,320,1250
84953,170,120,80,80,160,320,930
84954,220,160,200,160,160,320,1220
84955,230,160,80,160,320,0,950
84956,180,100,160,160,160,0,760
84957,230,100,80,80,160,0,650
84958,200,140,80,0,0,0,420
84959,230,140,160,160,160,0,850
84960,230,120,80,80,0,0,510
84961,220,160,120,80,160,0,740
84962,200,120,40,80,160,0,600
84963,200,160,120,80,0,0,560
84964,210,140,80,0,0,0,430
84965,170,120,120,80,0,0,490
84966,210,140,160,80,160,0,750
84967,190,120,80,160,160,0,710
84968,200,100,80,80,0,0,460
84969,190,100,160,160,320,320,1250
84970,200,100,120,240,320,0,980
84971,200,140,160,80,160,0,740
84972,190,140,200,80,160,0,770
84973,190,140,80,80,0,0,490
84974,240,160,120,80,160,0,760
84975,210,80,120,240,160,0,810
84976,190,200,120,80,0,0,590
84977,230,140,80,160,160,0,770
84978,180,100,80,80,0,0,440
84979,210,140,80,80,0,0,510
84980,220,100,80,80,160,0,640
84981,210,160,80,0,0,0,450
84982,200,120,120,80,160,0,680
84983,210,160,120,160,160,0,810
84984,210,160,200,80,160,0,810
84985,220,120,120,80,160,0,700
84986,230,160,120,80,160,320,1070
84987,230,120,120,80,0,0,550
84988,230,180,120,80,160,0,770
84989,220,160,200,240,320,320,1460
84990,210,180,160,80,160,0,790
84991,220,140,120,80,0,0,560
84992,200,140,80,0,0,0,420
84993,200,100,80,80,0,0,460
84994,190,100,80,160,160,0,690
84995,220,100,40,80,0,0,440
84996,180,140,120,80,0,0,520
84997,200,100,120,160,160,0,740
84998,220,160,120,160,0,0,660
84999,200,120,120,0,0,0,440
85000,160,100,0,0,0,0,260
85001,210,100,80,80,160,320,950
85002,170,140,160,80,160,0,710
85003,230,120,120,160,320,0,950
85004,190,120,120,80,160,0,670
85005,240,180,120,160,160,0,860
85006,190,160,160,160,160,0,830
85007,200,140,120,0,0,0,460
85008,220,180,80,160,160,0,800
85009,150,80,120,80,160,0,590
85010,180,100,80,80,0,0,440
85011,200,200,160,160,160,0,880
85012,160,140,120,80,0,0,500
85013,250,120,80,0,0,0,450
85014,200,180,160,80,160,0,780
85015,170,140,160,240,160,320,1190
85016,180,120,120,240,160,0,820
85017,180,80,40,0,0,0,300
85018,160,100,120,0,0,0,380
85019,200,140,120,240,160,0,860
85020,190,120,40,0,0,0,350
85021,210,140,160,160,0,0,670
85022,210,160,80,80,0,0,530
85023,180,160,120,80,0,0,540
85024,200,120,160,80,160,320,1040
85025,210,80,120,0,0,0,410
85026,230,140,80,80,160,0,690
85027,200,120,160,240,160,0,880
85028,180,100,160,240,0,0,680
85029,240,140,120,160,320,0,980
85030,170,120,120,160,160,320,1050
85031,190,100,80,160,320,320,1170
85032,220,140,80,160,160,0,760
85033,200,140,40,0,0,0,380
85034,250,120,120,80,160,0,730
85035,220,100,80,80,160,0,640
85036,230,100,120,80,0,0,530
85037,210,140,120,0,0,0,470
85038,210,100,120,80,160,0,670
85039,230,140,40,80,160,0,650
85040,180,140,120,160,320,0,920
85041,150,100,80,0,0,0,330
85042,210,80,80,0,0,0,370
85043,170,60,80,80,160,0,550
85044,200,200,240,240,160,0,1040
85045,200,100,120,0,0,0,420
85046,210,160,120,80,160,0,730
85047,230,120,160,320,320,320,1470
85048,190,80,40,80,160,320,870
85049,200,160,80,80,0,0,520
85050,200,100,80,80,0,0,460
85051,190,100,40,80,160,0,570
85052,170,120,80,160,0,0,530
85053,200,180,240,160,160,0,940
85054,170,120,160,160,0,0,610
85055,220,140,80,80,0,0,520
85056,170,100,80,80,0,0,430
85057,190,120,40,80,0,0,430
85058,220,120,80,80,160,0,660
85059,170,120,80,80,0,0,450
85060,170,60,80,0,0,0,310
85061,160,120,0,0,0,0,280
85062,250,140,80,80,160,320,1030
85063,200,100,120,80,160,320,980
85064,150,80,80,0,0,0,310
85065,260,140,80,80,0,0,560
85066,170,180,160,160,320,0,990
85067,210,120,120,160,320,0,930
85068,220,100,40,80,0,0,440
85069,130,80,80,80,160,0,530
85070,220,120,80,80,0,0,500
85071,140,100,120,160,160,0,680
85072,220,100,120,160,160,0,760
85073,180,120,80,160,160,320,1020
85074,180,140,120,240,320,0,1000
85075,190,140,120,160,160,0,770
85076,210,140,120,160,160,0,790
85077,170,120,160,80,0,0,530
85078,220,120,120,160,160,0,780
85079,200,140,160,160,320,320,1300
85080,280,160,40,80,160,320,1040
85081,200,100,80,80,160,320,940
85082,220,120,40,80,0,0,460
85083,190,120,120,160,0,0,590
85084,190,100,80,0,0,0,370
85085,200,120,80,80,160,0,640
85086,250,120,80,160,160,320,1090
85087,190,80,40,0,0,0,310
85088,200,100,80,0,0,0,380
85089,200,120,120,160,160,0,760
85090,180,160,200,160,320,0,1020
85091,200,140,120,80,160,0,700
85092,190,120,120,80,160,0,670
85093,160,120,120,80,160,0,640
85094,180,140,80,160,160,0,720
85095,230,140,80,80,0,0,530
85096,210,80,120,80,0,0,490
85097,190,100,40,0,0,0,330
85098,240,160,120,160,320,0,1000
85099,210,160,80,160,160,0,770
85100,200,120,120,80,160,0,680
85101,180,140,120,240,0,0,680
85102,240,140,80,80,0,0,540
85103,230,180,120,80,0,0,610
85104,190,140,160,80,0,0,570
85105,190,120,80,160,160,0,710
85106,170,180,160,160,160,0,830
85107,160,80,80,160,320,0,800
85108,170,100,80,80,0,0,430
85109,260,180,80,80,160,0,760
85110,240,100,80,80,160,0,660
85111,200,100,80,80,160,0,620
85112,220,80,80,0,0,0,380
85113,190,100,120,80,160,0,650
85114,140,100,120,80,0,0,440
85115,180,100,80,80,0,0,440
85116,160,120,120,160,320,320,1200
85117,210,140,80,160,0,0,590
85118,210,100,80,80,160,0,630
85119,190,160,200,160,320,0,1030
85120,220,120,80,160,160,0,740
85121,220,120,80,160,160,0,740
85122,180,100,160,80,0,0,520
85123,230,140,120,160,320,320,1290
85124,210,100,80,80,0,0,470
85125,210,80,80,80,0,0,450
85126,200,160,160,160,0,0,680
85127,190,100,120,160,160,0,730
85128,200,180,120,0,0,0,500
85129,240,140,120,160,160,0,820
85130,190,140,120,160,160,0,770
85131,190,120,160,160,160,0,790
85132,210,140,80,80,0,0,510
85133,200,140,160,240,0,0,740
85134,180,120,120,80,160,0,660
85135,180,120,80,160,0,0,540
85136,180,100,40,80,0,0,400
85137,210,120,80,160,160,0,730
85138,180,120,80,0,0,0,380
85139,250,100,160,240,0,0,750
85140,190,160,120,160,320,0,950
85141,210,160,80,80,160,0,690
85142,180,80,80,80,0,0,420
85143,210,80,80,80,0,0,450
85144,230,120,160,80,160,0,750
85145,160,40,40,80,160,0,480
85146,220,120,160,80,160,0,740
85147,180,120,120,80,160,320,980
85148,220,140,80,80,160,0,680
85149,230,120,40,0,0,0,390
85150,190,100,80,160,160,0,690
85151,180,120,120,80,0,0,500
85152,200,140,200,160,0,0,700
85153,150,140,80,160,0,0,530
85154,230,100,80,80,160,0,650
85155,180,140,120,80,160,0,680
85156,160,100,120,160,320,0,860
85157,220,180,80,80,160,320,1040
85158,210,100,120,80,0,0,510
85159,220,80,80,80,160,0,620
85160,200,40,40,0,0,0,280
85161,190,140,120,160,160,0,770
85162,210,140,240,160,160,0,910
85163,200,180,40,80,160,320,980
85164,200,80,120,160,160,320,1040
85165,210,100,120,160,160,0,750
85166,200,160,120,0,0,0,480
85167,220,40,0,0,0,0,260
85168,210,80,40,80,160,0,570
85169,220,120,80,80,160,0,660
85170,190,140,160,80,160,0,730
85171,200,140,160,80,160,0,740
85172,190,140,160,160,0,0,650
85173,190,140,120,80,160,0,690
85174,220,200,80,0,0,0,500
85175,180,100,160,240,320,320,1320
85176,200,120,120,80,160,0,680
85177,220,140,160,80,0,0,600
85178,170,100,80,160,0,0,510
85179,200,160,120,160,320,0,960
85180,220,120,120,80,160,0,700
85181,210,200,160,80,160,320,1130
85182,170,120,160,160,320,320,1250
85183,220,140,80,160,320,320,1240
85184,230,140,80,80,160,0,690
85185,200,80,40,0,0,0,320
85186,210,80,40,0,0,0,330
85187,180,160,160,0,0,0,500
85188,170,120,80,80,0,0,450
85189,190,160,80,80,160,0,670
85190,250,180,240,160,160,0,990
85191,230,120,120,160,160,0,790
85192,210,120,40,0,0,0,370
85193,230,160,80,160,160,0,790
85194,180,160,200,160,160,0,860
85195,200,180,80,80,0,0,540
85196,190,120,80,0,0,0,390
85197,180,160,120,80,160,0,700
85198,200,140,160,160,160,320,1140
85199,200,100,160,160,160,0,780
85200,210,180,80,0,0,0,470
85201,220,140,80,80,0,0,520
85202,200,160,160,160,160,320,1160
85203,230,100,120,160,160,0,770
85204,190,80,0,0,0,0,270
85205,230,180,160,160,0,0,730
85206,170,120,200,80,0,0,570
85207,200,180,200,160,160,0,900
85208,190,100,80,80,160,0,610
85209,180,80,40,80,0,0,380
85210,200,120,40,80,0,0,440
85211,220,160,120,160,160,0,820
85212,190,100,120,80,160,0,650
85213,200,120,120,160,160,0,760
85214,190,140,0,0,0,0,330
85215,190,120,80,0,0,0,390
85216,200,100,80,80,160,0,620
85217,140,60,40,80,160,0,480
85218,200,100,120,160,320,320,1220
85219,240,120,120,80,160,0,720
85220,210,120,40,0,0,0,370
85221,180,120,80,160,160,0,700
85222,240,140,120,160,160,0,820
85223,170,100,160,80,160,0,670
85224,190,140,120,80,160,320,1010
85225,140,120,120,160,320,0,860
85226,190,140,200,160,160,0,850
85227,130,100,160,80,160,0,630
85228,200,120,120,80,0,0,520
85229,180,120,120,160,320,320,1220
85230,180,60,80,160,320,320,1120
85231,230,160,120,240,160,0,910
85232,200,120,160,160,0,0,640
85233,200,100,80,80,160,0,620
85234,170,120,120,160,320,0,890
85235,210,80,80,80,0,0,450
85236,180,160,160,160,160,0,820
85237,170,20,0,0,0,0,190
85238,170,140,120,0,0,0,430
85239,220,160,40,0,0,0,420
85240,250,140,200,160,160,0,910
85241,210,120,80,160,0,0,570
85242,220,140,80,0,0,0,440
85243,190,140,120,0,0,0,450
85244,190,120,120,80,160,0,670
85245,240,200,200,80,0,0,720
85246,230,100,200,240,160,0,930
85247,180,140,160,80,0,0,560
85248,210,120,120,240,160,0,850
85249,190,140,40,0,0,0,370
85250,230,160,80,80,160,0,710
85251,240,100,40,0,0,0,380
85252,200,100,80,80,160,0,620
85253,190,180,200,80,160,0,810
85254,140,60,40,0,0,0,240
85255,210,120,80,80,160,0,650
85256,160,80,80,80,160,0,560
85257,210,120,40,0,0,0,370
85258,180,120,80,80,160,0,620
85259,160,120,120,0,0,0,400
85260,190,80,120,80,0,0,470
85261,200,140,240,80,0,0,660
85262,200,100,80,80,160,0,620
85263,250,180,200,0,0,0,630
85264,180,100,80,160,160,0,680
85265,220,160,160,80,160,0,780
85266,180,140,120,160,320,320,1240
85267,180,100,80,80,0,0,440
85268,220,160,240,160,160,0,940
85269,190,140,120,0,0,0,450
85270,220,80,80,80,0,0,460
85271,170,80,160,0,0,0,410
85272,210,140,80,80,0,0,510
85273,220,160,40,80,160,0,660
85274,230,160,160,80,0,0,630
85275,170,80,80,0,0,0,330
85276,190,100,120,160,160,0,730
85277,190,100,40,80,0,0,410
85278,210,120,80,80,160,0,650
85279,180,100,80,80,160,0,600
85280,190,140,80,80,0,0,490
85281,180,140,160,160,320,320,1280
85282,190,100,40,0,0,0,330
85283,180,60,40,80,160,0,520
85284,190,120,120,160,160,0,750
85285,210,120,120,160,0,0,610
85286,170,140,120,160,0,0,590
85287,190,140,80,160,160,0,730
85288,190,140,80,160,160,320,1050
85289,200,100,80,160,160,0,700
85290,240,160,160,160,160,320,1200
85291,190,140,80,160,320,0,890
85292,210,100,200,240,320,0,1070
85293,200,100,80,80,160,0,620
85294,200,120,160,80,160,0,720
85295,180,160,160,0,0,0,500
85296,220,140,40,80,160,0,640
85297,200,140,80,0,0,0,420
85298,140,100,80,80,160,0,560
85299,220,120,160,80,0,0,580
85300,220,140,120,80,160,0,720
85301,160,140,160,160,320,320,1260
85302,200,120,120,80,0,0,520
85303,190,120,120,160,160,0,750
85304,190,80,80,80,160,0,590
85305,190,160,160,0,0,0,510
85306,260,180,120,160,160,320,1200
85307,230,160,120,160,320,0,990
85308,190,120,80,160,160,0,710
85309,120,80,80,80,160,320,840
85310,210,120,160,80,0,0,570
85311,200,140,40,80,160,0,620
85312,220,120,120,160,320,0,940
85313,170,80,40,0,0,0,290
85314,180,120,160,80,0,0,540
85315,200,120,120,160,0,0,600
85316,220,120,0,0,0,0,340
85317,230,100,40,80,160,0,610
85318,190,120,120,80,160,0,670
85319,170,120,160,240,160,320,1170
85320,200,100,120,160,160,320,1060
85321,200,160,120,160,160,0,800
85322,190,80,80,160,160,320,990
85323,220,140,160,80,160,0,760
85324,170,80,40,0,0,0,290
85325,170,100,40,0,0,0,310
85326,160,120,160,240,320,320,1320
85327,190,100,120,80,160,0,650
85328,210,40,80,80,0,0,410
85329,180,80,40,0,0,0,300
85330,220,140,40,0,0,0,400
85331,210,120,80,80,160,320,970
85332,190,140,120,160,160,0,770
85333,170,160,160,80,0,0,570
85334,210,160,160,160,160,320,1170
85335,260,180,80,0,0,0,520
85336,240,120,80,80,160,0,680
85337,180,140,40,80,160,0,600
85338,180,80,120,80,160,0,620
85339,230,120,120,160,160,0,790
85340,190,120,120,80,160,0,670
85341,190,100,160,80,160,0,690
85342,180,140,160,160,0,0,640
85343,170,80,120,80,160,0,610
85344,200,80,40,80,160,0,560
85345,200,120,160,160,160,0,800
85346,150,60,40,80,0,0,330
85347,180,100,120,160,0,0,560
85348,220,140,80,80,160,0,680
85349,220,120,80,80,160,0,660
85350,130,100,40,80,0,0,350
85351,180,120,160,160,160,0,780
85352,250,140,120,80,0,0,590
85353,220,100,80,0,0,0,400
85354,220,160,40,0,0,0,420
85355,170,140,120,80,160,0,670
85356,200,120,120,160,320,320,1240
85357,210,140,120,0,0,0,470
85358,170,100,120,80,160,320,950
85359,190,100,160,80,0,0,530
85360,170,100,120,80,160,0,630
85361,180,80,80,0,0,0,340
85362,200,180,160,80,0,0,620
85363,200,160,160,80,160,0,760
85364,170,100,40,80,0,0,390
85365,180,100,0,0,0,0,280
85366,210,80,40,0,0,0,330
85367,180,100,80,80,160,0,600
85368,220,140,80,80,0,0,520
85369,170,60,0,0,0,0,230
85370,210,160,120,160,160,0,810
85371,180,140,160,80,0,0,560
85372,220,140,120,160,160,0,800
85373,180,100,120,80,0,0,480
85374,200,160,40,0,0,0,400
85375,180,140,0,0,0,0,320
85376,190,140,120,80,160,0,690
85377,200,80,80,160,160,0,680
85378,200,160,160,160,0,0,680
85379,210,120,120,160,160,0,770
85380,200,180,120,160,160,0,820
85381,210,100,0,0,0,0,310
85382,210,120,40,80,160,0,610
85383,210,120,80,80,160,0,650
85384,210,140,160,80,160,320,1070
85385,150,140,160,80,160,0,690
85386,160,120,120,160,160,0,720
85387,190,120,160,0,0,0,470
85388,220,180,120,80,160,0,760
85389,230,160,160,80,0,0,630
85390,150,40,40,0,0,0,230
85391,170,160,120,80,0,0,530
85392,190,140,120,160,160,0,770
85393,190,140,40,80,160,0,610
85394,220,140,160,160,160,320,1160
85395,200,80,80,80,160,320,920
85396,230,40,0,0,0,0,270
85397,210,140,120,160,320,320,1270
85398,210,60,80,80,160,0,590
85399,190,160,160,80,0,0,590
85400,210,160,120,160,160,0,810
85401,190,120,120,240,160,0,830
85402,180,80,40,80,160,0,540
85403,210,100,80,160,160,0,710
85404,130,140,80,0,0,0,350
85405,170,140,160,160,320,320,1270
85406,170,100,80,80,160,0,590
85407,190,160,200,160,0,0,710
85408,200,140,80,80,0,0,500
85409,240,120,120,80,160,0,720
85410,200,140,120,80,0,0,540
85411,190,120,80,0,0,0,390
85412,170,120,120,0,0,0,410
85413,200,100,120,80,0,0,500
85414,210,120,160,160,0,0,650
85415,210,160,120,80,0,0,570
85416,230,100,80,0,0,0,410
85417,160,100,120,160,160,0,700
85418,180,100,80,80,160,0,600
85419,210,180,120,80,0,0,590
85420,190,80,40,0,0,0,310
85421,160,160,80,80,0,0,480
85422,160,60,40,80,0,0,340
85423,240,100,80,80,0,0,500
85424,170,100,120,80,0,0,470
85425,170,80,0,0,0,0,250
85426,240,160,160,160,0,0,720
85427,250,120,120,160,160,0,810
85428,210,140,40,80,0,0,470
85429,160,80,80,0,0,0,320
85430,150,140,120,80,0,0,490
85431,170,120,120,80,160,0,650
85432,170,100,80,160,320,320,1150
85433,220,160,80,160,320,0,940
85434,190,120,80,80,0,0,470
85435,150,120,160,160,160,0,750
85436,180,140,120,80,0,0,520
85437,200,160,120,0,0,0,480
85438,240,80,80,0,0,0,400
85439,220,140,120,160,160,0,800
85440,220,160,120,160,320,0,980
85441,180,200,160,80,160,0,780
85442,200,80,80,80,0,0,440
85443,180,100,160,160,320,0,920
85444,170,120,120,160,0,0,570
85445,160,140,120,80,160,0,660
85446,190,200,80,0,0,0,470
85447,220,120,80,0,0,0,420
85448,190,60,40,80,160,0,530
85449,210,100,160,240,320,320,1350
85450,180,120,160,80,160,0,700
85451,270,120,40,80,160,0,670
85452,210,100,120,80,160,0,670
85453,200,140,40,80,0,0,460
85454,220,200,120,0,0,0,540
85455,200,120,80,160,320,0,880
85456,150,80,120,80,0,0,430
85457,180,120,80,0,0,0,380
85458,170,120,0,0,0,0,290
85459,170,120,40,80,0,0,410
85460,170,120,80,160,320,0,850
85461,170,180,160,80,0,0,590
85462,220,180,200,160,320,0,1080
85463,190,120,120,160,320,0,910
85464,230,140,80,0,0,0,450
85465,230,160,40,80,160,320,990
85466,210,160,120,160,160,0,810
85467,210,80,40,80,0,0,410
85468,190,100,120,80,160,0,650
85469,180,120,120,240,160,0,820
85470,220,100,80,80,160,0,640
85471,160,80,40,0,0,0,280
85472,210,160,80,80,0,0,530
85473,190,120,160,80,0,0,550
85474,230,140,80,80,0,0,530
85475,240,120,160,160,160,0,840
85476,200,120,80,80,0,0,480
85477,200,140,80,160,160,0,740
85478,200,120,40,80,160,0,600
85479,200,160,120,80,0,0,560
85480,210,160,160,160,160,320,1170
85481,200,140,80,80,0,0,500
85482,160,100,120,160,0,0,540
85483,180,140,160,80,160,0,720
85484,210,160,120,80,160,320,1050
85485,180,120,80,0,0,0,380
85486,180,100,160,80,160,320,1000
85487,210,140,0,0,0,0,350
85488,210,80,40,80,160,0,570
85489,190,160,160,240,160,0,910
85490,230,160,120,240,320,320,1390
85491,200,100,80,80,160,0,620
85492,250,140,120,80,0,0,590
85493,190,140,120,80,0,0,530
85494,210,180,200,160,320,320,1390
85495,190,160,160,80,160,0,750
85496,200,100,40,0,0,0,340
85497,190,100,160,160,160,0,770
85498,210,120,40,80,160,320,930
85499,250,140,0,0,0,0,390
85500,200,140,40,0,0,0,380
85501,180,140,200,80,160,0,760
85502,170,100,80,80,160,0,590
85503,230,140,40,0,0,0,410
85504,220,100,160,240,160,0,880
85505,170,140,80,0,0,0,390
85506,240,180,200,160,160,320,1260
85507,190,120,120,0,0,0,430
85508,180,140,120,160,160,320,1080
85509,190,100,80,0,0,0,370
85510,190,140,80,80,160,0,650
85511,180,140,120,160,320,0,920
85512,170,120,120,160,160,0,730
85513,220,120,120,80,160,0,700
85514,150,80,80,80,160,320,870
85515,180,100,80,80,0,0,440
85516,150,100,80,160,320,0,810
85517,150,100,80,160,0,0,490
85518,190,60,0,0,0,0,250
85519,160,160,160,80,160,0,720
85520,250,200,120,160,160,0,890
85521,190,60,40,80,160,320,850
85522,160,80,120,240,0,0,600
85523,230,120,40,0,0,0,390
85524,220,160,80,160,160,0,780
85525,190,120,80,80,0,0,470
85526,190,80,80,160,0,0,510
85527,240,100,120,80,160,0,700
85528,190,140,200,160,0,0,690
85529,200,120,80,0,0,0,400
85530,220,140,120,160,320,0,960
85531,210,140,120,160,0,0,630
85532,200,100,40,80,160,0,580
85533,180,120,120,0,0,0,420
85534,160,120,160,240,320,320,1320
85535,190,120,40,80,160,0,590
85536,200,180,200,160,160,0,900
85537,230,140,80,160,160,0,770
85538,180,120,200,320,320,320,1460
85539,160,120,120,80,160,0,640
85540,240,120,120,80,160,0,720
85541,190,60,40,0,0,0,290
85542,210,140,120,80,160,320,1030
85543,130,80,160,160,160,0,690
85544,270,180,160,240,160,0,1010
85545,230,100,120,160,160,0,770
85546,210,160,200,80,0,0,650
85547,160,120,160,80,160,0,680
85548,230,180,160,80,160,320,1130
85549,190,60,80,80,160,320,890
85550,160,120,200,160,160,0,800
85551,180,120,160,240,160,320,1180
85552,210,100,120,240,320,320,1310
85553,190,160,120,80,160,0,710
85554,170,120,120,80,160,0,650
85555,170,140,120,0,0,0,430
85556,210,180,120,80,160,0,750
85557,180,140,80,80,160,0,640
85558,190,60,40,0,0,0,290
85559,220,140,80,0,0,0,440
85560,200,40,40,0,0,0,280
85561,220,120,160,160,320,0,980
85562,220,140,160,240,160,0,920
85563,210,160,200,160,0,0,730
85564,170,80,80,80,160,320,890
85565,150,80,120,80,160,0,590
85566,220,100,160,240,160,320,1200
85567,210,200,120,80,0,0,610
85568,250,140,80,0,0,0,470
85569,220,140,160,160,160,0,840
85570,170,140,160,80,160,0,710
85571,200,100,120,80,0,0,500
85572,210,80,0,0,0,0,290
85573,170,160,160,240,320,320,1370
85574,180,140,160,240,320,320,1360
85575,250,140,120,80,0,0,590
85576,220,100,80,160,320,0,880
85577,190,80,120,160,160,0,710
85578,220,140,120,160,160,320,1120
85579,200,100,120,80,0,0,500
85580,160,120,40,0,0,0,320
85581,180,140,160,80,160,0,720
85582,200,100,120,160,320,0,900
85583,150,80,80,80,160,0,550
85584,210,180,80,80,160,320,1030
85585,200,140,120,160,0,0,620
85586,200,80,40,80,0,0,400
85587,230,140,80,160,160,320,1090
85588,190,140,120,80,160,0,690
85589,190,140,160,160,160,0,810
85590,210,80,80,160,160,0,690
85591,220,160,160,160,160,0,860
85592,180,160,80,80,160,0,660
85593,220,140,160,160,0,0,680
85594,210,120,120,160,160,0,770
85595,160,120,120,160,320,0,880
85596,230,120,200,160,0,0,710
85597,180,60,120,80,160,0,600
85598,180,120,80,80,160,0,620
85599,170,120,120,160,160,0,730
85600,170,140,200,160,0,0,670
85601,190,140,160,240,320,0,1050
85602,220,60,80,160,320,0,840
85603,190,140,200,160,160,0,850
85604,200,120,160,80,160,0,720
85605,170,140,120,160,160,320,1070
85606,220,80,40,80,160,0,580
85607,180,20,40,0,0,0,240
85608,180,160,120,160,160,0,780
85609,210,100,80,160,320,320,1190
85610,200,120,160,160,320,0,960
85611,220,120,80,80,160,0,660
85612,230,180,160,240,320,0,1130
85613,220,80,80,80,160,0,620
85614,170,140,120,0,0,0,430
85615,180,60,80,80,160,0,560
85616,170,100,0,0,0,0,270
85617,180,120,120,240,320,320,1300
85618,210,140,160,160,160,320,1150
85619,150,140,120,240,160,320,1130
85620,200,120,160,160,320,0,960
85621,190,120,80,80,0,0,470
85622,220,140,120,160,160,0,800
85623,200,120,80,0,0,0,400
85624,230,100,80,0,0,0,410
85625,210,60,80,80,160,0,590
85626,180,100,80,160,320,0,840
85627,210,60,80,80,160,0,590
85628,190,160,120,160,160,0,790
85629,200,100,120,160,160,320,1060
85630,240,120,40,0,0,0,400
85631,220,120,160,160,160,0,820
85632,170,100,120,160,320,0,870
85633,230,100,80,80,160,0,650
85634,200,160,80,80,0,0,520
85635,240,140,80,160,160,0,780
85636,200,140,160,80,160,0,740
85637,190,140,120,80,160,320,1010
85638,190,120,40,80,0,0,430
85639,160,120,80,80,0,0,440
85640,220,160,160,160,160,0,860
85641,240,120,80,80,160,0,680
85642,170,140,160,240,160,320,1190
85643,190,60,0,0,0,0,250
85644,220,140,80,80,160,320,1000
85645,190,100,80,160,0,0,530
85646,250,120,120,80,160,0,730
85647,150,100,120,160,160,0,690
85648,230,180,160,160,160,0,890
85649,180,140,80,0,0,0,400
85650,230,160,160,0,0,0,550
85651,200,140,80,0,0,0,420
85652,190,120,160,80,0,0,550
85653,230,140,120,160,160,0,810
85654,150,120,160,160,160,0,750
85655,210,140,80,0,0,0,430
85656,190,80,40,80,160,0,550
85657,200,140,120,80,160,0,700
85658,190,100,120,160,160,0,730
85659,170,100,40,80,160,0,550
85660,210,100,120,160,160,320,1070
85661,210,160,80,80,160,0,690
85662,240,160,120,0,0,0,520
85663,190,100,120,0,0,0,410
85664,220,140,40,80,160,0,640
85665,220,120,40,0,0,0,380
85666,160,80,0,0,0,0,240
85667,230,140,120,240,320,0,1050
85668,160,40,0,0,0,0,200
85669,210,120,80,0,0,0,410
85670,190,140,80,80,160,0,650
85671,170,140,0,0,0,0,310
85672,180,120,160,160,320,320,1260
85673,180,60,120,80,0,0,440
85674,180,160,120,160,160,0,780
85675,240,140,120,80,0,0,580
85676,220,120,80,160,160,0,740
85677,170,120,160,0,0,0,450
85678,180,60,40,0,0,0,280
85679,200,140,80,160,0,0,580
85680,160,100,120,0,0,0,380
85681,200,100,120,80,160,0,660
85682,220,100,40,0,0,0,360
85683,170,100,160,240,320,320,1310
85684,150,140,80,160,0,0,530
85685,210,100,120,80,160,0,670
85686,220,140,120,80,160,0,720
85687,210,120,40,80,160,0,610
85688,240,100,200,80,0,0,620
85689,180,140,160,80,160,0,720
85690,200,100,160,160,320,0,940
85691,210,160,80,80,160,0,690
85692,230,120,80,80,160,320,990
85693,210,120,160,160,160,320,1130
85694,200,160,120,80,160,320,1040
85695,210,80,80,80,160,320,930
85696,200,140,160,240,320,0,1060
85697,160,140,120,80,160,320,980
85698,190,160,160,240,320,320,1390
85699,230,60,40,80,160,0,570
85700,180,140,120,160,320,0,920
85701,180,120,80,0,0,0,380
85702,230,120,80,160,320,320,1230
85703,180,100,120,160,160,320,1040
85704,180,100,40,80,160,0,560
85705,240,100,80,0,0,0,420
85706,190,80,80,160,160,0,670
85707,150,140,120,160,0,0,570
85708,220,160,120,80,160,0,740
85709,190,200,80,80,0,0,550
85710,160,140,80,160,160,0,700
85711,220,100,0,0,0,0,320
85712,210,120,160,160,160,0,810
85713,210,120,160,160,320,0,970
85714,210,100,120,160,160,0,750
85715,190,160,160,240,160,320,1230
85716,220,140,120,80,0,0,560
85717,140,80,120,80,160,0,580
85718,230,100,160,160,320,320,1290
85719,160,120,120,160,0,0,560
85720,170,120,160,160,320,320,1250
85721,190,60,120,0,0,0,370
85722,190,120,80,80,0,0,470
85723,200,160,120,0,0,0,480
85724,160,80,40,80,160,0,520
85725,170,80,80,80,0,0,410
85726,180,80,40,0,0,0,300
85727,200,80,80,80,160,0,600
85728,210,180,200,160,160,0,910
85729,230,80,80,160,160,0,710
85730,200,80,40,0,0,0,320
85731,220,80,0,0,0,0,300
85732,170,100,80,160,0,0,510
85733,190,140,160,160,0,0,650
85734,210,180,160,160,320,0,1030
85735,200,120,80,80,160,0,640
85736,190,100,120,0,0,0,410
85737,210,160,160,160,160,320,1170
85738,200,120,120,80,160,320,1000
85739,200,160,40,0,0,0,400
85740,160,100,200,80,160,0,700
85741,200,140,120,0,0,0,460
85742,200,80,80,0,0,0,360
85743,200,160,160,80,160,320,1080
85744,250,160,200,80,160,0,850
85745,210,100,120,80,160,0,670
85746,200,120,160,80,0,0,560
85747,210,180,160,80,0,0,630
85748,210,120,80,160,160,0,730
85749,180,100,80,80,0,0,440
85750,160,140,200,240,320,320,1380
85751,200,120,120,160,320,0,920
85752,200,140,160,80,160,0,740
85753,180,120,200,160,160,0,820
85754,210,120,80,160,160,0,730
85755,190,100,80,80,160,0,610
85756,170,80,80,160,160,0,650
85757,160,140,160,80,160,320,1020
85758,190,40,40,80,160,0,510
85759,260,160,80,80,160,320,1060
85760,170,80,80,0,0,0,330
85761,150,80,120,80,160,0,590
85762,160,140,120,160,160,0,740
85763,210,100,80,0,0,0,390
85764,190,140,120,160,160,0,770
85765,200,100,80,80,160,320,940
85766,130,80,120,160,160,0,650
85767,190,120,120,160,320,320,1230
85768,200,120,160,160,160,0,800
85769,200,120,120,160,160,0,760
85770,190,120,160,80,0,0,550
85771,190,140,160,80,160,0,730
85772,200,80,40,80,0,0,400
85773,200,140,40,80,160,0,620
85774,200,60,80,80,0,0,420
85775,200,140,200,80,0,0,620
85776,190,160,120,160,320,320,1270
85777,220,100,40,80,160,0,600
85778,180,120,80,80,160,0,620
85779,190,180,160,160,0,0,690
85780,220,180,160,240,320,0,1120
85781,190,140,120,160,160,0,770
85782,250,120,120,0,0,0,490
85783,160,100,80,0,0,0,340
85784,190,120,0,0,0,0,310
85785,150,80,120,80,0,0,430
85786,200,140,80,80,160,320,980
85787,180,120,120,80,0,0,500
85788,200,180,120,80,160,0,740
85789,170,140,160,160,160,0,790
85790,150,120,160,240,320,0,990
85791,230,140,120,160,160,320,1130
85792,220,180,160,80,160,0,800
85793,220,140,80,80,160,320,1000
85794,220,160,160,80,0,0,620
85795,220,100,80,0,0,0,400
85796,210,100,40,0,0,0,350
85797,170,120,0,0,0,0,290
85798,210,140,40,0,0,0,390
85799,170,140,40,0,0,0,350
85800,200,120,40,80,160,0,600
85801,190,100,160,240,320,320,1330
85802,170,160,120,0,0,0,450
85803,200,180,120,80,160,0,740
85804,220,100,80,80,160,0,640
85805,220,180,120,160,160,0,840
85806,210,160,120,80,0,0,570
85807,170,120,120,80,0,0,490
85808,230,120,80,80,0,0,510
85809,210,180,120,80,160,0,750
85810,170,100,40,80,160,0,550
85811,190,120,160,160,320,320,1270
85812,180,140,160,80,160,0,720
85813,240,160,120,160,160,0,840
85814,220,180,200,240,160,0,1000
85815,210,120,120,80,160,0,690
85816,160,80,80,80,160,0,560
85817,230,160,160,80,0,0,630
85818,220,160,120,160,160,0,820
85819,170,80,120,160,160,0,690
85820,220,120,80,0,0,0,420
85821,190,60,0,0,0,0,250
85822,170,140,200,240,320,0,1070
85823,200,60,40,0,0,0,300
85824,140,80,40,80,160,0,500
85825,180,100,80,160,160,0,680
85826,190,100,120,0,0,0,410
85827,170,100,80,80,0,0,430
85828,240,60,40,80,160,0,580
85829,200,140,120,80,160,0,700
85830,170,180,80,0,0,0,430
85831,190,140,120,160,0,0,610
85832,200,120,80,80,160,0,640
85833,210,160,120,160,160,0,810
85834,150,140,120,80,160,0,650
85835,250,140,0,0,0,0,390
85836,170,60,0,0,0,0,230
85837,200,140,120,80,160,320,1020
85838,200,120,80,80,160,320,960
85839,240,120,120,160,320,0,960
85840,220,100,80,160,320,0,880
85841,190,160,200,240,160,0,950
85842,200,140,120,80,0,0,540
85843,200,100,120,160,160,0,740
85844,170,100,80,80,160,0,590
85845,170,140,80,80,160,0,630
85846,270,120,80,80,160,0,710
85847,180,140,40,0,0,0,360
85848,200,140,80,160,160,0,740
85849,200,140,160,240,160,0,900
85850,170,160,200,160,0,0,690
85851,150,120,40,0,0,0,310
85852,200,100,80,80,160,0,620
85853,190,100,160,240,320,0,1010
85854,230,120,80,80,0,0,510
85855,180,160,160,160,160,0,820
85856,190,140,160,240,160,0,890
85857,200,100,80,0,0,0,380
85858,200,140,80,80,160,0,660
85859,160,120,120,160,320,0,880
85860,200,140,40,80,160,0,620
85861,180,60,80,80,0,0,400
85862,210,80,40,80,0,0,410
85863,190,140,80,160,160,0,730
85864,210,140,160,160,320,0,990
85865,220,160,160,80,160,0,780
85866,170,80,40,80,0,0,370
85867,180,80,120,160,160,0,700
85868,220,140,0,0,0,0,360
85869,210,120,160,160,160,0,810
85870,220,100,120,80,0,0,520
85871,160,100,0,0,0,0,260
85872,210,140,160,0,0,0,510
85873,200,100,40,0,0,0,340
85874,160,120,80,0,0,0,360
85875,210,160,200,160,160,0,890
85876,200,160,120,0,0,0,480
85877,170,160,40,0,0,0,370
85878,240,80,80,160,320,0,880
85879,210,140,160,240,160,0,910
85880,190,80,80,80,160,320,910
85881,200,120,120,80,0,0,520
85882,220,140,200,160,160,0,880
85883,200,120,80,0,0,0,400
85884,240,160,200,240,160,0,1000
85885,150,100,160,80,0,0,490
85886,170,140,160,80,0,0,550
85887,190,120,80,80,160,0,630
85888,200,140,80,80,0,0,500
85889,190,140,80,80,160,0,650
85890,180,120,120,80,160,0,660
85891,190,80,0,0,0,0,270
85892,210,160,80,80,160,0,690
85893,230,100,80,80,0,0,490
85894,170,100,120,0,0,0,390
85895,180,140,160,160,160,0,800
85896,190,200,160,80,160,320,1110
85897,170,100,80,80,0,0,430
85898,170,120,80,160,160,0,690
85899,180,140,160,80,160,0,720
85900,200,140,80,0,0,0,420
85901,210,140,160,160,160,320,1150
85902,220,120,80,80,160,0,660
85903,140,80,80,160,160,0,620
85904,220,120,40,0,0,0,380
85905,200,140,120,80,0,0,540
85906,200,80,120,80,160,0,640
85907,200,120,120,80,0,0,520
85908,170,40,0,0,0,0,210
85909,160,140,80,80,160,0,620
85910,180,140,120,160,0,0,600
85911,180,120,80,80,160,320,940
85912,190,120,80,80,160,0,630
85913,170,120,40,0,0,0,330
85914,200,100,40,0,0,0,340
85915,210,120,160,240,160,0,890
85916,200,140,160,80,160,320,1060
85917,150,80,120,0,0,0,350
85918,180,120,160,160,160,0,780
85919,170,120,160,160,0,0,610
85920,200,120,80,0,0,0,400
85921,240,140,80,0,0,0,460
85922,230,80,80,80,0,0,470
85923,210,120,40,0,0,0,370
85924,210,140,80,80,160,0,670
85925,190,180,160,160,320,0,1010
85926,200,100,40,0,0,0,340
85927,220,120,80,160,160,0,740
85928,190,80,160,160,160,0,750
85929,200,80,120,0,0,0,400
85930,190,80,40,80,160,0,550
85931,150,140,80,80,160,0,610
85932,190,140,160,160,160,0,810
85933,220,80,120,80,0,0,500
85934,210,140,0,0,0,0,350
85935,180,160,80,80,160,0,660
85936,160,120,80,160,160,0,680
85937,200,120,40,0,0,0,360
85938,220,140,120,160,320,320,1280
85939,190,180,80,80,160,0,690
85940,200,80,120,240,160,0,800
85941,200,120,120,80,160,0,680
85942,200,120,160,240,0,0,720
85943,180,60,40,0,0,0,280
85944,230,160,120,160,160,0,830
85945,170,80,40,0,0,0,290
85946,200,80,80,160,0,0,520
85947,230,200,120,160,0,0,710
85948,190,60,40,80,0,0,370
85949,200,140,120,160,160,0,780
85950,160,140,120,80,160,0,660
85951,210,100,120,80,160,0,670
85952,230,180,200,160,0,0,770
85953,190,120,40,0,0,0,350
85954,160,80,80,80,160,0,560
85955,220,120,200,80,0,0,620
85956,220,140,80,160,0,0,600
85957,190,120,120,80,160,0,670
85958,190,140,160,160,160,0,810
85959,240,160,160,240,160,0,960
85960,180,100,160,240,160,0,840
85961,170,140,80,160,0,0,550
85962,210,140,80,160,160,0,750
85963,200,160,80,80,0,0,520
85964,200,80,80,80,160,0,600
85965,190,80,120,160,0,0,550
85966,190,140,200,0,0,0,530
85967,220,140,120,240,160,0,880
85968,210,140,120,80,160,0,710
85969,180,160,160,160,160,0,820
85970,220,80,80,160,320,320,1180
85971,160,120,80,0,0,0,360
85972,180,120,120,80,160,0,660
85973,200,80,80,160,160,0,680
85974,190,80,80,80,160,320,910
85975,160,160,160,160,160,0,800
85976,190,100,160,160,0,0,610
85977,210,140,80,0,0,0,430
85978,190,120,80,80,160,0,630
85979,180,160,80,160,160,320,1060
85980,170,140,160,80,0,0,550
85981,220,140,120,160,160,0,800
85982,170,100,40,80,0,0,390
85983,180,80,40,0,0,0,300
85984,200,100,80,80,160,0,620
85985,200,180,200,240,160,320,1300
85986,210,120,200,80,0,0,610
85987,190,140,120,80,0,0,530
85988,220,120,80,160,160,0,740
85989,160,60,80,80,160,0,540
85990,200,100,80,80,0,0,460
85991,200,140,120,160,320,0,940
85992,160,80,80,80,160,0,560
85993,190,100,120,160,160,0,730
85994,220,140,80,160,160,0,760
85995,170,120,200,160,160,0,810
85996,180,120,120,160,320,0,900
85997,200,140,120,80,160,0,700
85998,200,120,120,80,0,0,520
85999,200,100,120,0,0,0,420
86000,210,140,120,160,320,320,1270
86001,170,140,160,160,320,0,950
86002,190,100,160,80,0,0,530
86003,240,140,120,160,320,0,980
86004,170,100,80,0,0,0,350
86005,230,100,160,0,0,0,490
86006,210,140,200,240,160,0,950
86007,190,120,80,80,160,0,630
86008,170,140,120,80,160,0,670
86009,190,100,160,240,160,0,850
86010,180,100,160,160,160,0,760
86011,240,180,40,0,0,0,460
86012,160,100,160,160,160,0,740
86013,220,140,160,0,0,0,520
86014,200,140,120,80,160,0,700
86015,210,180,120,0,0,0,510
86016,220,180,160,80,160,0,800
86017,200,80,40,80,160,0,560
86018,220,140,120,160,160,0,800
86019,220,140,80,80,0,0,520
86020,200,140,80,160,320,0,900
86021,180,160,40,80,160,0,620
86022,190,180,120,160,320,320,1290
86023,240,160,160,160,160,0,880
86024,160,80,120,80,160,0,600
86025,200,140,160,80,160,320,1060
86026,190,160,80,80,0,0,510
86027,210,100,40,80,160,0,590
86028,200,100,160,240,320,0,1020
86029,170,80,40,0,0,0,290
86030,210,160,120,80,160,0,730
86031,230,80,80,80,160,0,630
86032,170,140,160,80,160,0,710
86033,190,120,120,240,160,0,830
86034,210,120,40,80,160,0,610
86035,200,180,120,80,160,0,740
86036,180,80,120,80,0,0,460
86037,180,120,120,160,320,0,900
86038,210,120,80,80,160,0,650
86039,190,200,160,160,320,320,1350
86040,210,160,160,160,320,0,1010
86041,180,60,80,0,0,0,320
86042,200,160,160,160,160,0,840
86043,240,120,120,0,0,0,480
86044,200,120,120,80,0,0,520
86045,160,80,80,160,160,0,640
86046,190,140,120,80,160,0,690
86047,200,120,120,160,320,0,920
86048,210,140,160,80,160,0,750
86049,180,180,160,80,0,0,600
86050,210,100,40,80,160,0,590
86051,190,120,40,80,0,0,430
86052,190,140,160,160,320,0,970
86053,170,100,120,160,160,0,710
86054,160,100,80,80,0,0,420
86055,210,120,120,160,160,0,770
86056,180,120,120,80,160,0,660
86057,190,100,160,80,0,0,530
86058,210,140,160,80,160,320,1070
86059,210,100,80,160,160,0,710
86060,200,140,40,80,0,0,460
86061,200,140,40,0,0,0,380
86062,220,140,160,0,0,0,520
86063,210,80,120,160,160,0,730
86064,200,80,80,0,0,0,360
86065,150,120,120,80,160,0,630
86066,180,100,40,80,0,0,400
86067,190,160,160,160,160,320,1150
86068,140,100,80,80,160,0,560
86069,180,160,80,160,320,0,900
86070,200,120,120,160,160,0,760
86071,210,140,160,160,0,0,670
86072,190,180,120,80,0,0,570
86073,160,140,120,160,160,320,1060
86074,190,80,80,160,160,0,670
86075,220,120,80,80,160,0,660
86076,160,40,40,80,160,0,480
86077,160,100,40,80,160,0,540
86078,230,140,160,160,320,0,1010
86079,190,120,120,80,160,0,670
86080,180,120,120,80,160,0,660
86081,210,160,120,160,320,0,970
86082,220,160,80,80,0,0,540
86083,210,120,80,80,160,0,650
86084,190,80,120,80,0,0,470
86085,200,140,80,80,0,0,500
86086,200,100,40,0,0,0,340
86087,190,120,120,80,160,0,670
86088,170,60,40,80,160,0,510
86089,210,120,40,80,160,320,930
86090,170,100,120,160,160,0,710
86091,190,120,80,160,320,0,870
86092,190,80,120,160,320,0,870
86093,180,80,80,160,160,0,660
86094,200,120,160,160,160,0,800
86095,220,180,80,80,160,0,720
86096,210,140,160,240,160,320,1230
86097,200,140,120,160,320,320,1260
86098,190,120,120,80,0,0,510
86099,210,180,160,80,0,0,630
86100,190,80,160,80,160,320,990
86101,180,100,80,80,0,0,440
86102,230,100,120,160,0,0,610
86103,120,120,200,160,0,0,600
86104,210,140,160,0,0,0,510
86105,180,120,80,0,0,0,380
86106,170,100,80,0,0,0,350
86107,190,180,120,160,160,320,1130
86108,250,160,80,80,160,0,730
86109,190,100,160,240,320,0,1010
86110,170,40,40,0,0,0,250
86111,170,100,80,0,0,0,350
86112,140,100,80,80,0,0,400
86113,200,100,160,240,320,0,1020
86114,170,120,120,160,320,0,890
86115,200,160,120,160,160,0,800
86116,210,160,80,80,0,0,530
86117,190,160,120,240,160,0,870
86118,220,160,80,0,0,0,460
86119,180,120,120,240,320,320,1300
86120,210,160,160,80,0,0,610
86121,180,120,160,0,0,0,460
86122,200,160,80,160,160,0,760
86123,180,100,80,160,160,0,680
86124,210,120,120,80,160,0,690
86125,220,60,40,0,0,0,320
86126,180,120,80,80,160,0,620
86127,130,60,40,0,0,0,230
86128,220,100,80,160,160,0,720
86129,230,180,120,240,160,0,930
86130,150,100,160,160,160,0,730
86131,220,160,120,160,160,0,820
86132,200,160,120,160,160,0,800
86133,180,160,120,160,320,0,940
86134,180,120,120,80,160,0,660
86135,210,120,120,80,0,0,530
86136,180,120,120,160,160,0,740
86137,170,100,80,80,160,0,590
86138,220,160,160,80,0,0,620
86139,190,140,80,0,0,0,410
86140,190,180,200,160,0,0,730
86141,210,80,40,80,0,0,410
86142,210,100,80,80,160,0,630
86143,200,180,80,0,0,0,460
86144,230,140,120,0,0,0,490
86145,200,80,0,0,0,0,280
86146,250,140,80,160,160,0,790
86147,160,120,80,160,160,320,1000
86148,140,140,120,0,0,0,400
86149,230,160,120,240,320,320,1390
86150,210,140,40,80,0,0,470
86151,190,120,160,80,160,0,710
86152,220,120,80,160,0,0,580
86153,160,80,40,80,0,0,360
86154,190,120,120,80,160,0,670
86155,180,100,80,80,0,0,440
86156,210,120,40,0,0,0,370
86157,200,180,120,80,160,0,740
86158,190,140,120,160,160,320,1090
86159,190,80,120,160,160,0,710
86160,200,140,160,80,160,0,740
86161,190,120,120,80,0,0,510
86162,190,120,120,160,320,0,910
86163,200,100,0,0,0,0,300
86164,260,60,40,0,0,0,360
86165,170,100,120,80,160,320,950
86166,200,120,120,80,0,0,520
86167,190,100,80,80,0,0,450
86168,180,140,160,0,0,0,480
86169,210,160,200,160,160,0,890
86170,180,140,120,160,160,0,760
86171,200,100,120,160,160,0,740
86172,200,80,80,160,320,0,840
86173,180,100,120,240,320,0,960
86174,150,60,40,0,0,0,250
86175,210,160,160,160,160,0,850
86176,180,100,160,80,160,0,680
86177,200,100,80,80,160,320,940
86178,210,100,80,160,160,0,710
86179,210,100,120,160,0,0,590
86180,190,120,80,0,0,0,390
86181,230,120,120,0,0,0,470
86182,180,40,80,0,0,0,300
86183,170,80,40,0,0,0,290
86184,190,80,120,80,160,0,630
86185,240,200,160,0,0,0,600
86186,190,120,40,80,0,0,430
86187,210,140,200,240,160,0,950
86188,170,120,120,160,160,0,730
86189,190,80,80,0,0,0,350
86190,210,140,160,80,160,320,1070
86191,170,120,120,240,320,320,1290
86192,190,80,120,80,160,0,630
86193,150,120,80,80,160,0,590
86194,160,80,80,160,160,320,960
86195,190,120,40,0,0,0,350
86196,220,120,160,80,0,0,580
86197,220,140,120,80,160,0,720
86198,230,80,120,0,0,0,430
86199,190,160,160,160,160,0,830
86200,200,100,80,80,0,0,460
86201,210,120,40,80,0,0,450
86202,190,160,80,80,0,0,510
86203,210,180,120,0,0,0,510
86204,160,120,80,0,0,0,360
86205,190,160,80,160,320,320,1230
86206,170,120,80,0,0,0,370
86207,220,120,80,80,160,0,660
86208,180,40,40,80,160,320,820
86209,200,140,160,160,160,320,1140
86210,220,100,80,80,160,0,640
86211,180,140,160,160,160,0,800
86212,200,120,120,160,0,0,600
86213,240,120,40,80,160,0,640
86214,220,100,120,160,320,320,1240
86215,230,220,160,160,320,0,1090
86216,160,100,120,160,160,0,700
86217,200,180,80,160,160,0,780
86218,180,140,120,80,0,0,520
86219,210,160,160,80,0,0,610
86220,200,160,40,0,0,0,400
86221,230,140,80,80,160,0,690
86222,180,80,80,160,320,0,820
86223,200,100,40,0,0,0,340
86224,240,140,120,80,160,0,740
86225,190,60,0,0,0,0,250
86226,250,140,120,80,160,0,750
86227,190,120,120,80,160,0,670
86228,220,120,120,80,160,320,1020
86229,200,140,160,240,320,0,1060
86230,150,60,0,0,0,0,210
86231,220,180,120,160,320,0,1000
86232,190,100,40,0,0,0,330
86233,160,80,160,240,0,0,640
86234,170,160,200,240,320,0,1090
86235,180,140,120,160,160,0,760
86236,150,160,160,80,160,0,710
86237,200,180,120,80,0,0,580
86238,180,100,120,0,0,0,400
86239,180,120,160,80,0,0,540
86240,180,180,200,240,320,0,1120
86241,150,120,120,160,160,0,710
86242,220,120,120,80,160,0,700
86243,160,80,120,80,0,0,440
86244,180,140,120,160,0,0,600
86245,150,120,120,80,160,0,630
86246,220,100,120,160,320,0,920
86247,220,140,80,160,160,0,760
86248,170,140,160,240,320,0,1030
86249,180,140,40,80,0,0,440
86250,180,120,200,240,0,0,740
86251,200,100,40,80,0,0,420
86252,220,140,160,160,160,0,840
86253,170,140,80,80,160,0,630
86254,180,160,40,0,0,0,380
86255,180,100,80,80,0,0,440
86256,160,100,120,240,320,0,940
86257,190,80,40,0,0,0,310
86258,240,200,160,160,320,320,1400
86259,220,60,80,160,320,0,840
86260,160,120,120,0,0,0,400
86261,190,140,40,0,0,0,370
86262,230,180,80,80,160,0,730
86263,200,140,120,0,0,0,460
86264,200,120,160,80,160,0,720
86265,180,120,80,0,0,0,380
86266,200,120,80,80,160,0,640
86267,240,100,80,80,0,0,500
86268,190,80,120,160,160,0,710
86269,210,180,120,160,160,320,1150
86270,200,120,80,0,0,0,400
86271,190,60,120,160,160,0,690
86272,220,120,40,0,0,0,380
86273,210,180,120,160,160,0,830
86274,200,160,80,80,160,0,680
86275,170,140,120,80,0,0,510
86276,200,120,160,240,160,0,880
86277,240,140,120,160,160,0,820
86278,210,160,120,160,160,0,810
86279,210,140,80,80,0,0,510
86280,190,120,40,80,0,0,430
86281,220,120,40,0,0,0,380
86282,210,160,120,0,0,0,490
86283,210,120,120,160,0,0,610
86284,180,120,120,160,320,0,900
86285,170,100,80,0,0,0,350
86286,180,140,80,160,160,320,1040
86287,170,140,120,160,160,0,750
86288,190,60,80,160,320,320,1130
86289,160,80,80,80,160,0,560
86290,180,160,120,80,0,0,540
86291,180,100,40,80,160,0,560
86292,190,180,200,160,160,320,1210
86293,170,40,80,0,0,0,290
86294,240,120,160,160,160,0,840
86295,220,120,160,160,160,0,820
86296,210,140,200,80,160,0,790
86297,210,100,80,80,160,320,950
86298,220,80,40,0,0,0,340
86299,220,140,160,160,160,0,840
86300,210,140,80,0,0,0,430
86301,220,140,80,80,0,0,520
86302,190,100,120,160,160,0,730
86303,190,160,40,80,0,0,470
86304,190,60,40,0,0,0,290
86305,190,120,160,160,320,320,1270
86306,210,120,80,80,0,0,490
86307,210,80,120,80,0,0,490
86308,180,140,80,160,320,320,1200
86309,210,120,80,80,160,0,650
86310,160,80,80,80,160,0,560
86311,190,120,120,160,160,320,1070
86312,210,160,40,0,0,0,410
86313,210,100,160,160,160,0,790
86314,170,120,80,80,160,0,610
86315,220,100,80,80,0,0,480
86316,160,80,40,80,160,0,520
86317,190,80,120,160,160,0,710
86318,150,120,80,0,0,0,350
86319,230,160,80,80,160,0,710
86320,190,120,120,80,160,320,990
86321,200,120,80,0,0,0,400
86322,210,60,40,80,0,0,390
86323,170,140,0,0,0,0,310
86324,140,80,80,160,320,320,1100
86325,200,100,160,160,0,0,620
86326,200,60,0,0,0,0,260
86327,190,160,40,0,0,0,390
86328,220,160,120,80,0,0,580
86329,180,160,200,240,160,0,940
86330,180,140,120,160,160,0,760
86331,190,120,80,80,160,0,630
86332,190,140,200,80,0,0,610
86333,180,140,160,240,320,0,1040
86334,200,120,120,80,0,0,520
86335,200,120,120,80,0,0,520
86336,230,140,120,160,320,0,970
86337,150,120,40,0,0,0,310
86338,220,120,120,160,320,0,940
86339,220,120,120,160,160,0,780
86340,240,160,80,80,160,0,720
86341,180,140,160,160,320,0,960
86342,200,80,80,80,0,0,440
86343,200,180,160,240,160,0,940
86344,170,100,80,80,160,0,590
86345,210,140,120,160,160,0,790
86346,190,120,80,160,320,0,870
86347,170,140,80,0,0,0,390
86348,180,140,120,0,0,0,440
86349,170,100,80,160,160,0,670
86350,230,120,80,0,0,0,430
86351,160,120,80,80,160,320,920
86352,190,140,120,80,0,0,530
86353,180,140,120,80,160,0,680
86354,180,160,160,0,0,0,500
86355,150,120,160,80,160,0,670
86356,190,120,80,160,160,0,710
86357,210,160,160,80,160,0,770
86358,190,180,160,160,0,0,690
86359,220,180,160,80,0,0,640
86360,180,120,80,80,160,0,620
86361,210,140,120,0,0,0,470
86362,230,100,120,80,160,320,1010
86363,210,80,120,0,0,0,410
86364,250,160,80,160,320,0,970
86365,220,80,40,0,0,0,340
86366,260,120,160,80,160,320,1100
86367,230,100,80,80,0,0,490
86368,250,140,120,160,160,0,830
86369,200,160,160,160,320,0,1000
86370,180,100,120,80,160,320,960
86371,160,100,80,80,0,0,420
86372,220,160,160,240,160,0,940
86373,170,60,80,80,160,0,550
86374,220,80,120,160,0,0,580
86375,180,120,120,240,160,0,820
86376,220,140,80,80,0,0,520
86377,230,120,120,80,160,0,710
86378,190,120,120,0,0,0,430
86379,210,100,40,80,160,320,910
86380,220,140,120,80,160,0,720
86381,220,100,120,80,0,0,520
86382,200,120,120,80,160,0,680
86383,190,140,160,80,0,0,570
86384,190,100,80,0,0,0,370
86385,250,160,160,160,0,0,730
86386,240,160,40,80,160,0,680
86387,220,140,120,160,0,0,640
86388,210,80,40,0,0,0,330
86389,180,80,80,0,0,0,340
86390,140,140,80,160,160,320,1000
86391,160,180,160,160,0,0,660
86392,210,80,80,80,160,0,610
86393,170,100,40,80,0,0,390
86394,210,140,160,80,160,0,750
86395,220,140,120,0,0,0,480
86396,210,140,160,80,0,0,590
86397,190,120,80,0,0,0,390
86398,230,120,160,160,320,0,990
86399,210,160,160,160,0,0,690
86400,210,140,40,0,0,0,390
86401,190,160,120,80,160,0,710
86402,180,80,40,0,0,0,300
86403,190,160,160,160,320,0,990
86404,220,180,80,0,0,0,480
86405,210,160,120,80,160,0,730
86406,170,160,120,160,160,0,770
86407,200,60,40,80,160,0,540
86408,230,100,80,160,0,0,570
86409,190,120,160,240,0,0,710
86410,170,120,40,80,0,0,410
86411,160,80,80,0,0,0,320
86412,190,100,80,80,0,0,450
86413,230,120,80,160,160,320,1070
86414,170,120,80,80,160,0,610
86415,210,140,80,0,0,0,430
86416,220,160,160,240,320,0,1100
86417,190,100,40,80,160,0,570
86418,210,100,40,80,0,0,430
86419,240,100,120,80,0,0,540
86420,220,140,160,160,320,320,1320
86421,240,180,40,80,160,0,700
86422,200,100,160,160,0,0,620
86423,190,120,120,80,160,0,670
86424,220,100,80,80,160,0,640
86425,220,100,80,0,0,0,400
86426,220,160,200,160,160,0,900
86427,150,100,80,80,160,0,570
86428,230,180,160,160,160,0,890
86429,220,160,80,80,0,0,540
86430,240,200,160,160,0,0,760
86431,220,160,200,240,160,0,980
86432,170,140,120,80,0,0,510
86433,190,100,120,80,160,320,970
86434,180,160,120,80,160,0,700
86435,210,100,80,80,0,0,470
86436,180,120,120,80,160,320,980
86437,190,120,160,80,160,0,710
86438,220,120,120,160,160,0,780
86439,200,80,80,80,160,0,600
86440,250,120,80,160,320,320,1250
86441,170,160,120,80,0,0,530
86442,210,140,120,160,320,320,1270
86443,200,160,80,80,0,0,520
86444,180,120,120,160,0,0,580
86445,180,140,80,80,160,320,960
86446,190,140,160,160,160,0,810
86447,230,160,120,80,160,0,750
86448,170,120,160,160,320,320,1250
86449,200,120,120,80,0,0,520
86450,140,100,80,80,160,0,560
86451,190,120,160,160,320,320,1270
86452,180,140,80,0,0,0,400
86453,220,140,120,160,160,0,800
86454,190,80,80,80,160,0,590
86455,210,120,80,80,0,0,490
86456,190,120,40,0,0,0,350
86457,210,180,120,80,0,0,590
86458,220,180,120,80,160,0,760
86459,160,120,160,240,320,320,1320
86460,210,140,120,0,0,0,470
86461,200,120,160,80,160,0,720
86462,240,140,80,80,160,0,700
86463,200,80,120,0,0,0,400
86464,160,100,80,0,0,0,340
86465,180,120,80,80,160,320,940
86466,200,160,120,0,0,0,480
86467,180,140,160,0,0,0,480
86468,190,80,160,80,160,320,990
86469,230,120,40,0,0,0,390
86470,220,120,120,160,160,0,780
86471,210,100,80,80,160,0,630
86472,170,120,120,160,160,0,730
86473,230,120,160,160,0,0,670
86474,210,120,80,160,160,320,1050
86475,230,140,40,80,0,0,490
86476,200,120,120,80,160,320,1000
86477,220,60,40,80,160,0,560
86478,170,40,40,80,0,0,330
86479,220,60,40,80,160,0,560
86480,200,60,40,80,160,0,540
86481,200,100,40,80,0,0,420
86482,210,120,80,80,160,0,650
86483,190,40,80,0,0,0,310
86484,210,80,120,160,160,0,730
86485,170,160,200,160,320,0,1010
86486,200,60,0,0,0,0,260
86487,190,140,120,80,160,320,1010
86488,190,80,80,80,160,0,590
86489,190,140,80,80,0,0,490
86490,220,160,160,80,160,0,780
86491,190,120,80,0,0,0,390
86492,150,120,120,160,160,0,710
86493,230,120,160,240,320,320,1390
86494,160,100,120,80,160,320,940
86495,200,160,120,80,160,0,720
86496,260,160,160,80,0,0,660
86497,160,140,120,160,0,0,580
86498,190,120,160,80,0,0,550
86499,190,140,120,0,0,0,450
86500,220,140,160,160,0,0,680
86501,190,140,120,160,0,0,610
86502,170,120,160,160,160,320,1090
86503,180,180,200,160,160,0,880
86504,140,100,80,80,0,0,400
86505,150,80,80,80,160,0,550
86506,210,80,40,0,0,0,330
86507,210,120,40,80,160,0,610
86508,170,100,40,0,0,0,310
86509,210,120,80,80,0,0,490
86510,190,160,160,80,160,320,1070
86511,170,140,120,80,160,0,670
86512,210,200,120,160,160,0,850
86513,160,100,120,160,160,0,700
86514,180,120,80,80,160,320,940
86515,190,60,80,80,160,320,890
86516,220,140,120,80,160,0,720
86517,200,140,120,160,160,0,780
86518,160,140,120,80,0,0,500
86519,170,140,200,240,160,0,910
86520,190,140,120,160,160,0,770
86521,170,100,40,80,0,0,390
86522,190,120,120,160,160,0,750
86523,170,80,120,0,0,0,370
86524,200,100,160,160,160,0,780
86525,180,160,120,0,0,0,460
86526,180,120,120,80,160,0,660
86527,200,140,120,160,160,0,780
86528,220,120,80,0,0,0,420
86529,220,180,120,80,160,0,760
86530,180,180,160,160,160,0,840
86531,160,100,80,80,0,0,420
86532,200,80,160,160,160,320,1080
86533,210,120,120,240,0,0,690
86534,190,120,120,160,160,320,1070
86535,210,180,120,80,160,0,750
86536,190,180,160,160,160,0,850
86537,230,100,0,0,0,0,330
86538,180,140,160,80,160,320,1040
86539,220,80,40,80,160,0,580
86540,200,120,160,80,160,0,720
86541,230,100,80,80,0,0,490
86542,180,80,160,160,320,0,900
86543,240,160,80,80,0,0,560
86544,190,80,40,0,0,0,310
86545,180,100,80,0,0,0,360
86546,190,100,120,80,0,0,490
86547,230,120,80,80,160,0,670
86548,180,120,120,240,320,0,980
86549,190,100,40,80,0,0,410
86550,190,160,80,160,320,0,910
86551,180,180,80,80,160,0,680
86552,220,80,80,160,0,0,540
86553,190,120,80,80,160,320,950
86554,170,180,120,160,160,0,790
86555,190,120,80,0,0,0,390
86556,210,140,120,80,160,320,1030
86557,180,100,120,80,0,0,480
86558,200,80,80,80,160,320,920
86559,200,120,120,80,160,0,680
86560,170,140,40,0,0,0,350
86561,220,120,80,0,0,0,420
86562,200,140,40,0,0,0,380
86563,150,140,80,0,0,0,370
86564,200,80,120,160,320,0,880
86565,210,120,200,240,160,0,930
86566,140,140,160,80,160,0,680
86567,190,100,120,80,0,0,490
86568,160,100,80,0,0,0,340
86569,200,200,160,160,160,320,1200
86570,220,140,80,80,160,0,680
86571,180,80,120,160,0,0,540
86572,230,120,120,160,160,0,790
86573,190,200,200,160,160,320,1230
86574,170,80,40,80,0,0,370
86575,210,100,80,80,160,0,630
86576,240,120,80,80,160,0,680
86577,210,200,160,160,320,0,1050
86578,220,200,120,80,160,0,780
86579,170,140,160,160,160,320,1110
86580,180,160,200,160,160,0,860
86581,240,160,160,160,160,0,880
86582,200,80,0,0,0,0,280
86583,190,100,80,80,0,0,450
86584,180,160,80,80,160,320,980
86585,240,160,160,160,320,0,1040
86586,210,80,40,80,160,0,570
86587,220,120,120,80,160,320,1020
86588,170,160,40,80,160,0,610
86589,180,160,200,160,0,0,700
86590,250,180,200,160,320,0,1110
86591,230,160,40,80,0,0,510
86592,200,180,240,160,160,320,1260
86593,200,160,120,80,0,0,560
86594,190,80,80,80,160,0,590
86595,170,100,120,80,0,0,470
86596,220,160,120,160,0,0,660
86597,220,140,80,80,160,0,680
86598,180,160,160,80,0,0,580
86599,200,100,120,160,0,0,580
86600,170,100,0,0,0,0,270
86601,180,80,40,80,160,320,860
86602,180,120,80,80,160,0,620
86603,250,120,120,160,160,0,810
86604,220,120,40,0,0,0,380
86605,190,80,120,160,320,320,1190
86606,180,100,40,80,160,0,560
86607,200,160,160,80,160,320,1080
86608,200,120,80,0,0,0,400
86609,160,140,80,0,0,0,380
86610,210,140,80,80,0,0,510
86611,160,40,80,80,160,0,520
86612,170,100,120,160,160,0,710
86613,180,60,80,160,0,0,480
86614,190,100,120,160,0,0,570
86615,180,120,40,80,160,0,580
86616,180,80,80,160,320,0,820
86617,200,100,80,80,160,0,620
86618,170,100,160,80,160,0,670
86619,210,140,80,0,0,0,430
86620,190,160,80,80,0,0,510
86621,230,140,160,160,0,0,690
86622,210,160,80,80,0,0,530
86623,180,120,160,160,0,0,620
86624,210,120,120,80,0,0,530
86625,170,100,40,80,0,0,390
86626,220,160,120,0,0,0,500
86627,190,140,200,160,160,0,850
86628,200,60,0,0,0,0,260
86629,180,120,200,240,0,0,740
86630,210,120,120,240,160,0,850
86631,210,140,120,160,0,0,630
86632,200,160,80,80,0,0,520
86633,220,140,160,160,0,0,680
86634,180,80,40,80,0,0,380
86635,200,140,120,80,160,0,700
86636,150,40,40,0,0,0,230
86637,210,140,120,0,0,0,470
86638,200,140,160,0,0,0,500
86639,190,120,120,80,160,0,670
86640,210,140,160,0,0,0,510
86641,200,80,120,0,0,0,400
86642,200,100,80,80,0,0,460
86643,180,120,120,160,0,0,580
86644,180,140,160,160,160,0,800
86645,230,180,120,80,0,0,610
86646,220,140,160,80,160,0,760
86647,190,80,40,0,0,0,310
86648,170,200,200,80,0,0,650
86649,210,120,120,80,0,0,530
86650,200,120,80,0,0,0,400
86651,200,120,40,80,160,0,600
86652,220,160,120,240,160,0,900
86653,240,120,40,0,0,0,400
86654,220,140,160,80,160,320,1080
86655,180,100,120,240,160,0,800
86656,150,100,120,80,160,0,610
86657,180,100,80,80,0,0,440
86658,180,100,0,0,0,0,280
86659,190,80,80,160,320,0,830
86660,220,120,120,240,320,0,1020
86661,170,160,160,160,160,0,810
86662,200,100,120,160,160,0,740
86663,200,120,160,160,320,0,960
86664,170,120,120,80,0,0,490
86665,210,160,80,0,0,0,450
86666,190,80,80,0,0,0,350
86667,160,100,120,80,0,0,460
86668,220,120,80,80,0,0,500
86669,220,180,120,80,0,0,600
86670,210,160,80,160,0,0,610
86671,160,40,80,80,160,0,520
86672,200,120,40,80,160,0,600
86673,190,100,40,80,0,0,410
86674,220,140,40,0,0,0,400
86675,190,80,120,160,160,0,710
86676,190,120,120,160,320,320,1230
86677,200,140,160,160,160,320,1140
86678,210,100,40,80,160,0,590
86679,160,100,120,80,0,0,460
86680,160,40,40,0,0,0,240
86681,190,80,40,80,0,0,390
86682,170,100,80,80,160,0,590
86683,190,100,80,160,160,0,690
86684,220,20,40,80,160,0,520
86685,180,120,40,0,0,0,340
86686,240,100,80,0,0,0,420
86687,190,140,160,240,160,0,890
86688,200,140,120,80,160,320,1020
86689,210,160,80,80,160,0,690
86690,230,120,120,160,320,0,950
86691,160,120,120,160,320,320,1200
86692,220,140,120,80,0,0,560
86693,200,160,160,160,160,0,840
86694,170,100,40,0,0,0,310
86695,210,120,80,160,0,0,570
86696,220,140,40,0,0,0,400
86697,220,80,0,0,0,0,300
86698,200,140,120,160,320,0,940
86699,180,100,120,0,0,0,400
86700,200,100,40,80,160,0,580
86701,160,100,160,160,160,320,1060
86702,220,120,80,0,0,0,420
86703,180,140,120,0,0,0,440
86704,160,80,120,160,0,0,520
86705,220,200,160,160,160,0,900
86706,230,140,120,80,0,0,570
86707,220,140,120,160,160,320,1120
86708,210,140,40,80,0,0,470
86709,210,120,120,80,160,320,1010
86710,190,80,80,160,160,0,670
86711,170,120,120,80,160,0,650
86712,250,120,80,80,160,0,690
86713,210,120,80,80,160,320,970
86714,160,80,40,0,0,0,280
86715,170,140,80,80,160,0,630
86716,200,140,80,80,160,0,660
86717,240,160,160,80,0,0,640
86718,150,120,80,80,160,0,590
86719,190,120,120,160,160,320,1070
86720,160,80,80,160,160,0,640
86721,220,140,40,80,160,320,960
86722,190,100,120,80,160,0,650
86723,180,100,80,160,160,0,680
86724,200,160,120,80,160,0,720
86725,200,160,120,80,0,0,560
86726,190,120,120,80,160,0,670
86727,210,140,80,0,0,0,430
86728,180,120,120,80,160,0,660
86729,190,160,120,160,320,0,950
86730,250,180,160,80,160,0,830
86731,150,40,40,0,0,0,230
86732,230,120,80,80,160,320,990
86733,220,60,80,160,0,0,520
86734,190,140,120,80,160,320,1010
86735,170,140,120,80,160,0,670
86736,180,140,120,80,0,0,520
86737,180,160,160,80,0,0,580
86738,220,120,160,160,160,0,820
86739,130,100,120,80,160,0,590
86740,210,120,40,80,160,0,610
86741,210,120,80,80,160,0,650
86742,170,120,80,80,160,0,610
86743,200,180,160,240,320,320,1420
86744,200,140,120,80,0,0,540
86745,220,60,120,80,0,0,480
86746,190,120,80,80,160,0,630
86747,200,120,80,80,160,320,960
86748,240,180,160,80,160,0,820
86749,210,100,40,80,160,0,590
86750,180,120,0,0,0,0,300
86751,180,140,120,80,160,0,680
86752,200,120,80,0,0,0,400
86753,200,140,160,240,160,0,900
86754,170,120,160,80,0,0,530
86755,200,120,160,80,160,320,1040
86756,170,100,120,160,160,0,710
86757,180,120,120,80,160,0,660
86758,170,120,40,80,160,0,570
86759,210,160,120,240,160,0,890
86760,240,160,200,160,320,0,1080
86761,170,100,80,80,160,320,910
86762,220,140,120,80,0,0,560
86763,220,160,40,0,0,0,420
86764,190,160,80,80,160,0,670
86765,210,120,160,160,320,320,1290
86766,150,120,0,0,0,0,270
86767,220,80,80,80,0,0,460
86768,240,140,160,80,0,0,620
86769,230,160,160,160,160,0,870
86770,200,160,120,0,0,0,480
86771,220,80,80,80,160,0,620
86772,190,80,40,0,0,0,310
86773,170,40,0,0,0,0,210
86774,180,100,40,80,0,0,400
86775,190,120,120,80,160,0,670
86776,200,120,160,80,160,0,720
86777,250,180,80,80,160,0,750
86778,220,80,40,80,160,0,580
86779,170,100,120,160,160,0,710
86780,210,120,120,160,320,320,1250
86781,200,140,120,80,0,0,540
86782,230,160,160,160,320,320,1350
86783,200,120,120,80,0,0,520
86784,180,100,80,80,160,0,600
86785,210,120,80,80,160,0,650
86786,190,140,80,160,0,0,570
86787,200,80,40,80,160,0,560
86788,190,60,40,80,0,0,370
86789,190,100,120,80,0,0,490
86790,210,180,40,0,0,0,430
86791,190,60,40,0,0,0,290
86792,190,140,120,0,0,0,450
86793,160,80,120,80,160,0,600
86794,210,120,40,0,0,0,370
86795,170,100,40,0,0,0,310
86796,150,80,120,160,320,0,830
86797,170,100,120,160,160,0,710
86798,160,140,160,240,320,0,1020
86799,210,120,80,0,0,0,410
86800,180,160,80,160,320,320,1220
86801,200,100,80,160,160,0,700
86802,180,120,120,160,0,0,580
86803,190,160,120,80,160,0,710
86804,230,180,120,80,0,0,610
86805,200,140,120,80,0,0,540
86806,200,160,120,80,0,0,560
86807,190,140,160,80,160,0,730
86808,170,100,40,80,160,0,550
86809,220,120,160,160,320,320,1300
86810,200,100,160,0,0,0,460
86811,200,140,120,160,0,0,620
86812,220,140,120,160,160,0,800
86813,180,160,40,80,160,0,620
86814,200,60,80,80,160,0,580
86815,260,140,120,80,160,0,760
86816,220,160,120,80,160,0,740
86817,150,80,80,80,160,0,550
86818,210,60,120,240,320,0,950
86819,180,100,200,80,0,0,560
86820,250,160,160,80,160,0,810
86821,230,120,200,160,160,0,870
86822,230,180,40,80,160,320,1010
86823,190,100,80,80,160,0,610
86824,150,100,80,160,160,0,650
86825,210,140,120,0,0,0,470
86826,180,100,40,80,160,0,560
86827,220,140,120,160,160,320,1120
86828,150,100,40,80,160,0,530
86829,220,120,80,160,0,0,580
86830,180,120,200,240,0,0,740
86831,150,120,160,80,0,0,510
86832,230,140,120,80,160,0,730
86833,190,100,40,80,160,0,570
86834,200,180,160,160,160,0,860
86835,210,160,40,0,0,0,410
86836,220,180,120,160,160,0,840
86837,200,140,160,160,160,0,820
86838,180,100,120,160,160,0,720
86839,140,140,80,160,320,0,840
86840,180,160,160,80,160,0,740
86841,250,180,160,80,0,0,670
86842,170,120,80,160,320,0,850
86843,210,80,80,80,160,0,610
86844,190,120,120,80,160,320,990
86845,190,140,120,160,160,0,770
86846,210,80,80,0,0,0,370
86847,200,140,120,80,0,0,540
86848,220,80,40,0,0,0,340
86849,160,100,80,80,160,0,580
86850,200,160,80,0,0,0,440
86851,190,120,80,0,0,0,390
86852,200,140,160,240,160,0,900
86853,200,120,80,80,160,0,640
86854,150,140,200,80,0,0,570
86855,180,140,160,240,320,0,1040
86856,200,40,80,80,160,0,560
86857,180,160,160,240,320,0,1060
86858,190,160,160,160,160,0,830
86859,180,100,40,0,0,0,320
86860,230,160,120,160,160,320,1150
86861,210,120,120,80,0,0,530
86862,180,140,120,160,0,0,600
86863,220,140,120,80,0,0,560
86864,200,140,40,0,0,0,380
86865,190,100,40,0,0,0,330
86866,180,140,200,160,160,320,1160
86867,250,140,80,80,160,320,1030
86868,210,120,80,160,320,320,1210
86869,180,120,80,160,160,0,700
86870,180,160,120,80,160,0,700
86871,180,80,0,0,0,0,260
86872,170,80,40,80,160,0,530
86873,180,180,160,160,0,0,680
86874,190,120,120,80,0,0,510
86875,210,120,40,80,160,0,610
86876,190,120,80,160,160,320,1030
86877,190,120,160,240,160,0,870
86878,220,140,120,80,0,0,560
86879,160,160,120,0,0,0,440
86880,200,120,80,80,160,0,640
86881,180,100,120,240,160,0,800
86882,200,60,80,80,0,0,420
86883,190,60,80,0,0,0,330
86884,210,100,120,80,160,0,670
86885,210,120,120,80,0,0,530
86886,180,80,80,80,160,320,900
86887,200,200,240,160,160,320,1280
86888,250,100,80,160,160,320,1070
86889,220,120,80,0,0,0,420
86890,220,180,120,80,160,0,760
86891,190,120,80,80,0,0,470
86892,190,120,40,80,160,0,590
86893,160,120,80,80,0,0,440
86894,230,140,40,0,0,0,410
86895,250,200,200,240,320,0,1210
86896,210,160,80,0,0,0,450
86897,210,140,160,240,320,320,1390
86898,160,120,80,80,160,0,600
86899,220,200,160,160,320,0,1060
86900,190,140,120,80,160,0,690
86901,220,100,160,160,160,0,800
86902,190,100,80,80,160,0,610
86903,210,120,120,0,0,0,450
86904,160,120,120,80,0,0,480
86905,230,140,80,80,160,320,1010
86906,150,100,80,160,160,0,650
86907,170,100,40,80,0,0,390
86908,220,100,40,0,0,0,360
86909,220,200,40,0,0,0,460
86910,200,140,160,160,320,320,1300
86911,210,120,160,80,0,0,570
86912,200,100,120,80,160,0,660
86913,170,80,120,80,160,0,610
86914,240,140,120,240,160,320,1220
86915,210,100,120,80,0,0,510
86916,200,140,200,240,160,0,940
86917,220,160,200,160,320,0,1060
86918,200,120,120,160,320,0,920
86919,160,140,80,0,0,0,380
86920,200,120,120,80,0,0,520
86921,210,100,120,80,160,0,670
86922,160,80,80,160,320,320,1120
86923,230,160,120,160,0,0,670
86924,190,100,0,0,0,0,290
86925,220,160,120,160,160,0,820
86926,170,80,120,80,160,0,610
86927,190,80,80,0,0,0,350
86928,220,140,80,80,160,0,680
86929,190,100,160,160,0,0,610
86930,180,80,40,0,0,0,300
86931,220,120,120,160,320,320,1260
86932,180,60,80,80,0,0,400
86933,160,120,80,80,0,0,440
86934,220,140,120,80,160,0,720
86935,260,140,160,160,320,320,1360
86936,150,120,120,160,160,0,710
86937,200,140,120,160,160,0,780
86938,200,100,40,80,0,0,420
86939,240,160,160,0,0,0,560
86940,200,140,40,80,160,0,620
86941,210,140,40,80,160,0,630
86942,210,80,80,160,0,0,530
86943,210,220,120,160,160,0,870
86944,170,100,80,160,160,320,990
86945,180,120,0,0,0,0,300
86946,240,160,80,80,160,0,720
86947,160,80,40,0,0,0,280
86948,240,80,80,80,160,0,640
86949,180,80,80,160,320,0,820
86950,200,160,120,160,320,0,960
86951,240,120,120,80,0,0,560
86952,220,140,40,0,0,0,400
86953,200,140,160,240,160,0,900
86954,220,140,120,80,160,0,720
86955,210,100,120,160,160,0,750
86956,190,160,160,160,160,0,830
86957,190,140,120,0,0,0,450
86958,150,80,80,160,160,320,950
86959,190,120,40,0,0,0,350
86960,230,120,80,0,0,0,430
86961,220,140,120,80,0,0,560
86962,200,100,40,80,160,0,580
86963,190,140,160,160,320,320,1290
86964,240,180,80,80,0,0,580
86965,190,140,120,80,160,0,690
86966,180,140,160,160,160,320,1120
86967,180,140,0,0,0,0,320
86968,200,140,80,80,160,0,660
86969,190,100,160,80,0,0,530
86970,230,140,40,0,0,0,410
86971,220,140,160,240,320,320,1400
86972,200,100,40,0,0,0,340
86973,230,120,160,0,0,0,510
86974,200,120,80,160,160,0,720
86975,200,120,160,160,160,320,1120
86976,150,80,120,80,160,0,590
86977,180,100,40,80,0,0,400
86978,190,140,120,160,160,0,770
86979,180,60,40,0,0,0,280
86980,220,140,160,80,0,0,600
86981,210,120,120,160,160,320,1090
86982,220,100,120,160,0,0,600
86983,200,120,160,160,160,0,800
86984,200,120,120,80,160,320,1000
86985,180,80,80,160,160,0,660
86986,200,160,120,160,0,0,640
86987,230,100,80,160,160,0,730
86988,180,100,160,160,160,0,760
86989,170,140,120,160,160,0,750
86990,240,180,120,160,0,0,700
86991,190,120,40,0,0,0,350
86992,210,140,120,80,0,0,550
86993,130,80,120,0,0,0,330
86994,200,160,120,160,0,0,640
86995,230,180,120,160,0,0,690
86996,200,140,0,0,0,0,340
86997,220,180,160,80,0,0,640
86998,210,100,80,80,160,0,630
86999,200,40,40,80,0,0,360
87000,160,100,160,80,160,0,660
87001,150,140,160,160,320,0,930
87002,190,160,200,160,160,0,870
87003,190,120,120,80,0,0,510
87004,200,120,120,80,160,320,1000
87005,240,160,160,80,160,320,1120
87006,230,100,80,80,0,0,490
87007,240,120,160,80,160,0,760
87008,170,120,160,80,160,320,1010
87009,180,160,200,240,320,0,1100
87010,170,140,120,80,0,0,510
87011,190,100,160,80,160,0,690
87012,180,120,120,80,160,0,660
87013,210,200,120,80,0,0,610
87014,190,200,160,160,320,0,1030
87015,180,140,40,0,0,0,360
87016,220,100,160,160,320,0,960
87017,210,140,40,0,0,0,390
87018,190,140,120,80,0,0,530
87019,200,180,160,160,160,320,1180
87020,210,100,80,80,160,0,630
87021,210,80,120,0,0,0,410
87022,190,120,80,80,160,0,630
87023,160,100,40,0,0,0,300
87024,200,80,80,160,160,0,680
87025,210,120,80,0,0,0,410
87026,200,100,80,80,160,0,620
87027,180,60,80,80,160,0,560
87028,210,140,80,80,160,320,990
87029,180,120,120,80,160,320,980
87030,200,80,80,80,160,0,600
87031,210,140,120,160,320,320,1270
87032,230,180,200,160,160,0,930
87033,210,180,80,160,160,0,790
87034,230,100,120,80,160,0,690
87035,220,120,120,160,160,0,780
87036,190,120,80,80,160,0,630
87037,190,120,80,0,0,0,390
87038,240,120,160,160,0,0,680
87039,220,200,200,80,160,0,860
87040,150,60,120,80,0,0,410
87041,200,100,120,160,0,0,580
87042,190,100,120,80,160,0,650
87043,190,100,120,160,160,0,730
87044,180,140,40,80,160,0,600
87045,200,80,80,80,160,0,600
87046,190,100,80,80,160,320,930
87047,210,80,80,0,0,0,370
87048,200,140,80,160,160,0,740
87049,190,140,120,160,320,320,1250
87050,200,100,0,0,0,0,300
87051,200,120,80,80,0,0,480
87052,200,100,80,80,160,0,620
87053,230,80,120,160,0,0,590
87054,180,100,80,80,0,0,440
87055,200,160,80,80,160,0,680
87056,230,100,80,80,160,0,650
87057,200,120,40,80,0,0,440
87058,200,140,160,80,0,0,580
87059,200,120,80,80,160,0,640
87060,230,160,80,160,160,0,790
87061,220,180,120,160,160,0,840
87062,200,120,80,80,0,0,480
87063,180,100,80,160,320,0,840
87064,180,120,80,80,160,0,620
87065,200,100,120,80,160,320,980
87066,180,100,0,0,0,0,280
87067,210,180,120,80,160,0,750
87068,160,80,40,0,0,0,280
87069,230,140,80,160,160,320,1090
87070,190,100,120,80,160,0,650
87071,220,120,120,80,0,0,540
87072,190,60,80,0,0,0,330
87073,180,140,160,80,0,0,560
87074,210,100,80,80,160,0,630
87075,210,160,240,160,320,0,1090
87076,210,140,160,160,160,0,830
87077,170,120,160,80,0,0,530
87078,210,120,120,160,160,320,1090
87079,190,160,160,160,160,0,830
87080,170,140,160,160,160,0,790
87081,170,120,120,80,0,0,490
87082,230,140,160,160,0,0,690
87083,200,160,200,160,160,0,880
87084,200,140,80,80,160,0,660
87085,220,120,80,80,160,0,660
87086,240,100,80,80,160,0,660
87087,230,160,200,240,320,0,1150
87088,170,100,120,160,320,0,870
87089,200,100,40,80,160,0,580
87090,230,100,80,0,0,0,410
87091,170,80,80,80,0,0,410
87092,170,120,120,160,0,0,570
87093,190,60,80,80,160,0,570
87094,210,160,40,0,0,0,410
87095,190,80,80,160,160,0,670
87096,220,140,120,80,160,0,720
87097,150,60,80,80,160,0,530
87098,210,100,80,80,160,0,630
87099,180,120,80,160,0,0,540
87100,210,140,80,160,160,0,750
87101,240,120,80,80,0,0,520
87102,210,120,120,160,0,0,610
87103,230,140,80,80,0,0,530
87104,190,160,160,80,0,0,590
87105,210,180,120,160,320,0,990
87106,220,140,80,160,320,0,920
87107,210,160,160,160,0,0,690
87108,200,140,160,240,160,0,900
87109,210,80,120,160,160,0,730
87110,200,80,80,160,160,320,1000
87111,190,120,80,0,0,0,390
87112,210,100,40,80,160,0,590
87113,170,140,160,160,320,0,950
87114,200,120,80,0,0,0,400
87115,180,120,120,80,0,0,500
87116,180,160,160,0,0,0,500
87117,190,140,80,0,0,0,410
87118,200,140,120,160,160,0,780
87119,160,80,80,160,320,0,800
87120,210,80,80,160,160,0,690
87121,150,100,120,80,160,0,610
87122,170,120,40,0,0,0,330
87123,180,120,40,0,0,0,340
87124,140,120,80,0,0,0,340
87125,180,160,80,160,0,0,580
87126,160,100,80,80,160,0,580
87127,190,180,120,80,160,0,730
87128,220,120,120,160,160,0,780
87129,210,140,200,160,320,320,1350
87130,210,140,120,240,160,0,870
87131,170,80,80,80,0,0,410
87132,160,80,120,160,160,0,680
87133,220,100,40,0,0,0,360
87134,220,140,80,80,0,0,520
87135,190,140,120,80,160,0,690
87136,210,140,120,80,0,0,550
87137,230,140,80,0,0,0,450
87138,180,140,120,80,0,0,520
87139,220,120,80,80,0,0,500
87140,180,120,120,160,160,0,740
87141,170,140,120,240,160,0,830
87142,200,140,120,0,0,0,460
87143,220,160,200,320,320,320,1540
87144,190,40,80,160,320,0,790
87145,220,160,160,160,320,0,1020
87146,160,100,80,80,160,0,580
87147,200,100,40,0,0,0,340
87148,180,140,120,240,320,320,1320
87149,200,120,160,160,0,0,640
87150,140,60,40,80,160,0,480
87151,220,140,160,160,320,0,1000
87152,180,100,40,80,0,0,400
87153,180,140,80,0,0,0,400
87154,200,100,40,0,0,0,340
87155,200,80,80,80,160,0,600
87156,230,120,160,80,0,0,590
87157,190,120,80,160,320,320,1190
87158,160,80,80,80,160,0,560
87159,220,120,80,80,160,0,660
87160,180,120,120,160,160,0,740
87161,180,180,120,240,320,320,1360
87162,200,140,120,0,0,0,460
87163,210,160,120,160,160,0,810
87164,160,120,40,0,0,0,320
87165,140,120,120,160,160,0,700
87166,180,100,120,160,320,0,880
87167,210,140,0,0,0,0,350
87168,220,160,40,0,0,0,420
87169,200,120,80,80,160,0,640
87170,190,120,120,160,160,0,750
87171,170,100,120,160,0,0,550
87172,210,100,120,0,0,0,430
87173,190,160,160,160,160,320,1150
87174,160,100,0,0,0,0,260
87175,200,120,160,160,0,0,640
87176,200,100,40,80,160,320,900
87177,160,140,120,80,0,0,500
87178,180,80,80,80,160,320,900
87179,200,140,120,80,0,0,540
87180,210,120,160,80,160,0,730
87181,200,60,40,80,160,0,540
87182,210,100,80,0,0,0,390
87183,170,120,160,240,0,0,690
87184,230,180,120,80,0,0,610
87185,190,140,160,80,0,0,570
87186,170,180,200,80,0,0,630
87187,200,60,40,0,0,0,300
87188,160,80,80,80,0,0,400
87189,210,100,120,160,160,0,750
87190,190,120,120,160,160,320,1070
87191,210,100,80,80,0,0,470
87192,200,100,80,0,0,0,380
87193,170,120,160,80,160,0,690
87194,210,100,80,80,0,0,470
87195,200,160,120,160,160,0,800
87196,240,140,80,80,0,0,540
87197,230,120,120,160,320,320,1270
87198,210,80,80,80,0,0,450
87199,220,160,120,80,0,0,580
87200,240,120,0,0,0,0,360
87201,230,120,120,240,320,0,1030
87202,180,160,80,80,0,0,500
87203,200,140,120,160,320,320,1260
87204,240,80,120,160,320,0,920
87205,210,120,80,0,0,0,410
87206,180,120,120,160,0,0,580
87207,200,120,80,80,160,320,960
87208,200,140,120,80,0,0,540
87209,220,140,120,80,160,0,720
87210,190,80,80,80,160,0,590
87211,200,120,120,80,0,0,520
87212,200,120,80,160,320,0,880
87213,210,140,160,160,0,0,670
87214,240,120,40,0,0,0,400
87215,180,180,200,80,0,0,640
87216,220,80,80,160,320,320,1180
87217,210,200,200,80,0,0,690
87218,230,140,160,160,320,0,1010
87219,210,120,80,0,0,0,410
87220,160,80,120,80,0,0,440
87221,210,140,80,80,160,320,990
87222,190,160,80,160,160,0,750
87223,170,100,80,0,0,0,350
87224,200,80,80,160,320,320,1160
87225,250,140,120,240,160,0,910
87226,160,100,80,80,160,0,580
87227,220,140,120,160,160,0,800
87228,210,140,160,160,0,0,670
87229,150,60,40,80,160,0,490
87230,160,100,160,160,0,0,580
87231,150,100,80,160,320,0,810
87232,190,80,80,80,0,0,430
87233,170,140,80,80,0,0,470
87234,190,120,80,0,0,0,390
87235,210,120,120,160,320,0,930
87236,210,160,160,80,0,0,610
87237,200,80,120,240,160,0,800
87238,200,80,80,160,160,0,680
87239,200,80,40,80,0,0,400
87240,210,120,80,160,160,0,730
87241,210,100,120,80,0,0,510
87242,170,100,200,240,0,0,710
87243,200,140,120,80,160,0,700
87244,240,140,160,80,160,320,1100
87245,200,140,120,160,160,0,780
87246,180,40,40,80,0,0,340
87247,210,140,40,80,160,0,630
87248,180,100,120,160,0,0,560
87249,180,100,80,80,160,0,600
87250,160,80,80,80,160,0,560
87251,190,140,80,80,0,0,490
87252,210,140,120,80,160,0,710
87253,170,80,40,80,160,0,530
87254,180,80,80,80,0,0,420
87255,230,160,80,160,160,0,790
87256,210,120,120,240,160,0,850
87257,200,60,40,0,0,0,300
87258,200,140,80,160,160,0,740
87259,210,100,80,80,160,0,630
87260,180,120,80,160,320,0,860
87261,220,120,40,80,160,0,620
87262,180,100,40,80,0,0,400
87263,190,160,120,160,0,0,630
87264,150,160,200,240,160,0,910
87265,170,60,80,0,0,0,310
87266,220,160,80,160,160,0,780
87267,200,140,120,240,160,320,1180
87268,150,100,40,80,160,320,850
87269,210,40,40,80,0,0,370
87270,200,140,160,240,160,0,900
87271,200,120,80,80,160,0,640
87272,190,180,200,160,160,0,890
87273,240,120,80,160,320,0,920
87274,250,160,160,160,160,0,890
87275,170,60,80,0,0,0,310
87276,230,80,120,160,0,0,590
87277,230,120,120,80,0,0,550
87278,190,120,80,80,160,0,630
87279,200,140,80,0,0,0,420
87280,250,120,120,160,0,0,650
87281,230,120,40,0,0,0,390
87282,230,140,80,160,160,0,770
87283,200,120,120,160,320,0,920
87284,230,80,80,0,0,0,390
87285,210,140,120,0,0,0,470
87286,160,80,40,80,0,0,360
87287,220,120,80,80,160,320,980
87288,220,120,120,80,0,0,540
87289,190,60,0,0,0,0,250
87290,210,180,160,160,160,0,870
87291,220,160,200,160,160,320,1220
87292,180,100,120,160,160,0,720
87293,150,100,40,80,0,0,370
87294,240,140,80,80,160,320,1020
87295,220,140,40,80,0,0,480
87296,200,140,80,160,160,0,740
87297,220,120,120,0,0,0,460
87298,240,140,120,240,160,0,900
87299,190,140,80,160,160,0,730
87300,200,120,160,160,160,320,1120
87301,160,120,120,80,0,0,480
87302,210,120,120,80,0,0,530
87303,180,180,160,80,0,0,600
87304,170,100,80,160,160,0,670
87305,240,140,80,80,160,0,700
87306,250,180,160,160,160,0,910
87307,190,140,120,160,160,0,770
87308,260,140,80,160,0,0,640
87309,200,140,80,80,160,0,660
87310,220,160,160,80,0,0,620
87311,140,140,120,80,0,0,480
87312,190,120,160,160,0,0,630
87313,220,100,120,160,0,0,600
87314,180,80,80,160,160,320,980
87315,120,60,40,0,0,0,220
87316,220,100,120,160,0,0,600
87317,220,120,80,0,0,0,420
87318,230,140,40,0,0,0,410
87319,190,120,80,80,0,0,470
87320,180,140,80,160,160,0,720
87321,210,200,120,160,160,0,850
87322,250,140,120,80,160,0,750
87323,210,180,120,160,160,0,830
87324,240,140,80,160,320,0,940
87325,230,100,120,160,320,0,930
87326,170,80,80,160,160,320,970
87327,200,140,120,240,160,0,860
87328,180,200,120,160,160,0,820
87329,170,120,80,80,160,0,610
87330,170,140,120,80,160,0,670
87331,180,100,120,160,160,0,720
87332,190,80,40,80,160,0,550
87333,170,100,0,0,0,0,270
87334,190,160,120,0,0,0,470
87335,170,80,120,160,160,0,690
87336,200,140,80,80,0,0,500
87337,210,80,40,80,160,0,570
87338,190,140,160,80,160,0,730
87339,200,160,200,160,160,0,880
87340,200,140,80,0,0,0,420
87341,180,120,200,80,160,0,740
87342,210,120,120,160,160,0,770
87343,200,140,80,80,0,0,500
87344,170,140,160,160,160,0,790
87345,200,100,120,80,160,320,980
87346,200,160,160,240,160,0,920
87347,230,180,240,160,160,320,1290
87348,210,140,160,160,320,0,990
87349,230,140,160,160,0,0,690
87350,200,160,160,160,160,0,840
87351,200,100,120,160,0,0,580
87352,200,120,80,0,0,0,400
87353,160,100,40,80,160,0,540
87354,150,120,200,160,160,320,1110
87355,200,140,160,80,160,0,740
87356,180,80,80,80,0,0,420
87357,200,100,120,160,320,0,900
87358,200,180,80,80,160,0,700
87359,250,160,40,80,0,0,530
87360,200,60,40,80,160,320,860
87361,200,160,160,240,0,0,760
87362,190,60,80,80,160,320,890
87363,180,120,160,80,0,0,540
87364,190,100,40,80,160,0,570
87365,190,160,160,80,0,0,590
87366,200,180,200,160,160,0,900
87367,260,80,40,0,0,0,380
87368,160,120,160,240,320,0,1000
87369,170,80,120,160,320,0,850
87370,160,100,80,80,160,0,580
87371,210,80,120,80,0,0,490
87372,210,120,160,160,320,0,970
87373,160,100,80,80,160,0,580
87374,200,140,80,80,0,0,500
87375,180,100,40,0,0,0,320
87376,200,120,160,160,160,0,800
87377,180,120,120,0,0,0,420
87378,200,120,80,80,160,0,640
87379,200,100,120,160,160,0,740
87380,170,140,40,0,0,0,350
87381,210,100,80,0,0,0,390
87382,200,120,120,80,0,0,520
87383,170,160,200,80,0,0,610
87384,240,100,80,80,160,0,660
87385,220,180,120,80,0,0,600
87386,190,120,80,160,0,0,550
87387,220,80,80,80,0,0,460
87388,180,100,120,160,0,0,560
87389,190,120,80,0,0,0,390
87390,200,80,80,0,0,0,360
87391,170,80,80,160,160,0,650
87392,190,100,40,0,0,0,330
87393,190,120,120,240,320,320,1310
87394,230,140,80,80,0,0,530
87395,220,140,120,80,160,0,720
87396,200,140,80,80,160,320,980
87397,200,80,80,80,0,0,440
87398,180,160,120,160,160,320,1100
87399,200,140,120,80,160,0,700
87400,170,100,40,80,160,0,550
87401,220,80,120,160,320,320,1220
87402,140,60,80,80,0,0,360
87403,200,140,80,80,0,0,500
87404,200,120,120,80,0,0,520
87405,210,120,120,160,160,0,770
87406,230,120,120,80,160,0,710
87407,170,100,120,80,0,0,470
87408,220,100,80,80,0,0,480
87409,170,80,40,0,0,0,290
87410,160,120,120,80,0,0,480
87411,150,120,80,80,0,0,430
87412,180,100,80,80,160,0,600
87413,200,160,120,160,160,0,800
87414,170,140,160,80,160,0,710
87415,180,80,120,160,160,320,1020
87416,180,100,40,80,160,320,880
87417,210,100,80,80,0,0,470
87418,200,80,40,80,160,0,560
87419,200,140,80,80,160,0,660
87420,180,140,160,160,160,0,800
87421,210,120,40,0,0,0,370
87422,180,100,80,160,160,0,680
87423,200,140,120,0,0,0,460
87424,180,100,40,0,0,0,320
87425,200,140,120,160,320,0,940
87426,200,80,80,80,160,320,920
87427,140,80,160,160,160,0,700
87428,210,100,120,160,160,0,750
87429,220,140,120,80,0,0,560
87430,150,80,40,80,0,0,350
87431,210,120,40,80,160,0,610
87432,160,100,80,80,160,0,580
87433,220,120,120,80,0,0,540
87434,190,80,40,80,0,0,390
87435,210,140,40,80,0,0,470
87436,220,200,120,160,160,0,860
87437,230,180,40,80,0,0,530
87438,170,140,40,80,0,0,430
87439,180,100,120,80,160,0,640
87440,180,100,40,0,0,0,320
87441,180,100,80,80,160,0,600
87442,190,120,120,80,0,0,510
87443,180,60,120,160,320,0,840
87444,190,100,120,80,0,0,490
87445,200,180,80,0,0,0,460
87446,190,80,120,0,0,0,390
87447,220,180,80,80,0,0,560
87448,180,100,80,80,0,0,440
87449,210,120,40,80,160,320,930
87450,200,140,120,160,320,320,1260
87451,220,120,40,80,160,0,620
87452,190,140,40,80,160,0,610
87453,210,140,160,0,0,0,510
87454,170,120,120,160,160,0,730
87455,200,120,160,240,320,0,1040
87456,200,140,120,160,0,0,620
87457,200,120,120,0,0,0,440
87458,190,160,120,160,160,0,790
87459,190,140,80,80,160,0,650
87460,200,100,80,80,0,0,460
87461,210,120,120,160,320,0,930
87462,170,100,120,80,160,0,630
87463,170,120,120,160,160,0,730
87464,260,160,160,240,160,0,980
87465,210,80,40,0,0,0,330
87466,190,80,120,240,160,0,790
87467,220,160,120,80,160,320,1060
87468,200,140,120,160,320,0,940
87469,190,120,160,80,160,0,710
87470,220,120,120,80,0,0,540
87471,190,80,80,0,0,0,350
87472,220,180,160,240,320,0,1120
87473,200,160,160,160,320,320,1320
87474,190,120,160,240,320,0,1030
87475,230,180,120,80,160,320,1090
87476,200,140,200,240,160,0,940
87477,210,220,200,80,0,0,710
87478,200,100,160,80,0,0,540
87479,170,140,160,240,320,0,1030
87480,230,100,40,80,0,0,450
87481,220,160,120,160,160,0,820
87482,180,140,160,80,160,0,720
87483,170,120,160,160,0,0,610
87484,200,160,160,160,0,0,680
87485,190,80,120,80,160,0,630
87486,190,120,120,160,160,0,750
87487,180,120,80,0,0,0,380
87488,200,140,80,80,160,320,980
87489,210,100,40,80,160,0,590
87490,210,180,120,160,320,320,1310
87491,170,140,80,0,0,0,390
87492,220,100,40,80,160,0,600
87493,190,80,120,80,0,0,470
87494,210,80,120,80,0,0,490
87495,190,160,120,80,160,320,1030
87496,210,100,40,80,160,0,590
87497,220,160,120,160,160,0,820
87498,170,140,160,160,160,320,1110
87499,190,120,80,160,160,0,710
87500,190,100,40,80,160,0,570
87501,200,120,120,160,320,0,920
87502,190,100,120,240,320,0,970
87503,200,160,80,80,160,0,680
87504,190,80,160,160,320,0,910
87505,200,40,40,80,0,0,360
87506,190,160,80,80,0,0,510
87507,220,100,40,80,160,0,600
87508,190,120,0,0,0,0,310
87509,190,100,80,80,160,0,610
87510,160,120,80,160,160,0,680
87511,200,80,40,80,160,0,560
87512,180,120,80,80,160,0,620
87513,240,160,160,160,160,0,880
87514,170,120,160,80,160,320,1010
87515,190,180,160,80,0,0,610
87516,210,80,80,80,0,0,450
87517,180,120,80,80,160,0,620
87518,180,160,120,80,0,0,540
87519,170,60,80,80,0,0,390
87520,180,80,80,80,160,0,580
87521,170,220,120,80,160,0,750
87522,210,120,40,0,0,0,370
87523,190,100,80,80,160,0,610
87524,180,160,120,80,160,0,700
87525,170,80,80,160,320,320,1130
87526,210,100,120,160,160,0,750
87527,230,120,120,80,0,0,550
87528,250,120,120,240,320,0,1050
87529,180,120,40,80,160,0,580
87530,160,80,80,80,0,0,400
87531,220,120,120,160,160,0,780
87532,170,120,160,80,0,0,530
87533,220,60,80,160,160,0,680
87534,170,140,160,80,160,0,710
87535,130,140,120,160,320,0,870
87536,200,180,160,160,320,0,1020
87537,160,140,120,80,0,0,500
87538,200,100,40,0,0,0,340
87539,170,120,80,160,160,320,1010
87540,220,180,120,160,0,0,680
87541,210,80,80,80,160,0,610
87542,230,80,80,0,0,0,390
87543,200,140,80,160,0,0,580
87544,220,100,160,80,160,0,720
87545,200,100,120,80,0,0,500
87546,190,160,160,240,160,0,910
87547,160,100,40,0,0,0,300
87548,220,60,120,80,0,0,480
87549,210,180,40,80,0,0,510
87550,180,80,120,80,0,0,460
87551,210,120,120,80,160,0,690
87552,190,140,160,160,160,0,810
87553,190,120,40,80,0,0,430
87554,170,160,160,160,160,0,810
87555,180,180,120,0,0,0,480
87556,200,120,80,0,0,0,400
87557,210,120,120,160,160,0,770
87558,210,160,40,80,160,0,650
87559,240,120,80,0,0,0,440
87560,160,140,120,160,0,0,580
87561,250,120,40,80,160,0,650
87562,190,140,160,160,0,0,650
87563,230,120,120,80,160,0,710
87564,190,140,40,0,0,0,370
87565,200,100,80,160,0,0,540
87566,160,100,80,160,160,0,660
87567,210,120,120,160,0,0,610
87568,170,140,120,80,160,0,670
87569,220,140,120,80,0,0,560
87570,180,140,80,80,160,320,960
87571,170,60,40,0,0,0,270
87572,220,80,120,80,0,0,500
87573,210,140,80,80,160,0,670
87574,230,160,160,240,0,0,790
87575,170,180,160,160,160,0,830
87576,170,120,120,80,0,0,490
87577,220,160,160,80,160,0,780
87578,200,80,40,80,160,0,560
87579,230,80,120,80,0,0,510
87580,230,80,40,80,160,0,590
87581,160,120,80,80,160,0,600
87582,190,100,120,160,320,0,890
87583,250,140,40,0,0,0,430
87584,230,140,80,80,160,320,1010
87585,180,120,120,240,320,0,980
87586,200,140,120,160,320,320,1260
87587,200,220,120,160,320,0,1020
87588,210,100,80,160,0,0,550
87589,180,120,80,160,160,0,700
87590,190,100,40,80,0,0,410
87591,170,80,80,0,0,0,330
87592,170,140,40,80,160,0,590
87593,160,120,80,80,160,0,600
87594,170,100,80,80,160,0,590
87595,230,140,120,0,0,0,490
87596,200,120,120,80,0,0,520
87597,200,80,80,80,160,320,920
87598,200,160,80,80,160,0,680
87599,170,120,120,160,160,0,730
87600,180,60,80,160,0,0,480
87601,260,140,80,80,160,0,720
87602,200,120,160,80,160,0,720
87603,210,140,40,0,0,0,390
87604,150,120,120,80,160,320,950
87605,210,140,80,160,160,320,1070
87606,200,100,120,80,0,0,500
87607,180,120,40,80,160,0,580
87608,200,120,120,80,0,0,520
87609,230,120,200,240,160,0,950
87610,200,80,120,160,160,0,720
87611,190,140,160,160,0,0,650
87612,170,120,120,240,160,0,810
87613,210,120,120,240,160,0,850
87614,220,80,80,80,160,0,620
87615,200,80,40,80,0,0,400
87616,160,140,120,80,160,0,660
87617,180,60,0,0,0,0,240
87618,230,180,200,240,160,0,1010
87619,200,100,80,160,0,0,540
87620,160,160,160,160,160,0,800
87621,210,140,80,80,0,0,510
87622,240,200,160,160,160,0,920
87623,210,100,0,0,0,0,310
87624,180,120,120,240,160,320,1140
87625,160,140,40,0,0,0,340
87626,200,100,40,80,160,0,580
87627,210,120,120,80,0,0,530
87628,190,160,160,160,320,0,990
87629,210,180,200,240,160,320,1310
87630,180,140,40,80,160,0,600
87631,220,160,80,80,160,0,700
87632,160,80,120,160,160,320,1000
87633,200,180,80,80,160,0,700
87634,170,120,40,0,0,0,330
87635,190,100,120,240,320,0,970
87636,190,160,160,160,0,0,670
87637,200,100,120,160,160,0,740
87638,210,120,80,160,320,0,890
87639,210,100,80,0,0,0,390
87640,200,80,80,80,160,0,600
87641,190,140,80,80,160,0,650
87642,190,120,80,80,160,320,950
87643,180,120,120,160,320,320,1220
87644,190,80,40,0,0,0,310
87645,200,120,120,160,160,320,1080
87646,190,80,40,80,0,0,390
87647,190,100,120,160,160,0,730
87648,210,160,160,160,160,0,850
87649,230,180,80,160,0,0,650
87650,200,140,120,80,0,0,540
87651,140,140,80,0,0,0,360
87652,180,100,80,80,160,320,920
87653,170,120,120,160,0,0,570
87654,220,140,80,80,160,320,1000
87655,160,140,40,0,0,0,340
87656,170,160,120,80,160,0,690
87657,180,100,80,0,0,0,360
87658,210,100,120,240,160,0,830
87659,230,140,120,240,320,320,1370
87660,160,100,80,80,0,0,420
87661,220,180,120,0,0,0,520
87662,200,100,160,160,160,0,780
87663,230,160,120,0,0,0,510
87664,180,100,0,0,0,0,280
87665,190,120,160,160,160,0,790
87666,180,120,80,0,0,0,380
87667,190,140,80,80,160,0,650
87668,190,80,40,0,0,0,310
87669,200,180,160,160,0,0,700
87670,200,140,40,80,160,0,620
87671,240,120,80,80,160,320,1000
87672,160,60,80,80,0,0,380
87673,140,100,80,80,0,0,400
87674,190,140,160,80,160,0,730
87675,180,60,40,80,160,0,520
87676,200,100,40,0,0,0,340
87677,180,140,120,160,160,320,1080
87678,200,120,80,160,160,0,720
87679,190,100,80,80,160,0,610
87680,190,160,80,0,0,0,430
87681,200,160,80,80,0,0,520
87682,200,80,120,0,0,0,400
87683,240,100,80,160,320,320,1220
87684,180,160,160,160,160,0,820
87685,150,120,120,160,160,320,1030
87686,230,80,80,0,0,0,390
87687,200,140,80,80,0,0,500
87688,210,200,200,160,160,0,930
87689,210,180,160,80,160,0,790
87690,200,80,160,80,0,0,520
87691,200,120,40,0,0,0,360
87692,200,140,160,240,160,0,900
87693,200,140,160,80,0,0,580
87694,200,120,120,160,160,0,760
87695,240,80,40,80,0,0,440
87696,170,160,160,160,160,0,810
87697,190,80,80,80,0,0,430
87698,230,80,40,80,160,0,590
87699,170,120,120,160,320,0,890
87700,210,200,120,80,160,0,770
87701,200,100,80,0,0,0,380
87702,180,80,40,80,0,0,380
87703,190,60,40,80,160,0,530
87704,160,120,80,80,160,0,600
87705,200,120,80,0,0,0,400
87706,220,160,160,160,320,320,1340
87707,180,100,120,160,160,0,720
87708,200,140,80,0,0,0,420
87709,210,140,200,160,160,0,870
87710,220,160,160,240,320,0,1100
87711,190,80,80,80,0,0,430
87712,160,160,120,0,0,0,440
87713,180,80,80,0,0,0,340
87714,230,120,80,80,160,0,670
87715,160,80,80,80,160,0,560
87716,180,120,120,160,0,0,580
87717,180,160,120,160,0,0,620
87718,190,120,120,160,160,0,750
87719,220,120,120,0,0,0,460
87720,160,60,80,80,160,0,540
87721,270,100,80,160,0,0,610
87722,180,80,80,80,0,0,420
87723,170,140,0,0,0,0,310
87724,200,160,80,80,160,0,680
87725,200,180,120,160,320,0,980
87726,200,140,120,80,160,0,700
87727,220,140,40,80,160,320,960
87728,210,120,120,240,320,0,1010
87729,190,100,80,80,0,0,450
87730,180,100,80,80,0,0,440
87731,190,140,120,160,160,0,770
87732,140,100,80,80,160,0,560
87733,170,120,0,0,0,0,290
87734,200,180,160,0,0,0,540
87735,170,100,80,80,160,0,590
87736,220,180,200,240,320,0,1160
87737,210,100,160,160,320,320,1270
87738,220,160,120,80,0,0,580
87739,200,140,80,80,0,0,500
87740,170,140,160,160,160,0,790
87741,190,100,40,80,160,320,890
87742,190,160,160,160,160,0,830
87743,210,200,80,80,0,0,570
87744,230,120,120,0,0,0,470
87745,220,140,120,240,0,0,720
87746,180,80,40,0,0,0,300
87747,220,120,80,80,160,320,980
87748,200,180,160,240,0,0,780
87749,190,140,120,160,0,0,610
87750,200,140,160,80,0,0,580
87751,230,120,80,80,160,0,670
87752,190,80,120,160,160,0,710
87753,200,100,120,80,160,320,980
87754,210,140,80,80,160,320,990
87755,240,100,80,80,160,0,660
87756,240,140,120,160,160,0,820
87757,190,120,80,80,160,0,630
87758,210,80,80,160,0,0,530
87759,200,100,40,0,0,0,340
87760,180,100,80,0,0,0,360
87761,190,100,80,80,160,0,610
87762,190,100,80,0,0,0,370
87763,200,160,120,160,0,0,640
87764,180,100,120,160,160,0,720
87765,170,120,120,80,160,0,650
87766,150,100,80,160,320,320,1130
87767,210,140,80,0,0,0,430
87768,240,140,120,80,160,0,740
87769,220,140,120,160,0,0,640
87770,210,160,120,160,160,0,810
87771,210,160,160,80,0,0,610
87772,240,120,160,160,320,0,1000
87773,190,100,160,80,160,0,690
87774,200,140,80,80,160,0,660
87775,250,100,40,0,0,0,390
87776,190,100,80,80,0,0,450
87777,200,100,120,0,0,0,420
87778,220,140,120,80,160,0,720
87779,220,60,80,0,0,0,360
87780,200,120,120,80,160,0,680
87781,230,140,80,80,0,0,530
87782,200,100,80,80,160,0,620
87783,210,160,40,0,0,0,410
87784,180,140,160,0,0,0,480
87785,170,80,120,160,0,0,530
87786,190,100,120,80,160,0,650
87787,190,100,120,160,320,0,890
87788,220,180,120,160,160,0,840
87789,160,140,120,0,0,0,420
87790,220,140,160,160,160,0,840
87791,180,160,40,0,0,0,380
87792,210,140,160,240,0,0,750
87793,220,100,120,160,160,320,1080
87794,190,100,80,80,160,0,610
87795,190,100,80,160,0,0,530
87796,200,140,160,160,0,0,660
87797,220,120,120,160,320,0,940
87798,190,120,120,160,160,0,750
87799,220,140,80,160,160,0,760
87800,230,160,120,80,0,0,590
87801,180,160,120,160,320,0,940
87802,230,60,80,80,160,0,610
87803,120,100,40,80,0,0,340
87804,160,100,120,80,160,0,620
87805,210,120,80,0,0,0,410
87806,190,100,40,0,0,0,330
87807,220,140,120,80,0,0,560
87808,170,120,80,80,0,0,450
87809,150,160,120,80,160,320,990
87810,210,60,40,0,0,0,310
87811,240,140,120,160,0,0,660
87812,160,160,200,80,160,0,760
87813,210,120,160,160,160,0,810
87814,200,160,160,80,160,0,760
87815,180,80,40,0,0,0,300
87816,150,140,120,160,0,0,570
87817,210,120,40,0,0,0,370
87818,240,100,80,80,0,0,500
87819,190,120,40,0,0,0,350
87820,190,100,80,80,0,0,450
87821,190,140,40,80,0,0,450
87822,180,80,80,80,160,0,580
87823,220,180,120,240,320,0,1080
87824,180,100,160,240,160,0,840
87825,240,140,80,160,0,0,620
87826,200,140,160,80,160,320,1060
87827,190,160,80,80,160,0,670
87828,180,140,200,80,0,0,600
87829,200,120,40,0,0,0,360
87830,220,140,120,160,320,320,1280
87831,220,160,80,160,160,0,780
87832,200,180,200,160,160,0,900
87833,200,120,0,0,0,0,320
87834,170,80,40,0,0,0,290
87835,180,100,120,240,160,0,800
87836,190,120,160,80,0,0,550
87837,200,120,80,80,160,0,640
87838,210,120,160,160,320,0,970
87839,210,180,160,0,0,0,550
87840,240,140,120,80,160,320,1060
87841,200,120,120,160,160,0,760
87842,160,100,0,0,0,0,260
87843,180,140,160,160,0,0,640
87844,190,140,120,160,160,0,770
87845,170,60,40,0,0,0,270
87846,190,100,120,80,0,0,490
87847,230,140,80,80,160,0,690
87848,230,120,120,160,160,0,790
87849,190,120,120,160,160,0,750
87850,220,160,80,80,160,0,700
87851,200,140,80,80,160,0,660
87852,200,80,0,0,0,0,280
87853,150,100,160,160,160,0,730
87854,160,40,40,0,0,0,240
87855,220,180,120,80,160,0,760
87856,170,80,80,80,160,320,890
87857,190,160,120,160,0,0,630
87858,230,180,120,240,160,0,930
87859,170,60,80,160,160,0,630
87860,190,140,40,0,0,0,370
87861,180,80,120,80,160,320,940
87862,190,160,120,80,160,0,710
87863,220,160,0,0,0,0,380
87864,200,120,80,160,160,0,720
87865,220,160,80,80,160,320,1020
87866,180,120,120,160,0,0,580
87867,200,140,120,80,160,0,700
87868,210,160,120,160,160,320,1130
87869,200,160,120,160,160,320,1120
87870,160,100,120,160,160,0,700
87871,190,140,120,160,160,0,770
87872,200,100,40,0,0,0,340
87873,180,120,120,80,160,0,660
87874,170,120,160,160,0,0,610
87875,190,100,80,80,160,0,610
87876,180,120,120,160,160,0,740
87877,210,120,120,80,160,0,690
87878,200,100,80,80,160,320,940
87879,220,100,80,80,0,0,480
87880,230,100,120,80,160,0,690
87881,220,120,80,160,160,0,740
87882,210,160,120,240,160,0,890
87883,180,100,80,80,160,0,600
87884,200,100,80,80,160,320,940
87885,190,140,120,80,160,0,690
87886,210,140,80,80,0,0,510
87887,190,120,160,80,160,0,710
87888,160,120,80,80,0,0,440
87889,200,140,120,160,160,0,780
87890,230,140,80,160,0,0,610
87891,190,120,40,0,0,0,350
87892,200,80,80,160,160,0,680
87893,200,180,200,80,160,0,820
87894,200,120,40,0,0,0,360
87895,190,100,40,80,0,0,410
87896,210,140,120,80,160,0,710
87897,190,100,120,240,320,0,970
87898,190,120,160,320,160,0,950
87899,170,100,120,160,160,0,710
87900,210,100,120,160,320,0,910
87901,180,100,120,80,160,320,960
87902,180,140,200,80,0,0,600
87903,160,100,160,160,160,0,740
87904,190,140,160,0,0,0,490
87905,190,80,40,80,160,0,550
87906,190,160,80,0,0,0,430
87907,160,100,80,160,160,0,660
87908,210,80,40,80,0,0,410
87909,200,140,120,80,160,0,700
87910,190,80,120,80,0,0,470
87911,190,140,40,80,0,0,450
87912,190,60,0,0,0,0,250
87913,170,120,80,0,0,0,370
87914,200,120,80,80,160,0,640
87915,190,140,160,160,160,320,1130
87916,200,180,120,0,0,0,500
87917,210,180,120,80,160,0,750
87918,280,160,160,240,0,0,840
87919,240,120,160,160,160,0,840
87920,200,160,80,80,160,0,680
87921,220,100,120,0,0,0,440
87922,230,140,160,160,0,0,690
87923,190,160,120,160,160,0,790
87924,190,180,160,160,0,0,690
87925,170,80,120,160,160,0,690
87926,210,200,80,0,0,0,490
87927,200,140,160,80,160,0,740
87928,160,120,120,160,160,320,1040
87929,200,60,120,0,0,0,380
87930,210,120,160,160,320,0,970
87931,180,80,40,0,0,0,300
87932,170,120,40,0,0,0,330
87933,220,140,80,80,160,0,680
87934,180,140,80,160,160,0,720
87935,160,100,80,80,0,0,420
87936,190,120,80,0,0,0,390
87937,190,100,80,160,320,0,850
87938,190,140,120,160,160,0,770
87939,190,140,120,160,160,320,1090
87940,220,100,120,160,160,0,760
87941,200,120,160,80,0,0,560
87942,210,180,120,240,160,0,910
87943,250,160,80,80,160,0,730
87944,210,80,120,80,160,0,650
87945,200,120,160,80,0,0,560
87946,160,140,80,160,160,0,700
87947,210,120,120,0,0,0,450
87948,180,60,80,80,0,0,400
87949,250,160,160,80,0,0,650
87950,220,120,80,80,160,320,980
87951,220,120,120,240,160,0,860
87952,210,100,120,80,0,0,510
87953,190,160,160,80,0,0,590
87954,190,100,80,160,160,320,1010
87955,160,80,120,160,160,0,680
87956,210,160,80,0,0,0,450
87957,190,140,80,160,160,0,730
87958,180,80,120,160,320,0,860
87959,170,140,120,80,160,0,670
87960,220,120,160,160,320,0,980
87961,220,120,160,160,160,0,820
87962,160,140,160,160,160,0,780
87963,210,160,80,80,160,0,690
87964,180,140,120,80,0,0,520
87965,190,100,120,240,320,0,970
87966,210,120,40,80,0,0,450
87967,180,100,120,0,0,0,400
87968,180,100,200,160,0,0,640
87969,170,100,80,0,0,0,350
87970,200,100,120,80,160,0,660
87971,190,120,160,160,320,0,950
87972,200,120,120,80,160,320,1000
87973,210,160,160,80,0,0,610
87974,220,140,120,240,320,0,1040
87975,180,100,80,0,0,0,360
87976,220,140,120,80,0,0,560
87977,180,100,80,0,0,0,360
87978,150,120,120,160,160,0,710
87979,190,160,120,160,160,320,1110
87980,220,100,80,0,0,0,400
87981,240,120,80,160,320,0,920
87982,230,140,160,160,160,0,850
87983,180,100,80,80,0,0,440
87984,170,120,40,80,0,0,410
87985,240,160,40,0,0,0,440
87986,190,120,120,160,0,0,590
87987,180,60,40,0,0,0,280
87988,200,160,80,0,0,0,440
87989,220,120,120,80,0,0,540
87990,200,100,120,160,0,0,580
87991,170,140,80,80,0,0,470
87992,200,40,40,80,160,0,520
87993,190,160,160,80,0,0,590
87994,190,120,160,240,160,320,1190
87995,210,180,200,160,160,0,910
87996,210,140,120,160,160,0,790
87997,220,160,120,240,160,320,1220
87998,220,120,120,160,320,0,940
87999,190,160,160,160,320,0,990
88000,210,140,120,240,320,320,1350
88001,220,120,120,0,0,0,460
88002,190,140,120,160,320,0,930
88003,160,120,120,0,0,0,400
88004,160,140,160,0,0,0,460
88005,210,160,160,80,0,0,610
88006,180,120,40,80,160,0,580
88007,200,100,120,80,0,0,500
88008,210,120,80,80,0,0,490
88009,190,140,80,160,160,0,730
88010,200,160,80,0,0,0,440
88011,200,160,120,0,0,0,480
88012,210,100,120,80,0,0,510
88013,210,80,80,0,0,0,370
88014,220,100,40,0,0,0,360
88015,200,100,40,0,0,0,340
88016,190,120,160,80,160,320,1030
88017,200,120,80,0,0,0,400
88018,150,120,160,80,160,0,670
88019,170,140,120,80,160,0,670
88020,200,120,80,160,160,0,720
88021,200,160,200,80,0,0,640
88022,190,80,40,80,160,0,550
88023,240,180,80,80,160,0,740
88024,240,100,120,160,160,320,1100
88025,240,180,160,160,320,0,1060
88026,180,100,80,160,320,320,1160
88027,190,80,80,80,160,0,590
88028,210,140,160,160,160,0,830
88029,190,140,120,160,160,320,1090
88030,180,120,80,0,0,0,380
88031,210,160,120,160,320,320,1290
88032,220,160,160,80,0,0,620
88033,180,140,80,0,0,0,400
88034,220,140,40,0,0,0,400
88035,190,100,120,160,320,0,890
88036,180,100,120,160,160,0,720
88037,200,160,80,80,160,0,680
88038,220,80,120,80,0,0,500
88039,190,140,160,80,0,0,570
88040,190,80,40,80,160,320,870
88041,200,120,80,160,160,0,720
88042,190,140,80,80,160,0,650
88043,210,160,200,80,160,0,810
88044,150,120,80,0,0,0,350
88045,210,160,120,160,0,0,650
88046,210,100,80,80,160,320,950
88047,200,80,120,160,160,0,720
88048,210,80,120,80,160,320,970
88049,180,120,120,80,0,0,500
88050,160,120,120,80,0,0,480
88051,210,120,40,0,0,0,370
88052,190,160,120,160,160,0,790
88053,200,140,80,80,160,0,660
88054,220,180,160,240,160,320,1280
88055,180,60,0,0,0,0,240
88056,190,180,120,80,160,0,730
88057,230,180,120,240,320,0,1090
88058,190,180,120,80,0,0,570
88059,200,120,40,0,0,0,360
88060,190,180,160,160,160,0,850
88061,140,140,120,80,0,0,480
88062,160,120,120,160,160,0,720
88063,250,100,120,160,160,0,790
88064,190,120,120,80,160,0,670
88065,200,140,240,160,0,0,740
88066,180,160,120,80,0,0,540
88067,210,140,80,80,0,0,510
88068,210,80,80,80,160,0,610
88069,170,100,160,160,160,0,750
88070,210,140,160,80,160,0,750
88071,200,140,160,160,160,0,820
88072,180,120,80,160,320,320,1180
88073,200,120,80,160,160,0,720
88074,200,100,80,80,160,320,940
88075,200,120,160,80,160,0,720
88076,200,160,160,160,160,0,840
88077,200,120,120,160,160,0,760
88078,170,120,80,160,160,0,690
88079,190,60,0,0,0,0,250
88080,170,180,120,80,0,0,550
88081,210,140,160,80,0,0,590
88082,220,80,40,80,0,0,420
88083,180,180,160,80,160,0,760
88084,210,100,80,80,160,0,630
88085,170,100,40,0,0,0,310
88086,160,120,160,240,0,0,680
88087,200,180,200,160,0,0,740
88088,190,140,120,160,320,0,930
88089,200,140,40,0,0,0,380
88090,210,200,120,160,320,0,1010
88091,220,160,80,160,160,0,780
88092,160,100,0,0,0,0,260
88093,210,80,120,80,160,0,650
88094,200,100,80,80,160,0,620
88095,210,140,40,80,0,0,470
88096,230,180,160,160,160,0,890
88097,200,180,160,240,160,0,940
88098,200,120,80,80,160,0,640
88099,200,80,160,160,160,0,760
88100,200,100,120,80,160,0,660
88101,200,140,120,160,320,0,940
88102,200,100,0,0,0,0,300
88103,220,160,120,160,0,0,660
88104,160,120,200,160,160,0,800
88105,200,140,160,160,160,320,1140
88106,190,120,80,0,0,0,390
88107,240,140,160,160,160,0,860
88108,180,140,80,0,0,0,400
88109,180,100,120,80,0,0,480
88110,200,100,40,0,0,0,340
88111,190,140,160,240,160,320,1210
88112,230,140,40,0,0,0,410
88113,210,120,120,80,0,0,530
88114,190,120,160,160,320,0,950
88115,200,120,120,80,160,0,680
88116,210,100,40,0,0,0,350
88117,180,140,120,80,0,0,520
88118,170,100,80,80,0,0,430
88119,160,140,80,160,160,320,1020
88120,160,180,160,240,320,0,1060
88121,180,60,80,80,160,0,560
88122,190,160,160,80,160,0,750
88123,190,120,40,0,0,0,350
88124,200,80,80,80,0,0,440
88125,200,140,120,80,0,0,540
88126,170,80,120,240,320,0,930
88127,210,140,40,80,160,0,630
88128,210,60,80,80,0,0,430
88129,190,100,160,80,160,0,690
88130,210,120,80,80,160,0,650
88131,240,160,160,240,320,0,1120
88132,210,160,160,80,160,320,1090
88133,200,120,80,80,160,0,640
88134,180,160,80,80,0,0,500
88135,200,140,80,80,160,0,660
88136,210,120,120,160,160,0,770
88137,210,140,120,0,0,0,470
88138,200,100,160,160,320,320,1260
88139,230,120,40,80,160,0,630
88140,210,120,40,80,160,0,610
88141,240,120,80,0,0,0,440
88142,210,120,120,160,160,320,1090
88143,190,60,40,80,160,0,530
88144,160,140,160,80,160,0,700
88145,210,160,80,0,0,0,450
88146,210,200,120,80,160,320,1090
88147,210,120,160,80,160,0,730
88148,210,80,80,80,0,0,450
88149,200,140,240,240,160,0,980
88150,220,80,80,80,160,0,620
88151,210,160,80,160,320,0,930
88152,190,120,120,80,160,0,670
88153,190,100,40,80,0,0,410
88154,210,140,120,160,320,320,1270
88155,160,140,160,240,160,320,1180
88156,190,100,160,80,160,0,690
88157,150,140,200,160,160,0,810
88158,210,140,120,160,0,0,630
88159,200,140,80,80,160,0,660
88160,250,80,40,80,160,0,610
88161,170,40,0,0,0,0,210
88162,190,160,160,240,0,0,750
88163,180,120,120,0,0,0,420
88164,210,120,80,80,160,0,650
88165,190,100,40,0,0,0,330
88166,170,140,120,80,0,0,510
88167,250,140,120,80,160,0,750
88168,240,180,120,80,160,0,780
88169,220,160,160,160,0,0,700
88170,180,60,120,80,0,0,440
88171,160,120,40,0,0,0,320
88172,180,140,40,0,0,0,360
88173,190,100,40,80,160,0,570
88174,190,80,80,160,160,0,670
88175,210,60,120,160,160,0,710
88176,170,80,120,240,160,320,1090
88177,200,100,80,160,160,0,700
88178,220,160,120,160,320,320,1300
88179,200,160,40,80,160,320,960
88180,200,140,160,160,160,0,820
88181,170,120,160,160,320,0,930
88182,220,140,80,0,0,0,440
88183,190,180,120,160,0,0,650
88184,230,100,120,0,0,0,450
88185,180,120,120,160,0,0,580
88186,170,100,160,240,160,0,830
88187,200,140,80,0,0,0,420
88188,200,140,240,0,0,0,580
88189,190,120,120,80,0,0,510
88190,170,120,80,80,160,0,610
88191,200,160,80,80,0,0,520
88192,150,100,160,80,0,0,490
88193,220,120,120,160,160,320,1100
88194,200,100,120,80,0,0,500
88195,180,80,40,80,160,0,540
88196,210,100,120,80,160,0,670
88197,210,80,80,80,0,0,450
88198,210,100,80,80,160,0,630
88199,240,180,200,160,160,320,1260
88200,160,100,80,80,0,0,420
88201,220,120,80,80,0,0,500
88202,180,160,120,160,160,0,780
88203,230,80,80,0,0,0,390
88204,210,140,120,160,320,0,950
88205,240,120,160,160,160,320,1160
88206,180,120,120,160,160,0,740
88207,200,120,40,80,160,0,600
88208,130,120,40,0,0,0,290
88209,210,140,200,240,160,320,1270
88210,210,140,160,80,0,0,590
88211,190,100,120,80,160,0,650
88212,170,140,160,80,160,0,710
88213,200,100,80,80,160,0,620
88214,170,120,120,160,160,0,730
88215,230,160,80,160,160,0,790
88216,180,100,80,160,320,0,840
88217,180,100,80,80,160,320,920
88218,210,120,120,160,160,0,770
88219,200,140,40,0,0,0,380
88220,200,120,120,80,0,0,520
88221,200,160,160,80,0,0,600
88222,160,100,160,160,160,320,1060
88223,240,140,160,80,0,0,620
88224,210,140,120,160,320,320,1270
88225,210,160,80,0,0,0,450
88226,210,120,120,80,160,320,1010
88227,220,60,40,80,160,0,560
88228,200,120,160,80,0,0,560
88229,160,100,120,80,160,320,940
88230,170,100,80,160,0,0,510
88231,180,120,120,160,160,0,740
88232,160,80,160,160,160,0,720
88233,210,100,120,160,160,0,750
88234,210,60,80,80,160,0,590
88235,160,100,80,80,160,0,580
88236,170,140,160,80,0,0,550
88237,190,160,120,160,160,0,790
88238,180,140,160,80,160,0,720
88239,180,60,40,80,160,0,520
88240,190,120,80,80,0,0,470
88241,230,80,120,80,0,0,510
88242,200,140,40,80,160,0,620
88243,190,120,160,80,160,320,1030
88244,210,80,40,0,0,0,330
88245,210,140,160,0,0,0,510
88246,140,100,80,80,160,0,560
88247,170,80,80,80,0,0,410
88248,220,120,200,240,320,0,1100
88249,220,80,40,80,0,0,420
88250,210,120,160,160,320,320,1290
88251,180,120,80,80,160,0,620
88252,200,120,40,80,160,0,600
88253,230,120,160,240,160,320,1230
88254,170,140,200,240,320,0,1070
88255,220,160,160,160,160,0,860
88256,200,100,120,80,160,0,660
88257,190,160,200,240,160,0,950
88258,180,80,120,160,160,0,700
88259,220,180,240,160,0,0,800
88260,170,120,80,0,0,0,370
88261,200,120,80,80,160,0,640
88262,200,140,120,80,160,0,700
88263,200,120,40,0,0,0,360
88264,190,120,80,160,320,0,870
88265,200,100,80,160,0,0,540
88266,180,160,160,160,160,0,820
88267,190,100,80,80,160,0,610
88268,150,100,80,0,0,0,330
88269,210,160,120,160,320,0,970
88270,170,100,120,80,0,0,470
88271,220,100,120,160,160,0,760
88272,180,120,40,80,160,0,580
88273,160,100,0,0,0,0,260
88274,190,160,120,80,0,0,550
88275,170,80,40,0,0,0,290
88276,200,140,80,80,160,0,660
88277,210,140,80,80,0,0,510
88278,190,120,120,80,160,0,670
88279,190,160,80,0,0,0,430
88280,220,160,120,240,160,0,900
88281,180,100,120,80,0,0,480
88282,190,120,40,0,0,0,350
88283,220,160,160,240,160,0,940
88284,210,100,80,80,160,0,630
88285,220,140,120,160,320,0,960
88286,210,80,80,80,160,0,610
88287,210,60,80,80,0,0,430
88288,190,160,160,160,160,0,830
88289,180,120,120,160,160,320,1060
88290,180,80,80,80,160,0,580
88291,200,100,40,80,160,0,580
88292,170,140,40,0,0,0,350
88293,200,140,40,0,0,0,380
88294,210,80,80,80,160,0,610
88295,180,80,40,80,160,0,540
88296,180,100,80,80,160,0,600
88297,220,160,80,0,0,0,460
88298,140,160,120,240,320,0,980
88299,220,160,80,160,160,0,780
88300,180,120,160,80,0,0,540
88301,150,140,160,160,320,0,930
88302,170,140,80,160,160,320,1030
88303,220,100,80,80,0,0,480
88304,210,100,40,0,0,0,350
88305,170,120,80,80,160,0,610
88306,220,100,120,160,160,320,1080
88307,180,120,120,160,160,0,740
88308,180,120,160,80,160,0,700
88309,200,80,80,80,160,320,920
88310,200,80,120,160,160,320,1040
88311,200,180,120,160,160,0,820
88312,160,80,160,80,0,0,480
88313,200,140,120,240,320,0,1020
88314,200,120,120,80,160,0,680
88315,160,80,80,160,160,0,640
88316,210,120,80,80,160,320,970
88317,220,100,40,0,0,0,360
88318,170,60,80,0,0,0,310
88319,210,180,40,80,160,320,990
88320,170,160,80,0,0,0,410
88321,220,140,120,160,160,0,800
88322,160,140,160,80,0,0,540
88323,210,140,120,160,0,0,630
88324,180,80,40,0,0,0,300
88325,210,120,160,160,160,0,810
88326,210,120,120,160,0,0,610
88327,230,100,160,160,0,0,650
88328,150,100,120,80,160,0,610
88329,190,100,80,0,0,0,370
88330,210,120,120,0,0,0,450
88331,210,160,120,80,0,0,570
88332,150,100,0,0,0,0,250
88333,150,60,40,80,0,0,330
88334,230,160,160,160,160,0,870
88335,190,120,160,80,160,0,710
88336,180,60,80,160,320,320,1120
88337,210,100,80,0,0,0,390
88338,230,140,80,160,320,0,930
88339,220,120,160,240,0,0,740
88340,180,120,120,80,160,0,660
88341,240,120,120,160,160,0,800
88342,240,120,80,80,160,0,680
88343,210,120,120,160,160,0,770
88344,220,180,160,80,160,320,1120
88345,220,80,80,160,320,320,1180
88346,170,80,40,80,160,0,530
88347,190,140,80,160,0,0,570
88348,210,160,120,80,160,0,730
88349,190,160,160,160,320,0,990
88350,190,140,120,160,0,0,610
88351,220,160,80,80,0,0,540
88352,190,100,80,160,320,320,1170
88353,200,80,40,0,0,0,320
88354,200,120,120,160,160,0,760
88355,200,160,40,80,160,0,640
88356,220,120,80,80,160,0,660
88357,200,140,40,80,160,0,620
88358,220,140,80,80,160,320,1000
88359,210,120,160,160,160,320,1130
88360,150,80,120,80,160,320,910
88361,220,100,120,160,160,0,760
88362,220,120,120,0,0,0,460
88363,190,140,40,80,0,0,450
88364,210,100,120,80,0,0,510
88365,200,160,80,160,160,0,760
88366,190,140,160,80,0,0,570
88367,220,140,120,80,0,0,560
88368,190,60,80,160,0,0,490
88369,170,100,120,160,160,0,710
88370,230,120,80,80,0,0,510
88371,200,100,40,0,0,0,340
88372,160,140,120,160,160,320,1060
88373,220,120,80,160,160,0,740
88374,170,120,200,160,160,0,810
88375,190,60,0,0,0,0,250
88376,170,160,120,160,160,0,770
88377,180,140,160,160,160,0,800
88378,220,140,80,0,0,0,440
88379,190,160,120,160,160,0,790
88380,230,140,120,80,160,320,1050
88381,170,80,80,80,160,0,570
88382,220,120,160,160,0,0,660
88383,220,200,80,80,0,0,580
88384,200,140,120,0,0,0,460
88385,220,140,120,0,0,0,480
88386,210,100,40,80,160,0,590
88387,200,100,160,240,320,0,1020
88388,190,120,80,160,160,0,710
88389,170,120,160,240,160,0,850
88390,220,100,80,0,0,0,400
88391,190,60,80,0,0,0,330
88392,230,160,120,80,160,0,750
88393,170,60,40,80,160,320,830
88394,150,100,80,80,0,0,410
88395,200,140,200,240,160,0,940
88396,240,160,120,160,160,0,840
88397,230,180,40,80,160,0,690
88398,210,140,120,80,0,0,550
88399,190,80,40,80,0,0,390
88400,230,160,120,80,160,0,750
88401,190,100,80,80,160,0,610
88402,220,160,120,160,160,0,820
88403,160,100,120,160,160,0,700
88404,170,100,160,240,320,0,990
88405,170,100,80,80,160,0,590
88406,200,120,120,160,160,0,760
88407,200,80,80,80,0,0,440
88408,170,120,160,320,0,0,770
88409,170,120,120,160,0,0,570
88410,220,180,120,160,320,0,1000
88411,180,180,120,160,160,0,800
88412,210,140,40,0,0,0,390
88413,190,160,40,80,160,320,950
88414,170,100,120,160,160,0,710
88415,190,120,120,0,0,0,430
88416,200,160,120,80,0,0,560
88417,210,140,80,160,160,320,1070
88418,220,140,160,160,160,0,840
88419,220,80,40,80,160,320,900
88420,190,100,80,80,160,0,610
88421,190,120,160,80,0,0,550
88422,210,180,120,80,160,0,750
88423,230,100,40,80,160,0,610
88424,150,100,120,160,160,0,690
88425,190,100,80,0,0,0,370
88426,170,100,80,80,160,0,590
88427,240,120,120,80,0,0,560
88428,180,80,80,80,160,0,580
88429,200,120,120,80,0,0,520
88430,210,140,80,0,0,0,430
88431,210,140,120,160,0,0,630
88432,180,100,80,0,0,0,360
88433,210,140,120,240,320,0,1030
88434,250,140,80,160,320,0,950
88435,190,140,120,80,160,0,690
88436,220,120,80,80,0,0,500
88437,170,120,160,160,160,0,770
88438,210,120,160,160,160,0,810
88439,190,140,120,160,320,320,1250
88440,170,140,120,160,160,0,750
88441,160,100,120,160,160,0,700
88442,200,160,80,0,0,0,440
88443,190,160,120,80,160,0,710
88444,200,120,80,80,160,0,640
88445,200,120,80,80,160,0,640
88446,190,120,40,0,0,0,350
88447,260,120,120,80,160,320,1060
88448,210,160,120,0,0,0,490
88449,170,120,160,80,0,0,530
88450,160,100,160,80,160,0,660
88451,220,160,80,80,0,0,540
88452,150,40,40,0,0,0,230
88453,190,60,80,160,0,0,490
88454,200,140,120,160,320,320,1260
88455,190,100,80,160,320,320,1170
88456,220,140,120,160,160,0,800
88457,180,140,120,160,320,320,1240
88458,190,140,120,80,160,0,690
88459,220,180,160,80,160,0,800
88460,200,120,160,160,320,0,960
88461,170,120,40,80,0,0,410
88462,200,160,120,0,0,0,480
88463,150,100,120,160,320,0,850
88464,150,80,120,80,160,0,590
88465,180,120,120,160,320,320,1220
88466,170,100,160,160,0,0,590
88467,210,180,160,160,160,0,870
88468,120,120,120,240,320,320,1240
88469,200,100,40,80,0,0,420
88470,180,100,120,0,0,0,400
88471,210,100,160,80,160,0,710
88472,170,160,160,160,160,0,810
88473,210,160,120,160,160,320,1130
88474,170,140,120,80,0,0,510
88475,160,120,80,80,0,0,440
88476,180,80,40,80,160,0,540
88477,170,140,80,80,160,0,630
88478,180,100,120,160,160,320,1040
88479,240,180,120,80,0,0,620
88480,190,120,120,0,0,0,430
88481,190,100,120,160,160,0,730
88482,210,140,120,160,320,320,1270
88483,180,120,160,80,0,0,540
88484,220,180,80,80,160,0,720
88485,180,100,120,80,0,0,480
88486,150,160,80,0,0,0,390
88487,190,80,120,0,0,0,390
88488,190,100,0,0,0,0,290
88489,210,200,120,160,160,0,850
88490,190,120,80,0,0,0,390
88491,160,100,80,80,160,0,580
88492,220,160,120,240,160,0,900
88493,210,160,80,80,160,0,690
88494,190,140,80,80,0,0,490
88495,170,100,40,80,160,320,870
88496,260,200,120,160,160,0,900
88497,200,60,0,0,0,0,260
88498,200,100,120,160,160,0,740
88499,210,120,80,0,0,0,410
88500,170,80,120,160,160,0,690
88501,230,220,160,240,160,320,1330
88502,180,120,80,0,0,0,380
88503,180,140,80,160,160,320,1040
88504,190,120,120,80,160,0,670
88505,200,160,160,80,160,0,760
88506,190,120,120,160,160,320,1070
88507,240,120,40,0,0,0,400
88508,180,120,120,80,0,0,500
88509,180,80,120,160,160,0,700
88510,210,140,200,160,160,0,870
88511,170,100,40,80,0,0,390
88512,190,120,80,80,160,0,630
88513,250,160,80,0,0,0,490
88514,190,120,80,80,0,0,470
88515,210,120,120,80,160,0,690
88516,280,180,120,160,160,0,900
88517,180,100,80,0,0,0,360
88518,220,180,240,80,160,0,880
88519,180,180,80,80,160,0,680
88520,200,100,40,80,0,0,420
88521,180,100,80,80,0,0,440
88522,170,80,80,80,0,0,410
88523,220,200,120,0,0,0,540
88524,190,120,120,160,320,320,1230
88525,220,120,120,160,320,320,1260
88526,190,120,120,160,160,0,750
88527,200,140,160,160,320,320,1300
88528,200,120,80,80,0,0,480
88529,200,140,120,80,160,0,700
88530,180,140,200,80,0,0,600
88531,210,60,0,0,0,0,270
88532,190,120,120,80,160,0,670
88533,190,120,40,0,0,0,350
88534,220,140,80,0,0,0,440
88535,210,120,80,0,0,0,410
88536,210,160,160,160,160,0,850
88537,190,100,120,160,320,0,890
88538,190,120,120,160,0,0,590
88539,200,100,160,160,160,0,780
88540,230,140,120,0,0,0,490
88541,240,160,80,0,0,0,480
88542,220,140,120,160,160,0,800
88543,230,140,120,160,160,0,810
88544,210,120,80,0,0,0,410
88545,210,140,120,80,0,0,550
88546,210,140,120,160,320,0,950
88547,240,100,160,240,160,0,900
88548,190,120,40,0,0,0,350
88549,210,120,80,80,0,0,490
88550,180,120,120,160,160,320,1060
88551,210,80,120,80,0,0,490
88552,160,140,120,240,160,0,820
88553,190,120,120,160,160,0,750
88554,210,80,120,160,160,0,730
88555,230,160,240,160,160,0,950
88556,170,80,80,80,0,0,410
88557,210,180,160,240,320,0,1110
88558,220,140,80,80,0,0,520
88559,160,140,120,80,0,0,500
88560,210,120,120,0,0,0,450
88561,220,120,120,80,0,0,540
88562,180,120,80,80,160,0,620
88563,220,140,120,80,160,320,1040
88564,200,160,200,240,160,0,960
88565,210,120,160,80,0,0,570
88566,200,100,80,80,0,0,460
88567,260,100,120,160,160,0,800
88568,180,120,160,80,0,0,540
88569,230,160,80,0,0,0,470
88570,140,100,80,80,0,0,400
88571,150,100,40,80,160,320,850
88572,200,100,120,160,0,0,580
88573,180,100,160,240,320,0,1000
88574,170,120,200,160,0,0,650
88575,170,120,160,80,0,0,530
88576,230,140,40,80,160,0,650
88577,170,160,120,80,0,0,530
88578,190,120,120,160,160,0,750
88579,220,180,160,160,0,0,720
88580,180,100,80,80,160,0,600
88581,200,140,40,0,0,0,380
88582,210,180,200,80,160,320,1150
88583,200,160,160,240,320,0,1080
88584,210,120,80,160,160,0,730
88585,170,60,80,80,160,0,550
88586,190,100,80,80,160,0,610
88587,210,140,200,160,160,320,1190
88588,180,120,120,160,160,0,740
88589,170,140,120,240,320,0,990
88590,230,140,120,80,160,0,730
88591,230,100,0,0,0,0,330
88592,230,120,80,80,160,0,670
88593,200,120,120,0,0,0,440
88594,210,160,160,160,160,0,850
88595,200,100,120,160,0,0,580
88596,180,120,120,80,0,0,500
88597,210,80,80,80,160,0,610
88598,190,140,120,160,320,320,1250
88599,200,120,160,160,160,320,1120
88600,170,120,80,80,0,0,450
88601,160,140,120,0,0,0,420
88602,230,160,160,80,160,0,790
88603,190,160,120,0,0,0,470
88604,180,100,120,160,160,320,1040
88605,260,160,160,160,160,0,900
88606,190,180,80,0,0,0,450
88607,220,80,80,0,0,0,380
88608,210,100,120,80,0,0,510
88609,220,60,80,0,0,0,360
88610,220,160,160,160,320,0,1020
88611,170,60,120,160,160,0,670
88612,180,60,0,0,0,0,240
88613,230,140,40,80,0,0,490
88614,230,140,80,0,0,0,450
88615,190,80,80,80,160,0,590
88616,200,120,160,160,160,0,800
88617,210,100,120,0,0,0,430
88618,220,60,40,0,0,0,320
88619,190,160,160,160,320,0,990
88620,210,100,0,0,0,0,310
88621,180,100,40,0,0,0,320
88622,170,80,120,240,160,0,770
88623,220,240,160,240,0,0,860
88624,170,100,120,160,160,320,1030
88625,220,140,160,160,160,0,840
88626,200,120,80,80,0,0,480
88627,170,140,160,160,160,0,790
88628,220,100,120,80,160,0,680
88629,200,140,80,0,0,0,420
88630,220,120,120,0,0,0,460
88631,210,140,200,240,160,0,950
88632,220,140,120,240,320,320,1360
88633,200,140,120,80,160,0,700
88634,190,140,40,80,0,0,450
88635,190,100,160,80,160,0,690
88636,220,160,160,240,160,0,940
88637,200,120,160,160,320,320,1280
88638,240,200,240,160,320,320,1480
88639,190,140,120,0,0,0,450
88640,200,140,120,160,160,0,780
88641,170,160,80,80,0,0,490
88642,240,120,80,80,0,0,520
88643,180,200,200,240,320,320,1460
88644,230,120,120,80,160,0,710
88645,200,100,120,80,160,320,980
88646,210,160,160,80,160,320,1090
88647,170,140,160,160,160,0,790
88648,210,80,0,0,0,0,290
88649,160,120,120,0,0,0,400
88650,140,120,120,0,0,0,380
88651,190,120,80,0,0,0,390
88652,220,100,120,80,160,320,1000
88653,170,120,40,80,160,0,570
88654,190,140,120,160,0,0,610
88655,190,120,80,80,160,320,950
88656,210,60,40,80,160,0,550
88657,180,40,80,80,160,0,540
88658,170,180,80,0,0,0,430
88659,200,140,120,160,320,0,940
88660,220,120,80,0,0,0,420
88661,210,120,120,160,160,0,770
88662,200,120,80,80,0,0,480
88663,220,120,120,160,320,320,1260
88664,210,140,120,240,160,320,1190
88665,140,60,80,80,160,0,520
88666,200,220,160,160,160,0,900
88667,150,80,120,80,160,0,590
88668,200,160,120,160,160,0,800
88669,220,120,40,0,0,0,380
88670,210,200,120,80,160,0,770
88671,210,160,120,80,160,320,1050
88672,200,140,80,80,0,0,500
88673,240,100,80,80,160,320,980
88674,160,140,80,80,0,0,460
88675,190,140,160,0,0,0,490
88676,190,100,80,80,0,0,450
88677,230,160,120,80,0,0,590
88678,150,120,80,80,160,0,590
88679,220,80,40,0,0,0,340
88680,170,60,120,80,160,0,590
88681,200,140,40,80,160,0,620
88682,240,120,120,80,160,0,720
88683,220,120,80,0,0,0,420
88684,190,120,120,160,160,0,750
88685,200,120,120,160,0,0,600
88686,210,140,120,80,0,0,550
88687,190,100,120,80,0,0,490
88688,170,60,0,0,0,0,230
88689,200,100,120,80,0,0,500
88690,180,120,160,240,320,0,1020
88691,180,120,80,160,320,320,1180
88692,230,120,80,80,0,0,510
88693,210,140,160,80,0,0,590
88694,160,120,120,160,160,0,720
88695,170,100,80,160,320,0,830
88696,180,100,80,160,160,0,680
88697,200,140,200,240,160,0,940
88698,210,160,160,80,160,0,770
88699,200,120,120,80,160,0,680
88700,180,80,40,80,0,0,380
88701,230,120,120,80,160,320,1030
88702,150,100,80,160,160,0,650
88703,180,100,40,0,0,0,320
88704,220,100,80,80,0,0,480
88705,190,80,0,0,0,0,270
88706,210,80,40,80,0,0,410
88707,190,140,80,0,0,0,410
88708,210,220,120,80,160,0,790
88709,180,120,120,80,160,320,980
88710,180,100,120,80,0,0,480
88711,200,120,80,80,160,320,960
88712,150,80,160,240,320,0,950
88713,190,140,160,160,320,320,1290
88714,190,140,120,80,0,0,530
88715,220,180,160,160,320,0,1040
88716,210,100,120,80,160,0,670
88717,230,140,120,80,160,0,730
88718,150,100,80,80,0,0,410
88719,190,180,200,160,0,0,730
88720,200,180,200,160,160,0,900
88721,160,120,80,160,160,0,680
88722,220,200,240,240,160,0,1060
88723,200,160,160,160,0,0,680
88724,140,160,160,160,320,0,940
88725,190,40,40,0,0,0,270
88726,220,140,200,160,160,0,880
88727,200,140,120,160,320,0,940
88728,200,140,120,160,320,320,1260
88729,170,120,80,80,160,320,930
88730,220,100,120,160,160,0,760
88731,210,140,80,160,160,0,750
88732,210,100,80,0,0,0,390
88733,200,100,80,160,160,0,700
88734,250,120,160,160,160,0,850
88735,220,140,80,160,0,0,600
88736,200,140,120,160,320,0,940
88737,220,100,80,160,160,0,720
88738,180,120,80,160,160,0,700
88739,190,80,120,80,0,0,470
88740,140,80,120,160,0,0,500
88741,210,120,120,160,160,0,770
88742,170,100,120,160,160,0,710
88743,200,120,120,0,0,0,440
88744,210,100,120,160,160,0,750
88745,170,120,80,80,160,0,610
88746,200,80,40,80,160,0,560
88747,190,60,80,160,160,0,650
88748,160,60,80,80,160,320,860
88749,210,160,160,160,160,0,850
88750,170,100,120,160,0,0,550
88751,200,120,160,240,160,0,880
88752,200,100,80,0,0,0,380
88753,160,100,80,80,160,0,580
88754,130,120,160,80,160,0,650
88755,210,140,120,160,160,0,790
88756,190,120,80,160,0,0,550
88757,210,140,120,0,0,0,470
88758,200,120,80,80,160,0,640
88759,170,120,120,80,0,0,490
88760,200,100,120,80,0,0,500
88761,200,160,80,160,0,0,600
88762,210,140,120,0,0,0,470
88763,220,160,40,0,0,0,420
88764,220,140,200,80,0,0,640
88765,230,120,80,80,160,320,990
88766,200,100,80,80,160,0,620
88767,190,120,120,160,160,0,750
88768,220,120,160,160,0,0,660
88769,170,120,160,160,160,0,770
88770,200,80,40,0,0,0,320
88771,210,140,200,160,160,0,870
88772,180,80,80,0,0,0,340
88773,200,140,120,160,320,0,940
88774,220,140,120,80,160,0,720
88775,200,120,80,80,160,0,640
88776,170,120,120,80,0,0,490
88777,180,120,160,240,160,0,860
88778,240,140,80,0,0,0,460
88779,160,100,40,0,0,0,300
88780,220,160,200,160,160,0,900
88781,170,60,40,0,0,0,270
88782,190,60,40,80,160,320,850
88783,160,100,80,80,160,320,900
88784,180,120,80,160,320,0,860
88785,190,180,200,80,0,0,650
88786,240,60,80,80,160,0,620
88787,190,160,200,160,160,0,870
88788,170,160,160,80,160,0,730
88789,200,120,80,80,160,0,640
88790,210,80,120,240,160,0,810
88791,230,140,160,160,0,0,690
88792,190,60,120,160,160,0,690
88793,220,80,40,80,0,0,420
88794,190,120,80,160,160,0,710
88795,200,140,200,240,160,0,940
88796,170,140,120,160,160,320,1070
88797,200,120,120,0,0,0,440
88798,170,80,80,0,0,0,330
88799,190,140,80,160,320,0,890
88800,210,140,200,160,0,0,710
88801,180,100,80,80,160,0,600
88802,180,120,120,160,320,0,900
88803,190,120,200,80,160,0,750
88804,200,140,80,160,160,320,1060
88805,170,140,120,160,0,0,590
88806,210,80,80,160,320,320,1170
88807,190,100,80,80,0,0,450
88808,170,80,40,0,0,0,290
88809,140,100,160,160,160,0,720
88810,260,120,40,80,160,0,660
88811,150,100,80,80,160,0,570
88812,200,140,160,160,160,0,820
88813,180,140,120,80,160,320,1000
88814,220,160,160,80,0,0,620
88815,190,100,120,80,160,0,650
88816,220,100,120,160,160,0,760
88817,200,160,160,80,0,0,600
88818,190,200,160,80,160,0,790
88819,200,120,120,160,320,320,1240
88820,230,100,80,0,0,0,410
88821,240,120,120,240,0,0,720
88822,170,140,80,0,0,0,390
88823,150,180,200,160,320,0,1010
88824,200,140,120,160,160,320,1100
88825,170,100,80,80,160,0,590
88826,230,80,160,160,160,0,790
88827,200,140,160,80,0,0,580
88828,160,100,80,80,0,0,420
88829,200,180,120,160,0,0,660
88830,220,180,120,160,320,0,1000
88831,180,120,160,240,160,320,1180
88832,230,140,120,80,0,0,570
88833,190,140,120,80,160,320,1010
88834,210,140,120,240,160,0,870
88835,190,120,200,160,320,320,1310
88836,190,100,0,0,0,0,290
88837,220,140,40,0,0,0,400
88838,220,140,200,160,160,0,880
88839,170,120,80,160,0,0,530
88840,170,120,40,80,0,0,410
88841,180,140,120,80,0,0,520
88842,210,120,40,80,0,0,450
88843,180,100,80,160,160,0,680
88844,180,140,120,160,160,0,760
88845,220,120,160,80,160,0,740
88846,160,40,80,80,160,0,520
88847,170,160,80,80,160,0,650
88848,160,120,40,80,160,0,560
88849,170,140,80,0,0,0,390
88850,200,140,120,80,160,0,700
88851,170,120,120,80,160,0,650
88852,200,140,160,80,0,0,580
88853,170,80,120,80,160,0,610
88854,190,140,120,80,160,0,690
88855,190,80,120,80,160,320,950
88856,200,80,40,80,0,0,400
88857,230,120,80,0,0,0,430
88858,180,60,80,160,160,0,640
88859,190,180,160,160,0,0,690
88860,200,120,80,160,160,320,1040
88861,180,60,80,160,160,0,640
88862,200,120,120,80,160,0,680
88863,210,120,120,80,0,0,530
88864,240,140,120,80,0,0,580
88865,180,100,160,80,0,0,520
88866,140,100,120,160,0,0,520
88867,210,180,120,80,0,0,590
88868,220,140,120,240,0,0,720
88869,200,140,80,80,160,0,660
88870,160,60,40,0,0,0,260
88871,160,120,80,80,0,0,440
88872,210,100,80,160,160,0,710
88873,220,100,80,160,160,0,720
88874,190,120,120,0,0,0,430
88875,190,140,120,160,0,0,610
88876,220,140,80,80,160,0,680
88877,180,140,120,80,160,0,680
88878,200,120,0,0,0,0,320
88879,200,120,80,80,160,0,640
88880,220,120,120,160,320,0,940
88881,210,60,80,160,160,320,990
88882,180,120,80,80,0,0,460
88883,240,120,0,0,0,0,360
88884,190,140,40,80,160,0,610
88885,190,100,80,0,0,0,370
88886,190,100,120,160,320,0,890
88887,190,80,80,80,0,0,430
88888,170,120,200,240,320,320,1370
88889,210,140,120,160,160,0,790
88890,230,160,120,160,320,0,990
88891,200,120,80,0,0,0,400
88892,220,120,120,160,320,320,1260
88893,210,40,0,0,0,0,250
88894,180,140,120,80,0,0,520
88895,210,120,80,160,160,0,730
88896,150,100,80,160,160,0,650
88897,170,120,160,80,160,0,690
88898,180,220,160,240,320,320,1440
88899,170,100,120,160,160,320,1030
88900,240,180,40,0,0,0,460
88901,230,140,120,80,0,0,570
88902,180,120,80,160,320,0,860
88903,180,60,0,0,0,0,240
88904,230,120,160,160,320,0,990
88905,220,160,120,160,160,0,820
88906,190,80,120,0,0,0,390
88907,220,140,80,80,160,0,680
88908,240,220,160,160,320,320,1420
88909,150,120,120,160,160,0,710
88910,210,160,40,0,0,0,410
88911,230,140,80,0,0,0,450
88912,200,140,200,240,320,320,1420
88913,210,100,120,80,160,0,670
88914,170,120,40,80,160,0,570
88915,230,120,80,0,0,0,430
88916,220,100,0,0,0,0,320
88917,200,100,80,160,160,0,700
88918,230,220,80,0,0,0,530
88919,210,120,80,0,0,0,410
88920,140,80,120,160,160,320,980
88921,210,120,120,80,0,0,530
88922,210,140,200,160,0,0,710
88923,160,100,160,80,160,0,660
88924,220,120,80,80,160,0,660
88925,200,100,120,160,160,320,1060
88926,180,120,80,160,0,0,540
88927,210,100,120,160,160,0,750
88928,160,80,40,0,0,0,280
88929,200,120,80,160,160,0,720
88930,190,100,120,80,0,0,490
88931,200,120,120,80,160,0,680
88932,200,100,80,80,160,0,620
88933,210,120,80,80,160,0,650
88934,210,100,120,80,160,0,670
88935,160,20,40,80,0,0,300
88936,180,100,120,160,160,320,1040
88937,170,100,80,80,0,0,430
88938,200,80,0,0,0,0,280
88939,190,140,160,80,160,0,730
88940,230,140,120,160,320,320,1290
88941,230,220,160,160,160,0,930
88942,150,60,120,160,160,0,650
88943,210,180,200,80,0,0,670
88944,210,180,120,80,160,0,750
88945,160,140,80,80,0,0,460
88946,200,100,80,160,0,0,540
88947,180,100,120,160,0,0,560
88948,200,160,80,0,0,0,440
88949,180,120,80,80,160,0,620
88950,240,120,160,80,160,0,760
88951,170,40,0,0,0,0,210
88952,220,60,40,80,160,0,560
88953,200,120,120,80,0,0,520
88954,140,100,120,160,160,0,680
88955,200,140,160,80,0,0,580
88956,160,60,80,0,0,0,300
88957,170,140,80,160,160,0,710
88958,200,100,120,80,0,0,500
88959,180,120,160,80,0,0,540
88960,200,140,120,80,160,320,1020
88961,210,120,120,160,320,320,1250
88962,180,80,120,160,160,0,700
88963,180,140,80,80,0,0,480
88964,200,140,200,160,320,0,1020
88965,190,80,120,80,160,0,630
88966,210,40,40,80,160,0,530
88967,190,100,120,160,160,0,730
88968,200,100,120,160,160,0,740
88969,200,140,160,80,0,0,580
88970,190,120,120,80,160,0,670
88971,210,100,120,160,320,320,1230
88972,220,140,80,160,0,0,600
88973,230,120,120,160,0,0,630
88974,160,100,120,160,160,0,700
88975,220,140,160,160,160,0,840
88976,200,100,120,80,160,0,660
88977,200,140,120,160,320,320,1260
88978,200,120,120,160,320,0,920
88979,220,100,120,80,160,0,680
88980,200,60,40,0,0,0,300
88981,200,160,120,80,0,0,560
88982,180,80,40,0,0,0,300
88983,210,80,160,80,0,0,530
88984,180,120,80,0,0,0,380
88985,210,160,160,160,160,320,1170
88986,170,180,120,160,0,0,630
88987,220,120,80,80,160,0,660
88988,200,140,80,80,160,0,660
88989,180,120,160,240,160,0,860
88990,150,60,80,0,0,0,290
88991,240,120,80,80,160,0,680
88992,190,200,160,160,320,320,1350
88993,180,120,120,0,0,0,420
88994,190,160,160,240,0,0,750
88995,220,120,80,80,0,0,500
88996,170,100,80,0,0,0,350
88997,180,120,120,80,0,0,500
88998,200,100,120,0,0,0,420
88999,220,140,160,80,0,0,600
89000,210,180,120,80,160,0,750
89001,220,120,80,160,160,0,740
89002,190,140,80,160,160,0,730
89003,230,120,80,80,160,0,670
89004,230,100,40,0,0,0,370
89005,180,180,160,80,0,0,600
89006,190,80,40,80,0,0,390
89007,140,100,40,80,0,0,360
89008,220,120,80,160,0,0,580
89009,220,100,120,80,0,0,520
89010,210,140,80,0,0,0,430
89011,240,100,0,0,0,0,340
89012,170,160,40,80,160,320,930
89013,210,140,120,240,160,0,870
89014,180,160,160,160,160,0,820
89015,200,140,160,240,160,320,1220
89016,240,180,120,0,0,0,540
89017,160,180,80,80,160,0,660
89018,170,120,80,0,0,0,370
89019,170,120,120,160,160,320,1050
89020,130,120,40,80,160,320,850
89021,180,120,120,160,160,0,740
89022,210,120,40,80,160,0,610
89023,210,140,160,160,320,320,1310
89024,170,140,120,80,160,0,670
89025,190,80,120,160,0,0,550
89026,170,100,120,80,160,0,630
89027,180,160,120,160,320,0,940
89028,210,140,120,80,0,0,550
89029,210,120,80,0,0,0,410
89030,210,100,80,80,160,0,630
89031,190,140,160,160,320,0,970
89032,200,120,120,160,0,0,600
89033,190,140,160,80,160,320,1050
89034,250,160,80,80,160,0,730
89035,200,180,120,160,160,0,820
89036,200,140,80,0,0,0,420
89037,230,140,120,160,0,0,650
89038,160,80,120,80,160,320,920
89039,180,140,120,160,160,0,760
89040,200,60,40,80,0,0,380
89041,190,120,80,0,0,0,390
89042,150,140,80,80,0,0,450
89043,170,180,120,160,160,320,1110
89044,170,60,40,80,160,0,510
89045,190,140,120,80,160,0,690
89046,220,140,80,80,0,0,520
89047,200,160,80,80,0,0,520
89048,200,180,120,80,160,0,740
89049,180,40,80,80,160,320,860
89050,220,140,160,160,160,0,840
89051,180,100,120,80,0,0,480
89052,180,100,160,80,160,0,680
89053,180,100,40,80,0,0,400
89054,190,160,160,240,160,320,1230
89055,200,120,120,240,160,0,840
89056,190,160,160,240,320,320,1390
89057,180,140,80,160,160,0,720
89058,190,100,80,0,0,0,370
89059,220,40,80,80,160,320,900
89060,230,140,120,80,0,0,570
89061,190,140,120,160,160,0,770
89062,220,120,120,160,160,0,780
89063,220,160,120,160,0,0,660
89064,190,120,120,80,160,0,670
89065,220,100,160,160,160,320,1120
89066,190,100,80,0,0,0,370
89067,220,100,80,80,160,0,640
89068,220,60,80,80,160,0,600
89069,180,100,40,0,0,0,320
89070,240,140,80,80,160,0,700
89071,220,80,80,80,160,0,620
89072,170,100,80,80,160,320,910
89073,230,120,0,0,0,0,350
89074,180,80,80,0,0,0,340
89075,220,140,120,80,0,0,560
89076,180,120,200,240,320,320,1380
89077,200,140,200,160,320,0,1020
89078,170,160,200,240,160,0,930
89079,210,120,40,0,0,0,370
89080,160,140,120,80,0,0,500
89081,220,180,240,160,320,320,1440
89082,170,40,40,80,160,0,490
89083,150,120,160,240,160,0,830
89084,190,100,40,80,160,0,570
89085,200,140,120,80,160,0,700
89086,210,120,120,160,160,0,770
89087,250,140,120,80,0,0,590
89088,170,60,0,0,0,0,230
89089,180,100,120,80,0,0,480
89090,230,160,160,160,320,320,1350
89091,210,120,120,80,0,0,530
89092,220,140,80,80,160,0,680
89093,200,100,120,160,160,0,740
89094,180,160,120,240,160,0,860
89095,210,160,80,0,0,0,450
89096,190,140,160,240,320,0,1050
89097,150,140,80,0,0,0,370
89098,210,140,120,80,0,0,550
89099,160,140,40,80,160,320,900
89100,190,120,120,160,320,320,1230
89101,190,120,40,80,160,0,590
89102,190,160,200,160,320,0,1030
89103,160,60,80,160,0,0,460
89104,210,80,80,160,160,0,690
89105,240,120,40,0,0,0,400
89106,170,140,160,80,160,0,710
89107,220,120,40,0,0,0,380
89108,170,100,120,240,320,0,950
89109,210,120,120,160,160,0,770
89110,240,200,200,160,320,0,1120
89111,210,120,80,80,160,0,650
89112,180,140,80,0,0,0,400
89113,220,140,120,80,160,0,720
89114,230,80,80,0,0,0,390
89115,220,140,120,160,160,0,800
89116,160,120,160,160,160,0,760
89117,190,140,160,240,320,320,1370
89118,150,120,120,160,0,0,550
89119,210,140,120,0,0,0,470
89120,180,140,120,80,160,0,680
89121,200,140,120,240,160,0,860
89122,190,100,160,160,0,0,610
89123,210,80,80,80,160,0,610
89124,200,120,80,80,160,0,640
89125,210,180,200,80,0,0,670
89126,170,80,40,0,0,0,290
89127,210,140,80,80,160,320,990
89128,200,120,80,0,0,0,400
89129,200,100,80,80,0,0,460
89130,160,60,40,0,0,0,260
89131,160,140,80,160,0,0,540
89132,210,80,40,80,0,0,410
89133,190,80,40,80,160,0,550
89134,210,140,120,80,160,0,710
89135,240,120,120,80,160,0,720
89136,180,140,160,160,160,0,800
89137,190,180,120,160,320,320,1290
89138,180,100,80,80,0,0,440
89139,160,140,40,0,0,0,340
89140,190,100,120,160,160,0,730
89141,150,120,40,80,0,0,390
89142,200,80,120,240,320,0,960
89143,200,180,160,240,160,0,940
89144,160,120,160,240,320,320,1320
89145,210,140,40,80,160,320,950
89146,200,120,120,80,160,0,680
89147,190,80,80,80,0,0,430
89148,180,200,160,80,160,0,780
89149,190,120,160,240,320,320,1350
89150,200,80,80,160,320,320,1160
89151,220,160,80,0,0,0,460
89152,170,100,120,160,160,0,710
89153,220,80,120,160,160,0,740
89154,230,180,160,160,160,0,890
89155,220,180,80,80,160,0,720
89156,170,80,80,80,160,0,570
89157,180,140,120,0,0,0,440
89158,190,120,120,160,0,0,590
89159,200,160,200,160,320,0,1040
89160,220,100,80,160,160,0,720
89161,190,160,40,0,0,0,390
89162,250,140,40,0,0,0,430
89163,170,100,0,0,0,0,270
89164,220,140,160,80,0,0,600
89165,210,180,160,160,320,0,1030
89166,220,160,160,80,0,0,620
89167,210,160,120,0,0,0,490
89168,220,140,160,160,160,0,840
89169,270,160,120,160,320,320,1350
89170,180,160,120,240,320,320,1340
89171,210,120,160,80,160,0,730
89172,230,160,0,0,0,0,390
89173,210,140,120,80,160,0,710
89174,170,100,40,80,160,0,550
89175,160,140,120,160,160,0,740
89176,220,80,40,80,0,0,420
89177,220,140,120,80,160,0,720
89178,200,100,80,80,0,0,460
89179,170,60,80,160,160,320,950
89180,190,60,40,0,0,0,290
89181,200,140,200,0,0,0,540
89182,190,140,80,80,0,0,490
89183,210,100,160,160,160,320,1110
89184,200,120,120,80,0,0,520
89185,170,120,80,0,0,0,370
89186,180,100,80,80,0,0,440
89187,190,100,0,0,0,0,290
89188,190,160,160,240,0,0,750
89189,190,100,40,0,0,0,330
89190,190,100,80,0,0,0,370
89191,180,120,160,80,160,320,1020
89192,210,120,120,160,160,0,770
89193,190,120,160,160,320,0,950
89194,190,140,80,160,160,0,730
89195,170,160,120,160,160,0,770
89196,210,80,40,0,0,0,330
89197,190,60,40,0,0,0,290
89198,220,180,160,160,160,0,880
89199,210,140,40,0,0,0,390
89200,170,140,160,0,0,0,470
89201,220,80,80,80,160,0,620
89202,180,40,40,80,160,320,820
89203,210,80,120,160,160,0,730
89204,170,60,80,80,0,0,390
89205,220,100,120,160,0,0,600
89206,220,100,120,0,0,0,440
89207,200,160,160,80,0,0,600
89208,220,160,80,160,0,0,620
89209,170,120,80,80,0,0,450
89210,150,100,160,240,160,0,810
89211,190,100,40,80,160,0,570
89212,230,120,160,80,160,0,750
89213,180,100,80,160,0,0,520
89214,220,100,120,80,0,0,520
89215,180,160,80,160,0,0,580
89216,180,160,120,0,0,0,460
89217,210,120,160,160,160,0,810
89218,200,160,120,80,160,0,720
89219,180,100,160,80,0,0,520
89220,210,100,160,80,160,0,710
89221,160,100,80,80,0,0,420
89222,220,80,40,80,160,0,580
89223,220,120,80,80,160,0,660
89224,200,120,80,160,160,0,720
89225,170,160,40,0,0,0,370
89226,200,80,120,160,160,0,720
89227,210,140,200,240,160,0,950
89228,180,140,160,160,160,0,800
89229,190,140,120,160,160,0,770
89230,160,80,40,0,0,0,280
89231,240,180,160,160,160,0,900
89232,190,120,40,0,0,0,350
89233,180,180,200,80,0,0,640
89234,200,120,200,160,320,320,1320
89235,190,160,120,160,320,0,950
89236,220,200,240,240,320,0,1220
89237,200,180,80,160,160,0,780
89238,190,140,120,80,160,0,690
89239,220,140,160,240,320,0,1080
89240,150,120,160,80,0,0,510
89241,190,140,80,160,320,0,890
89242,220,120,120,160,160,0,780
89243,220,120,160,160,160,320,1140
89244,170,120,80,160,320,320,1170
89245,240,180,160,240,320,0,1140
89246,210,100,80,80,160,0,630
89247,180,80,80,0,0,0,340
89248,230,140,120,240,320,0,1050
89249,210,100,80,160,160,320,1030
89250,210,180,40,80,0,0,510
89251,190,120,80,80,160,0,630
89252,160,120,120,80,160,0,640
89253,200,120,40,80,160,0,600
89254,210,80,80,80,160,0,610
89255,170,100,0,0,0,0,270
89256,170,120,120,80,0,0,490
89257,190,120,80,0,0,0,390
89258,210,140,160,160,160,0,830
89259,200,100,120,240,160,0,820
89260,200,120,120,80,160,320,1000
89261,220,140,160,160,160,0,840
89262,190,120,80,0,0,0,390
89263,150,100,120,80,0,0,450
89264,240,120,160,160,320,0,1000
89265,230,160,200,240,160,0,990
89266,210,160,160,160,0,0,690
89267,200,100,80,80,160,0,620
89268,180,120,200,240,320,320,1380
89269,180,120,40,0,0,0,340
89270,200,140,120,0,0,0,460
89271,230,120,80,80,160,0,670
89272,210,140,160,80,160,320,1070
89273,250,160,120,160,0,0,690
89274,180,100,120,160,160,0,720
89275,170,120,120,0,0,0,410
89276,220,120,40,80,0,0,460
89277,240,180,200,80,0,0,700
89278,210,160,80,80,160,0,690
89279,210,180,240,160,0,0,790
89280,210,120,80,80,0,0,490
89281,180,120,120,80,160,0,660
89282,190,60,80,80,160,0,570
89283,180,120,120,80,0,0,500
89284,170,100,160,0,0,0,430
89285,200,100,80,80,160,0,620
89286,180,180,160,240,0,0,760
89287,190,100,0,0,0,0,290
89288,230,60,80,160,320,0,850
89289,190,140,120,160,160,0,770
89290,220,120,80,160,320,0,900
89291,190,100,80,0,0,0,370
89292,220,160,120,160,160,0,820
89293,210,180,120,80,160,0,750
89294,180,120,40,80,0,0,420
89295,190,100,120,80,160,0,650
89296,180,120,120,160,160,0,740
89297,230,80,80,80,160,320,950
89298,180,100,160,160,320,320,1240
89299,240,160,40,80,0,0,520
89300,160,160,160,160,0,0,640
89301,230,80,0,0,0,0,310
89302,220,140,80,80,0,0,520
89303,200,140,200,160,160,0,860
89304,190,120,120,80,160,0,670
89305,220,100,120,240,320,0,1000
89306,190,140,120,80,0,0,530
89307,200,100,80,80,160,0,620
89308,170,120,80,80,160,0,610
89309,200,100,120,160,160,0,740
89310,160,120,40,80,0,0,400
89311,190,120,80,160,320,0,870
89312,230,100,80,80,160,0,650
89313,180,100,80,80,160,320,920
89314,150,120,80,80,160,0,590
89315,210,100,120,80,160,0,670
89316,230,160,120,0,0,0,510
89317,190,60,120,0,0,0,370
89318,210,100,120,160,0,0,590
89319,170,60,40,80,160,0,510
89320,190,160,200,240,160,0,950
89321,180,120,40,80,160,0,580
89322,220,160,120,160,160,0,820
89323,200,140,80,80,160,320,980
89324,240,140,120,160,0,0,660
89325,170,140,40,80,160,0,590
89326,220,100,120,240,160,0,840
89327,210,160,40,80,160,320,970
89328,220,180,160,160,320,0,1040
89329,200,120,160,240,320,320,1360
89330,200,120,120,240,320,320,1320
89331,200,80,80,160,160,0,680
89332,210,80,40,80,160,0,570
89333,230,160,80,0,0,0,470
89334,180,80,80,80,0,0,420
89335,230,160,120,80,160,0,750
89336,210,140,160,80,0,0,590
89337,230,140,160,80,0,0,610
89338,220,100,80,0,0,0,400
89339,190,140,80,80,0,0,490
89340,210,60,0,0,0,0,270
89341,180,120,80,80,0,0,460
89342,180,60,80,80,160,320,880
89343,200,120,120,80,0,0,520
89344,200,100,40,80,0,0,420
89345,190,140,200,160,0,0,690
89346,210,100,120,160,160,0,750
89347,210,100,120,160,160,320,1070
89348,180,120,120,160,320,320,1220
89349,200,160,160,160,160,0,840
89350,210,160,160,160,0,0,690
89351,200,120,160,80,0,0,560
89352,220,200,40,80,0,0,540
89353,160,120,80,80,160,0,600
89354,210,180,160,160,160,0,870
89355,230,140,200,160,160,0,890
89356,200,100,120,80,0,0,500
89357,160,160,80,160,0,0,560
89358,190,140,80,80,160,0,650
89359,200,120,40,80,160,0,600
89360,190,160,160,160,160,0,830
89361,180,40,40,80,160,0,500
89362,260,140,120,160,320,320,1320
89363,240,180,200,80,0,0,700
89364,180,100,120,80,0,0,480
89365,200,140,80,80,160,0,660
89366,240,160,120,80,0,0,600
89367,190,120,80,160,0,0,550
89368,220,180,120,80,0,0,600
89369,150,120,200,80,160,320,1030
89370,230,160,120,80,160,0,750
89371,210,160,120,160,160,0,810
89372,210,140,120,160,160,0,790
89373,210,80,40,80,0,0,410
89374,210,80,80,160,160,320,1010
89375,140,120,80,80,0,0,420
89376,220,120,80,80,160,0,660
89377,210,100,80,80,0,0,470
89378,240,120,160,80,160,0,760
89379,180,120,80,80,0,0,460
89380,200,160,160,80,160,0,760
89381,170,80,120,80,160,320,930
89382,160,140,160,80,160,0,700
89383,210,100,120,80,0,0,510
89384,190,120,120,160,160,0,750
89385,230,140,120,160,160,0,810
89386,200,100,80,80,0,0,460
89387,210,120,160,160,160,0,810
89388,180,140,160,80,0,0,560
89389,170,100,80,80,160,320,910
89390,240,140,120,0,0,0,500
89391,250,80,40,0,0,0,370
89392,220,100,160,80,160,0,720
89393,150,80,120,160,0,0,510
89394,180,120,160,160,160,320,1100
89395,190,140,120,80,160,0,690
89396,200,140,160,160,0,0,660
89397,210,120,80,80,160,0,650
89398,180,100,80,80,160,0,600
89399,190,140,80,0,0,0,410
89400,160,140,120,160,160,0,740
89401,200,60,80,0,0,0,340
89402,170,120,80,0,0,0,370
89403,150,120,120,240,160,0,790
89404,190,100,120,160,0,0,570
89405,190,120,120,160,160,320,1070
89406,150,120,80,80,0,0,430
89407,210,100,80,0,0,0,390
89408,200,40,80,160,160,0,640
89409,200,100,160,80,0,0,540
89410,210,160,160,160,160,0,850
89411,210,120,120,80,160,0,690
89412,180,100,80,80,160,320,920
89413,240,100,120,80,0,0,540
89414,190,120,80,80,0,0,470
89415,230,160,80,80,160,0,710
89416,210,140,120,80,0,0,550
89417,200,140,80,80,160,0,660
89418,180,160,80,0,0,0,420
89419,200,140,160,240,160,0,900
89420,180,120,160,80,160,0,700
89421,220,200,80,80,0,0,580
89422,200,100,120,80,160,320,980
89423,190,120,80,160,320,0,870
89424,220,180,120,80,160,0,760
89425,140,0,0,0,0,0,140
89426,220,180,80,0,0,0,480
89427,210,140,80,80,160,0,670
89428,160,140,240,160,320,0,1020
89429,200,100,40,80,160,320,900
89430,180,100,120,80,160,0,640
89431,230,140,160,160,160,0,850
89432,210,40,40,0,0,0,290
89433,200,120,80,0,0,0,400
89434,210,140,80,160,160,0,750
89435,180,100,80,160,160,0,680
89436,190,140,120,160,320,320,1250
89437,150,100,120,80,160,0,610
89438,170,80,80,0,0,0,330
89439,190,100,120,0,0,0,410
89440,200,100,120,80,0,0,500
89441,210,180,160,240,320,0,1110
89442,180,160,160,160,0,0,660
89443,170,120,40,80,0,0,410
89444,230,120,40,80,160,0,630
89445,180,120,80,0,0,0,380
89446,200,140,160,160,160,320,1140
89447,210,120,80,160,320,0,890
89448,210,80,80,80,160,0,610
89449,200,140,120,0,0,0,460
89450,190,140,80,80,160,0,650
89451,220,80,80,0,0,0,380
89452,150,140,120,160,320,0,890
89453,180,100,40,0,0,0,320
89454,260,200,160,160,160,0,940
89455,180,160,160,80,0,0,580
89456,180,160,120,160,160,0,780
89457,170,100,40,0,0,0,310
89458,230,160,120,80,160,0,750
89459,210,140,40,80,0,0,470
89460,120,80,120,80,0,0,400
89461,190,140,120,80,160,320,1010
89462,190,120,120,80,160,0,670
89463,220,200,120,160,160,0,860
89464,210,140,160,240,320,320,1390
89465,190,160,120,160,160,0,790
89466,200,100,160,80,0,0,540
89467,200,120,80,0,0,0,400
89468,200,120,40,80,0,0,440
89469,190,140,160,160,0,0,650
89470,190,120,80,80,0,0,470
89471,230,160,120,80,160,0,750
89472,180,100,80,0,0,0,360
89473,200,140,80,160,160,0,740
89474,190,140,160,160,160,0,810
89475,150,100,80,80,160,0,570
89476,230,80,80,80,0,0,470
89477,170,100,80,80,160,0,590
89478,190,120,120,240,320,320,1310
89479,230,140,160,160,160,0,850
89480,230,160,80,80,160,0,710
89481,180,160,240,160,320,320,1380
89482,170,100,40,80,0,0,390
89483,190,140,200,160,160,0,850
89484,200,140,160,160,0,0,660
89485,180,120,80,80,0,0,460
89486,160,80,40,0,0,0,280
89487,230,160,120,240,320,320,1390
89488,210,100,40,80,160,0,590
89489,170,100,80,0,0,0,350
89490,190,100,80,80,160,0,610
89491,250,100,40,80,160,0,630
89492,180,100,160,240,160,0,840
89493,180,140,160,240,320,0,1040
89494,190,100,80,160,160,0,690
89495,180,180,160,240,160,0,920
89496,190,80,160,80,160,0,670
89497,220,160,200,80,0,0,660
89498,220,180,120,80,0,0,600
89499,200,140,80,80,0,0,500
89500,210,200,120,160,160,320,1170
89501,180,140,80,0,0,0,400
89502,180,80,80,160,160,0,660
89503,150,100,0,0,0,0,250
89504,200,100,120,80,0,0,500
89505,140,80,120,80,160,0,580
89506,190,120,160,80,160,0,710
89507,160,100,120,80,0,0,460
89508,170,100,120,0,0,0,390
89509,220,140,120,160,160,0,800
89510,200,80,120,240,0,0,640
89511,190,120,120,160,160,0,750
89512,210,140,80,80,0,0,510
89513,230,120,40,80,160,0,630
89514,200,160,120,160,160,320,1120
89515,260,160,80,80,0,0,580
89516,190,80,120,80,160,0,630
89517,190,100,160,160,320,320,1250
89518,230,180,120,160,160,0,850
89519,200,80,80,80,160,320,920
89520,220,100,80,80,160,0,640
89521,220,120,120,80,0,0,540
89522,200,120,120,240,320,0,1000
89523,190,120,120,80,160,320,990
89524,260,120,80,0,0,0,460
89525,180,140,120,80,160,0,680
89526,230,160,80,80,160,0,710
89527,230,160,80,160,160,0,790
89528,190,140,160,160,320,0,970
89529,240,140,160,160,320,320,1340
89530,160,120,160,160,0,0,600
89531,180,80,80,160,320,320,1140
89532,170,160,120,80,0,0,530
89533,150,60,120,80,160,0,570
89534,90,100,80,80,0,0,350
89535,230,140,120,160,160,0,810
89536,180,80,80,0,0,0,340
89537,180,100,80,160,160,0,680
89538,230,160,120,160,0,0,670
89539,160,140,80,80,160,320,940
89540,210,180,120,80,0,0,590
89541,180,100,200,160,0,0,640
89542,230,60,80,80,160,0,610
89543,230,80,80,0,0,0,390
89544,190,160,80,80,0,0,510
89545,190,100,120,80,0,0,490
89546,220,120,120,240,160,320,1180
89547,240,80,80,80,0,0,480
89548,150,80,80,160,160,0,630
89549,210,140,160,80,160,0,750
89550,210,120,120,80,160,0,690
89551,230,160,40,80,160,0,670
89552,260,160,200,160,160,0,940
89553,200,100,120,160,0,0,580
89554,160,80,80,80,0,0,400
89555,240,140,80,160,160,0,780
89556,170,120,80,80,0,0,450
89557,180,180,160,240,320,0,1080
89558,190,120,80,80,0,0,470
89559,220,80,80,80,160,0,620
89560,190,100,80,160,320,320,1170
89561,180,160,120,160,160,320,1100
89562,210,140,80,160,160,0,750
89563,220,180,120,160,160,0,840
89564,210,180,80,160,320,320,1270
89565,190,80,80,80,0,0,430
89566,210,140,120,80,160,0,710
89567,170,80,80,80,160,0,570
89568,230,100,160,80,0,0,570
89569,200,160,160,160,0,0,680
89570,180,160,120,80,160,0,700
89571,210,120,80,80,160,0,650
89572,220,120,80,80,160,0,660
89573,200,120,120,160,160,320,1080
89574,220,140,40,0,0,0,400
89575,200,100,80,80,160,320,940
89576,210,120,80,80,160,0,650
89577,180,140,120,160,320,320,1240
89578,180,140,160,80,0,0,560
89579,220,120,80,0,0,0,420
89580,190,100,80,80,160,0,610
89581,180,140,120,80,0,0,520
89582,230,160,80,80,160,0,710
89583,200,120,120,160,320,320,1240
89584,170,80,80,160,160,320,970
89585,210,120,40,0,0,0,370
89586,240,140,120,160,320,0,980
89587,190,140,120,160,160,0,770
89588,210,160,120,80,0,0,570
89589,210,120,120,160,160,0,770
89590,240,120,80,0,0,0,440
89591,230,80,120,160,160,0,750
89592,150,100,120,80,160,0,610
89593,250,140,80,80,0,0,550
89594,180,140,120,80,0,0,520
89595,200,140,160,160,320,0,980
89596,190,80,120,80,160,0,630
89597,180,120,120,0,0,0,420
89598,170,120,80,80,160,0,610
89599,140,100,120,240,160,0,760
89600,140,120,40,0,0,0,300
89601,200,140,40,80,160,0,620
89602,200,160,160,80,160,0,760
89603,240,160,120,0,0,0,520
89604,190,140,120,240,320,0,1010
89605,240,140,200,160,160,0,900
89606,170,100,80,80,0,0,430
89607,200,140,80,80,0,0,500
89608,190,120,120,80,160,0,670
89609,180,160,120,160,160,0,780
89610,210,120,80,80,0,0,490
89611,160,100,80,160,160,0,660
89612,230,180,120,160,320,0,1010
89613,220,140,80,160,320,0,920
89614,190,120,80,80,0,0,470
89615,200,100,80,0,0,0,380
89616,220,140,160,80,160,0,760
89617,170,120,80,160,0,0,530
89618,200,140,120,160,160,0,780
89619,180,60,80,160,160,0,640
89620,210,120,80,80,160,320,970
89621,210,100,120,160,160,0,750
89622,210,100,40,0,0,0,350
89623,170,120,40,80,160,0,570
89624,220,140,120,160,160,320,1120
89625,210,180,120,160,160,320,1150
89626,240,220,120,80,0,0,660
89627,250,100,120,0,0,0,470
89628,170,180,160,0,0,0,510
89629,150,120,80,80,0,0,430
89630,220,100,40,0,0,0,360
89631,250,160,120,0,0,0,530
89632,200,120,80,80,160,320,960
89633,170,120,80,80,160,0,610
89634,180,100,40,80,160,0,560
89635,210,120,120,80,0,0,530
89636,220,140,120,80,0,0,560
89637,210,160,120,160,160,0,810
89638,200,120,120,240,320,0,1000
89639,170,140,120,160,160,320,1070
89640,180,120,120,80,0,0,500
89641,190,120,80,80,0,0,470
89642,160,160,80,0,0,0,400
89643,200,120,120,160,160,0,760
89644,220,140,160,160,160,0,840
89645,200,160,120,80,0,0,560
89646,210,100,0,0,0,0,310
89647,230,100,160,0,0,0,490
89648,180,60,80,80,160,0,560
89649,130,100,80,80,0,0,390
89650,210,140,120,160,160,320,1110
89651,180,100,160,80,0,0,520
89652,210,120,120,80,160,0,690
89653,210,160,80,0,0,0,450
89654,170,100,80,80,160,0,590
89655,230,200,160,80,160,0,830
89656,200,200,160,160,160,0,880
89657,220,140,160,160,160,0,840
89658,200,160,120,80,160,0,720
89659,210,160,160,160,160,0,850
89660,180,100,80,80,0,0,440
89661,190,120,80,80,160,320,950
89662,190,160,160,160,160,320,1150
89663,190,180,0,0,0,0,370
89664,170,80,40,0,0,0,290
89665,200,140,120,0,0,0,460
89666,180,100,120,160,160,0,720
89667,220,140,160,240,160,0,920
89668,160,120,120,0,0,0,400
89669,190,160,120,0,0,0,470
89670,180,140,120,80,0,0,520
89671,220,140,120,0,0,0,480
89672,200,120,80,80,160,320,960
89673,160,120,80,80,0,0,440
89674,240,200,200,80,0,0,720
89675,220,200,160,0,0,0,580
89676,160,80,120,160,0,0,520
89677,200,120,80,160,160,0,720
89678,230,160,80,0,0,0,470
89679,160,100,120,80,0,0,460
89680,250,160,160,0,0,0,570
89681,180,100,120,160,0,0,560
89682,180,120,80,80,160,320,940
89683,200,120,80,80,0,0,480
89684,220,100,40,80,160,0,600
89685,190,120,120,80,160,0,670
89686,240,100,120,160,320,320,1260
89687,200,180,160,160,160,0,860
89688,200,100,80,160,160,0,700
89689,230,120,200,160,160,0,870
89690,200,100,0,0,0,0,300
89691,200,120,160,0,0,0,480
89692,170,180,200,160,0,0,710
89693,200,120,80,80,160,0,640
89694,190,160,120,80,160,0,710
89695,160,100,120,80,160,0,620
89696,150,60,40,0,0,0,250
89697,190,80,120,160,160,320,1030
89698,170,140,200,160,160,0,830
89699,230,140,200,160,0,0,730
89700,220,80,0,0,0,0,300
89701,180,160,120,0,0,0,460
89702,220,120,80,80,160,0,660
89703,190,100,120,0,0,0,410
89704,220,120,80,80,160,0,660
89705,200,140,120,160,160,0,780
89706,210,140,160,80,160,0,750
89707,170,140,80,160,320,0,870
89708,200,140,120,240,320,0,1020
89709,200,120,160,160,0,0,640
89710,190,140,120,160,320,0,930
89711,200,140,80,80,0,0,500
89712,240,160,160,240,160,0,960
89713,230,140,120,80,160,0,730
89714,160,80,80,160,320,0,800
89715,210,140,160,160,320,0,990
89716,230,140,120,0,0,0,490
89717,190,160,40,0,0,0,390
89718,150,120,120,160,160,0,710
89719,170,140,120,80,160,0,670
89720,220,120,160,80,160,0,740
89721,200,140,160,160,160,320,1140
89722,200,100,40,0,0,0,340
89723,220,120,40,80,0,0,460
89724,190,80,160,160,160,320,1070
89725,150,160,120,80,160,0,670
89726,210,120,80,80,160,0,650
89727,210,120,120,160,0,0,610
89728,190,80,80,80,160,0,590
89729,240,140,120,160,320,0,980
89730,210,140,120,160,0,0,630
89731,220,180,80,80,0,0,560
89732,200,180,120,80,160,320,1060
89733,220,140,120,160,160,0,800
89734,200,140,120,160,160,0,780
89735,200,160,160,160,160,0,840
89736,200,120,40,80,160,320,920
89737,220,160,120,160,160,0,820
89738,170,120,80,80,160,0,610
89739,190,160,160,80,0,0,590
89740,220,160,80,0,0,0,460
89741,200,120,80,160,160,0,720
89742,200,120,40,0,0,0,360
89743,220,120,120,80,0,0,540
89744,260,120,160,160,320,0,1020
89745,200,140,160,80,0,0,580
89746,150,80,120,80,160,0,590
89747,240,160,280,160,0,0,840
89748,170,100,80,80,0,0,430
89749,210,140,120,160,0,0,630
89750,170,60,80,80,0,0,390
89751,200,120,120,160,320,0,920
89752,210,140,120,240,320,0,1030
89753,210,80,160,160,320,0,930
89754,210,100,40,80,160,0,590
89755,190,140,80,160,320,320,1210
89756,230,200,160,240,160,0,990
89757,170,100,80,80,160,0,590
89758,200,140,200,160,160,0,860
89759,200,140,120,80,160,320,1020
89760,180,100,80,80,0,0,440
89761,160,100,120,160,0,0,540
89762,190,160,160,160,320,320,1310
89763,230,140,120,80,160,320,1050
89764,190,100,40,80,160,0,570
89765,190,120,120,160,320,320,1230
89766,160,80,0,0,0,0,240
89767,210,120,80,80,160,0,650
89768,200,160,80,0,0,0,440
89769,180,160,0,0,0,0,340
89770,190,140,120,80,160,0,690
89771,210,140,200,80,160,0,790
89772,220,100,80,80,160,0,640
89773,210,100,80,0,0,0,390
89774,210,120,80,80,160,0,650
89775,220,140,160,160,160,0,840
89776,190,100,120,240,160,0,810
89777,150,100,120,240,160,0,770
89778,180,140,200,160,320,0,1000
89779,240,180,40,0,0,0,460
89780,130,120,120,0,0,0,370
89781,190,120,80,80,160,0,630
89782,170,120,120,240,160,0,810
89783,220,140,160,0,0,0,520
89784,140,60,80,0,0,0,280
89785,190,140,120,240,160,0,850
89786,170,100,80,160,160,0,670
89787,230,140,80,160,320,320,1250
89788,190,80,120,160,0,0,550
89789,210,120,80,160,160,0,730
89790,200,100,80,0,0,0,380
89791,170,120,40,0,0,0,330
89792,230,80,40,0,0,0,350
89793,240,80,80,80,0,0,480
89794,200,180,200,160,320,0,1060
89795,200,80,40,0,0,0,320
89796,210,120,120,160,320,320,1250
89797,170,100,80,80,160,0,590
89798,180,80,80,80,0,0,420
89799,190,60,40,80,160,0,530
89800,200,140,120,160,0,0,620
89801,200,120,80,80,160,0,640
89802,190,140,160,160,160,0,810
89803,230,160,160,80,160,0,790
89804,180,140,200,160,160,0,840
89805,180,120,80,80,0,0,460
89806,210,120,120,160,160,0,770
89807,210,100,80,160,0,0,550
89808,180,100,120,80,160,0,640
89809,230,120,160,160,0,0,670
89810,140,80,80,80,0,0,380
89811,180,120,120,160,160,0,740
89812,170,120,160,160,160,0,770
89813,190,40,40,0,0,0,270
89814,160,120,120,160,160,0,720
89815,240,100,40,0,0,0,380
89816,180,100,120,80,160,0,640
89817,230,120,120,80,160,0,710
89818,180,160,160,80,0,0,580
89819,200,140,80,160,320,0,900
89820,200,100,120,80,160,0,660
89821,170,100,40,80,160,0,550
89822,210,160,160,160,0,0,690
89823,220,160,120,80,0,0,580
89824,190,100,80,160,0,0,530
89825,220,80,40,0,0,0,340
89826,180,100,120,80,0,0,480
89827,210,140,80,0,0,0,430
89828,170,100,120,80,160,0,630
89829,190,180,120,80,0,0,570
89830,170,140,120,160,0,0,590
89831,160,160,80,160,160,0,720
89832,190,120,120,160,160,0,750
89833,170,80,80,0,0,0,330
89834,150,100,40,0,0,0,290
89835,180,140,120,160,160,0,760
89836,140,80,80,80,160,0,540
89837,170,60,80,80,160,320,870
89838,200,160,160,160,160,320,1160
89839,190,100,80,0,0,0,370
89840,200,120,160,80,0,0,560
89841,170,80,80,160,160,320,970
89842,180,140,120,80,0,0,520
89843,220,80,120,160,160,0,740
89844,190,140,120,160,320,320,1250
89845,230,120,80,160,160,0,750
89846,170,120,160,160,0,0,610
89847,180,100,120,80,160,0,640
89848,200,120,80,80,0,0,480
89849,230,60,80,80,160,320,930
89850,210,80,40,0,0,0,330
89851,180,120,160,240,160,0,860
89852,240,160,200,160,160,320,1240
89853,230,180,80,80,0,0,570
89854,210,160,120,80,160,0,730
89855,190,120,160,80,160,0,710
89856,190,120,120,160,160,0,750
89857,230,160,200,160,160,0,910
89858,230,140,200,160,0,0,730
89859,190,140,160,80,160,320,1050
89860,180,100,160,80,0,0,520
89861,200,120,160,160,0,0,640
89862,180,120,80,80,160,0,620
89863,160,100,80,80,160,0,580
89864,210,80,80,80,0,0,450
89865,180,160,40,0,0,0,380
89866,230,120,120,160,0,0,630
89867,150,100,120,80,160,320,930
89868,230,120,80,160,160,0,750
89869,170,120,40,80,160,0,570
89870,210,120,120,80,160,0,690
89871,190,120,120,160,320,320,1230
89872,170,80,40,0,0,0,290
89873,200,120,160,240,320,320,1360
89874,220,120,40,80,160,0,620
89875,210,120,40,0,0,0,370
89876,190,100,120,160,160,0,730
89877,170,160,120,80,160,0,690
89878,190,140,160,160,0,0,650
89879,200,100,120,80,160,0,660
89880,190,80,80,80,160,0,590
89881,210,200,160,160,160,0,890
89882,200,140,200,160,160,0,860
89883,160,80,80,80,0,0,400
89884,200,120,160,160,0,0,640
89885,200,120,80,80,160,320,960
89886,180,140,160,80,160,0,720
89887,200,160,160,160,320,0,1000
89888,190,140,120,80,160,0,690
89889,200,140,200,160,0,0,700
89890,210,100,160,80,0,0,550
89891,200,160,40,80,160,0,640
89892,200,60,40,80,160,0,540
89893,200,120,80,80,160,0,640
89894,220,140,120,160,160,0,800
89895,200,120,160,80,160,0,720
89896,180,80,80,80,160,0,580
89897,190,140,160,80,160,0,730
89898,190,120,120,160,160,0,750
89899,210,160,80,80,160,0,690
89900,220,140,160,160,0,0,680
89901,160,160,80,80,0,0,480
89902,180,80,80,160,160,0,660
89903,170,100,160,160,160,320,1070
89904,220,160,120,80,160,0,740
89905,250,180,160,160,160,0,910
89906,200,100,40,0,0,0,340
89907,190,160,80,80,160,0,670
89908,210,120,160,160,0,0,650
89909,190,120,80,80,0,0,470
89910,220,80,80,160,160,0,700
89911,190,80,40,80,0,0,390
89912,220,80,40,0,0,0,340
89913,210,120,120,80,0,0,530
89914,220,140,120,80,0,0,560
89915,190,80,80,80,160,0,590
89916,170,120,80,80,0,0,450
89917,220,100,40,0,0,0,360
89918,200,140,80,160,160,0,740
89919,210,140,120,160,160,0,790
89920,210,120,120,160,160,0,770
89921,210,60,80,80,160,320,910
89922,180,100,80,0,0,0,360
89923,180,120,120,160,320,0,900
89924,230,140,120,160,160,0,810
89925,200,160,120,80,160,0,720
89926,230,100,120,80,160,320,1010
89927,180,160,160,80,160,0,740
89928,170,140,80,80,160,0,630
89929,200,140,120,80,160,0,700
89930,230,80,40,80,160,0,590
89931,210,120,80,80,0,0,490
89932,190,120,80,80,160,0,630
89933,200,160,160,80,160,0,760
89934,200,100,80,80,160,0,620
89935,230,160,80,80,160,0,710
89936,190,120,40,0,0,0,350
89937,180,140,120,160,320,0,920
89938,170,120,80,80,0,0,450
89939,210,100,80,80,160,0,630
89940,200,80,120,80,160,0,640
89941,190,140,120,80,0,0,530
89942,210,120,160,240,160,0,890
89943,200,140,120,80,160,0,700
89944,210,120,80,80,160,0,650
89945,180,160,160,160,160,0,820
89946,200,100,40,80,0,0,420
89947,230,140,80,80,0,0,530
89948,210,100,40,80,0,0,430
89949,250,160,160,240,160,0,970
89950,190,60,120,80,160,0,610
89951,210,140,120,80,160,0,710
89952,170,100,80,160,160,0,670
89953,220,80,120,160,320,0,900
89954,210,120,80,0,0,0,410
89955,190,140,80,80,0,0,490
89956,210,100,120,160,320,0,910
89957,230,200,120,80,0,0,630
89958,190,120,80,80,160,0,630
89959,160,100,80,0,0,0,340
89960,200,120,120,0,0,0,440
89961,210,120,120,80,0,0,530
89962,220,160,160,160,160,320,1180
89963,250,140,80,160,160,320,1110
89964,170,160,120,80,160,0,690
89965,160,120,80,80,160,0,600
89966,170,100,80,80,0,0,430
89967,210,120,80,160,160,0,730
89968,250,140,200,160,160,0,910
89969,220,100,0,0,0,0,320
89970,170,140,160,80,160,0,710
89971,210,140,160,80,0,0,590
89972,220,160,160,240,160,0,940
89973,210,80,40,0,0,0,330
89974,230,180,160,160,160,0,890
89975,180,100,80,80,0,0,440
89976,230,80,120,160,160,320,1070
89977,200,120,80,80,0,0,480
89978,250,60,80,0,0,0,390
89979,140,80,120,80,160,0,580
89980,190,120,80,0,0,0,390
89981,180,100,120,80,160,0,640
89982,190,100,120,160,160,0,730
89983,190,100,40,0,0,0,330
89984,190,100,80,160,160,320,1010
89985,240,140,120,160,320,320,1300
89986,190,120,200,80,0,0,590
89987,220,120,120,80,0,0,540
89988,210,120,200,80,160,0,770
89989,200,100,120,160,320,0,900
89990,210,100,40,80,160,0,590
89991,240,160,120,80,160,0,760
89992,190,180,120,80,160,0,730
89993,200,120,120,80,0,0,520
89994,190,160,120,160,160,0,790
89995,200,60,80,80,160,320,900
89996,200,100,40,80,160,0,580
89997,190,120,80,80,160,0,630
89998,200,120,160,80,160,320,1040
89999,240,100,160,80,160,0,740
90000,220,120,120,80,0,0,540
90001,190,160,120,80,160,0,710
90002,210,80,120,0,0,0,410
90003,210,60,80,0,0,0,350
90004,190,100,40,80,160,0,570
90005,180,120,80,0,0,0,380
90006,210,160,120,160,320,0,970
90007,220,100,80,0,0,0,400
90008,180,140,80,80,160,0,640
90009,220,80,40,80,160,320,900
90010,210,80,40,80,0,0,410
90011,180,160,160,240,320,320,1380
90012,220,120,120,80,0,0,540
90013,180,100,80,160,320,320,1160
90014,210,140,120,160,160,0,790
90015,210,120,80,80,160,0,650
90016,200,100,40,80,0,0,420
90017,150,140,40,80,160,320,890
90018,190,80,40,80,160,0,550
90019,200,120,200,240,160,0,920
90020,200,140,80,80,160,0,660
90021,190,60,80,80,160,0,570
90022,220,120,80,80,0,0,500
90023,190,160,160,160,320,0,990
90024,180,120,160,160,320,0,940
90025,230,140,120,80,160,0,730
90026,200,140,80,0,0,0,420
90027,230,140,120,80,160,0,730
90028,210,120,160,240,160,0,890
90029,220,80,40,80,160,0,580
90030,190,120,120,80,160,0,670
90031,170,120,200,160,160,320,1130
90032,200,100,160,80,160,0,700
90033,210,200,120,80,160,320,1090
90034,150,140,80,80,0,0,450
90035,170,140,160,160,160,320,1110
90036,230,160,120,80,0,0,590
90037,150,100,120,80,160,0,610
90038,210,100,160,80,160,0,710
90039,160,80,80,80,0,0,400
90040,210,180,200,160,320,0,1070
90041,170,80,80,80,0,0,410
90042,190,100,120,80,160,0,650
90043,240,140,120,160,160,320,1140
90044,180,120,120,160,0,0,580
90045,250,160,40,80,160,320,1010
90046,230,140,160,160,0,0,690
90047,200,160,160,80,160,320,1080
90048,220,160,40,0,0,0,420
90049,150,40,40,80,160,0,470
90050,170,100,120,80,160,320,950
90051,190,140,40,0,0,0,370
90052,170,100,80,80,160,0,590
90053,210,200,200,160,0,0,770
90054,200,100,120,80,0,0,500
90055,180,120,120,160,160,320,1060
90056,190,60,40,80,0,0,370
90057,180,80,80,160,160,320,980
90058,200,120,120,160,0,0,600
90059,140,60,120,80,160,320,880
90060,200,140,160,160,160,320,1140
90061,220,140,120,80,0,0,560
90062,220,120,80,80,0,0,500
90063,160,140,120,240,320,320,1300
90064,200,140,160,160,160,320,1140
90065,220,140,120,160,160,0,800
90066,140,100,80,160,160,0,640
90067,200,120,120,160,160,320,1080
90068,180,80,120,80,160,0,620
90069,180,120,80,80,160,0,620
90070,200,140,120,160,0,0,620
90071,160,100,80,80,160,0,580
90072,160,140,120,160,160,0,740
90073,200,120,80,80,0,0,480
90074,200,100,80,160,160,0,700
90075,210,180,120,80,160,0,750
90076,230,180,200,240,320,0,1170
90077,190,200,240,160,160,0,950
90078,190,120,120,80,160,0,670
90079,200,120,40,0,0,0,360
90080,240,120,80,80,160,0,680
90081,220,120,80,80,0,0,500
90082,180,80,120,0,0,0,380
90083,220,180,160,240,320,0,1120
90084,170,100,40,80,160,0,550
90085,180,120,120,0,0,0,420
90086,190,160,160,80,160,320,1070
90087,210,140,120,240,160,0,870
90088,170,140,80,80,160,0,630
90089,190,140,160,160,160,0,810
90090,190,100,120,80,0,0,490
90091,200,120,120,80,160,0,680
90092,200,60,40,80,0,0,380
90093,180,100,80,160,160,0,680
90094,220,120,80,160,160,0,740
90095,220,120,120,160,160,0,780
90096,190,140,160,160,160,0,810
90097,160,60,80,160,160,0,620
90098,200,80,40,80,160,0,560
90099,190,80,80,80,0,0,430
90100,210,120,160,240,320,0,1050
90101,180,140,40,0,0,0,360
90102,180,80,0,0,0,0,260
90103,200,120,160,160,160,320,1120
90104,210,140,200,240,320,0,1110
90105,210,160,160,240,320,0,1090
90106,160,100,120,80,160,0,620
90107,190,100,80,80,0,0,450
90108,190,120,120,80,160,0,670
90109,190,100,120,80,0,0,490
90110,190,100,80,0,0,0,370
90111,210,140,200,80,0,0,630
90112,190,60,40,0,0,0,290
90113,210,80,80,160,160,0,690
90114,210,80,80,80,160,0,610
90115,190,100,80,80,160,0,610
90116,200,160,80,80,160,0,680
90117,160,80,120,160,0,0,520
90118,190,120,120,80,160,320,990
90119,230,140,160,80,0,0,610
90120,200,140,160,240,320,0,1060
90121,220,80,40,80,160,0,580
90122,190,140,160,80,160,0,730
90123,220,80,80,80,0,0,460
90124,180,80,40,0,0,0,300
90125,190,80,40,0,0,0,310
90126,200,140,160,80,0,0,580
90127,160,140,80,80,0,0,460
90128,170,60,80,80,0,0,390
90129,190,80,80,80,0,0,430
90130,160,120,120,160,320,320,1200
90131,180,80,80,0,0,0,340
90132,190,120,120,160,160,0,750
90133,250,160,80,160,320,320,1290
90134,200,140,160,160,160,320,1140
90135,200,100,80,80,160,0,620
90136,240,160,120,160,160,0,840
90137,250,140,80,80,0,0,550
90138,220,200,160,0,0,0,580
90139,180,120,80,160,160,0,700
90140,170,100,40,0,0,0,310
90141,200,120,120,160,320,0,920
90142,170,80,120,80,160,0,610
90143,170,100,80,80,160,320,910
90144,180,140,120,80,160,320,1000
90145,210,100,80,80,0,0,470
90146,160,140,120,160,0,0,580
90147,170,100,80,80,0,0,430
90148,160,140,160,80,0,0,540
90149,200,120,40,80,0,0,440
90150,190,80,80,0,0,0,350
90151,210,120,40,80,160,0,610
90152,210,120,200,80,0,0,610
90153,190,180,120,240,320,0,1050
90154,190,100,80,80,160,0,610
90155,200,120,80,160,160,0,720
90156,170,140,160,160,320,320,1270
90157,150,140,80,80,0,0,450
90158,190,100,160,240,0,0,690
90159,180,100,80,80,160,0,600
90160,210,140,80,80,0,0,510
90161,160,100,120,0,0,0,380
90162,240,140,80,0,0,0,460
90163,180,80,80,80,160,0,580
90164,200,120,80,160,160,0,720
90165,190,60,80,80,160,0,570
90166,220,120,120,0,0,0,460
90167,160,160,120,160,320,0,920
90168,180,100,80,80,0,0,440
90169,190,120,120,80,160,0,670
90170,220,160,160,80,0,0,620
90171,220,180,120,80,160,0,760
90172,280,140,40,80,160,0,700
90173,210,140,80,160,160,0,750
90174,200,120,120,160,160,0,760
90175,200,120,120,80,160,0,680
90176,220,100,120,80,160,0,680
90177,190,100,80,80,160,0,610
90178,210,140,80,160,160,0,750
90179,210,120,40,0,0,0,370
90180,160,100,80,80,160,0,580
90181,210,100,120,160,0,0,590
90182,180,100,80,80,160,0,600
90183,200,140,160,240,160,0,900
90184,160,80,80,80,160,0,560
90185,190,140,120,0,0,0,450
90186,160,80,80,80,160,0,560
90187,180,100,80,0,0,0,360
90188,170,100,40,0,0,0,310
90189,190,140,120,80,160,0,690
90190,190,120,160,0,0,0,470
90191,150,60,0,0,0,0,210
90192,190,100,80,80,0,0,450
90193,220,140,80,80,160,0,680
90194,150,140,120,80,0,0,490
90195,220,140,200,160,160,0,880
90196,250,160,200,160,160,0,930
90197,200,80,120,160,160,0,720
90198,190,120,120,80,160,0,670
90199,160,120,120,0,0,0,400
90200,240,80,80,160,160,0,720
90201,190,140,160,240,320,0,1050
90202,180,100,120,80,160,0,640
90203,190,160,80,160,160,0,750
90204,200,160,160,160,160,320,1160
90205,220,100,80,80,160,0,640
90206,250,120,40,0,0,0,410
90207,210,160,120,160,160,0,810
90208,200,100,40,0,0,0,340
90209,160,80,40,0,0,0,280
90210,180,60,120,160,160,0,680
90211,230,200,0,0,0,0,430
90212,220,100,80,80,160,320,960
90213,150,180,120,80,160,320,1010
90214,220,160,80,80,0,0,540
90215,170,80,80,0,0,0,330
90216,200,120,160,160,0,0,640
90217,170,60,80,0,0,0,310
90218,210,160,120,240,320,320,1370
90219,160,60,0,0,0,0,220
90220,180,100,80,160,320,0,840
90221,210,100,120,160,0,0,590
90222,200,80,0,0,0,0,280
90223,180,80,80,0,0,0,340
90224,200,120,200,160,320,0,1000
90225,190,120,120,80,160,0,670
90226,190,180,120,240,160,0,890
90227,200,140,120,160,160,0,780
90228,230,140,80,160,320,0,930
90229,150,100,120,160,160,320,1010
90230,200,160,120,80,0,0,560
90231,190,40,80,80,160,0,550
90232,150,120,160,80,160,0,670
90233,180,160,160,80,160,0,740
90234,200,160,160,160,160,0,840
90235,200,100,80,160,160,0,700
90236,180,180,120,160,160,320,1120
90237,180,120,120,80,160,0,660
90238,150,100,120,160,160,0,690
90239,170,120,80,80,0,0,450
90240,190,140,120,80,160,0,690
90241,220,120,80,80,0,0,500
90242,220,140,40,0,0,0,400
90243,150,140,120,80,160,0,650
90244,150,120,120,160,320,0,870
90245,190,160,240,80,160,0,830
90246,200,140,160,80,160,0,740
90247,180,160,80,160,160,0,740
90248,220,120,80,0,0,0,420
90249,150,100,120,80,160,0,610
90250,200,120,120,80,160,0,680
90251,220,80,120,0,0,0,420
90252,170,100,120,160,320,320,1190
90253,160,80,80,160,160,0,640
90254,220,120,200,80,160,0,780
90255,170,100,40,0,0,0,310
90256,200,80,120,160,0,0,560
90257,190,120,80,0,0,0,390
90258,200,140,120,0,0,0,460
90259,210,160,80,160,160,0,770
90260,190,160,120,80,0,0,550
90261,240,120,160,80,0,0,600
90262,230,160,200,160,160,0,910
90263,160,120,40,80,0,0,400
90264,240,140,120,160,160,0,820
90265,220,120,80,160,320,320,1220
90266,260,180,160,80,160,0,840
90267,210,120,120,160,0,0,610
90268,190,140,0,0,0,0,330
90269,220,140,200,240,160,0,960
90270,220,100,160,160,320,0,960
90271,190,100,160,80,0,0,530
90272,170,100,120,0,0,0,390
90273,210,100,40,80,160,320,910
90274,200,120,40,0,0,0,360
90275,180,120,120,160,320,320,1220
90276,180,120,160,240,160,0,860
90277,180,140,80,80,160,0,640
90278,170,100,40,0,0,0,310
90279,160,80,80,0,0,0,320
90280,230,180,160,80,0,0,650
90281,170,80,40,80,160,0,530
90282,190,100,0,0,0,0,290
90283,190,140,120,80,160,320,1010
90284,200,140,80,0,0,0,420
90285,180,120,80,80,160,0,620
90286,190,120,160,160,160,0,790
90287,210,140,40,80,0,0,470
90288,240,140,120,160,160,0,820
90289,200,160,200,240,160,0,960
90290,210,200,80,80,160,0,730
90291,220,140,80,0,0,0,440
90292,200,100,120,80,160,0,660
90293,200,100,120,160,160,0,740
90294,210,140,120,80,0,0,550
90295,200,100,160,80,160,320,1020
90296,230,140,120,80,0,0,570
90297,240,120,160,160,320,320,1320
90298,220,160,160,160,160,0,860
90299,190,140,160,160,0,0,650
90300,150,120,120,160,0,0,550
90301,220,160,80,0,0,0,460
90302,190,140,160,240,160,0,890
90303,210,160,80,80,0,0,530
90304,190,180,120,0,0,0,490
90305,180,100,80,160,160,0,680
90306,200,140,160,80,160,0,740
90307,200,100,40,80,160,0,580
90308,220,160,40,80,0,0,500
90309,220,180,160,160,320,0,1040
90310,180,100,120,160,320,320,1200
90311,200,140,120,80,160,0,700
90312,230,120,120,80,160,0,710
90313,160,120,120,160,320,0,880
90314,170,60,80,80,0,0,390
90315,210,120,80,80,160,320,970
90316,140,100,80,80,160,0,560
90317,180,100,40,80,0,0,400
90318,150,140,120,160,320,0,890
90319,200,140,200,160,160,0,860
90320,210,160,160,240,0,0,770
90321,200,140,160,80,160,0,740
90322,210,100,40,0,0,0,350
90323,140,100,160,80,160,320,960
90324,180,100,160,80,160,0,680
90325,190,140,160,160,160,320,1130
90326,150,80,120,160,160,0,670
90327,200,100,40,0,0,0,340
90328,190,80,40,80,160,0,550
90329,200,80,80,80,160,0,600
90330,180,120,40,80,160,320,900
90331,220,160,120,80,0,0,580
90332,190,80,120,80,0,0,470
90333,240,100,80,80,160,320,980
90334,180,160,160,160,320,0,980
90335,210,100,80,80,160,320,950
90336,220,180,160,240,320,320,1440
90337,180,100,80,0,0,0,360
90338,210,80,80,80,0,0,450
90339,190,100,80,0,0,0,370
90340,160,100,160,80,160,0,660
90341,220,120,80,80,160,0,660
90342,200,160,120,160,320,320,1280
90343,200,140,160,80,0,0,580
90344,210,180,160,240,0,0,790
90345,190,100,40,80,160,0,570
90346,210,140,80,80,160,0,670
90347,210,140,120,80,160,0,710
90348,200,140,160,160,160,0,820
90349,160,100,120,160,320,0,860
90350,240,140,40,0,0,0,420
90351,230,120,120,80,160,0,710
90352,180,120,160,160,320,0,940
90353,170,120,80,80,0,0,450
90354,170,120,80,0,0,0,370
90355,200,120,120,160,320,0,920
90356,180,100,80,80,160,0,600
90357,180,120,80,80,160,0,620
90358,210,120,160,240,320,0,1050
90359,150,80,40,0,0,0,270
90360,190,80,120,80,160,0,630
90361,240,160,160,320,160,0,1040
90362,170,80,40,0,0,0,290
90363,210,120,40,0,0,0,370
90364,180,100,120,160,160,0,720
90365,170,120,120,160,160,0,730
90366,200,160,160,160,160,0,840
90367,220,140,40,80,0,0,480
90368,160,80,120,80,160,320,920
90369,240,140,120,160,160,0,820
90370,180,100,40,80,160,320,880
90371,170,100,80,80,160,0,590
90372,240,140,160,80,160,0,780
90373,180,140,120,160,320,0,920
90374,220,140,40,0,0,0,400
90375,220,160,160,0,0,0,540
90376,190,80,80,80,0,0,430
90377,220,180,160,80,0,0,640
90378,230,100,40,80,0,0,450
90379,230,120,40,80,160,0,630
90380,200,160,120,80,160,0,720
90381,180,120,80,80,0,0,460
90382,210,160,120,80,0,0,570
90383,220,160,200,160,160,320,1220
90384,200,160,80,80,0,0,520
90385,220,80,80,160,160,0,700
90386,200,140,80,160,320,0,900
90387,160,100,80,0,0,0,340
90388,210,160,160,80,0,0,610
90389,230,120,80,160,320,0,910
90390,180,80,80,80,160,0,580
90391,250,180,80,160,160,320,1150
90392,200,160,120,160,160,0,800
90393,190,140,120,80,160,0,690
90394,190,120,80,80,0,0,470
90395,200,180,120,160,160,0,820
90396,230,80,80,80,160,0,630
90397,180,100,80,160,0,0,520
90398,180,120,160,160,160,0,780
90399,190,120,160,240,160,0,870
90400,220,120,80,160,160,0,740
90401,200,80,80,160,160,0,680
90402,230,180,80,160,0,0,650
90403,180,140,200,320,320,0,1160
90404,190,100,120,0,0,0,410
90405,210,100,120,80,0,0,510
90406,180,60,40,0,0,0,280
90407,180,80,80,80,160,0,580
90408,210,80,40,0,0,0,330
90409,200,160,80,80,160,0,680
90410,190,120,40,80,160,0,590
90411,170,80,80,80,160,0,570
90412,180,140,80,80,160,0,640
90413,220,100,120,160,320,0,920
90414,200,160,80,0,0,0,440
90415,240,80,40,0,0,0,360
90416,220,140,160,80,0,0,600
90417,180,80,120,160,160,0,700
90418,190,100,40,80,160,0,570
90419,190,160,120,160,320,0,950
90420,210,200,80,80,0,0,570
90421,230,120,120,80,0,0,550
90422,240,140,120,80,160,0,740
90423,250,80,40,80,160,0,610
90424,200,160,160,80,160,0,760
90425,210,140,40,80,0,0,470
90426,190,140,160,160,160,0,810
90427,210,160,120,240,160,0,890
90428,190,80,40,0,0,0,310
90429,200,120,160,240,160,0,880
90430,180,160,160,160,160,0,820
90431,190,100,80,80,160,320,930
90432,170,100,80,80,160,320,910
90433,210,100,80,160,160,0,710
90434,180,80,120,80,160,0,620
90435,180,120,160,80,160,320,1020
90436,200,40,40,0,0,0,280
90437,230,160,120,80,160,0,750
90438,240,120,120,160,0,0,640
90439,180,100,120,80,160,0,640
90440,190,160,120,160,160,0,790
90441,180,140,40,80,0,0,440
90442,200,120,80,0,0,0,400
90443,170,100,40,0,0,0,310
90444,190,140,120,160,160,320,1090
90445,220,160,160,80,160,0,780
90446,240,180,200,80,0,0,700
90447,160,120,120,160,160,0,720
90448,190,160,120,80,0,0,550
90449,190,140,40,0,0,0,370
90450,190,100,80,0,0,0,370
90451,170,160,120,160,0,0,610
90452,210,120,80,80,160,0,650
90453,220,100,120,80,0,0,520
90454,200,140,120,160,320,320,1260
90455,170,120,120,80,160,0,650
90456,220,80,120,240,0,0,660
90457,210,180,120,160,320,0,990
90458,180,160,160,80,160,0,740
90459,210,140,120,80,160,0,710
90460,220,120,120,160,160,0,780
90461,210,140,0,0,0,0,350
90462,210,160,160,160,160,0,850
90463,210,180,200,160,0,0,750
90464,220,120,160,80,0,0,580
90465,160,160,200,160,160,0,840
90466,200,100,120,160,160,0,740
90467,200,160,120,160,0,0,640
90468,180,60,80,160,0,0,480
90469,200,100,120,80,0,0,500
90470,190,100,120,160,160,320,1050
90471,180,80,80,80,0,0,420
90472,200,140,80,80,160,0,660
90473,180,120,80,160,160,0,700
90474,210,140,80,0,0,0,430
90475,210,80,80,160,160,0,690
90476,180,140,160,80,160,0,720
90477,210,160,160,80,0,0,610
90478,200,140,120,160,160,320,1100
90479,160,80,120,240,320,0,920
90480,210,160,200,80,160,0,810
90481,200,60,80,160,160,320,980
90482,200,140,120,160,320,320,1260
90483,190,160,80,80,0,0,510
90484,170,60,0,0,0,0,230
90485,200,180,80,0,0,0,460
90486,200,60,40,80,160,0,540
90487,170,100,120,160,320,0,870
90488,190,60,120,80,0,0,450
90489,230,140,120,80,160,0,730
90490,230,180,160,240,160,0,970
90491,180,160,80,0,0,0,420
90492,190,140,120,0,0,0,450
90493,200,140,40,80,160,320,940
90494,220,140,120,160,160,0,800
90495,190,100,160,160,320,0,930
90496,210,140,40,80,160,0,630
90497,200,140,120,80,160,320,1020
90498,200,180,80,80,160,320,1020
90499,200,140,80,80,160,0,660
90500,200,100,80,0,0,0,380
90501,190,80,120,160,160,0,710
90502,240,160,200,160,160,0,920
90503,220,120,120,160,320,0,940
90504,210,60,40,0,0,0,310
90505,220,140,120,0,0,0,480
90506,210,100,40,80,0,0,430
90507,170,140,120,0,0,0,430
90508,200,140,80,80,0,0,500
90509,190,80,80,80,160,0,590
90510,170,60,80,160,320,0,790
90511,240,220,160,160,160,0,940
90512,170,120,40,80,0,0,410
90513,200,120,120,160,160,320,1080
90514,220,160,120,160,320,320,1300
90515,230,120,160,160,160,320,1150
90516,210,160,80,80,160,0,690
90517,200,80,120,80,160,0,640
90518,210,120,120,160,320,0,930
90519,180,100,80,80,160,320,920
90520,160,80,120,160,320,0,840
90521,220,100,40,0,0,0,360
90522,170,100,160,80,0,0,510
90523,200,120,80,0,0,0,400
90524,210,80,120,160,320,0,890
90525,230,100,120,80,0,0,530
90526,160,80,80,80,160,0,560
90527,190,100,40,0,0,0,330
90528,250,180,120,160,160,0,870
90529,200,160,80,160,160,320,1080
90530,170,80,160,240,160,0,810
90531,180,60,40,80,0,0,360
90532,180,140,160,80,0,0,560
90533,160,120,160,240,320,320,1320
90534,160,80,120,0,0,0,360
90535,190,120,200,160,160,0,830
90536,140,120,160,240,160,0,820
90537,180,100,40,0,0,0,320
90538,170,140,160,80,160,320,1030
90539,190,60,80,160,320,0,810
90540,190,120,120,80,0,0,510
90541,200,180,160,160,160,0,860
90542,240,160,80,80,0,0,560
90543,200,160,120,80,0,0,560
90544,230,120,80,160,320,320,1230
90545,210,60,40,80,160,0,550
90546,230,80,120,80,0,0,510
90547,240,160,160,160,0,0,720
90548,180,140,200,160,0,0,680
90549,180,140,120,80,160,320,1000
90550,220,140,40,0,0,0,400
90551,210,180,120,80,160,0,750
90552,260,140,40,80,160,0,680
90553,180,80,40,80,160,0,540
90554,190,100,80,80,0,0,450
90555,150,120,160,240,160,0,830
90556,170,120,120,0,0,0,410
90557,240,140,160,80,160,0,780
90558,200,140,160,240,320,320,1380
90559,210,120,120,80,0,0,530
90560,230,80,0,0,0,0,310
90561,230,140,80,160,0,0,610
90562,230,160,80,80,160,320,1030
90563,190,80,80,80,160,0,590
90564,190,120,120,160,160,320,1070
90565,210,140,160,80,0,0,590
90566,190,100,40,80,160,0,570
90567,220,120,120,160,160,0,780
90568,180,100,120,0,0,0,400
90569,200,120,160,240,320,0,1040
90570,200,80,120,80,0,0,480
90571,180,80,120,240,160,0,780
90572,210,160,80,80,160,0,690
90573,210,140,80,160,160,0,750
90574,220,180,40,0,0,0,440
90575,180,140,120,80,160,0,680
90576,190,120,200,160,160,0,830
90577,180,120,120,160,160,0,740
90578,160,80,120,0,0,0,360
90579,220,140,40,0,0,0,400
90580,210,80,40,80,160,0,570
90581,210,100,120,160,160,0,750
90582,160,120,80,80,160,0,600
90583,190,140,120,80,0,0,530
90584,190,140,120,80,160,0,690
90585,160,100,160,240,160,320,1140
90586,210,160,120,0,0,0,490
90587,170,80,80,80,0,0,410
90588,170,100,120,80,160,0,630
90589,240,160,80,80,160,0,720
90590,210,200,200,160,320,0,1090
90591,200,160,80,80,160,320,1000
90592,200,120,120,80,160,0,680
90593,230,140,80,0,0,0,450
90594,220,80,80,160,160,320,1020
90595,180,80,120,160,160,0,700
90596,170,80,40,0,0,0,290
90597,200,140,40,80,160,320,940
90598,190,160,120,160,320,0,950
90599,200,160,80,80,0,0,520
90600,190,120,40,80,0,0,430
90601,210,140,80,0,0,0,430
90602,190,120,120,160,160,0,750
90603,180,120,80,160,160,0,700
90604,220,140,120,0,0,0,480
90605,180,80,80,80,0,0,420
90606,200,200,240,240,160,0,1040
90607,180,120,160,160,0,0,620
90608,180,100,160,80,160,0,680
90609,140,80,80,80,0,0,380
90610,240,140,120,160,0,0,660
90611,170,120,160,80,160,0,690
90612,220,140,120,240,320,320,1360
90613,210,100,160,160,160,320,1110
90614,190,140,120,80,160,0,690
90615,250,140,160,160,160,0,870
90616,220,140,120,160,320,0,960
90617,210,180,200,240,160,0,990
90618,220,120,120,0,0,0,460
90619,240,180,40,80,0,0,540
90620,160,40,0,0,0,0,200
90621,180,140,80,80,0,0,480
90622,210,160,120,80,0,0,570
90623,210,180,160,80,160,0,790
90624,190,160,160,240,0,0,750
90625,220,140,120,0,0,0,480
90626,180,140,160,160,160,0,800
90627,180,100,160,80,160,0,680
90628,220,160,120,80,160,0,740
90629,200,120,80,80,160,0,640
90630,250,100,40,80,0,0,470
90631,200,180,120,0,0,0,500
90632,210,180,120,160,160,320,1150
90633,200,140,120,80,160,0,700
90634,160,120,120,80,160,0,640
90635,200,140,160,240,320,320,1380
90636,160,100,120,80,160,0,620
90637,200,80,80,0,0,0,360
90638,150,120,120,160,160,0,710
90639,160,140,120,80,0,0,500
90640,210,80,80,80,160,0,610
90641,170,160,160,160,0,0,650
90642,190,120,120,80,0,0,510
90643,160,140,160,160,320,0,940
90644,190,180,120,0,0,0,490
90645,210,160,40,80,160,0,650
90646,190,180,120,80,160,0,730
90647,210,120,80,80,160,0,650
90648,200,160,120,160,320,0,960
90649,230,100,40,80,160,0,610
90650,170,100,40,0,0,0,310
90651,240,180,160,80,160,0,820
90652,220,100,40,80,160,0,600
90653,210,160,120,0,0,0,490
90654,200,100,160,0,0,0,460
90655,170,140,200,240,320,0,1070
90656,200,80,80,80,160,0,600
90657,180,140,160,160,0,0,640
90658,210,80,40,80,160,0,570
90659,210,100,120,80,160,0,670
90660,180,120,120,160,320,320,1220
90661,160,120,80,80,160,0,600
90662,190,160,120,80,160,0,710
90663,190,80,80,80,160,320,910
90664,210,140,160,240,320,0,1070
90665,210,160,160,240,320,0,1090
90666,190,180,160,80,160,0,770
90667,190,40,80,0,0,0,310
90668,170,100,80,160,160,0,670
90669,210,100,80,0,0,0,390
90670,180,140,120,80,160,320,1000
90671,170,100,120,160,160,0,710
90672,200,100,120,80,160,320,980
90673,190,120,160,240,160,0,870
90674,190,160,200,160,320,0,1030
90675,220,140,160,160,160,0,840
90676,240,120,80,80,160,0,680
90677,220,160,40,0,0,0,420
90678,160,80,80,80,160,0,560
90679,220,100,40,80,0,0,440
90680,220,100,80,80,160,0,640
90681,200,120,40,0,0,0,360
90682,200,120,80,160,160,0,720
90683,220,180,40,0,0,0,440
90684,220,120,80,80,160,0,660
90685,190,100,80,0,0,0,370
90686,240,120,120,80,0,0,560
90687,190,160,80,80,0,0,510
90688,170,140,160,80,0,0,550
90689,240,160,160,240,320,320,1440
90690,230,100,80,0,0,0,410
90691,200,100,160,160,160,0,780
90692,220,160,120,80,160,0,740
90693,180,120,80,80,160,0,620
90694,220,140,0,0,0,0,360
90695,190,140,80,80,160,0,650
90696,200,120,40,80,160,0,600
90697,170,160,160,240,0,0,730
90698,130,80,80,0,0,0,290
90699,190,120,120,80,160,0,670
90700,230,100,80,80,160,0,650
90701,180,100,0,0,0,0,280
90702,220,100,160,80,0,0,560
90703,200,160,120,80,160,0,720
90704,190,100,120,80,160,320,970
90705,140,160,160,80,160,0,700
90706,210,160,160,80,160,320,1090
90707,220,100,40,0,0,0,360
90708,230,120,120,160,320,320,1270
90709,150,120,160,80,0,0,510
90710,190,140,160,80,0,0,570
90711,160,140,80,80,0,0,460
90712,190,100,80,80,0,0,450
90713,170,80,120,160,160,0,690
90714,180,120,120,160,160,320,1060
90715,170,160,80,80,160,0,650
90716,190,160,120,80,0,0,550
90717,160,100,120,160,160,0,700
90718,200,100,40,80,0,0,420
90719,210,100,0,0,0,0,310
90720,210,140,80,0,0,0,430
90721,180,100,0,0,0,0,280
90722,190,160,80,80,160,0,670
90723,210,120,80,0,0,0,410
90724,150,120,80,80,160,320,910
90725,190,120,120,80,160,0,670
90726,190,160,120,160,160,0,790
90727,170,60,0,0,0,0,230
90728,170,120,120,240,320,0,970
90729,200,180,200,240,160,0,980
90730,190,140,160,160,160,0,810
90731,170,80,80,0,0,0,330
90732,200,120,120,80,160,320,1000
90733,180,100,40,80,160,0,560
90734,190,140,160,80,160,320,1050
90735,240,100,80,80,0,0,500
90736,190,120,120,160,160,0,750
90737,200,120,80,160,320,0,880
90738,210,60,0,0,0,0,270
90739,160,140,80,160,0,0,540
90740,200,140,80,80,0,0,500
90741,200,140,80,80,160,0,660
90742,210,140,80,160,160,320,1070
90743,190,180,160,80,160,0,770
90744,220,100,160,80,160,0,720
90745,170,140,160,160,0,0,630
90746,180,140,160,0,0,0,480
90747,190,140,80,80,160,0,650
90748,190,120,80,80,0,0,470
90749,180,120,160,80,160,0,700
90750,230,140,160,160,0,0,690
90751,250,120,80,80,0,0,530
90752,160,120,160,160,160,320,1080
90753,200,100,160,160,160,0,780
90754,200,80,80,80,160,320,920
90755,240,160,120,160,160,320,1160
90756,220,60,80,80,160,0,600
90757,210,120,160,160,0,0,650
90758,230,140,80,0,0,0,450
90759,190,80,120,160,160,320,1030
90760,230,120,120,80,160,320,1030
90761,200,120,160,240,320,0,1040
90762,190,180,80,0,0,0,450
90763,200,140,120,80,160,0,700
90764,210,120,120,80,0,0,530
90765,150,100,40,80,160,0,530
90766,210,100,120,80,0,0,510
90767,250,160,80,160,320,320,1290
90768,200,120,160,160,160,0,800
90769,250,200,120,160,160,0,890
90770,190,100,80,0,0,0,370
90771,210,80,120,240,160,0,810
90772,200,160,120,80,0,0,560
90773,160,120,80,80,0,0,440
90774,190,80,120,80,0,0,470
90775,160,120,40,80,0,0,400
90776,220,140,160,160,320,320,1320
90777,160,120,160,80,160,0,680
90778,220,100,120,0,0,0,440
90779,180,100,80,160,0,0,520
90780,240,180,160,240,160,0,980
90781,190,100,80,160,0,0,530
90782,180,80,160,80,160,0,660
90783,180,120,80,80,160,320,940
90784,190,100,40,80,160,0,570
90785,230,140,120,160,160,0,810
90786,190,140,200,160,0,0,690
90787,170,100,80,160,320,320,1150
90788,210,120,80,80,160,0,650
90789,220,100,120,80,160,0,680
90790,170,140,200,0,0,0,510
90791,170,120,80,160,320,0,850
90792,150,140,80,80,160,320,930
90793,180,100,120,160,320,0,880
90794,230,100,120,240,320,0,1010
90795,170,120,200,80,160,0,730
90796,180,60,80,160,160,0,640
90797,170,140,120,80,0,0,510
90798,180,100,80,80,0,0,440
90799,220,80,120,160,160,0,740
90800,200,200,160,160,320,320,1360
90801,200,80,40,0,0,0,320
90802,180,120,80,80,160,0,620
90803,200,120,160,160,0,0,640
90804,200,120,120,160,320,0,920
90805,200,100,120,160,0,0,580
90806,210,140,40,0,0,0,390
90807,200,100,160,80,160,0,700
90808,190,140,120,80,160,0,690
90809,170,120,0,0,0,0,290
90810,190,100,40,80,160,0,570
90811,190,120,120,160,160,320,1070
90812,170,60,80,160,160,0,630
90813,170,80,40,80,160,0,530
90814,160,60,40,80,160,320,820
90815,220,160,160,240,0,0,780
90816,210,180,120,80,0,0,590
90817,170,160,160,240,160,0,890
90818,200,140,40,80,0,0,460
90819,170,120,120,80,0,0,490
90820,140,120,120,80,0,0,460
90821,240,140,160,0,0,0,540
90822,170,80,80,80,0,0,410
90823,220,100,160,240,160,0,880
90824,180,120,80,0,0,0,380
90825,240,180,120,80,0,0,620
90826,200,120,120,160,320,320,1240
90827,190,140,160,240,320,320,1370
90828,220,140,120,160,0,0,640
90829,220,140,80,160,320,320,1240
90830,220,180,40,0,0,0,440
90831,190,200,200,160,0,0,750
90832,200,160,160,240,320,0,1080
90833,200,140,120,80,0,0,540
90834,230,140,120,0,0,0,490
90835,200,140,120,160,320,0,940
90836,190,100,160,160,320,320,1250
90837,180,140,200,160,160,0,840
90838,180,100,120,160,160,0,720
90839,180,120,160,160,320,320,1260
90840,210,180,160,160,160,0,870
90841,180,80,40,0,0,0,300
90842,210,140,80,80,160,0,670
90843,210,140,200,80,160,320,1110
90844,190,160,160,80,160,0,750
90845,200,120,80,80,0,0,480
90846,220,120,80,0,0,0,420
90847,150,60,80,80,160,0,530
90848,200,120,120,80,160,0,680
90849,170,100,120,240,160,0,790
90850,210,120,120,80,160,0,690
90851,170,120,120,80,160,320,970
90852,200,100,80,160,320,0,860
90853,200,120,120,160,160,0,760
90854,210,120,80,80,0,0,490
90855,210,120,80,160,0,0,570
90856,210,120,120,80,0,0,530
90857,140,100,120,80,160,320,920
90858,240,180,200,80,160,320,1180
90859,220,100,80,0,0,0,400
90860,190,140,80,80,0,0,490
90861,200,140,80,160,160,0,740
90862,190,120,40,80,160,0,590
90863,260,140,40,0,0,0,440
90864,180,100,80,0,0,0,360
90865,190,100,80,80,160,0,610
90866,190,140,160,160,160,0,810
90867,220,160,160,80,160,0,780
90868,210,100,0,0,0,0,310
90869,190,140,40,80,160,0,610
90870,200,120,120,80,160,0,680
90871,180,60,0,0,0,0,240
90872,170,100,80,0,0,0,350
90873,200,120,160,80,0,0,560
90874,200,140,120,80,160,0,700
90875,220,120,80,80,160,0,660
90876,200,160,80,80,0,0,520
90877,220,120,80,80,0,0,500
90878,230,100,120,160,160,320,1090
90879,190,120,120,160,160,0,750
90880,210,140,120,160,160,0,790
90881,180,80,40,0,0,0,300
90882,220,80,80,0,0,0,380
90883,220,180,200,80,160,0,840
90884,170,160,160,240,160,0,890
90885,180,100,40,0,0,0,320
90886,170,140,160,0,0,0,470
90887,220,100,80,80,0,0,480
90888,210,60,40,0,0,0,310
90889,210,120,80,80,0,0,490
90890,210,120,160,80,160,0,730
90891,200,120,40,80,0,0,440
90892,190,220,200,160,320,320,1410
90893,190,100,120,160,160,0,730
90894,210,140,160,80,160,320,1070
90895,210,80,120,240,320,320,1290
90896,210,120,80,0,0,0,410
90897,210,80,40,0,0,0,330
90898,210,120,120,160,160,0,770
90899,160,120,80,0,0,0,360
90900,220,80,80,160,0,0,540
90901,180,120,160,240,320,0,1020
90902,190,120,80,80,160,0,630
90903,170,100,80,0,0,0,350
90904,240,120,40,0,0,0,400
90905,190,100,120,160,160,0,730
90906,180,80,80,80,0,0,420
90907,250,180,160,160,160,0,910
90908,200,120,80,160,0,0,560
90909,190,120,160,160,160,320,1110
90910,210,200,160,160,320,320,1370
90911,160,120,120,160,160,0,720
90912,220,140,120,160,160,0,800
90913,160,120,80,0,0,0,360
90914,200,160,160,0,0,0,520
90915,160,140,160,80,160,320,1020
90916,200,160,200,160,0,0,720
90917,210,80,120,80,0,0,490
90918,190,120,120,160,0,0,590
90919,230,120,120,160,320,0,950
90920,160,80,40,0,0,0,280
90921,180,140,120,160,0,0,600
90922,210,120,160,80,160,0,730
90923,200,180,200,160,0,0,740
90924,200,120,80,80,160,0,640
90925,200,140,120,160,0,0,620
90926,190,80,40,80,0,0,390
90927,230,140,160,0,0,0,530
90928,160,100,120,160,160,0,700
90929,220,140,80,160,320,320,1240
90930,200,140,120,80,0,0,540
90931,230,160,80,160,160,320,1110
90932,220,120,200,240,320,0,1100
90933,180,120,80,80,160,320,940
90934,200,140,200,160,160,320,1180
90935,170,100,120,80,160,0,630
90936,180,120,120,80,160,0,660
90937,170,100,80,160,160,0,670
90938,220,120,80,160,320,0,900
90939,170,100,80,80,160,0,590
90940,190,120,120,80,0,0,510
90941,170,140,120,160,160,0,750
90942,200,100,120,80,0,0,500
90943,220,140,80,160,160,0,760
90944,180,100,40,0,0,0,320
90945,220,140,160,80,160,320,1080
90946,250,100,120,80,160,0,710
90947,200,160,120,160,160,320,1120
90948,190,100,80,80,0,0,450
90949,210,120,120,160,160,0,770
90950,230,120,40,80,0,0,470
90951,200,180,160,80,160,0,780
90952,250,180,120,80,160,320,1110
90953,230,160,160,240,160,0,950
90954,160,100,120,80,160,0,620
90955,180,120,120,80,160,320,980
90956,180,140,160,160,0,0,640
90957,220,120,80,80,0,0,500
90958,200,160,40,0,0,0,400
90959,170,80,80,80,160,0,570
90960,190,60,40,80,160,0,530
90961,230,100,120,160,320,320,1250
90962,210,120,120,80,0,0,530
90963,220,180,120,160,160,0,840
90964,210,160,120,160,0,0,650
90965,220,120,40,80,160,320,940
90966,210,120,40,0,0,0,370
90967,180,160,80,80,0,0,500
90968,230,180,120,160,160,0,850
90969,220,80,160,160,160,0,780
90970,180,120,200,160,320,320,1300
90971,220,180,120,80,160,320,1080
90972,210,100,80,0,0,0,390
90973,210,100,40,80,0,0,430
90974,210,80,80,80,0,0,450
90975,170,80,80,0,0,0,330
90976,210,100,0,0,0,0,310
90977,160,100,80,80,160,0,580
90978,210,160,120,80,0,0,570
90979,170,100,120,160,320,0,870
90980,220,180,40,0,0,0,440
90981,210,160,120,240,320,320,1370
90982,170,80,160,240,0,0,650
90983,220,140,80,80,160,0,680
90984,210,140,80,0,0,0,430
90985,190,140,120,80,0,0,530
90986,220,120,120,80,0,0,540
90987,190,120,120,80,160,0,670
90988,180,100,40,80,0,0,400
90989,210,60,0,0,0,0,270
90990,200,40,0,0,0,0,240
90991,170,60,80,80,160,0,550
90992,240,200,240,160,160,0,1000
90993,180,100,80,80,160,320,920
90994,170,100,120,160,320,320,1190
90995,180,100,40,80,160,320,880
90996,170,100,80,160,320,0,830
90997,190,140,120,160,320,0,930
90998,210,60,80,0,0,0,350
90999,220,140,200,80,160,0,800
91000,200,100,120,160,0,0,580
91001,220,160,120,80,160,0,740
91002,180,140,120,160,0,0,600
91003,200,120,40,80,160,320,920
91004,200,80,80,0,0,0,360
91005,180,80,80,160,160,0,660
91006,170,120,120,80,160,0,650
91007,180,160,160,160,160,0,820
91008,130,100,120,0,0,0,350
91009,180,100,160,160,320,0,920
91010,220,100,80,0,0,0,400
91011,220,160,80,80,0,0,540
91012,180,100,120,240,0,0,640
91013,200,140,80,80,0,0,500
91014,170,160,160,160,160,0,810
91015,190,140,40,80,160,0,610
91016,200,80,80,160,320,320,1160
91017,170,120,80,160,160,0,690
91018,190,100,40,80,0,0,410
91019,210,60,40,0,0,0,310
91020,200,160,200,160,160,0,880
91021,210,120,120,80,0,0,530
91022,230,100,40,0,0,0,370
91023,210,80,40,80,160,0,570
91024,180,120,80,80,0,0,460
91025,200,120,160,80,160,320,1040
91026,190,160,80,160,160,0,750
91027,230,180,160,80,0,0,650
91028,220,60,40,80,160,0,560
91029,210,100,120,80,160,0,670
91030,180,140,120,160,320,0,920
91031,210,100,120,80,160,0,670
91032,180,120,160,80,0,0,540
91033,180,120,40,80,160,0,580
91034,190,80,80,80,160,0,590
91035,210,80,40,0,0,0,330
91036,230,140,120,160,160,0,810
91037,220,100,0,0,0,0,320
91038,160,80,80,0,0,0,320
91039,140,100,120,80,160,0,600
91040,170,160,120,80,160,0,690
91041,210,120,120,80,160,0,690
91042,190,160,160,80,160,0,750
91043,180,60,80,0,0,0,320
91044,140,100,160,80,160,0,640
91045,190,140,120,160,160,0,770
91046,210,80,80,80,0,0,450
91047,240,160,40,0,0,0,440
91048,210,180,80,80,160,0,710
91049,200,200,160,160,160,0,880
91050,180,120,160,80,160,0,700
91051,200,140,120,0,0,0,460
91052,220,120,160,80,160,320,1060
91053,180,120,160,160,160,0,780
91054,170,200,120,80,160,320,1050
91055,190,80,80,80,160,0,590
91056,200,100,80,80,160,0,620
91057,140,120,160,240,320,0,980
91058,190,120,160,160,160,320,1110
91059,180,120,160,160,160,0,780
91060,170,80,80,80,160,0,570
91061,200,140,80,80,0,0,500
91062,190,140,40,80,160,320,930
91063,170,100,120,80,160,0,630
91064,180,120,200,80,160,0,740
91065,180,40,80,80,160,0,540
91066,170,120,120,160,160,0,730
91067,190,140,120,160,320,320,1250
91068,180,140,160,160,160,320,1120
91069,170,160,120,160,320,0,930
91070,180,120,160,160,320,320,1260
91071,170,140,120,160,0,0,590
91072,170,80,40,80,160,0,530
91073,200,120,120,0,0,0,440
91074,170,100,80,80,160,0,590
91075,170,160,200,160,160,0,850
91076,200,140,80,80,0,0,500
91077,180,100,80,80,160,0,600
91078,200,140,120,160,0,0,620
91079,180,180,160,160,320,0,1000
91080,180,140,80,0,0,0,400
91081,200,80,120,80,0,0,480
91082,220,160,120,160,160,0,820
91083,190,140,120,0,0,0,450
91084,230,120,40,80,160,320,950
91085,210,140,120,160,320,0,950
91086,170,100,40,80,0,0,390
91087,210,120,120,80,160,0,690
91088,180,160,120,0,0,0,460
91089,210,120,160,80,160,0,730
91090,180,100,40,0,0,0,320
91091,190,120,160,80,160,0,710
91092,210,200,120,160,160,0,850
91093,190,80,80,160,160,0,670
91094,200,100,80,80,160,0,620
91095,190,160,120,80,0,0,550
91096,180,80,80,0,0,0,340
91097,150,120,40,80,160,0,550
91098,210,120,120,160,320,320,1250
91099,150,80,80,80,0,0,390
91100,200,100,40,0,0,0,340
91101,210,100,80,80,160,320,950
91102,200,140,80,80,160,320,980
91103,220,100,120,240,160,0,840
91104,200,120,160,160,0,0,640
91105,200,180,160,160,160,0,860
91106,230,160,80,160,0,0,630
91107,200,100,80,80,0,0,460
91108,180,80,120,80,160,320,940
91109,160,120,120,160,160,0,720
91110,170,80,40,0,0,0,290
91111,200,100,80,0,0,0,380
91112,210,160,120,0,0,0,490
91113,240,140,160,80,160,0,780
91114,200,120,160,160,160,0,800
91115,170,140,80,80,160,0,630
91116,150,100,80,80,160,0,570
91117,170,80,40,0,0,0,290
91118,200,160,160,80,0,0,600
91119,210,120,160,160,160,320,1130
91120,180,160,120,80,0,0,540
91121,170,120,80,0,0,0,370
91122,220,160,160,160,0,0,700
91123,230,140,160,160,160,0,850
91124,210,100,40,0,0,0,350
91125,180,80,80,80,0,0,420
91126,210,180,160,80,0,0,630
91127,170,140,80,80,160,0,630
91128,190,120,120,0,0,0,430
91129,180,140,0,0,0,0,320
91130,210,140,40,80,160,0,630
91131,220,200,160,80,0,0,660
91132,210,100,80,0,0,0,390
91133,190,80,120,160,320,320,1190
91134,190,100,80,80,160,320,930
91135,220,180,200,160,320,0,1080
91136,220,140,120,160,160,320,1120
91137,200,120,160,240,160,0,880
91138,240,160,160,80,160,320,1120
91139,200,160,120,160,160,0,800
91140,190,160,80,80,160,0,670
91141,210,60,40,80,160,0,550
91142,190,120,80,160,160,0,710
91143,210,120,120,160,320,320,1250
91144,230,160,80,80,160,320,1030
91145,200,120,80,80,0,0,480
91146,170,80,80,80,160,320,890
91147,200,120,160,160,0,0,640
91148,190,100,120,160,160,0,730
91149,180,160,200,160,0,0,700
91150,200,40,80,80,0,0,400
91151,210,160,160,80,160,320,1090
91152,200,140,160,160,0,0,660
91153,200,120,80,80,0,0,480
91154,200,120,160,80,160,320,1040
91155,230,120,120,160,160,0,790
91156,180,180,160,160,160,0,840
91157,160,160,160,240,160,320,1200
91158,190,100,80,0,0,0,370
91159,200,180,160,160,160,0,860
91160,190,160,120,160,0,0,630
91161,210,120,160,160,320,0,970
91162,180,120,120,160,320,0,900
91163,190,120,120,80,160,320,990
91164,200,120,80,80,0,0,480
91165,210,120,120,160,160,320,1090
91166,240,160,40,80,160,0,680
91167,200,140,120,80,0,0,540
91168,190,100,80,80,160,0,610
91169,160,140,160,240,160,0,860
91170,220,200,120,0,0,0,540
91171,190,120,120,160,0,0,590
91172,190,100,40,80,160,0,570
91173,170,100,80,80,160,0,590
91174,110,100,120,80,160,0,570
91175,170,160,160,160,160,0,810
91176,170,120,120,160,160,320,1050
91177,160,100,80,0,0,0,340
91178,180,100,120,160,160,320,1040
91179,200,100,80,80,160,0,620
91180,190,80,80,80,0,0,430
91181,200,120,40,80,160,0,600
91182,180,80,120,80,0,0,460
91183,210,160,160,80,160,0,770
91184,210,100,80,160,0,0,550
91185,220,160,120,240,320,0,1060
91186,200,140,160,160,320,0,980
91187,220,100,80,80,0,0,480
91188,210,140,160,160,160,0,830
91189,170,100,120,80,0,0,470
91190,220,140,120,80,160,0,720
91191,210,180,120,80,160,0,750
91192,170,120,120,80,160,0,650
91193,150,120,120,80,0,0,470
91194,190,140,200,240,160,0,930
91195,150,80,80,80,0,0,390
91196,190,120,80,160,160,0,710
91197,210,180,160,80,160,320,1110
91198,170,40,0,0,0,0,210
91199,170,140,160,160,160,0,790
91200,220,140,160,160,160,0,840
91201,210,100,120,160,160,0,750
91202,230,100,80,80,160,320,970
91203,200,80,80,80,160,320,920
91204,180,60,0,0,0,0,240
91205,190,80,40,80,160,320,870
91206,200,100,120,160,160,0,740
91207,210,120,120,160,160,0,770
91208,230,120,120,80,0,0,550
91209,220,160,160,160,160,0,860
91210,170,60,40,80,160,0,510
91211,230,80,120,160,0,0,590
91212,180,100,120,160,160,0,720
91213,180,140,160,160,160,0,800
91214,170,140,80,0,0,0,390
91215,200,160,120,160,160,0,800
91216,180,160,160,80,160,0,740
91217,180,120,160,80,160,320,1020
91218,220,100,40,80,160,0,600
91219,190,120,80,80,160,0,630
91220,210,200,160,240,160,320,1290
91221,180,60,120,80,160,0,600
91222,180,100,120,80,160,0,640
91223,180,80,80,80,160,320,900
91224,210,120,40,80,160,0,610
91225,210,120,120,80,0,0,530
91226,180,80,120,80,160,320,940
91227,220,100,40,0,0,0,360
91228,190,120,80,80,0,0,470
91229,200,80,80,80,160,0,600
91230,180,120,80,80,0,0,460
91231,170,100,80,0,0,0,350
91232,190,100,40,0,0,0,330
91233,210,100,80,0,0,0,390
91234,230,120,40,80,160,0,630
91235,210,160,120,160,160,0,810
91236,210,160,120,80,160,0,730
91237,230,100,80,160,0,0,570
91238,180,20,40,0,0,0,240
91239,190,100,160,240,160,0,850
91240,190,120,120,160,320,0,910
91241,210,100,80,80,160,0,630
91242,170,160,120,80,0,0,530
91243,180,140,120,160,320,320,1240
91244,210,120,120,80,0,0,530
91245,230,160,200,240,160,0,990
91246,190,60,80,80,160,0,570
91247,210,180,120,160,0,0,670
91248,240,80,0,0,0,0,320
91249,180,80,40,80,0,0,380
91250,210,160,40,80,160,0,650
91251,150,60,40,80,0,0,330
91252,210,80,40,80,160,0,570
91253,180,160,160,160,160,0,820
91254,180,140,120,80,160,0,680
91255,160,180,200,80,0,0,620
91256,170,100,80,80,160,0,590
91257,220,160,120,80,160,0,740
91258,180,60,80,0,0,0,320
91259,210,180,160,160,0,0,710
91260,210,160,160,160,160,320,1170
91261,170,180,120,80,0,0,550
91262,190,120,120,0,0,0,430
91263,200,80,80,80,0,0,440
91264,170,120,120,160,160,0,730
91265,180,120,160,240,0,0,700
91266,230,160,120,160,320,0,990
91267,180,80,120,160,320,0,860
91268,200,120,80,0,0,0,400
91269,250,160,80,0,0,0,490
91270,140,100,40,80,0,0,360
91271,200,100,40,80,160,0,580
91272,190,120,120,160,160,0,750
91273,200,120,80,0,0,0,400
91274,190,140,40,0,0,0,370
91275,170,160,120,80,160,320,1010
91276,210,200,120,160,160,0,850
91277,160,100,80,0,0,0,340
91278,180,120,120,0,0,0,420
91279,160,40,40,0,0,0,240
91280,210,200,160,240,160,0,970
91281,190,140,80,0,0,0,410
91282,180,120,160,240,160,0,860
91283,190,140,40,0,0,0,370
91284,190,60,40,80,160,0,530
91285,210,100,80,0,0,0,390
91286,210,120,120,240,160,0,850
91287,160,120,120,80,0,0,480
91288,170,120,120,160,320,0,890
91289,220,100,120,80,0,0,520
91290,190,120,80,0,0,0,390
91291,210,120,80,80,160,0,650
91292,210,120,120,80,160,0,690
91293,220,100,80,160,320,0,880
91294,200,60,40,0,0,0,300
91295,160,100,120,240,160,0,780
91296,170,60,40,80,0,0,350
91297,150,140,80,160,160,0,690
91298,200,160,120,160,320,0,960
91299,190,120,120,160,160,320,1070
91300,180,120,80,160,320,0,860
91301,220,100,80,80,160,0,640
91302,210,160,80,0,0,0,450
91303,170,120,160,160,320,0,930
91304,200,140,160,160,160,0,820
91305,170,100,40,80,160,320,870
91306,200,120,40,0,0,0,360
91307,200,140,120,160,320,0,940
91308,200,120,80,80,0,0,480
91309,210,120,80,160,160,0,730
91310,180,100,120,160,160,0,720
91311,210,100,120,160,160,0,750
91312,210,80,80,80,160,0,610
91313,200,120,120,160,320,320,1240
91314,190,80,40,0,0,0,310
91315,150,140,120,80,0,0,490
91316,170,60,120,160,320,320,1150
91317,230,140,80,0,0,0,450
91318,210,60,80,0,0,0,350
91319,220,140,120,80,0,0,560
91320,200,180,200,80,160,0,820
91321,190,100,80,160,160,0,690
91322,180,100,40,0,0,0,320
91323,160,80,120,160,160,320,1000
91324,190,100,120,80,160,0,650
91325,220,140,80,0,0,0,440
91326,180,120,0,0,0,0,300
91327,210,120,80,0,0,0,410
91328,220,120,80,0,0,0,420
91329,180,100,80,160,160,0,680
91330,160,80,40,80,160,0,520
91331,220,140,80,0,0,0,440
91332,210,120,160,240,320,0,1050
91333,190,80,40,80,0,0,390
91334,180,140,120,160,160,0,760
91335,190,100,40,0,0,0,330
91336,180,120,80,80,160,0,620
91337,200,80,80,80,160,320,920
91338,180,120,120,160,320,320,1220
91339,180,160,120,160,320,0,940
91340,180,120,120,80,160,320,980
91341,170,120,160,80,160,0,690
91342,150,140,120,160,0,0,570
91343,210,140,120,160,160,0,790
91344,210,140,80,160,160,0,750
91345,190,140,80,0,0,0,410
91346,200,180,160,80,160,0,780
91347,210,160,40,80,0,0,490
91348,180,80,40,80,160,0,540
91349,200,120,120,80,160,0,680
91350,230,40,40,80,160,0,550
91351,230,100,80,80,160,320,970
91352,160,140,80,80,160,0,620
91353,250,100,40,80,160,0,630
91354,190,60,40,0,0,0,290
91355,180,100,120,160,0,0,560
91356,190,160,120,0,0,0,470
91357,220,100,120,160,320,320,1240
91358,240,140,120,160,160,0,820
91359,150,140,160,160,320,320,1250
91360,220,200,160,160,160,0,900
91361,230,80,80,80,0,0,470
91362,180,100,40,80,0,0,400
91363,190,120,120,80,160,0,670
91364,220,180,120,160,160,0,840
91365,190,120,80,80,0,0,470
91366,160,80,120,80,160,320,920
91367,230,80,80,0,0,0,390
91368,180,160,200,80,160,320,1100
91369,220,100,120,80,160,0,680
91370,190,140,80,80,0,0,490
91371,240,140,120,160,160,0,820
91372,200,120,80,160,160,0,720
91373,190,140,120,80,160,0,690
91374,180,140,160,80,0,0,560
91375,220,160,120,80,0,0,580
91376,200,100,120,80,0,0,500
91377,190,100,120,160,320,320,1210
91378,170,100,80,160,320,0,830
91379,160,120,80,80,0,0,440
91380,220,140,80,0,0,0,440
91381,220,60,80,80,0,0,440
91382,190,120,160,80,160,0,710
91383,170,80,80,80,160,0,570
91384,190,120,200,80,160,0,750
91385,200,80,80,80,0,0,440
91386,230,120,160,0,0,0,510
91387,120,120,40,80,160,320,840
91388,190,160,80,160,160,0,750
91389,200,160,200,160,160,0,880
91390,220,200,160,160,0,0,740
91391,150,80,80,80,160,0,550
91392,180,100,80,160,320,0,840
91393,160,140,40,0,0,0,340
91394,180,80,120,160,0,0,540
91395,220,180,120,160,320,320,1320
91396,200,140,80,80,0,0,500
91397,220,120,80,160,160,320,1060
91398,190,120,120,160,160,0,750
91399,200,140,160,0,0,0,500
91400,190,160,240,160,320,320,1390
91401,180,160,120,80,160,0,700
91402,220,140,80,80,160,0,680
91403,210,120,80,80,0,0,490
91404,150,140,160,80,160,0,690
91405,170,80,80,80,160,0,570
91406,150,140,120,80,0,0,490
91407,200,140,0,0,0,0,340
91408,200,120,160,240,160,320,1200
91409,220,100,120,80,0,0,520
91410,200,100,80,80,160,0,620
91411,190,100,120,80,160,0,650
91412,180,120,40,0,0,0,340
91413,220,100,80,0,0,0,400
91414,230,140,120,80,160,0,730
91415,190,140,200,160,320,0,1010
91416,200,160,120,80,160,0,720
91417,170,100,40,0,0,0,310
91418,180,140,200,0,0,0,520
91419,190,160,40,0,0,0,390
91420,150,120,120,80,160,0,630
91421,220,100,80,80,0,0,480
91422,150,100,120,160,160,0,690
91423,200,140,80,160,160,0,740
91424,190,140,200,240,160,0,930
91425,240,100,80,80,160,0,660
91426,200,120,80,0,0,0,400
91427,210,60,80,80,160,0,590
91428,220,120,160,160,160,0,820
91429,150,40,80,160,0,0,430
91430,210,120,80,80,160,0,650
91431,210,120,120,160,160,0,770
91432,230,100,40,80,160,320,930
91433,210,140,160,160,0,0,670
91434,190,100,80,80,160,0,610
91435,160,140,120,80,0,0,500
91436,200,60,120,160,320,0,860
91437,190,100,160,160,320,0,930
91438,220,160,160,160,320,0,1020
91439,240,140,80,80,160,320,1020
91440,170,100,80,0,0,0,350
91441,200,160,160,80,160,320,1080
91442,150,140,120,160,320,0,890
91443,210,120,120,0,0,0,450
91444,240,140,80,80,0,0,540
91445,240,160,160,80,0,0,640
91446,180,100,120,80,160,0,640
91447,190,80,80,80,0,0,430
91448,180,120,120,80,160,0,660
91449,250,160,200,240,320,0,1170
91450,200,160,40,0,0,0,400
91451,190,200,160,160,160,0,870
91452,180,160,120,0,0,0,460
91453,170,120,80,80,160,320,930
91454,180,100,120,80,160,0,640
91455,180,40,80,80,160,0,540
91456,180,160,80,80,0,0,500
91457,200,80,40,80,0,0,400
91458,180,100,80,80,160,0,600
91459,220,140,80,0,0,0,440
91460,210,160,160,160,160,0,850
91461,210,120,40,80,160,0,610
91462,170,120,120,80,160,0,650
91463,150,80,120,80,0,0,430
91464,180,120,160,240,160,0,860
91465,180,80,80,80,160,0,580
91466,200,80,80,80,0,0,440
91467,190,180,120,80,0,0,570
91468,170,100,80,80,0,0,430
91469,160,80,40,80,160,0,520
91470,210,140,120,160,160,0,790
91471,190,80,80,80,0,0,430
91472,200,120,120,80,160,320,1000
91473,200,160,120,80,160,0,720
91474,210,80,120,160,0,0,570
91475,200,140,80,160,320,0,900
91476,210,160,200,240,320,0,1130
91477,190,80,40,80,0,0,390
91478,190,120,200,160,320,0,990
91479,200,100,80,80,160,0,620
91480,210,60,120,80,0,0,470
91481,180,140,80,80,0,0,480
91482,210,100,80,80,160,0,630
91483,190,100,120,160,0,0,570
91484,200,160,160,160,160,0,840
91485,190,80,40,80,160,0,550
91486,180,120,80,80,0,0,460
91487,220,160,80,80,0,0,540
91488,200,160,120,80,160,320,1040
91489,180,140,160,240,160,0,880
91490,210,80,80,80,160,0,610
91491,200,120,120,160,320,0,920
91492,200,140,120,80,160,0,700
91493,150,80,40,0,0,0,270
91494,210,180,200,240,160,320,1310
91495,180,120,160,80,160,0,700
91496,210,80,40,80,160,0,570
91497,200,60,80,160,320,0,820
91498,210,120,120,160,160,320,1090
91499,180,120,120,80,160,0,660
91500,170,140,120,80,0,0,510
91501,170,100,80,160,320,320,1150
91502,180,160,200,0,0,0,540
91503,230,100,80,80,0,0,490
91504,220,160,200,80,0,0,660
91505,200,160,80,160,160,0,760
91506,190,120,120,160,160,0,750
91507,200,180,240,160,160,0,940
91508,200,80,40,0,0,0,320
91509,210,120,120,80,0,0,530
91510,190,100,80,80,160,0,610
91511,190,80,80,0,0,0,350
91512,200,120,80,80,0,0,480
91513,190,140,80,80,160,0,650
91514,210,120,160,160,160,0,810
91515,230,100,40,80,160,0,610
91516,190,100,80,160,160,0,690
91517,230,160,120,0,0,0,510
91518,210,80,80,80,0,0,450
91519,220,160,120,80,0,0,580
91520,220,100,40,80,0,0,440
91521,190,160,160,80,160,0,750
91522,210,120,120,0,0,0,450
91523,210,140,80,80,160,0,670
91524,190,100,40,0,0,0,330
91525,200,80,80,80,160,0,600
91526,210,140,120,0,0,0,470
91527,220,100,80,0,0,0,400
91528,170,100,40,80,0,0,390
91529,160,180,160,160,320,0,980
91530,240,140,160,160,0,0,700
91531,130,80,120,160,160,0,650
91532,240,200,200,80,0,0,720
91533,210,140,120,0,0,0,470
91534,200,140,80,80,160,0,660
91535,170,120,80,80,0,0,450
91536,190,120,160,80,160,0,710
91537,180,100,120,80,0,0,480
91538,210,140,80,0,0,0,430
91539,210,120,160,80,160,0,730
91540,210,120,120,160,160,0,770
91541,170,80,40,80,0,0,370
91542,210,100,0,0,0,0,310
91543,180,160,160,0,0,0,500
91544,130,80,80,160,160,0,610
91545,190,120,160,80,0,0,550
91546,170,160,160,240,320,320,1370
91547,220,140,120,80,0,0,560
91548,230,100,120,80,160,0,690
91549,220,120,80,80,160,320,980
91550,190,160,240,160,160,0,910
91551,180,140,120,160,160,0,760
91552,190,120,80,160,160,0,710
91553,230,160,160,160,160,0,870
91554,210,140,160,80,0,0,590
91555,220,140,160,240,160,0,920
91556,180,100,80,80,160,0,600
91557,220,160,160,160,320,0,1020
91558,200,100,80,160,160,0,700
91559,200,100,120,160,160,0,740
91560,210,80,80,160,0,0,530
91561,200,200,120,160,160,0,840
91562,190,200,200,160,0,0,750
91563,170,100,80,80,0,0,430
91564,190,100,80,80,0,0,450
91565,210,100,40,0,0,0,350
91566,180,160,120,160,160,0,780
91567,200,60,40,80,160,0,540
91568,210,60,40,80,0,0,390
91569,270,180,80,160,160,0,850
91570,140,40,0,0,0,0,180
91571,200,80,40,0,0,0,320
91572,160,160,120,160,320,320,1240
91573,210,120,120,160,160,0,770
91574,190,100,120,0,0,0,410
91575,200,180,240,160,160,0,940
91576,190,120,40,0,0,0,350
91577,210,100,80,80,0,0,470
91578,250,220,120,160,160,0,910
91579,210,100,120,240,0,0,670
91580,230,140,160,160,160,0,850
91581,190,120,120,80,0,0,510
91582,200,60,40,80,160,0,540
91583,170,80,40,0,0,0,290
91584,210,160,120,80,160,0,730
91585,190,60,80,160,320,0,810
91586,200,120,80,80,160,0,640
91587,200,100,120,160,320,0,900
91588,180,100,80,80,160,0,600
91589,200,100,120,160,160,0,740
91590,200,100,120,80,160,0,660
91591,210,180,120,80,160,320,1070
91592,210,140,80,80,0,0,510
91593,210,140,160,240,160,0,910
91594,190,120,120,80,0,0,510
91595,190,100,120,240,160,0,810
91596,200,80,80,80,0,0,440
91597,180,80,80,0,0,0,340
91598,170,120,160,160,160,320,1090
91599,250,160,200,80,160,0,850
91600,180,80,80,160,320,0,820
91601,180,180,200,80,0,0,640
91602,200,100,40,0,0,0,340
91603,220,120,80,80,0,0,500
91604,190,80,0,0,0,0,270
91605,210,140,120,80,160,0,710
91606,220,160,80,80,0,0,540
91607,180,100,80,0,0,0,360
91608,160,120,160,80,160,0,680
91609,190,160,160,80,160,0,750
91610,180,80,80,80,0,0,420
91611,210,180,200,160,320,320,1390
91612,220,140,80,0,0,0,440
91613,210,160,120,160,160,0,810
91614,200,80,80,80,160,320,920
91615,170,120,120,80,160,0,650
91616,200,160,80,80,0,0,520
91617,190,80,40,80,160,320,870
91618,220,180,160,240,320,0,1120
91619,190,120,160,0,0,0,470
91620,220,160,80,80,160,0,700
91621,190,140,80,0,0,0,410
91622,150,140,120,80,160,0,650
91623,210,120,80,0,0,0,410
91624,200,180,80,80,0,0,540
91625,180,140,80,80,0,0,480
91626,240,80,80,80,0,0,480
91627,210,60,80,80,160,0,590
91628,210,120,40,0,0,0,370
91629,160,100,120,160,160,0,700
91630,240,100,120,80,0,0,540
91631,190,140,120,80,160,0,690
91632,220,160,160,80,0,0,620
91633,200,120,80,0,0,0,400
91634,160,100,40,0,0,0,300
91635,220,140,200,160,0,0,720
91636,220,80,40,80,160,0,580
91637,150,120,40,80,0,0,390
91638,190,100,120,160,160,0,730
91639,190,140,80,80,160,0,650
91640,250,140,200,240,160,320,1310
91641,150,120,40,0,0,0,310
91642,200,100,160,160,160,0,780
91643,210,160,120,80,160,0,730
91644,190,100,120,0,0,0,410
91645,220,140,120,80,160,320,1040
91646,190,100,200,80,0,0,570
91647,200,100,120,240,160,0,820
91648,200,100,160,80,160,0,700
91649,200,140,80,0,0,0,420
91650,160,80,160,80,160,320,960
91651,230,100,40,80,160,0,610
91652,200,100,40,80,160,0,580
91653,230,100,40,0,0,0,370
91654,220,140,160,160,320,0,1000
91655,190,140,200,240,320,0,1090
91656,210,100,80,0,0,0,390
91657,200,80,120,80,0,0,480
91658,190,100,120,160,320,320,1210
91659,180,120,80,80,160,0,620
91660,190,160,160,80,0,0,590
91661,170,100,80,80,160,0,590
91662,180,100,40,80,0,0,400
91663,200,140,120,0,0,0,460
91664,250,140,120,160,0,0,670
91665,180,100,80,80,0,0,440
91666,200,80,80,80,160,0,600
91667,190,140,200,160,160,320,1170
91668,180,80,40,80,0,0,380
91669,200,80,40,0,0,0,320
91670,170,80,120,80,160,0,610
91671,230,160,240,160,160,320,1270
91672,170,120,80,80,160,0,610
91673,210,120,120,160,160,0,770
91674,200,80,80,160,160,0,680
91675,200,140,80,80,0,0,500
91676,200,100,120,160,160,320,1060
91677,220,140,120,160,160,0,800
91678,220,140,160,160,0,0,680
91679,170,120,160,160,320,320,1250
91680,170,160,160,80,160,320,1050
91681,150,100,120,240,160,0,770
91682,230,160,80,160,160,0,790
91683,210,40,80,0,0,0,330
91684,240,100,80,80,0,0,500
91685,200,140,80,0,0,0,420
91686,230,180,240,80,160,0,890
91687,220,100,40,0,0,0,360
91688,160,100,80,80,0,0,420
91689,160,140,160,240,320,0,1020
91690,220,160,80,80,0,0,540
91691,240,120,80,0,0,0,440
91692,190,160,160,160,320,320,1310
91693,220,160,160,160,160,0,860
91694,200,140,120,80,160,0,700
91695,190,100,80,0,0,0,370
91696,210,140,160,160,320,0,990
91697,200,120,120,160,160,0,760
91698,220,180,80,80,0,0,560
91699,190,100,80,160,320,0,850
91700,240,180,160,80,0,0,660
91701,220,80,40,80,0,0,420
91702,240,160,80,0,0,0,480
91703,220,120,120,160,320,0,940
91704,170,140,80,80,160,0,630
91705,190,120,120,0,0,0,430
91706,190,140,160,240,0,0,730
91707,190,180,120,240,160,0,890
91708,220,120,80,160,160,0,740
91709,190,120,80,160,0,0,550
91710,210,120,120,0,0,0,450
91711,170,100,80,160,320,0,830
91712,170,100,120,80,0,0,470
91713,190,100,40,80,160,0,570
91714,170,60,40,80,0,0,350
91715,230,160,120,80,160,0,750
91716,160,140,80,80,160,0,620
91717,190,140,160,0,0,0,490
91718,210,180,40,80,160,320,990
91719,190,120,120,0,0,0,430
91720,230,160,200,80,160,320,1150
91721,190,120,160,80,160,0,710
91722,190,80,160,240,160,0,830
91723,220,180,200,160,160,320,1240
91724,220,160,200,240,160,0,980
91725,180,100,160,160,0,0,600
91726,220,160,120,80,0,0,580
91727,210,140,120,0,0,0,470
91728,220,180,120,240,160,0,920
91729,210,160,80,0,0,0,450
91730,230,160,160,80,160,0,790
91731,200,120,120,160,320,0,920
91732,160,160,120,80,0,0,520
91733,220,120,80,0,0,0,420
91734,210,140,80,160,160,0,750
91735,240,140,120,80,160,0,740
91736,180,100,80,0,0,0,360
91737,210,80,80,160,320,0,850
91738,200,160,160,160,160,0,840
91739,160,120,120,240,320,0,960
91740,170,120,40,80,0,0,410
91741,220,140,160,160,0,0,680
91742,220,80,40,80,160,0,580
91743,150,120,80,160,0,0,510
91744,230,200,160,80,0,0,670
91745,220,180,120,80,160,0,760
91746,200,120,80,80,160,0,640
91747,180,120,120,80,160,0,660
91748,190,140,120,240,320,0,1010
91749,210,120,160,0,0,0,490
91750,250,100,80,80,160,0,670
91751,200,140,120,240,320,0,1020
91752,180,120,40,80,160,0,580
91753,190,80,40,80,160,0,550
91754,150,140,200,160,160,0,810
91755,200,80,40,80,160,0,560
91756,230,160,0,0,0,0,390
91757,200,120,120,80,160,0,680
91758,230,140,80,80,160,0,690
91759,200,120,120,240,320,320,1320
91760,200,120,80,80,0,0,480
91761,180,160,160,160,160,320,1140
91762,160,120,120,160,160,0,720
91763,190,180,120,80,0,0,570
91764,180,100,120,80,160,0,640
91765,190,140,40,0,0,0,370
91766,180,120,160,160,160,320,1100
91767,220,140,120,160,320,0,960
91768,180,100,120,160,0,0,560
91769,190,140,80,80,0,0,490
91770,210,80,120,160,0,0,570
91771,190,100,160,80,160,0,690
91772,230,180,40,80,0,0,530
91773,180,140,80,0,0,0,400
91774,200,160,120,80,160,0,720
91775,190,120,120,80,160,0,670
91776,220,160,160,160,160,0,860
91777,220,60,80,160,160,0,680
91778,170,100,80,0,0,0,350
91779,210,180,240,160,160,0,950
91780,180,100,40,80,160,0,560
91781,230,160,160,0,0,0,550
91782,200,80,80,160,0,0,520
91783,230,120,120,160,160,0,790
91784,200,160,160,160,160,320,1160
91785,190,120,120,80,160,0,670
91786,150,120,120,160,160,0,710
91787,160,40,0,0,0,0,200
91788,200,120,120,80,160,0,680
91789,190,140,200,240,160,0,930
91790,220,100,40,80,160,0,600
91791,220,140,120,160,320,320,1280
91792,210,140,80,80,0,0,510
91793,240,140,120,80,0,0,580
91794,160,140,120,160,160,0,740
91795,190,140,160,240,320,0,1050
91796,190,100,80,160,160,320,1010
91797,160,120,160,80,160,0,680
91798,160,40,40,80,160,0,480
91799,220,160,80,0,0,0,460
91800,190,180,120,160,160,320,1130
91801,220,180,160,160,160,0,880
91802,180,160,160,240,320,0,1060
91803,200,100,80,80,0,0,460
91804,240,160,160,160,0,0,720
91805,180,100,120,240,160,0,800
91806,190,100,80,80,160,320,930
91807,180,120,200,160,160,0,820
91808,200,100,120,80,0,0,500
91809,180,100,80,80,0,0,440
91810,140,100,80,80,0,0,400
91811,200,140,120,160,0,0,620
91812,190,140,120,0,0,0,450
91813,180,180,80,160,160,0,760
91814,200,140,40,0,0,0,380
91815,200,100,80,80,0,0,460
91816,200,140,80,80,160,0,660
91817,220,160,160,160,160,0,860
91818,190,140,40,0,0,0,370
91819,190,80,120,160,320,0,870
91820,190,100,120,160,160,0,730
91821,240,140,120,160,320,0,980
91822,220,160,120,80,160,0,740
91823,210,100,80,80,160,0,630
91824,200,120,80,80,160,0,640
91825,220,120,40,0,0,0,380
91826,200,200,120,160,160,0,840
91827,200,120,120,160,160,320,1080
91828,180,140,160,160,0,0,640
91829,180,120,120,80,0,0,500
91830,170,100,120,160,160,320,1030
91831,180,100,120,160,320,320,1200
91832,230,180,200,160,160,0,930
91833,170,160,120,160,160,320,1090
91834,180,100,120,160,160,0,720
91835,210,140,120,0,0,0,470
91836,180,160,120,160,0,0,620
91837,180,100,120,160,160,320,1040
91838,210,160,160,160,160,0,850
91839,160,100,40,0,0,0,300
91840,170,120,120,80,0,0,490
91841,210,180,120,80,0,0,590
91842,160,80,120,80,160,0,600
91843,170,100,120,160,160,0,710
91844,200,160,120,160,0,0,640
91845,210,80,80,160,320,0,850
91846,210,180,160,80,160,0,790
91847,200,140,120,160,160,0,780
91848,220,140,120,0,0,0,480
91849,210,120,120,160,160,0,770
91850,180,160,160,80,160,0,740
91851,200,100,40,80,160,320,900
91852,220,180,160,160,160,0,880
91853,230,140,160,80,160,0,770
91854,190,100,40,0,0,0,330
91855,200,140,160,80,160,0,740
91856,240,80,80,80,0,0,480
91857,190,120,120,160,160,320,1070
91858,170,140,120,0,0,0,430
91859,130,60,0,0,0,0,190
91860,200,80,80,80,160,320,920
91861,230,180,120,160,0,0,690
91862,150,80,80,80,0,0,390
91863,190,180,80,80,160,320,1010
91864,180,120,160,160,320,0,940
91865,210,140,120,80,160,320,1030
91866,190,140,120,80,0,0,530
91867,190,120,80,160,160,0,710
91868,200,120,160,240,320,320,1360
91869,180,120,80,80,160,320,940
91870,190,180,200,240,320,320,1450
91871,190,180,120,160,320,0,970
91872,200,140,120,240,160,0,860
91873,210,80,80,80,160,0,610
91874,170,100,120,160,160,320,1030
91875,180,120,120,80,0,0,500
91876,210,100,120,80,160,0,670
91877,210,100,160,80,160,0,710
91878,220,140,40,80,160,0,640
91879,200,180,200,240,160,0,980
91880,230,140,80,0,0,0,450
91881,230,140,80,80,0,0,530
91882,210,140,120,0,0,0,470
91883,220,140,120,160,160,0,800
91884,190,80,0,0,0,0,270
91885,200,100,80,160,320,0,860
91886,220,180,120,80,0,0,600
91887,210,160,160,80,160,0,770
91888,200,120,120,80,160,0,680
91889,150,60,80,80,160,320,850
91890,210,100,80,80,160,0,630
91891,190,100,120,240,160,0,810
91892,190,120,120,240,160,0,830
91893,150,100,80,160,320,0,810
91894,210,160,80,80,0,0,530
91895,190,160,120,80,160,0,710
91896,160,100,80,80,160,320,900
91897,220,140,120,80,160,0,720
91898,170,100,80,80,160,320,910
91899,240,180,160,0,0,0,580
91900,220,180,120,80,160,320,1080
91901,220,140,120,80,160,0,720
91902,210,120,120,160,0,0,610
91903,220,120,120,80,160,0,700
91904,220,140,80,0,0,0,440
91905,190,100,120,160,160,0,730
91906,210,200,120,80,160,0,770
91907,170,160,120,160,320,0,930
91908,180,120,160,160,320,0,940
91909,210,80,40,80,160,0,570
91910,160,100,120,160,0,0,540
91911,190,100,120,80,160,320,970
91912,200,160,160,160,0,0,680
91913,200,120,120,160,320,320,1240
91914,210,120,120,160,160,0,770
91915,180,120,120,160,160,0,740
91916,210,140,200,160,0,0,710
91917,210,80,0,0,0,0,290
91918,230,120,40,0,0,0,390
91919,190,60,40,0,0,0,290
91920,220,160,80,80,0,0,540
91921,170,80,120,160,160,0,690
91922,220,160,80,0,0,0,460
91923,210,120,120,80,160,0,690
91924,200,140,40,0,0,0,380
91925,170,140,160,160,160,0,790
91926,210,140,200,80,160,0,790
91927,140,80,80,80,0,0,380
91928,220,100,120,160,320,320,1240
91929,210,160,80,80,160,320,1010
91930,160,80,40,0,0,0,280
91931,160,120,80,80,160,0,600
91932,170,100,80,80,0,0,430
91933,230,140,120,160,320,0,970
91934,200,160,200,240,320,0,1120
91935,200,180,120,80,0,0,580
91936,170,120,80,80,0,0,450
91937,190,120,160,80,160,0,710
91938,160,120,160,80,160,0,680
91939,220,100,120,80,160,0,680
91940,200,140,40,80,160,0,620
91941,200,140,160,160,0,0,660
91942,200,120,120,80,160,320,1000
91943,180,100,120,80,0,0,480
91944,210,140,80,0,0,0,430
91945,150,100,80,80,160,0,570
91946,230,120,80,0,0,0,430
91947,180,140,120,0,0,0,440
91948,160,140,80,80,0,0,460
91949,180,80,40,0,0,0,300
91950,220,100,40,80,0,0,440
91951,160,120,80,0,0,0,360
91952,190,100,0,0,0,0,290
91953,200,140,120,160,160,0,780
91954,170,100,120,0,0,0,390
91955,200,120,160,160,160,0,800
91956,200,80,80,80,0,0,440
91957,210,100,120,0,0,0,430
91958,190,140,80,0,0,0,410
91959,150,120,80,80,0,0,430
91960,200,160,120,160,320,0,960
91961,180,140,160,80,0,0,560
91962,210,140,120,80,160,0,710
91963,190,100,120,0,0,0,410
91964,200,80,120,160,0,0,560
91965,210,180,160,160,160,0,870
91966,250,140,80,80,0,0,550
91967,240,180,40,80,160,320,1020
91968,190,80,40,0,0,0,310
91969,200,100,120,160,160,0,740
91970,180,140,40,0,0,0,360
91971,190,100,80,80,0,0,450
91972,220,160,160,80,160,0,780
91973,180,120,80,160,0,0,540
91974,230,100,80,160,160,0,730
91975,180,120,80,80,160,0,620
91976,220,100,120,80,160,0,680
91977,210,200,120,80,0,0,610
91978,200,80,120,80,160,0,640
91979,160,140,200,160,0,0,660
91980,190,160,120,0,0,0,470
91981,220,160,0,0,0,0,380
91982,230,140,40,0,0,0,410
91983,250,160,160,80,160,0,810
91984,190,120,80,80,0,0,470
91985,230,120,40,0,0,0,390
91986,180,180,160,0,0,0,520
91987,230,80,80,80,0,0,470
91988,180,100,80,80,160,0,600
91989,170,100,80,80,160,320,910
91990,190,120,80,0,0,0,390
91991,210,220,200,160,0,0,790
91992,190,120,120,0,0,0,430
91993,140,100,80,160,320,320,1120
91994,210,140,120,80,0,0,550
91995,210,140,80,160,160,0,750
91996,200,120,120,80,160,0,680
91997,200,100,80,80,0,0,460
91998,200,100,160,160,160,0,780
91999,170,120,40,0,0,0,330
92000,180,100,160,80,0,0,520
92001,170,100,120,160,160,0,710
92002,190,120,120,80,160,0,670
92003,240,60,40,0,0,0,340
92004,180,80,40,80,0,0,380
92005,160,120,80,80,160,0,600
92006,210,60,40,80,160,0,550
92007,170,80,40,80,160,0,530
92008,200,100,80,0,0,0,380
92009,170,120,80,80,160,0,610
92010,170,140,160,160,0,0,630
92011,250,160,120,80,160,0,770
92012,190,120,160,0,0,0,470
92013,170,120,40,0,0,0,330
92014,190,140,80,80,160,0,650
92015,190,80,40,80,0,0,390
92016,240,160,160,80,160,0,800
92017,220,100,80,160,0,0,560
92018,210,100,80,0,0,0,390
92019,190,100,80,160,320,0,850
92020,210,60,0,0,0,0,270
92021,180,100,80,160,160,0,680
92022,210,160,80,80,0,0,530
92023,210,100,80,80,0,0,470
92024,180,100,80,80,160,0,600
92025,160,120,120,80,160,0,640
92026,190,140,160,160,160,0,810
92027,200,140,120,80,160,0,700
92028,190,140,160,240,0,0,730
92029,210,180,160,160,320,320,1350
92030,170,120,40,80,160,0,570
92031,190,100,80,80,0,0,450
92032,190,100,160,240,160,0,850
92033,250,120,120,80,0,0,570
92034,220,140,120,160,160,0,800
92035,220,240,160,80,0,0,700
92036,190,120,80,80,160,0,630
92037,210,160,40,80,160,0,650
92038,190,80,0,0,0,0,270
92039,210,140,120,80,160,0,710
92040,200,100,160,160,320,0,940
92041,190,160,80,0,0,0,430
92042,200,120,40,80,160,0,600
92043,160,120,200,160,320,320,1280
92044,200,140,120,80,0,0,540
92045,180,80,80,0,0,0,340
92046,220,120,160,160,320,0,980
92047,220,180,160,160,0,0,720
92048,200,100,40,80,160,0,580
92049,190,100,120,160,160,320,1050
92050,230,140,120,80,160,0,730
92051,190,120,120,0,0,0,430
92052,190,120,80,160,320,0,870
92053,180,120,120,160,160,0,740
92054,180,100,80,80,160,0,600
92055,160,80,120,80,160,0,600
92056,210,120,120,80,0,0,530
92057,200,200,200,240,320,0,1160
92058,160,160,160,160,0,0,640
92059,180,100,80,80,0,0,440
92060,170,100,80,80,160,320,910
92061,140,140,160,160,160,0,760
92062,240,140,120,160,160,320,1140
92063,200,140,120,80,160,320,1020
92064,210,120,40,0,0,0,370
92065,170,120,120,160,160,0,730
92066,200,140,120,240,160,0,860
92067,170,160,80,80,160,0,650
92068,180,100,40,80,0,0,400
92069,210,80,120,160,320,0,890
92070,170,40,40,80,160,0,490
92071,200,160,120,160,160,0,800
92072,230,100,120,80,160,0,690
92073,230,120,160,80,160,0,750
92074,210,120,80,80,160,0,650
92075,240,160,160,240,160,0,960
92076,170,160,40,0,0,0,370
92077,180,120,120,80,0,0,500
92078,190,140,240,160,160,0,890
92079,180,160,120,160,160,0,780
92080,190,100,40,0,0,0,330
92081,220,140,160,240,160,0,920
92082,190,100,40,0,0,0,330
92083,180,100,80,80,160,0,600
92084,160,100,120,160,160,0,700
92085,210,140,120,80,160,0,710
92086,190,180,240,80,0,0,690
92087,210,60,80,80,160,0,590
92088,160,100,80,0,0,0,340
92089,150,120,120,160,160,320,1030
92090,180,120,120,160,160,0,740
92091,190,140,160,160,160,0,810
92092,180,60,80,80,160,320,880
92093,180,100,40,0,0,0,320
92094,180,120,80,160,320,0,860
92095,230,100,160,0,0,0,490
92096,130,100,80,80,0,0,390
92097,220,100,80,160,160,320,1040
92098,210,120,120,240,160,0,850
92099,180,120,120,160,0,0,580
92100,200,120,40,80,0,0,440
92101,200,120,160,160,320,320,1280
92102,200,100,80,160,0,0,540
92103,170,140,200,160,160,0,830
92104,200,100,80,80,160,0,620
92105,180,160,200,160,160,0,860
92106,140,80,120,160,0,0,500
92107,190,100,40,80,0,0,410
92108,170,100,120,80,160,0,630
92109,220,100,40,0,0,0,360
92110,240,120,120,80,0,0,560
92111,180,80,40,80,160,0,540
92112,190,120,160,160,160,320,1110
92113,190,180,160,240,320,0,1090
92114,150,160,120,80,0,0,510
92115,220,200,120,160,0,0,700
92116,200,180,160,80,160,0,780
92117,220,100,160,240,320,0,1040
92118,200,140,120,80,160,0,700
92119,180,120,120,160,160,0,740
92120,140,120,80,80,160,0,580
92121,170,160,160,160,160,320,1130
92122,260,120,40,0,0,0,420
92123,210,120,40,0,0,0,370
92124,190,140,80,80,0,0,490
92125,170,100,120,0,0,0,390
92126,210,140,120,160,160,0,790
92127,190,60,40,80,0,0,370
92128,180,100,120,0,0,0,400
92129,200,140,40,0,0,0,380
92130,190,120,120,160,160,0,750
92131,190,100,120,160,160,0,730
92132,180,120,120,80,0,0,500
92133,170,120,160,80,0,0,530
92134,160,140,160,80,160,0,700
92135,160,60,40,0,0,0,260
92136,180,120,120,160,160,320,1060
92137,240,140,80,80,0,0,540
92138,210,160,160,160,160,0,850
92139,200,120,160,160,160,0,800
92140,190,160,80,80,0,0,510
92141,180,100,80,0,0,0,360
92142,200,100,120,160,160,320,1060
92143,220,120,80,80,0,0,500
92144,220,120,160,80,160,320,1060
92145,180,140,120,0,0,0,440
92146,170,120,120,160,320,0,890
92147,230,140,80,80,0,0,530
92148,200,140,80,160,320,320,1220
92149,220,120,120,160,320,320,1260
92150,220,180,160,240,160,0,960
92151,170,140,200,240,320,320,1390
92152,220,140,120,240,0,0,720
92153,220,180,160,160,160,0,880
92154,180,140,120,80,160,0,680
92155,190,120,120,160,160,0,750
92156,190,120,160,80,0,0,550
92157,220,180,160,80,0,0,640
92158,220,140,80,80,160,320,1000
92159,180,80,40,80,0,0,380
92160,200,160,200,160,160,0,880
92161,160,100,40,80,0,0,380
92162,230,140,80,80,160,0,690
92163,210,140,80,80,160,0,670
92164,200,100,80,80,0,0,460
92165,220,200,80,80,0,0,580
92166,170,140,120,80,160,0,670
92167,170,80,120,160,320,0,850
92168,160,120,80,80,0,0,440
92169,200,100,80,160,0,0,540
92170,190,80,80,0,0,0,350
92171,220,140,120,160,160,0,800
92172,170,120,120,240,320,0,970
92173,200,120,80,160,160,320,1040
92174,200,120,160,160,160,0,800
92175,190,140,200,0,0,0,530
92176,160,80,120,0,0,0,360
92177,180,120,120,160,160,0,740
92178,200,120,80,0,0,0,400
92179,230,140,120,160,0,0,650
92180,240,140,80,160,320,0,940
92181,220,160,80,160,320,0,940
92182,210,120,80,0,0,0,410
92183,220,180,160,240,160,320,1280
92184,210,120,80,160,160,0,730
92185,220,120,80,80,0,0,500
92186,220,200,80,80,160,320,1060
92187,240,200,160,240,320,320,1480
92188,210,160,120,160,160,0,810
92189,200,100,80,160,160,0,700
92190,170,120,80,0,0,0,370
92191,210,120,160,240,320,0,1050
92192,230,100,80,80,160,0,650
92193,210,120,40,0,0,0,370
92194,180,140,200,80,160,0,760
92195,180,80,80,80,160,0,580
92196,160,120,120,160,0,0,560
92197,190,120,120,240,320,320,1310
92198,150,60,40,0,0,0,250
92199,210,100,160,160,160,0,790
92200,180,100,80,80,160,0,600
92201,160,100,80,80,160,0,580
92202,180,140,120,80,0,0,520
92203,220,120,80,80,160,0,660
92204,190,80,120,0,0,0,390
92205,200,160,120,0,0,0,480
92206,190,160,200,160,160,0,870
92207,220,100,120,80,0,0,520
92208,180,120,80,80,160,0,620
92209,190,100,80,80,160,320,930
92210,210,120,120,0,0,0,450
92211,240,140,40,0,0,0,420
92212,190,100,40,80,0,0,410
92213,180,140,120,0,0,0,440
92214,210,120,200,80,160,0,770
92215,200,140,40,80,160,0,620
92216,170,140,80,160,160,0,710
92217,230,120,120,160,160,0,790
92218,210,100,80,0,0,0,390
92219,150,120,80,0,0,0,350
92220,200,120,160,240,320,0,1040
92221,230,120,160,160,160,0,830
92222,190,120,240,160,320,0,1030
92223,160,100,40,80,160,0,540
92224,190,80,40,0,0,0,310
92225,200,140,200,160,320,0,1020
92226,210,120,120,160,320,0,930
92227,240,160,160,240,160,0,960
92228,230,140,80,80,160,320,1010
92229,180,100,120,0,0,0,400
92230,200,100,80,80,160,0,620
92231,240,60,80,160,0,0,540
92232,200,120,40,80,160,0,600
92233,180,140,200,80,0,0,600
92234,200,120,80,80,160,0,640
92235,200,120,80,160,160,0,720
92236,190,140,160,160,160,320,1130
92237,190,120,160,240,320,320,1350
92238,190,100,120,0,0,0,410
92239,180,120,120,80,160,0,660
92240,190,140,40,80,160,0,610
92241,200,100,80,80,0,0,460
92242,220,100,80,80,160,0,640
92243,170,140,40,80,160,0,590
92244,160,100,160,240,320,0,980
92245,180,160,80,80,0,0,500
92246,210,100,80,80,160,0,630
92247,200,100,80,160,0,0,540
92248,180,160,120,0,0,0,460
92249,200,140,40,0,0,0,380
92250,210,140,120,160,160,0,790
92251,190,120,80,0,0,0,390
92252,180,120,40,0,0,0,340
92253,190,140,120,0,0,0,450
92254,190,100,160,160,0,0,610
92255,160,140,200,240,160,0,900
92256,220,140,40,0,0,0,400
92257,210,80,80,160,160,0,690
92258,230,180,160,240,160,0,970
92259,200,160,80,80,160,0,680
92260,180,140,160,160,160,320,1120
92261,210,160,200,160,320,320,1370
92262,170,120,200,160,160,0,810
92263,200,140,200,240,320,0,1100
92264,200,120,120,160,320,320,1240
92265,210,120,80,160,320,320,1210
92266,190,120,120,160,160,0,750
92267,150,100,120,160,320,0,850
92268,220,100,120,0,0,0,440
92269,160,160,120,0,0,0,440
92270,180,100,80,160,160,0,680
92271,210,140,120,0,0,0,470
92272,200,100,120,80,160,0,660
92273,170,140,160,160,320,0,950
92274,200,160,120,80,0,0,560
92275,180,140,120,160,160,320,1080
92276,200,120,120,0,0,0,440
92277,220,120,0,0,0,0,340
92278,210,80,40,0,0,0,330
92279,230,140,80,0,0,0,450
92280,160,160,160,80,0,0,560
92281,170,160,160,80,160,0,730
92282,190,80,120,160,320,0,870
92283,200,160,160,240,0,0,760
92284,190,140,200,160,160,320,1170
92285,190,120,120,240,320,0,990
92286,210,140,160,160,160,0,830
92287,220,140,160,80,0,0,600
92288,200,140,80,80,0,0,500
92289,170,120,80,80,0,0,450
92290,210,140,80,0,0,0,430
92291,230,160,80,80,160,320,1030
92292,230,200,160,160,160,320,1230
92293,200,100,40,0,0,0,340
92294,180,60,0,0,0,0,240
92295,190,160,120,160,320,0,950
92296,190,160,120,80,160,0,710
92297,210,100,120,160,160,0,750
92298,180,160,120,80,0,0,540
92299,180,100,120,80,0,0,480
92300,160,80,120,160,160,0,680
92301,220,120,80,80,0,0,500
92302,190,140,80,160,160,0,730
92303,210,80,40,80,160,0,570
92304,220,120,160,160,320,320,1300
92305,190,140,120,80,0,0,530
92306,160,120,120,0,0,0,400
92307,200,100,40,80,0,0,420
92308,180,140,120,80,160,0,680
92309,220,140,120,80,160,0,720
92310,190,120,120,160,160,0,750
92311,200,100,80,80,0,0,460
92312,200,120,80,80,160,0,640
92313,170,100,160,160,160,320,1070
92314,190,100,0,0,0,0,290
92315,200,160,120,80,160,0,720
92316,210,120,120,160,320,0,930
92317,210,120,80,80,160,0,650
92318,190,140,120,160,0,0,610
92319,160,80,40,80,160,0,520
92320,220,140,80,80,0,0,520
92321,220,100,80,80,160,0,640
92322,160,80,80,160,0,0,480
92323,150,100,160,80,0,0,490
92324,230,100,80,0,0,0,410
92325,190,80,120,80,160,0,630
92326,230,80,40,80,160,0,590
92327,160,140,80,160,0,0,540
92328,200,140,40,80,0,0,460
92329,190,120,120,160,160,320,1070
92330,180,100,80,80,160,320,920
92331,190,140,120,80,160,0,690
92332,190,120,120,160,160,320,1070
92333,180,120,160,160,320,320,1260
92334,220,180,200,80,0,0,680
92335,190,120,120,80,0,0,510
92336,200,120,120,160,320,320,1240
92337,160,120,40,0,0,0,320
92338,210,120,40,80,0,0,450
92339,200,40,40,80,0,0,360
92340,210,100,160,80,160,0,710
92341,210,100,40,80,0,0,430
92342,220,160,160,240,320,320,1420
92343,220,160,120,80,160,0,740
92344,180,140,80,160,160,0,720
92345,170,80,80,0,0,0,330
92346,170,60,80,80,160,0,550
92347,230,120,80,0,0,0,430
92348,200,60,40,0,0,0,300
92349,160,120,80,0,0,0,360
92350,210,80,0,0,0,0,290
92351,220,180,120,80,160,0,760
92352,210,160,120,160,0,0,650
92353,200,100,40,80,0,0,420
92354,220,100,40,0,0,0,360
92355,200,180,120,160,160,0,820
92356,180,100,120,240,320,0,960
92357,170,100,0,0,0,0,270
92358,220,100,120,0,0,0,440
92359,180,180,160,80,160,0,760
92360,160,80,80,160,320,320,1120
92361,180,100,40,80,160,0,560
92362,190,120,200,80,0,0,590
92363,200,140,80,80,0,0,500
92364,180,160,80,80,0,0,500
92365,160,120,80,160,160,0,680
92366,210,140,200,240,320,0,1110
92367,210,100,80,80,0,0,470
92368,210,120,80,160,0,0,570
92369,200,100,40,0,0,0,340
92370,160,80,80,0,0,0,320
92371,170,60,80,80,0,0,390
92372,150,140,80,0,0,0,370
92373,230,160,120,160,0,0,670
92374,150,100,120,160,0,0,530
92375,170,100,120,80,0,0,470
92376,190,120,120,160,160,320,1070
92377,210,140,120,160,160,0,790
92378,210,100,80,160,160,0,710
92379,220,100,120,0,0,0,440
92380,210,140,160,160,160,0,830
92381,200,120,120,80,0,0,520
92382,230,100,40,80,0,0,450
92383,220,100,120,160,320,0,920
92384,210,140,120,80,160,320,1030
92385,140,120,120,160,160,0,700
92386,200,140,160,80,160,0,740
92387,210,80,40,0,0,0,330
92388,200,120,80,160,160,0,720
92389,220,60,120,160,320,0,880
92390,190,100,120,80,0,0,490
92391,220,60,0,0,0,0,280
92392,240,140,80,80,160,0,700
92393,180,140,80,0,0,0,400
92394,190,200,160,160,0,0,710
92395,190,160,120,80,0,0,550
92396,190,120,120,80,0,0,510
92397,210,160,80,0,0,0,450
92398,190,100,0,0,0,0,290
92399,200,180,120,80,160,0,740
92400,150,120,160,80,0,0,510
92401,230,160,80,80,160,0,710
92402,240,200,80,0,0,0,520
92403,180,100,80,0,0,0,360
92404,190,100,160,80,0,0,530
92405,170,120,80,80,160,0,610
92406,200,120,120,80,160,0,680
92407,170,80,120,80,0,0,450
92408,160,100,40,0,0,0,300
92409,140,80,120,160,320,320,1140
92410,160,120,80,80,0,0,440
92411,170,60,80,160,160,0,630
92412,220,200,160,80,160,0,820
92413,190,100,80,0,0,0,370
92414,200,160,120,240,320,320,1360
92415,190,180,200,160,320,320,1370
92416,210,120,40,80,160,0,610
92417,240,140,80,80,160,0,700
92418,180,180,120,80,0,0,560
92419,200,80,120,240,320,320,1280
92420,120,80,40,0,0,0,240
92421,190,100,80,80,160,0,610
92422,190,100,80,0,0,0,370
92423,210,140,120,0,0,0,470
92424,200,140,120,80,160,0,700
92425,170,140,160,160,0,0,630
92426,200,40,40,0,0,0,280
92427,150,120,80,0,0,0,350
92428,190,140,40,80,160,320,930
92429,190,160,200,240,160,0,950
92430,180,160,120,80,160,0,700
92431,180,80,80,160,320,0,820
92432,180,100,120,160,160,0,720
92433,160,20,40,0,0,0,220
92434,230,160,120,80,0,0,590
92435,220,140,120,160,160,320,1120
92436,220,140,80,80,160,0,680
92437,210,140,80,80,0,0,510
92438,210,120,160,160,320,320,1290
92439,180,100,160,80,0,0,520
92440,240,140,80,160,320,0,940
92441,160,80,120,160,320,0,840
92442,190,80,80,80,0,0,430
92443,210,140,200,160,320,0,1030
92444,180,120,120,160,0,0,580
92445,180,100,120,80,160,0,640
92446,190,80,80,160,160,0,670
92447,210,120,160,80,160,0,730
92448,210,100,40,80,0,0,430
92449,150,120,120,160,160,320,1030
92450,190,120,120,80,0,0,510
92451,180,100,80,160,320,0,840
92452,170,140,160,160,160,320,1110
92453,160,100,40,0,0,0,300
92454,170,80,40,80,160,320,850
92455,200,80,40,0,0,0,320
92456,150,100,80,0,0,0,330
92457,200,140,120,160,160,0,780
92458,240,160,120,80,0,0,600
92459,240,160,80,0,0,0,480
92460,220,60,40,0,0,0,320
92461,210,140,80,160,160,0,750
92462,200,100,160,160,0,0,620
92463,190,140,120,160,320,320,1250
92464,160,60,40,80,160,0,500
92465,210,80,80,160,160,0,690
92466,190,120,80,0,0,0,390
92467,200,100,120,80,160,0,660
92468,240,100,160,160,160,320,1140
92469,190,120,120,240,320,320,1310
92470,150,100,80,0,0,0,330
92471,220,180,80,0,0,0,480
92472,220,100,80,0,0,0,400
92473,190,140,80,0,0,0,410
92474,160,100,120,80,0,0,460
92475,200,160,120,160,320,320,1280
92476,200,140,200,240,160,0,940
92477,200,120,0,0,0,0,320
92478,240,180,160,240,320,0,1140
92479,210,200,120,160,320,320,1330
92480,240,100,80,80,160,0,660
92481,200,80,120,160,160,0,720
92482,210,80,40,80,0,0,410
92483,150,100,80,160,160,0,650
92484,180,100,120,80,0,0,480
92485,210,140,40,80,0,0,470
92486,230,180,120,160,0,0,690
92487,190,120,80,160,160,0,710
92488,190,120,80,80,0,0,470
92489,150,120,160,160,160,0,750
92490,210,140,120,160,160,320,1110
92491,190,80,80,80,160,0,590
92492,200,120,200,80,160,0,760
92493,180,120,0,0,0,0,300
92494,170,100,160,160,0,0,590
92495,180,80,80,0,0,0,340
92496,200,120,160,80,160,0,720
92497,190,140,120,160,0,0,610
92498,220,140,80,80,160,320,1000
92499,160,60,80,80,160,0,540
92500,180,100,80,0,0,0,360
92501,210,140,200,240,320,0,1110
92502,170,60,40,80,0,0,350
92503,190,160,120,80,160,0,710
92504,220,140,80,80,0,0,520
92505,190,120,120,80,160,0,670
92506,190,100,40,80,0,0,410
92507,180,120,120,240,160,320,1140
92508,220,120,120,160,320,0,940
92509,240,120,40,80,0,0,480
92510,200,120,80,80,0,0,480
92511,170,120,80,0,0,0,370
92512,240,160,80,160,160,0,800
92513,230,160,120,240,160,0,910
92514,190,100,80,160,160,0,690
92515,200,100,40,0,0,0,340
92516,210,120,200,160,320,0,1010
92517,130,80,120,160,160,0,650
92518,210,120,40,80,160,0,610
92519,210,120,120,80,0,0,530
92520,200,140,120,80,160,0,700
92521,220,140,160,80,0,0,600
92522,200,160,120,80,160,320,1040
92523,220,180,160,80,160,320,1120
92524,180,80,80,80,160,0,580
92525,210,140,80,80,0,0,510
92526,210,180,120,80,160,0,750
92527,160,80,80,160,160,0,640
92528,150,100,40,80,0,0,370
92529,210,140,80,160,160,0,750
92530,230,120,120,160,0,0,630
92531,210,80,40,0,0,0,330
92532,170,80,40,0,0,0,290
92533,210,100,80,80,160,0,630
92534,190,120,40,80,0,0,430
92535,150,140,160,80,160,0,690
92536,210,160,160,160,0,0,690
92537,170,100,80,0,0,0,350
92538,220,180,240,320,0,0,960
92539,170,100,80,80,160,0,590
92540,180,180,200,160,320,320,1360
92541,210,120,160,240,320,320,1370
92542,220,120,120,240,160,0,860
92543,150,120,40,0,0,0,310
92544,170,120,80,80,0,0,450
92545,290,180,160,160,160,320,1270
92546,190,100,80,80,0,0,450
92547,200,140,120,240,160,0,860
92548,190,140,80,0,0,0,410
92549,190,80,80,80,160,0,590
92550,200,120,120,160,160,320,1080
92551,190,100,40,0,0,0,330
92552,210,180,120,160,160,0,830
92553,230,180,160,80,0,0,650
92554,190,120,80,160,160,0,710
92555,180,80,80,80,160,320,900
92556,170,80,120,160,160,320,1010
92557,200,160,160,160,160,0,840
92558,150,80,120,160,320,320,1150
92559,190,160,200,0,0,0,550
92560,200,160,80,80,160,0,680
92561,170,80,40,0,0,0,290
92562,210,80,80,0,0,0,370
92563,180,80,40,80,160,0,540
92564,200,100,120,160,160,0,740
92565,240,200,160,160,320,320,1400
92566,200,120,80,0,0,0,400
92567,190,120,80,80,0,0,470
92568,200,80,0,0,0,0,280
92569,210,160,120,80,160,0,730
92570,220,120,120,80,160,0,700
92571,210,140,120,80,0,0,550
92572,200,140,120,160,160,320,1100
92573,170,100,120,160,0,0,550
92574,220,100,120,240,320,0,1000
92575,180,160,40,0,0,0,380
92576,200,120,120,160,160,0,760
92577,200,180,160,80,160,320,1100
92578,210,100,80,0,0,0,390
92579,210,160,40,0,0,0,410
92580,160,120,160,160,0,0,600
92581,190,160,240,80,0,0,670
92582,150,140,200,240,160,0,890
92583,190,80,120,0,0,0,390
92584,230,120,80,0,0,0,430
92585,230,100,40,80,160,0,610
92586,170,60,80,80,0,0,390
92587,210,80,80,80,0,0,450
92588,190,140,120,80,160,320,1010
92589,190,160,160,160,160,0,830
92590,190,100,120,80,160,0,650
92591,160,120,160,160,160,0,760
92592,190,100,160,80,160,0,690
92593,190,80,80,80,160,0,590
92594,160,160,80,80,0,0,480
92595,190,100,160,0,0,0,450
92596,170,120,160,160,160,0,770
92597,210,100,40,80,160,0,590
92598,190,140,80,80,0,0,490
92599,190,160,120,160,0,0,630
92600,220,140,80,80,0,0,520
92601,210,160,160,160,160,0,850
92602,160,60,80,80,0,0,380
92603,200,120,80,80,160,0,640
92604,170,140,120,0,0,0,430
92605,240,120,160,160,160,0,840
92606,230,140,160,240,160,0,930
92607,200,100,80,0,0,0,380
92608,190,80,120,80,160,320,950
92609,220,180,80,160,160,320,1120
92610,180,120,120,160,160,0,740
92611,160,80,0,0,0,0,240
92612,220,120,120,160,160,0,780
92613,210,180,160,160,160,0,870
92614,220,140,160,240,160,0,920
92615,180,140,120,160,320,320,1240
92616,200,140,160,160,160,0,820
92617,190,160,200,160,320,320,1350
92618,180,140,240,80,0,0,640
92619,190,120,40,80,160,0,590
92620,170,120,80,160,160,0,690
92621,160,140,80,0,0,0,380
92622,210,180,160,160,160,0,870
92623,190,140,120,160,0,0,610
92624,180,100,80,80,160,0,600
92625,220,140,80,80,160,0,680
92626,180,160,80,80,0,0,500
92627,180,160,120,0,0,0,460
92628,220,100,0,0,0,0,320
92629,210,160,120,80,0,0,570
92630,250,120,0,0,0,0,370
92631,180,100,160,240,320,0,1000
92632,250,100,80,160,320,320,1230
92633,210,140,120,80,0,0,550
92634,220,100,80,0,0,0,400
92635,180,80,40,80,0,0,380
92636,160,180,160,80,0,0,580
92637,210,140,120,80,160,0,710
92638,200,100,80,160,320,0,860
92639,210,100,120,160,160,0,750
92640,220,180,120,160,160,0,840
92641,200,100,120,80,0,0,500
92642,200,120,160,160,160,320,1120
92643,230,140,80,160,0,0,610
92644,220,180,120,160,320,0,1000
92645,210,140,80,0,0,0,430
92646,200,60,40,80,160,0,540
92647,200,80,80,0,0,0,360
92648,230,140,200,160,160,0,890
92649,200,140,120,80,160,0,700
92650,190,80,80,160,320,320,1150
92651,210,100,120,160,320,0,910
92652,210,120,80,80,160,0,650
92653,180,160,120,80,160,0,700
92654,220,140,80,80,160,0,680
92655,160,140,160,160,320,320,1260
92656,220,120,120,160,320,0,940
92657,230,120,40,80,160,0,630
92658,230,120,200,80,160,0,790
92659,190,40,40,0,0,0,270
92660,170,80,120,160,160,0,690
92661,210,120,120,80,160,0,690
92662,230,140,120,0,0,0,490
92663,210,120,120,80,160,0,690
92664,200,180,120,80,0,0,580
92665,240,100,120,160,320,320,1260
92666,260,160,80,80,160,0,740
92667,230,140,80,0,0,0,450
92668,190,200,200,160,0,0,750
92669,200,100,40,80,160,0,580
92670,170,120,160,160,160,0,770
92671,210,100,120,80,0,0,510
92672,130,80,120,160,320,0,810
92673,210,120,120,80,160,0,690
92674,210,120,80,80,160,0,650
92675,210,140,80,80,160,0,670
92676,210,140,80,0,0,0,430
92677,210,140,120,0,0,0,470
92678,170,120,160,0,0,0,450
92679,190,160,120,80,0,0,550
92680,200,100,120,160,160,0,740
92681,200,100,40,0,0,0,340
92682,220,100,40,80,160,0,600
92683,160,80,120,80,160,320,920
92684,180,60,40,80,160,0,520
92685,210,100,120,160,160,0,750
92686,160,140,40,0,0,0,340
92687,180,120,160,80,160,0,700
92688,150,100,120,80,0,0,450
92689,190,100,160,160,160,0,770
92690,230,140,120,80,0,0,570
92691,170,120,80,160,160,0,690
92692,180,120,160,80,0,0,540
92693,220,140,160,240,0,0,760
92694,180,180,80,80,160,0,680
92695,180,160,160,160,320,320,1300
92696,220,160,120,160,160,0,820
92697,210,140,120,160,160,0,790
92698,180,100,80,80,0,0,440
92699,220,120,120,240,0,0,700
92700,170,120,120,80,160,320,970
92701,210,200,120,160,0,0,690
92702,210,80,80,160,320,0,850
92703,200,100,160,80,0,0,540
92704,210,140,120,160,160,320,1110
92705,190,160,40,80,0,0,470
92706,150,120,40,80,0,0,390
92707,180,80,40,80,160,320,860
92708,180,160,200,240,320,0,1100
92709,200,120,80,80,160,0,640
92710,160,120,160,80,160,0,680
92711,160,120,120,80,0,0,480
92712,120,100,120,0,0,0,340
92713,200,120,80,80,160,0,640
92714,230,140,120,80,0,0,570
92715,220,180,120,0,0,0,520
92716,170,120,160,80,160,0,690
92717,230,120,160,80,0,0,590
92718,190,140,120,160,160,0,770
92719,180,140,120,160,0,0,600
92720,160,80,120,80,160,320,920
92721,190,80,40,0,0,0,310
92722,200,100,40,0,0,0,340
92723,180,120,120,160,160,0,740
92724,250,160,200,160,0,0,770
92725,210,140,120,80,160,0,710
92726,160,120,120,80,160,0,640
92727,220,180,80,80,0,0,560
92728,190,100,40,80,0,0,410
92729,200,120,80,0,0,0,400
92730,200,160,80,80,160,0,680
92731,190,120,40,0,0,0,350
92732,170,120,80,80,160,0,610
92733,200,100,120,0,0,0,420
92734,220,100,120,0,0,0,440
92735,170,120,120,0,0,0,410
92736,190,100,120,160,320,0,890
92737,200,160,200,160,320,0,1040
92738,160,160,120,80,0,0,520
92739,180,140,120,160,160,0,760
92740,200,160,120,160,320,0,960
92741,210,120,200,240,160,0,930
92742,200,100,80,160,160,0,700
92743,220,100,120,240,160,0,840
92744,150,100,40,0,0,0,290
92745,180,140,0,0,0,0,320
92746,230,120,120,240,320,0,1030
92747,150,120,160,80,0,0,510
92748,210,100,80,80,160,0,630
92749,160,120,120,80,160,0,640
92750,170,40,40,0,0,0,250
92751,230,180,120,80,160,320,1090
92752,190,160,80,80,160,0,670
92753,190,120,120,160,160,0,750
92754,170,60,80,160,0,0,470
92755,190,120,160,240,160,0,870
92756,220,140,120,80,160,320,1040
92757,230,200,120,0,0,0,550
92758,190,180,200,160,320,0,1050
92759,190,120,160,80,0,0,550
92760,220,180,160,80,0,0,640
92761,190,160,120,160,160,0,790
92762,220,140,120,80,160,0,720
92763,210,100,80,80,160,0,630
92764,210,160,120,0,0,0,490
92765,210,120,160,80,0,0,570
92766,190,100,120,0,0,0,410
92767,200,160,80,80,0,0,520
92768,200,180,80,160,320,320,1260
92769,170,140,120,80,0,0,510
92770,210,140,160,80,160,0,750
92771,200,140,40,0,0,0,380
92772,210,140,120,80,0,0,550
92773,170,120,120,160,160,0,730
92774,240,160,40,0,0,0,440
92775,150,80,80,0,0,0,310
92776,140,100,120,80,160,0,600
92777,180,100,80,80,160,0,600
92778,210,160,120,240,320,320,1370
92779,220,180,120,80,0,0,600
92780,230,200,160,80,160,0,830
92781,170,80,80,80,0,0,410
92782,160,60,0,0,0,0,220
92783,190,100,40,0,0,0,330
92784,230,160,200,80,160,0,830
92785,260,140,240,240,160,0,1040
92786,200,140,120,160,160,0,780
92787,210,140,160,240,320,0,1070
92788,180,120,120,240,160,0,820
92789,200,80,80,0,0,0,360
92790,210,160,160,80,160,0,770
92791,210,180,160,0,0,0,550
92792,220,160,160,240,320,320,1420
92793,200,160,80,80,0,0,520
92794,200,160,120,160,0,0,640
92795,190,140,120,240,320,0,1010
92796,190,140,120,160,320,0,930
92797,190,140,120,240,320,0,1010
92798,190,80,40,80,160,320,870
92799,180,120,40,80,160,0,580
92800,230,140,120,160,160,0,810
92801,210,160,120,80,0,0,570
92802,200,120,160,160,160,0,800
92803,190,120,120,0,0,0,430
92804,140,100,80,80,160,0,560
92805,230,140,80,80,160,0,690
92806,200,120,120,80,160,0,680
92807,230,60,80,0,0,0,370
92808,170,160,200,160,160,0,850
92809,210,160,120,240,320,320,1370
92810,220,100,80,80,160,0,640
92811,180,80,40,80,160,0,540
92812,230,80,80,80,0,0,470
92813,200,120,160,80,0,0,560
92814,190,140,120,80,0,0,530
92815,180,140,80,80,160,320,960
92816,200,80,120,80,160,0,640
92817,190,140,80,80,0,0,490
92818,190,120,80,80,160,0,630
92819,190,100,80,80,160,0,610
92820,180,120,160,80,160,0,700
92821,210,140,160,80,160,0,750
92822,190,140,80,80,160,0,650
92823,220,140,120,80,160,0,720
92824,230,80,0,0,0,0,310
92825,200,200,160,160,160,0,880
92826,200,120,120,0,0,0,440
92827,210,160,160,240,160,320,1250
92828,170,60,80,160,160,0,630
92829,200,100,40,0,0,0,340
92830,200,160,120,160,160,0,800
92831,210,160,240,160,160,0,930
92832,210,120,160,240,0,0,730
92833,180,120,120,240,320,0,980
92834,190,140,80,0,0,0,410
92835,210,160,120,240,320,320,1370
92836,190,120,80,0,0,0,390
92837,220,140,120,0,0,0,480
92838,190,120,120,80,0,0,510
92839,180,120,80,160,320,320,1180
92840,170,80,40,0,0,0,290
92841,140,100,160,160,320,0,880
92842,200,120,200,80,0,0,600
92843,240,200,160,160,320,320,1400
92844,200,140,80,80,0,0,500
92845,170,80,80,0,0,0,330
92846,220,140,80,80,0,0,520
92847,200,140,80,160,160,320,1060
92848,180,120,120,160,320,320,1220
92849,230,120,200,240,160,0,950
92850,200,160,200,80,0,0,640
92851,190,80,40,0,0,0,310
92852,180,140,200,240,320,0,1080
92853,150,140,80,160,160,0,690
92854,230,80,120,160,160,0,750
92855,190,60,40,0,0,0,290
92856,160,80,80,80,160,0,560
92857,210,60,40,0,0,0,310
92858,210,140,160,80,160,0,750
92859,200,120,120,160,0,0,600
92860,150,100,120,240,320,0,930
92861,190,100,80,80,160,0,610
92862,200,140,80,80,0,0,500
92863,240,140,120,160,160,0,820
92864,200,120,0,0,0,0,320
92865,200,120,80,0,0,0,400
92866,230,140,120,80,160,320,1050
92867,200,140,120,0,0,0,460
92868,220,100,120,160,160,320,1080
92869,190,80,120,80,160,0,630
92870,210,200,200,160,160,0,930
92871,210,100,80,80,0,0,470
92872,190,100,120,80,160,0,650
92873,170,160,120,80,160,0,690
92874,180,80,40,0,0,0,300
92875,180,140,120,160,160,320,1080
92876,160,120,120,80,160,0,640
92877,180,120,80,0,0,0,380
92878,180,60,80,80,0,0,400
92879,170,140,120,160,320,0,910
92880,160,120,80,0,0,0,360
92881,240,100,160,0,0,0,500
92882,200,140,200,160,160,0,860
92883,220,160,80,80,160,0,700
92884,180,100,120,80,0,0,480
92885,210,160,240,240,0,0,850
92886,200,100,80,160,160,0,700
92887,250,180,120,160,160,0,870
92888,230,120,80,80,160,0,670
92889,230,120,120,80,160,0,710
92890,190,100,80,80,160,0,610
92891,220,180,120,0,0,0,520
92892,190,160,120,0,0,0,470
92893,240,100,80,160,160,0,740
92894,180,160,120,160,0,0,620
92895,210,100,80,0,0,0,390
92896,190,100,80,160,320,0,850
92897,170,160,160,80,160,0,730
92898,210,100,40,80,160,0,590
92899,200,120,160,80,0,0,560
92900,260,140,120,80,160,0,760
92901,220,120,120,240,160,320,1180
92902,190,200,200,240,160,320,1310
92903,190,140,40,80,160,0,610
92904,190,80,120,80,160,0,630
92905,140,100,40,80,160,0,520
92906,170,100,80,80,160,0,590
92907,230,120,80,80,160,0,670
92908,130,100,160,240,320,0,950
92909,200,120,120,80,160,0,680
92910,190,120,40,0,0,0,350
92911,220,160,200,160,0,0,740
92912,180,80,120,0,0,0,380
92913,210,180,160,240,0,0,790
92914,190,120,80,80,160,0,630
92915,150,100,80,0,0,0,330
92916,210,180,120,0,0,0,510
92917,190,120,160,80,0,0,550
92918,220,180,200,160,0,0,760
92919,190,140,200,240,0,0,770
92920,190,140,160,240,160,0,890
92921,200,140,120,80,0,0,540
92922,240,200,160,160,0,0,760
92923,160,100,120,160,160,0,700
92924,170,80,40,80,0,0,370
92925,200,160,120,80,0,0,560
92926,210,80,120,240,160,0,810
92927,180,160,80,160,160,0,740
92928,140,60,40,0,0,0,240
92929,250,140,160,80,0,0,630
92930,200,120,80,0,0,0,400
92931,210,160,200,240,160,0,970
92932,190,120,80,80,0,0,470
92933,170,120,80,160,0,0,530
92934,190,60,80,80,0,0,410
92935,210,120,120,80,160,320,1010
92936,190,80,40,80,160,320,870
92937,210,160,80,0,0,0,450
92938,180,120,160,80,0,0,540
92939,200,100,120,80,160,0,660
92940,210,80,120,160,160,320,1050
92941,220,100,80,80,0,0,480
92942,240,160,160,80,160,0,800
92943,210,120,80,80,160,0,650
92944,200,120,80,0,0,0,400
92945,190,140,80,0,0,0,410
92946,180,100,0,0,0,0,280
92947,190,120,120,0,0,0,430
92948,190,180,120,0,0,0,490
92949,200,160,160,160,0,0,680
92950,180,160,80,160,160,0,740
92951,200,120,160,80,0,0,560
92952,160,40,80,0,0,0,280
92953,180,80,80,80,160,0,580
92954,220,140,200,240,160,320,1280
92955,220,200,200,160,160,0,940
92956,170,140,0,0,0,0,310
92957,210,100,80,160,160,0,710
92958,210,140,80,160,160,0,750
92959,190,160,160,240,160,0,910
92960,210,160,80,160,160,0,770
92961,150,100,120,80,160,0,610
92962,210,140,80,80,0,0,510
92963,180,120,120,240,160,0,820
92964,240,140,200,160,0,0,740
92965,190,120,120,240,160,320,1150
92966,220,140,160,160,160,0,840
92967,210,160,80,80,160,0,690
92968,190,80,80,80,160,0,590
92969,200,100,120,160,160,320,1060
92970,190,180,160,160,320,0,1010
92971,180,80,160,160,320,0,900
92972,210,140,80,80,0,0,510
92973,190,140,120,80,160,0,690
92974,220,160,200,160,160,0,900
92975,220,140,80,80,160,0,680
92976,180,120,80,80,0,0,460
92977,230,140,80,160,320,0,930
92978,200,120,120,80,160,0,680
92979,180,80,120,240,160,0,780
92980,200,120,80,160,320,320,1200
92981,160,120,80,80,0,0,440
92982,190,140,80,80,0,0,490
92983,160,80,40,80,0,0,360
92984,160,80,160,80,160,0,640
92985,190,100,80,160,0,0,530
92986,150,160,80,0,0,0,390
92987,220,80,80,0,0,0,380
92988,190,140,160,80,0,0,570
92989,170,100,80,0,0,0,350
92990,190,100,0,0,0,0,290
92991,210,120,160,80,160,320,1050
92992,200,140,200,240,320,0,1100
92993,180,100,40,0,0,0,320
92994,160,60,40,0,0,0,260
92995,170,80,40,0,0,0,290
92996,160,140,80,80,160,0,620
92997,200,160,120,80,160,0,720
92998,210,120,40,80,160,0,610
92999,220,140,120,80,0,0,560
93000,250,120,80,80,160,0,690
93001,250,200,160,80,160,320,1170
93002,220,160,120,240,160,0,900
93003,180,140,120,160,0,0,600
93004,180,100,80,80,160,320,920
93005,190,80,80,80,0,0,430
93006,170,120,80,160,320,0,850
93007,180,120,80,160,160,0,700
93008,210,120,120,240,160,0,850
93009,200,120,80,0,0,0,400
93010,210,140,40,80,0,0,470
93011,210,120,120,80,160,0,690
93012,190,160,80,0,0,0,430
93013,170,80,80,0,0,0,330
93014,180,100,80,80,0,0,440
93015,210,140,80,0,0,0,430
93016,180,80,80,80,0,0,420
93017,170,120,160,240,160,0,850
93018,190,120,160,240,160,320,1190
93019,230,180,200,0,0,0,610
93020,210,120,120,80,0,0,530
93021,180,120,80,0,0,0,380
93022,230,140,120,160,160,0,810
93023,220,140,40,0,0,0,400
93024,200,140,120,160,160,320,1100
93025,220,120,40,80,0,0,460
93026,210,140,80,80,160,0,670
93027,240,120,120,80,160,0,720
93028,210,160,120,80,160,0,730
93029,220,140,40,80,160,0,640
93030,170,100,80,80,160,0,590
93031,140,80,120,240,0,0,580
93032,220,100,120,160,160,0,760
93033,190,120,160,80,160,0,710
93034,220,160,80,80,160,0,700
93035,150,80,120,80,0,0,430
93036,170,60,80,80,0,0,390
93037,190,200,200,0,0,0,590
93038,210,140,80,80,160,0,670
93039,180,160,200,160,160,320,1180
93040,180,40,0,0,0,0,220
93041,220,120,120,80,160,0,700
93042,210,140,160,240,160,0,910
93043,180,100,80,80,0,0,440
93044,220,140,120,240,160,0,880
93045,170,80,0,0,0,0,250
93046,210,60,0,0,0,0,270
93047,180,120,200,240,0,0,740
93048,190,120,80,0,0,0,390
93049,220,140,120,80,0,0,560
93050,200,160,80,80,160,0,680
93051,150,60,40,0,0,0,250
93052,230,120,120,160,160,0,790
93053,200,140,120,0,0,0,460
93054,220,100,40,0,0,0,360
93055,210,140,80,80,160,0,670
93056,200,140,160,240,160,0,900
93057,250,100,80,80,0,0,510
93058,190,80,80,160,160,0,670
93059,150,80,120,80,160,0,590
93060,200,100,120,0,0,0,420
93061,200,120,200,240,160,0,920
93062,220,100,80,80,0,0,480
93063,220,200,200,240,320,320,1500
93064,140,60,80,80,160,0,520
93065,230,160,120,0,0,0,510
93066,210,100,40,0,0,0,350
93067,220,140,120,0,0,0,480
93068,230,180,240,240,160,0,1050
93069,210,100,120,80,160,0,670
93070,180,80,80,0,0,0,340
93071,220,100,80,80,160,0,640
93072,160,120,120,80,0,0,480
93073,200,100,80,80,160,0,620
93074,190,120,80,80,0,0,470
93075,210,100,80,80,0,0,470
93076,200,180,200,160,0,0,740
93077,190,120,80,80,160,0,630
93078,200,140,120,80,160,0,700
93079,230,140,80,80,160,320,1010
93080,190,120,120,80,160,0,670
93081,160,140,40,80,160,0,580
93082,200,80,80,0,0,0,360
93083,200,60,40,80,160,0,540
93084,220,80,80,80,160,0,620
93085,190,160,160,160,160,0,830
93086,230,140,120,80,160,0,730
93087,260,140,160,160,160,0,880
93088,220,180,80,160,160,0,800
93089,190,200,200,160,0,0,750
93090,190,160,120,0,0,0,470
93091,230,180,120,80,0,0,610
93092,230,160,80,80,160,0,710
93093,220,140,80,160,0,0,600
93094,130,120,80,0,0,0,330
93095,190,140,40,80,160,0,610
93096,220,120,40,80,0,0,460
93097,190,140,80,0,0,0,410
93098,220,120,80,80,160,0,660
93099,200,140,80,80,0,0,500
93100,170,60,40,80,0,0,350
93101,180,160,40,80,160,320,940
93102,190,100,120,80,160,0,650
93103,230,140,80,0,0,0,450
93104,230,120,160,240,160,0,910
93105,220,80,40,80,0,0,420
93106,250,160,120,80,160,320,1090
93107,220,160,40,80,0,0,500
93108,160,100,120,160,160,320,1020
93109,200,180,120,0,0,0,500
93110,210,140,200,80,160,0,790
93111,160,140,120,80,160,0,660
93112,210,120,200,80,0,0,610
93113,170,180,80,160,160,0,750
93114,200,120,160,160,160,0,800
93115,190,120,120,160,160,0,750
93116,240,140,80,160,320,0,940
93117,130,100,80,80,160,0,550
93118,200,120,160,160,160,0,800
93119,170,80,0,0,0,0,250
93120,200,100,160,0,0,0,460
93121,190,80,80,0,0,0,350
93122,200,160,160,160,160,0,840
93123,200,100,40,0,0,0,340
93124,190,80,40,80,160,0,550
93125,180,160,80,160,160,0,740
93126,210,140,80,0,0,0,430
93127,220,140,80,80,160,0,680
93128,190,100,80,160,160,0,690
93129,180,100,120,160,320,0,880
93130,200,140,160,160,320,0,980
93131,200,40,40,0,0,0,280
93132,210,180,200,160,320,0,1070
93133,200,100,80,160,0,0,540
93134,210,140,40,0,0,0,390
93135,230,180,40,80,0,0,530
93136,180,100,120,160,160,0,720
93137,140,80,0,0,0,0,220
93138,210,160,160,80,160,0,770
93139,200,120,120,80,0,0,520
93140,210,120,160,160,0,0,650
93141,140,60,80,160,160,0,600
93142,190,80,80,0,0,0,350
93143,210,140,120,80,0,0,550
93144,180,100,0,0,0,0,280
93145,220,140,120,160,160,0,800
93146,220,160,160,160,160,320,1180
93147,210,140,120,160,0,0,630
93148,210,120,120,160,160,0,770
93149,170,160,40,80,0,0,450
93150,190,100,80,160,160,0,690
93151,190,80,80,160,160,320,990
93152,210,120,40,80,160,320,930
93153,200,120,120,80,0,0,520
93154,220,200,160,160,0,0,740
93155,210,160,200,160,0,0,730
93156,220,100,80,80,160,320,960
93157,170,120,80,80,0,0,450
93158,260,180,80,160,0,0,680
93159,180,140,120,80,160,0,680
93160,220,140,120,160,0,0,640
93161,200,180,160,160,0,0,700
93162,200,140,160,160,160,0,820
93163,200,80,80,80,0,0,440
93164,210,120,120,80,160,0,690
93165,230,140,120,160,320,0,970
93166,210,120,120,80,0,0,530
93167,210,80,120,80,0,0,490
93168,200,120,160,240,160,0,880
93169,210,100,80,80,160,320,950
93170,190,140,80,160,160,320,1050
93171,170,80,40,0,0,0,290
93172,230,160,120,80,160,0,750
93173,230,140,160,80,0,0,610
93174,200,160,160,80,0,0,600
93175,230,160,120,240,320,0,1070
93176,190,120,80,160,0,0,550
93177,170,120,160,160,0,0,610
93178,150,100,40,80,0,0,370
93179,200,120,80,80,160,0,640
93180,200,100,80,0,0,0,380
93181,260,140,120,80,0,0,600
93182,180,60,40,80,160,0,520
93183,220,180,80,80,0,0,560
93184,180,120,120,240,320,320,1300
93185,200,120,80,80,160,0,640
93186,240,160,200,160,320,0,1080
93187,170,120,120,80,160,0,650
93188,190,120,40,80,0,0,430
93189,210,140,120,160,160,0,790
93190,250,140,120,80,0,0,590
93191,220,140,160,0,0,0,520
93192,210,120,200,80,160,320,1090
93193,210,140,120,240,160,320,1190
93194,190,160,120,80,160,320,1030
93195,210,80,120,160,0,0,570
93196,240,160,120,160,0,0,680
93197,190,200,80,0,0,0,470
93198,200,120,80,80,160,0,640
93199,160,120,160,80,160,0,680
93200,180,120,80,80,0,0,460
93201,240,120,160,240,160,0,920
93202,230,140,200,160,160,0,890
93203,190,100,80,0,0,0,370
93204,130,100,80,80,160,0,550
93205,150,100,80,80,160,0,570
93206,210,120,160,160,0,0,650
93207,190,60,80,80,160,0,570
93208,180,160,120,160,320,320,1260
93209,220,100,40,80,0,0,440
93210,150,60,40,0,0,0,250
93211,170,120,40,80,160,0,570
93212,180,120,120,80,0,0,500
93213,220,160,120,160,160,0,820
93214,210,120,120,160,160,0,770
93215,220,200,80,80,160,320,1060
93216,180,140,0,0,0,0,320
93217,220,160,160,160,160,0,860
93218,150,60,0,0,0,0,210
93219,240,100,40,0,0,0,380
93220,160,120,40,0,0,0,320
93221,190,120,120,240,160,0,830
93222,210,80,40,0,0,0,330
93223,220,180,80,80,160,0,720
93224,180,120,120,240,0,0,660
93225,200,120,200,160,320,320,1320
93226,170,120,80,160,320,0,850
93227,200,80,0,0,0,0,280
93228,160,140,160,160,160,0,780
93229,180,120,80,160,160,0,700
93230,220,140,120,80,160,0,720
93231,190,80,80,0,0,0,350
93232,220,140,160,160,320,320,1320
93233,180,100,40,0,0,0,320
93234,210,100,80,80,160,0,630
93235,160,160,200,160,160,0,840
93236,170,180,120,0,0,0,470
93237,170,100,80,0,0,0,350
93238,170,120,40,0,0,0,330
93239,180,120,40,80,0,0,420
93240,240,100,80,0,0,0,420
93241,190,60,40,80,160,0,530
93242,190,100,40,80,160,320,890
93243,190,140,160,160,0,0,650
93244,210,120,120,80,160,0,690
93245,150,80,40,0,0,0,270
93246,200,60,40,80,160,320,860
93247,170,160,160,80,160,0,730
93248,150,80,80,80,0,0,390
93249,180,100,40,80,0,0,400
93250,200,100,120,160,160,0,740
93251,170,120,80,80,0,0,450
93252,220,120,120,80,0,0,540
93253,250,120,80,160,320,0,930
93254,190,60,40,80,160,0,530
93255,210,120,120,80,0,0,530
93256,180,160,120,80,160,0,700
93257,180,80,80,80,0,0,420
93258,180,140,160,80,160,320,1040
93259,180,80,160,80,160,0,660
93260,200,100,40,0,0,0,340
93261,160,100,80,0,0,0,340
93262,180,120,80,80,160,320,940
93263,210,140,40,0,0,0,390
93264,160,80,0,0,0,0,240
93265,210,60,80,0,0,0,350
93266,220,160,120,0,0,0,500
93267,210,100,120,80,0,0,510
93268,210,140,80,80,160,0,670
93269,230,140,120,80,0,0,570
93270,200,80,120,80,0,0,480
93271,200,140,160,240,160,320,1220
93272,210,120,80,80,0,0,490
93273,180,100,160,160,320,320,1240
93274,210,60,40,80,160,0,550
93275,190,160,160,240,320,320,1390
93276,220,140,160,160,0,0,680
93277,200,180,160,160,0,0,700
93278,210,140,200,240,320,320,1430
93279,190,100,80,160,320,0,850
93280,200,120,120,80,160,0,680
93281,200,140,80,80,160,0,660
93282,180,140,160,240,320,0,1040
93283,220,160,200,160,160,0,900
93284,170,120,120,160,0,0,570
93285,170,120,120,160,160,0,730
93286,210,120,80,80,160,0,650
93287,200,80,40,80,0,0,400
93288,180,100,80,160,160,0,680
93289,180,100,120,160,320,0,880
93290,230,160,80,80,0,0,550
93291,220,80,40,80,160,0,580
93292,210,140,160,80,160,320,1070
93293,210,100,120,160,160,0,750
93294,200,120,120,160,320,0,920
93295,140,100,120,80,0,0,440
93296,190,140,160,80,0,0,570
93297,180,160,200,160,160,0,860
93298,210,140,80,160,160,0,750
93299,180,100,80,80,160,0,600
93300,200,100,40,80,160,0,580
93301,230,80,40,0,0,0,350
93302,180,100,0,0,0,0,280
93303,190,140,80,160,160,320,1050
93304,190,80,120,0,0,0,390
93305,200,80,120,80,160,0,640
93306,160,100,80,80,0,0,420
93307,210,200,200,240,160,0,1010
93308,220,140,200,160,320,0,1040
93309,210,120,120,160,160,320,1090
93310,200,180,120,0,0,0,500
93311,190,140,120,80,160,320,1010
93312,160,80,80,80,0,0,400
93313,220,180,240,160,160,0,960
93314,210,140,160,240,320,320,1390
93315,190,80,120,160,160,320,1030
93316,180,100,40,0,0,0,320
93317,210,120,120,160,160,0,770
93318,200,160,160,80,160,0,760
93319,170,100,40,80,0,0,390
93320,190,140,80,80,160,0,650
93321,180,160,120,160,160,0,780
93322,220,140,120,160,160,0,800
93323,180,80,40,80,0,0,380
93324,180,120,120,80,160,0,660
93325,220,180,40,80,160,320,1000
93326,150,120,80,80,0,0,430
93327,200,120,80,80,160,0,640
93328,170,20,40,80,0,0,310
93329,190,100,120,0,0,0,410
93330,200,160,120,80,160,320,1040
93331,240,180,160,0,0,0,580
93332,210,120,160,240,320,320,1370
93333,150,120,80,80,160,0,590
93334,170,160,120,80,160,0,690
93335,200,180,80,80,160,0,700
93336,190,120,120,240,320,0,990
93337,210,100,120,80,160,320,990
93338,200,80,40,0,0,0,320
93339,200,100,160,240,160,0,860
93340,210,180,120,80,0,0,590
93341,180,120,80,80,160,0,620
93342,150,140,80,80,160,320,930
93343,180,120,80,80,160,0,620
93344,210,160,120,160,0,0,650
93345,190,160,120,160,0,0,630
93346,180,80,40,80,160,0,540
93347,210,80,80,160,160,320,1010
93348,170,120,80,80,0,0,450
93349,190,120,160,80,0,0,550
93350,140,80,120,80,160,0,580
93351,180,100,160,160,320,320,1240
93352,190,100,40,80,160,0,570
93353,200,160,40,0,0,0,400
93354,180,140,160,160,0,0,640
93355,190,120,80,80,160,320,950
93356,180,180,40,0,0,0,400
93357,220,160,40,0,0,0,420
93358,200,140,160,240,320,0,1060
93359,190,140,40,0,0,0,370
93360,210,140,160,160,160,0,830
93361,210,140,0,0,0,0,350
93362,210,120,160,80,0,0,570
93363,130,100,80,0,0,0,310
93364,190,140,160,80,0,0,570
93365,210,60,40,0,0,0,310
93366,200,140,40,80,0,0,460
93367,260,100,80,0,0,0,440
93368,210,100,120,80,160,0,670
93369,190,140,120,160,0,0,610
93370,220,160,120,80,160,0,740
93371,160,100,120,160,160,0,700
93372,200,80,40,80,160,0,560
93373,200,60,40,0,0,0,300
93374,230,180,160,240,160,0,970
93375,190,120,160,160,0,0,630
93376,200,100,40,80,160,320,900
93377,230,120,160,160,160,0,830
93378,220,180,160,80,0,0,640
93379,160,60,40,0,0,0,260
93380,180,180,160,80,0,0,600
93381,180,100,120,80,0,0,480
93382,210,140,160,160,320,320,1310
93383,170,120,120,160,320,320,1210
93384,240,120,160,80,160,320,1080
93385,190,120,80,80,160,0,630
93386,180,120,120,80,0,0,500
93387,170,100,80,160,160,0,670
93388,210,160,80,160,160,320,1090
93389,180,140,80,80,160,0,640
93390,230,100,80,0,0,0,410
93391,210,140,160,240,0,0,750
93392,190,100,80,160,160,0,690
93393,200,140,160,80,160,0,740
93394,190,120,120,160,160,320,1070
93395,200,140,120,160,160,0,780
93396,180,40,40,80,0,0,340
93397,190,140,120,160,320,0,930
93398,230,180,240,240,160,0,1050
93399,180,80,0,0,0,0,260
93400,170,100,160,160,320,320,1230
93401,230,180,160,160,160,320,1210
93402,220,160,40,0,0,0,420
93403,160,120,120,160,0,0,560
93404,170,120,80,160,160,0,690
93405,230,120,80,80,160,0,670
93406,230,160,80,80,160,0,710
93407,170,160,120,80,160,320,1010
93408,200,100,160,240,320,320,1340
93409,170,160,120,80,160,0,690
93410,220,140,80,80,160,0,680
93411,200,60,80,80,160,0,580
93412,200,120,120,160,0,0,600
93413,200,120,120,80,0,0,520
93414,230,160,80,80,0,0,550
93415,210,120,200,160,0,0,690
93416,170,80,0,0,0,0,250
93417,210,100,0,0,0,0,310
93418,200,140,120,0,0,0,460
93419,210,80,40,80,0,0,410
93420,200,120,160,160,160,0,800
93421,220,120,0,0,0,0,340
93422,140,100,80,160,320,0,800
93423,150,140,160,160,160,0,770
93424,200,120,120,160,160,0,760
93425,230,160,120,160,160,320,1150
93426,200,160,160,80,0,0,600
93427,160,120,120,160,160,0,720
93428,160,80,160,160,160,0,720
93429,180,80,40,0,0,0,300
93430,220,140,40,0,0,0,400
93431,150,100,80,80,160,0,570
93432,230,120,160,160,160,0,830
93433,240,160,200,240,160,0,1000
93434,210,140,160,160,0,0,670
93435,200,160,120,80,0,0,560
93436,210,140,40,0,0,0,390
93437,210,100,120,240,160,0,830
93438,180,180,160,160,160,0,840
93439,220,120,80,80,0,0,500
93440,190,100,40,80,160,0,570
93441,220,120,80,0,0,0,420
93442,180,100,120,160,320,0,880
93443,210,160,120,80,160,0,730
93444,260,100,80,80,0,0,520
93445,210,140,200,160,320,0,1030
93446,190,120,80,80,160,0,630
93447,160,80,160,160,320,0,880
93448,160,80,80,0,0,0,320
93449,200,80,120,240,160,0,800
93450,180,80,80,80,160,0,580
93451,150,100,160,0,0,0,410
93452,180,120,120,160,320,320,1220
93453,150,120,120,160,160,0,710
93454,210,120,80,80,160,0,650
93455,200,140,80,0,0,0,420
93456,250,120,160,160,160,0,850
93457,190,100,80,80,0,0,450
93458,160,120,200,80,160,0,720
93459,220,120,120,0,0,0,460
93460,190,100,80,80,0,0,450
93461,180,60,80,80,0,0,400
93462,210,140,120,160,160,0,790
93463,220,140,80,80,160,0,680
93464,210,100,120,160,320,0,910
93465,160,120,80,80,0,0,440
93466,200,80,0,0,0,0,280
93467,220,200,120,160,160,0,860
93468,220,120,120,160,320,0,940
93469,190,100,160,240,160,0,850
93470,230,120,80,80,0,0,510
93471,210,160,80,80,160,0,690
93472,170,140,120,80,0,0,510
93473,220,140,160,0,0,0,520
93474,210,40,80,160,160,0,650
93475,220,160,120,240,0,0,740
93476,200,100,80,80,160,0,620
93477,230,140,80,80,160,0,690
93478,170,80,0,0,0,0,250
93479,190,80,120,160,160,0,710
93480,150,120,40,0,0,0,310
93481,180,120,120,160,160,320,1060
93482,200,120,120,160,160,0,760
93483,220,100,80,80,160,320,960
93484,210,140,160,80,0,0,590
93485,250,100,80,0,0,0,430
93486,190,140,160,160,160,320,1130
93487,200,80,120,160,320,320,1200
93488,230,120,120,80,160,0,710
93489,140,120,0,0,0,0,260
93490,240,120,80,160,0,0,600
93491,170,160,80,80,160,0,650
93492,150,100,80,80,160,0,570
93493,160,120,80,80,160,0,600
93494,190,120,120,0,0,0,430
93495,250,160,120,160,320,0,1010
93496,230,160,80,80,0,0,550
93497,200,160,120,80,0,0,560
93498,190,160,120,160,160,0,790
93499,180,140,80,160,320,0,880
93500,180,120,120,0,0,0,420
93501,200,100,80,160,0,0,540
93502,180,60,80,80,160,320,880
93503,210,100,80,80,160,0,630
93504,200,160,200,160,160,320,1200
93505,190,100,120,160,160,0,730
93506,170,140,160,80,0,0,550
93507,180,160,160,160,160,320,1140
93508,190,140,40,80,160,320,930
93509,220,220,160,80,0,0,680
93510,160,120,80,160,160,0,680
93511,220,140,160,80,0,0,600
93512,210,140,80,80,0,0,510
93513,190,80,40,0,0,0,310
93514,200,120,120,0,0,0,440
93515,240,120,80,0,0,0,440
93516,220,120,120,160,160,0,780
93517,210,140,80,80,160,0,670
93518,220,140,80,0,0,0,440
93519,220,140,80,80,0,0,520
93520,200,120,40,80,160,320,920
93521,180,140,80,80,160,0,640
93522,210,100,120,160,160,0,750
93523,210,120,80,80,160,0,650
93524,210,140,80,80,160,0,670
93525,190,160,120,240,320,0,1030
93526,220,120,160,160,160,0,820
93527,190,100,40,80,160,0,570
93528,170,60,80,160,320,0,790
93529,180,200,120,160,160,320,1140
93530,220,80,120,240,320,320,1300
93531,220,140,120,160,320,0,960
93532,180,180,160,80,160,0,760
93533,210,140,80,0,0,0,430
93534,220,120,120,160,160,0,780
93535,220,60,40,0,0,0,320
93536,190,160,160,80,160,0,750
93537,150,80,40,0,0,0,270
93538,210,80,80,160,0,0,530
93539,210,160,120,160,160,0,810
93540,180,120,80,160,160,0,700
93541,220,140,120,80,0,0,560
93542,200,100,120,240,160,0,820
93543,120,120,120,160,160,0,680
93544,210,60,0,0,0,0,270
93545,190,120,120,80,0,0,510
93546,160,80,40,0,0,0,280
93547,210,160,120,160,160,0,810
93548,210,140,80,0,0,0,430
93549,170,100,120,160,160,0,710
93550,210,140,200,160,160,0,870
93551,180,80,40,0,0,0,300
93552,160,140,200,160,160,0,820
93553,170,180,200,240,320,320,1430
93554,220,180,160,160,320,320,1360
93555,210,120,160,160,160,320,1130
93556,170,60,40,0,0,0,270
93557,190,180,120,80,0,0,570
93558,190,120,120,80,0,0,510
93559,210,100,80,0,0,0,390
93560,220,120,120,240,160,0,860
93561,180,140,160,160,160,0,800
93562,190,100,120,160,160,0,730
93563,200,140,80,0,0,0,420
93564,220,40,40,0,0,0,300
93565,200,120,80,80,160,0,640
93566,170,140,40,80,160,0,590
93567,190,140,120,240,320,320,1330
93568,180,60,40,80,0,0,360
93569,200,120,80,80,0,0,480
93570,210,140,120,0,0,0,470
93571,200,120,40,0,0,0,360
93572,260,160,80,160,160,0,820
93573,210,180,160,160,320,320,1350
93574,220,80,40,80,160,0,580
93575,240,120,80,80,0,0,520
93576,160,160,120,80,160,0,680
93577,190,160,120,80,0,0,550
93578,180,100,160,80,160,0,680
93579,190,120,80,80,160,0,630
93580,210,120,80,80,160,0,650
93581,220,200,160,160,320,320,1380
93582,210,140,160,160,0,0,670
93583,230,120,120,80,0,0,550
93584,250,120,120,160,0,0,650
93585,200,160,160,160,160,0,840
93586,190,100,80,80,0,0,450
93587,180,180,120,80,160,0,720
93588,180,140,80,80,0,0,480
93589,210,140,120,80,0,0,550
93590,210,100,40,80,0,0,430
93591,150,80,40,0,0,0,270
93592,200,100,120,160,160,0,740
93593,230,100,120,160,0,0,610
93594,220,120,80,80,160,320,980
93595,210,140,80,0,0,0,430
93596,180,80,80,160,160,0,660
93597,200,100,120,80,160,0,660
93598,220,80,40,0,0,0,340
93599,230,180,200,160,0,0,770
93600,200,220,240,240,160,0,1060
93601,200,120,80,0,0,0,400
93602,200,100,120,80,160,0,660
93603,200,100,120,160,0,0,580
93604,260,120,200,240,320,0,1140
93605,200,120,80,160,160,320,1040
93606,200,140,80,160,160,0,740
93607,140,100,120,80,0,0,440
93608,190,140,120,80,0,0,530
93609,180,120,120,160,160,320,1060
93610,180,140,80,0,0,0,400
93611,230,140,160,240,320,0,1090
93612,220,160,200,160,320,320,1380
93613,200,140,120,160,160,0,780
93614,200,100,80,160,160,0,700
93615,200,140,120,160,160,0,780
93616,240,120,40,80,160,0,640
93617,210,100,120,80,0,0,510
93618,180,100,80,160,0,0,520
93619,200,140,120,240,160,0,860
93620,170,120,120,160,0,0,570
93621,200,120,120,240,0,0,680
93622,190,140,40,80,0,0,450
93623,220,120,80,80,160,0,660
93624,180,120,80,80,0,0,460
93625,220,140,120,0,0,0,480
93626,200,100,80,80,160,0,620
93627,180,140,120,80,0,0,520
93628,200,160,160,160,160,0,840
93629,190,160,200,240,160,0,950
93630,190,160,160,160,160,320,1150
93631,200,120,120,160,160,0,760
93632,180,60,80,160,160,0,640
93633,180,140,80,80,160,0,640
93634,250,100,80,80,160,0,670
93635,240,180,80,80,0,0,580
93636,170,80,80,80,160,0,570
93637,200,140,120,160,160,0,780
93638,160,160,160,160,320,0,960
93639,230,120,40,80,160,0,630
93640,240,140,160,80,160,0,780
93641,190,80,120,80,160,320,950
93642,220,160,120,80,0,0,580
93643,210,120,120,160,160,0,770
93644,190,120,40,80,160,320,910
93645,150,140,40,0,0,0,330
93646,200,140,120,80,160,0,700
93647,170,120,80,160,320,0,850
93648,210,100,0,0,0,0,310
93649,200,80,40,80,0,0,400
93650,180,80,80,80,0,0,420
93651,210,80,40,80,0,0,410
93652,200,120,160,160,160,0,800
93653,160,100,160,80,160,0,660
93654,200,100,80,80,0,0,460
93655,210,100,80,80,160,0,630
93656,200,100,80,80,0,0,460
93657,230,140,120,0,0,0,490
93658,150,80,40,0,0,0,270
93659,190,120,200,80,0,0,590
93660,170,140,80,0,0,0,390
93661,190,120,160,160,0,0,630
93662,200,140,160,240,160,0,900
93663,210,160,120,0,0,0,490
93664,200,160,120,160,320,0,960
93665,110,100,40,0,0,0,250
93666,180,120,80,80,0,0,460
93667,220,80,80,0,0,0,380
93668,180,160,160,80,0,0,580
93669,200,100,120,80,160,0,660
93670,200,120,80,80,160,320,960
93671,190,160,120,80,160,0,710
93672,200,120,80,80,0,0,480
93673,160,140,200,240,160,0,900
93674,210,60,120,160,160,0,710
93675,180,140,160,0,0,0,480
93676,210,140,80,80,160,0,670
93677,240,160,120,80,0,0,600
93678,180,60,80,160,160,0,640
93679,170,140,80,80,0,0,470
93680,200,120,120,80,160,0,680
93681,190,80,80,160,160,0,670
93682,220,140,80,0,0,0,440
93683,170,140,120,0,0,0,430
93684,200,160,200,240,320,320,1440
93685,170,120,80,80,0,0,450
93686,200,80,80,0,0,0,360
93687,160,120,80,0,0,0,360
93688,200,120,80,80,0,0,480
93689,170,160,200,80,160,320,1090
93690,200,100,120,160,160,0,740
93691,200,160,160,0,0,0,520
93692,210,100,200,160,320,0,990
93693,200,80,40,0,0,0,320
93694,200,160,120,160,160,0,800
93695,220,140,160,160,160,0,840
93696,200,120,120,160,160,0,760
93697,200,160,120,80,0,0,560
93698,220,120,80,80,0,0,500
93699,190,100,160,160,0,0,610
93700,180,120,160,160,320,0,940
93701,240,200,200,80,0,0,720
93702,190,140,120,80,0,0,530
93703,190,140,120,0,0,0,450
93704,200,140,160,160,160,0,820
93705,190,120,80,80,0,0,470
93706,180,100,120,80,160,0,640
93707,200,140,120,80,160,0,700
93708,180,100,160,0,0,0,440
93709,180,120,80,80,160,0,620
93710,190,140,120,80,160,320,1010
93711,220,140,160,240,160,0,920
93712,180,160,160,80,160,0,740
93713,230,80,120,160,160,0,750
93714,170,160,120,160,160,0,770
93715,180,100,80,0,0,0,360
93716,190,80,40,80,0,0,390
93717,200,180,80,80,160,0,700
93718,210,160,160,80,160,320,1090
93719,170,100,80,80,160,0,590
93720,210,140,80,0,0,0,430
93721,180,60,80,80,160,0,560
93722,210,80,80,80,0,0,450
93723,220,180,160,80,0,0,640
93724,150,20,40,80,160,0,450
93725,180,180,120,80,160,0,720
93726,180,100,80,80,160,0,600
93727,210,100,120,0,0,0,430
93728,190,120,160,160,0,0,630
93729,180,80,80,0,0,0,340
93730,200,120,120,160,160,0,760
93731,190,140,120,0,0,0,450
93732,160,140,160,160,160,0,780
93733,170,100,80,0,0,0,350
93734,170,140,120,0,0,0,430
93735,170,120,80,80,160,0,610
93736,160,80,40,80,160,0,520
93737,210,120,160,80,160,0,730
93738,170,160,160,80,160,0,730
93739,170,60,80,80,0,0,390
93740,230,120,120,160,320,0,950
93741,190,100,120,160,160,0,730
93742,180,140,120,80,160,0,680
93743,250,120,120,80,0,0,570
93744,240,120,120,80,0,0,560
93745,200,140,120,80,0,0,540
93746,180,140,120,80,0,0,520
93747,220,80,120,160,160,0,740
93748,180,100,80,160,320,320,1160
93749,180,80,80,80,160,0,580
93750,200,140,120,80,0,0,540
93751,220,120,160,160,160,0,820
93752,170,60,80,80,160,0,550
93753,210,160,80,80,0,0,530
93754,200,140,120,80,160,0,700
93755,170,160,40,0,0,0,370
93756,150,140,80,80,160,0,610
93757,210,140,80,80,0,0,510
93758,170,100,80,80,160,320,910
93759,210,120,80,160,160,0,730
93760,210,140,120,160,160,320,1110
93761,200,160,120,160,160,0,800
93762,220,80,80,80,0,0,460
93763,210,140,80,0,0,0,430
93764,200,120,40,0,0,0,360
93765,210,180,160,160,320,320,1350
93766,210,80,80,160,320,0,850
93767,190,100,160,160,160,0,770
93768,180,80,40,80,160,0,540
93769,220,120,120,160,320,0,940
93770,170,140,120,160,160,0,750
93771,220,120,40,80,160,0,620
93772,180,120,120,160,320,320,1220
93773,240,200,120,0,0,0,560
93774,180,80,80,160,160,0,660
93775,210,120,40,0,0,0,370
93776,200,120,80,80,0,0,480
93777,200,160,120,80,160,0,720
93778,160,120,80,160,160,0,680
93779,210,80,120,80,160,320,970
93780,200,80,120,240,160,0,800
93781,190,120,160,160,160,0,790
93782,200,120,80,0,0,0,400
93783,200,100,120,80,0,0,500
93784,190,160,160,240,160,0,910
93785,190,160,80,160,160,320,1070
93786,220,100,160,80,160,320,1040
93787,180,120,160,80,160,0,700
93788,170,120,80,80,160,0,610
93789,150,100,120,160,0,0,530
93790,200,120,120,80,160,0,680
93791,210,120,80,160,320,0,890
93792,180,80,120,160,160,0,700
93793,220,120,40,80,160,0,620
93794,220,100,80,160,160,0,720
93795,190,160,120,80,160,320,1030
93796,190,100,80,0,0,0,370
93797,190,200,160,160,160,320,1190
93798,230,120,80,80,160,0,670
93799,190,80,120,0,0,0,390
93800,210,120,80,80,0,0,490
93801,200,100,80,80,0,0,460
93802,180,120,120,80,0,0,500
93803,170,120,120,80,160,0,650
93804,200,160,200,320,160,0,1040
93805,200,180,120,0,0,0,500
93806,170,60,40,80,160,0,510
93807,190,100,80,160,160,0,690
93808,170,60,80,160,160,320,950
93809,180,120,120,160,160,0,740
93810,190,100,80,80,160,0,610
93811,240,160,160,80,0,0,640
93812,200,120,80,80,160,320,960
93813,190,160,80,0,0,0,430
93814,200,140,120,160,320,320,1260
93815,200,140,120,80,0,0,540
93816,190,140,80,80,0,0,490
93817,190,80,80,80,0,0,430
93818,210,140,160,160,160,320,1150
93819,190,80,120,80,0,0,470
93820,150,140,120,160,0,0,570
93821,190,140,160,160,0,0,650
93822,210,120,160,160,160,0,810
93823,190,140,40,80,0,0,450
93824,220,80,120,80,0,0,500
93825,200,100,40,80,160,0,580
93826,170,100,120,160,0,0,550
93827,190,160,120,0,0,0,470
93828,190,120,120,160,320,0,910
93829,180,100,40,80,160,0,560
93830,200,180,160,160,0,0,700
93831,180,120,160,160,160,0,780
93832,170,140,160,160,0,0,630
93833,190,160,40,0,0,0,390
93834,180,160,200,240,320,320,1420
93835,200,120,80,80,160,0,640
93836,140,120,80,0,0,0,340
93837,180,140,120,80,160,0,680
93838,190,100,120,80,160,0,650
93839,200,120,120,160,320,0,920
93840,230,140,80,80,160,0,690
93841,220,120,40,80,0,0,460
93842,240,160,120,0,0,0,520
93843,170,120,80,160,160,0,690
93844,230,160,80,0,0,0,470
93845,200,160,160,160,160,0,840
93846,190,160,120,160,160,320,1110
93847,220,160,40,80,160,0,660
93848,190,160,160,160,0,0,670
93849,190,140,40,80,160,0,610
93850,220,160,120,160,160,0,820
93851,220,140,120,80,0,0,560
93852,170,120,120,160,320,0,890
93853,210,80,80,80,0,0,450
93854,210,160,200,80,160,0,810
93855,200,80,120,160,0,0,560
93856,170,100,80,80,0,0,430
93857,170,140,120,80,0,0,510
93858,190,140,80,160,0,0,570
93859,190,100,120,160,160,0,730
93860,180,140,80,0,0,0,400
93861,180,140,40,80,160,320,920
93862,180,160,80,0,0,0,420
93863,160,140,200,160,160,0,820
93864,230,180,80,160,160,0,810
93865,200,80,80,0,0,0,360
93866,190,120,160,240,160,0,870
93867,210,80,120,80,0,0,490
93868,210,100,80,80,0,0,470
93869,210,140,80,160,160,0,750
93870,190,120,120,160,160,320,1070
93871,180,120,40,0,0,0,340
93872,160,80,120,80,160,0,600
93873,210,180,80,80,160,0,710
93874,220,100,80,80,160,320,960
93875,210,100,80,80,160,0,630
93876,180,140,80,0,0,0,400
93877,160,80,120,160,320,0,840
93878,170,120,120,160,320,320,1210
93879,220,100,120,80,160,0,680
93880,210,140,40,80,160,0,630
93881,210,180,80,0,0,0,470
93882,160,160,80,160,320,320,1200
93883,180,120,40,0,0,0,340
93884,180,40,0,0,0,0,220
93885,190,180,160,240,160,0,930
93886,220,140,200,0,0,0,560
93887,180,120,120,80,160,0,660
93888,210,40,80,160,320,320,1130
93889,210,180,80,80,0,0,550
93890,180,160,80,80,0,0,500
93891,180,140,160,160,160,0,800
93892,180,140,160,160,320,0,960
93893,190,160,160,80,160,0,750
93894,150,120,120,160,160,0,710
93895,210,140,40,0,0,0,390
93896,240,160,80,0,0,0,480
93897,220,100,160,160,160,0,800
93898,200,140,120,160,320,0,940
93899,210,80,120,80,160,0,650
93900,160,100,80,80,0,0,420
93901,210,140,120,80,160,0,710
93902,200,140,120,240,160,320,1180
93903,170,120,160,80,0,0,530
93904,160,140,120,80,0,0,500
93905,200,160,160,80,160,0,760
93906,180,80,80,160,160,0,660
93907,190,160,120,0,0,0,470
93908,190,180,120,80,160,0,730
93909,150,160,200,160,160,320,1150
93910,170,140,200,160,320,320,1310
93911,190,80,120,80,0,0,470
93912,170,140,120,160,0,0,590
93913,190,140,80,80,160,0,650
93914,180,140,160,240,320,0,1040
93915,200,140,160,80,0,0,580
93916,200,140,120,80,0,0,540
93917,210,100,40,80,160,320,910
93918,250,180,120,240,320,320,1430
93919,180,100,80,80,160,0,600
93920,220,140,120,80,0,0,560
93921,240,180,80,80,160,0,740
93922,220,120,120,80,160,0,700
93923,170,80,80,0,0,0,330
93924,240,160,80,80,0,0,560
93925,170,140,40,0,0,0,350
93926,210,80,120,80,160,0,650
93927,170,100,80,80,160,0,590
93928,220,160,160,160,320,0,1020
93929,210,140,120,160,320,0,950
93930,170,80,40,80,0,0,370
93931,190,140,160,160,160,0,810
93932,210,100,80,160,160,0,710
93933,160,80,40,80,0,0,360
93934,200,160,120,80,160,0,720
93935,190,80,120,80,0,0,470
93936,220,140,80,0,0,0,440
93937,180,140,160,80,160,320,1040
93938,230,120,120,80,160,0,710
93939,180,120,160,160,0,0,620
93940,170,140,80,0,0,0,390
93941,230,180,160,80,160,0,810
93942,170,120,120,80,160,0,650
93943,190,120,160,80,160,320,1030
93944,190,120,160,240,160,0,870
93945,230,120,40,0,0,0,390
93946,230,160,80,80,160,320,1030
93947,190,100,40,0,0,0,330
93948,210,140,120,80,160,0,710
93949,190,140,160,80,0,0,570
93950,190,120,120,160,160,0,750
93951,250,120,120,160,160,320,1130
93952,190,120,160,80,160,320,1030
93953,210,100,120,160,0,0,590
93954,210,120,0,0,0,0,330
93955,210,100,80,80,160,0,630
93956,230,140,120,80,160,0,730
93957,200,120,80,80,160,0,640
93958,190,100,120,240,160,0,810
93959,210,60,40,0,0,0,310
93960,180,160,80,0,0,0,420
93961,180,160,80,80,0,0,500
93962,180,120,40,0,0,0,340
93963,230,140,80,160,160,0,770
93964,210,140,120,80,0,0,550
93965,190,160,120,80,160,320,1030
93966,220,100,80,0,0,0,400
93967,150,100,80,0,0,0,330
93968,180,140,160,160,160,0,800
93969,190,100,160,80,0,0,530
93970,220,160,160,240,0,0,780
93971,220,80,80,80,160,0,620
93972,210,140,160,240,320,0,1070
93973,230,180,80,80,160,0,730
93974,190,80,120,240,0,0,630
93975,190,140,80,80,0,0,490
93976,170,80,120,160,160,0,690
93977,210,140,40,0,0,0,390
93978,210,160,160,240,320,0,1090
93979,170,40,80,80,160,0,530
93980,180,120,120,160,160,0,740
93981,180,100,80,160,160,0,680
93982,200,100,160,160,160,320,1100
93983,200,140,80,0,0,0,420
93984,230,100,80,0,0,0,410
93985,220,120,120,80,160,320,1020
93986,180,120,80,0,0,0,380
93987,220,140,160,160,160,0,840
93988,220,80,80,80,0,0,460
93989,150,120,40,0,0,0,310
93990,220,160,80,80,160,0,700
93991,210,140,40,80,0,0,470
93992,180,60,80,80,160,0,560
93993,200,140,160,160,320,320,1300
93994,160,100,160,160,160,320,1060
93995,220,100,120,160,0,0,600
93996,200,120,160,80,160,0,720
93997,210,80,80,0,0,0,370
93998,190,160,120,160,160,0,790
93999,200,80,40,80,0,0,400
94000,200,140,80,80,160,0,660
94001,180,160,120,160,160,0,780
94002,170,100,80,160,320,0,830
94003,160,80,80,80,0,0,400
94004,210,80,80,80,160,320,930
94005,230,160,40,80,0,0,510
94006,200,140,120,80,0,0,540
94007,170,100,80,160,320,0,830
94008,180,100,120,80,160,0,640
94009,210,120,40,0,0,0,370
94010,250,120,160,80,0,0,610
94011,190,120,80,80,160,0,630
94012,200,80,40,0,0,0,320
94013,210,120,160,240,320,0,1050
94014,210,200,200,320,320,320,1570
94015,160,120,80,0,0,0,360
94016,160,60,80,0,0,0,300
94017,200,160,80,80,0,0,520
94018,180,140,160,160,160,320,1120
94019,190,80,120,80,160,0,630
94020,230,80,160,80,160,0,710
94021,180,100,120,160,320,0,880
94022,200,140,160,240,0,0,740
94023,230,160,160,160,320,0,1030
94024,200,120,80,80,160,0,640
94025,180,60,40,80,0,0,360
94026,200,80,80,0,0,0,360
94027,180,120,240,80,160,0,780
94028,140,120,120,0,0,0,380
94029,240,120,120,240,0,0,720
94030,210,140,120,0,0,0,470
94031,230,140,120,240,320,0,1050
94032,210,160,40,0,0,0,410
94033,170,160,200,160,320,0,1010
94034,210,80,40,80,0,0,410
94035,200,100,80,160,0,0,540
94036,180,80,40,80,160,0,540
94037,200,160,120,80,160,0,720
94038,170,100,120,160,160,0,710
94039,220,180,160,80,0,0,640
94040,180,180,160,80,0,0,600
94041,170,140,40,80,0,0,430
94042,190,60,0,0,0,0,250
94043,210,80,40,80,160,0,570
94044,210,120,120,80,160,0,690
94045,200,120,160,160,0,0,640
94046,200,140,120,160,320,0,940
94047,180,120,120,80,0,0,500
94048,190,140,80,80,160,0,650
94049,190,180,160,160,160,320,1170
94050,190,80,80,80,160,320,910
94051,170,160,80,160,160,0,730
94052,210,140,80,160,160,0,750
94053,160,140,120,80,0,0,500
94054,170,120,120,160,320,320,1210
94055,190,60,40,80,0,0,370
94056,160,100,160,240,320,320,1300
94057,150,160,120,80,160,0,670
94058,220,160,120,160,320,0,980
94059,160,100,80,80,0,0,420
94060,220,180,160,160,0,0,720
94061,190,200,80,80,160,0,710
94062,170,160,160,160,160,0,810
94063,220,140,80,80,0,0,520
94064,170,80,0,0,0,0,250
94065,210,100,80,80,160,0,630
94066,180,120,120,160,160,0,740
94067,200,140,80,80,160,0,660
94068,160,120,120,80,0,0,480
94069,160,140,160,160,160,0,780
94070,190,80,40,80,160,0,550
94071,200,100,80,80,160,0,620
94072,230,100,40,80,0,0,450
94073,200,100,80,80,0,0,460
94074,190,80,40,80,160,0,550
94075,170,80,80,160,320,320,1130
94076,210,100,80,160,160,0,710
94077,210,220,200,80,0,0,710
94078,230,180,80,0,0,0,490
94079,170,120,160,160,160,320,1090
94080,230,80,120,80,0,0,510
94081,170,60,40,80,160,0,510
94082,190,100,160,80,160,0,690
94083,150,100,120,0,0,0,370
94084,200,100,80,80,0,0,460
94085,170,80,40,0,0,0,290
94086,200,140,160,160,160,0,820
94087,180,40,40,0,0,0,260
94088,180,140,120,80,160,320,1000
94089,220,120,40,80,0,0,460
94090,170,100,120,240,160,0,790
94091,210,140,120,80,0,0,550
94092,200,100,40,80,160,0,580
94093,170,100,80,160,0,0,510
94094,150,100,40,80,160,0,530
94095,230,160,120,0,0,0,510
94096,200,120,120,160,160,0,760
94097,220,180,120,160,160,0,840
94098,150,120,80,160,320,320,1150
94099,180,120,80,80,0,0,460
94100,240,160,80,80,0,0,560
94101,230,200,160,240,320,0,1150
94102,220,160,200,160,160,0,900
94103,180,140,160,80,160,0,720
94104,170,60,40,0,0,0,270
94105,180,100,160,240,160,0,840
94106,240,120,120,80,0,0,560
94107,190,80,120,80,160,0,630
94108,170,120,40,80,0,0,410
94109,200,120,80,80,160,0,640
94110,220,100,80,0,0,0,400
94111,190,100,120,80,160,0,650
94112,210,80,80,80,0,0,450
94113,170,120,80,160,0,0,530
94114,210,120,80,160,0,0,570
94115,180,80,80,80,160,0,580
94116,210,100,40,80,160,0,590
94117,220,160,120,160,160,0,820
94118,210,100,80,160,0,0,550
94119,200,80,120,160,160,0,720
94120,180,100,80,0,0,0,360
94121,230,80,80,0,0,0,390
94122,230,180,120,80,0,0,610
94123,200,140,80,80,160,0,660
94124,200,140,120,160,320,0,940
94125,200,140,80,160,320,320,1220
94126,200,180,160,160,160,0,860
94127,210,140,160,80,0,0,590
94128,140,120,80,80,160,0,580
94129,220,100,160,160,320,320,1280
94130,190,120,80,80,160,320,950
94131,210,120,80,80,160,0,650
94132,220,160,160,80,160,0,780
94133,220,120,40,0,0,0,380
94134,200,60,80,80,160,0,580
94135,230,140,120,160,160,0,810
94136,200,140,160,240,160,0,900
94137,210,100,120,80,0,0,510
94138,200,120,200,80,160,0,760
94139,220,120,120,80,160,0,700
94140,180,60,40,80,160,0,520
94141,190,100,80,80,0,0,450
94142,200,180,80,80,160,0,700
94143,220,60,80,80,160,0,600
94144,200,160,120,0,0,0,480
94145,200,140,40,80,0,0,460
94146,200,120,80,80,160,0,640
94147,170,140,0,0,0,0,310
94148,210,100,40,0,0,0,350
94149,210,220,80,0,0,0,510
94150,160,160,200,0,0,0,520
94151,200,120,120,240,320,0,1000
94152,170,160,160,80,0,0,570
94153,170,200,160,160,160,0,850
94154,210,220,200,160,0,0,790
94155,170,140,160,160,0,0,630
94156,190,160,160,0,0,0,510
94157,220,100,40,80,0,0,440
94158,240,160,80,80,0,0,560
94159,200,180,160,0,0,0,540
94160,180,120,80,0,0,0,380
94161,230,160,120,80,160,0,750
94162,190,120,80,160,320,320,1190
94163,200,120,40,80,160,0,600
94164,200,80,80,80,0,0,440
94165,180,80,40,0,0,0,300
94166,180,140,80,80,160,0,640
94167,210,160,200,240,320,0,1130
94168,220,180,200,240,160,0,1000
94169,170,180,160,160,160,0,830
94170,180,120,120,160,160,0,740
94171,230,160,120,240,320,320,1390
94172,250,120,120,80,160,0,730
94173,240,160,200,160,160,0,920
94174,210,120,80,0,0,0,410
94175,180,60,40,0,0,0,280
94176,190,80,80,160,160,0,670
94177,240,140,80,80,160,0,700
94178,180,180,160,240,160,0,920
94179,200,100,80,0,0,0,380
94180,170,140,120,80,160,0,670
94181,190,120,40,0,0,0,350
94182,170,100,80,160,160,0,670
94183,190,40,40,0,0,0,270
94184,200,140,160,80,160,0,740
94185,190,140,120,80,160,0,690
94186,220,100,80,80,0,0,480
94187,140,120,120,160,160,0,700
94188,240,180,160,80,160,0,820
94189,200,120,120,80,160,0,680
94190,190,120,120,80,160,320,990
94191,180,100,80,160,0,0,520
94192,210,160,80,80,0,0,530
94193,210,120,120,80,0,0,530
94194,170,80,80,0,0,0,330
94195,210,120,240,80,160,320,1130
94196,220,160,80,0,0,0,460
94197,200,120,120,80,160,0,680
94198,210,140,160,160,160,0,830
94199,200,80,120,160,160,320,1040
94200,180,80,120,0,0,0,380
94201,190,100,80,160,160,0,690
94202,210,100,40,80,160,320,910
94203,210,180,200,160,0,0,750
94204,230,80,120,80,160,0,670
94205,190,80,80,80,160,320,910
94206,190,100,160,160,320,0,930
94207,170,120,80,160,160,0,690
94208,200,160,120,0,0,0,480
94209,180,100,80,0,0,0,360
94210,210,120,40,80,0,0,450
94211,220,100,40,80,160,0,600
94212,200,80,80,80,160,0,600
94213,200,120,40,0,0,0,360
94214,190,120,120,80,160,0,670
94215,220,160,40,0,0,0,420
94216,150,120,160,80,160,0,670
94217,210,140,120,80,160,0,710
94218,200,120,40,0,0,0,360
94219,230,140,160,80,0,0,610
94220,200,120,160,160,160,0,800
94221,190,160,120,0,0,0,470
94222,160,100,80,160,160,0,660
94223,190,140,80,0,0,0,410
94224,210,120,80,80,160,0,650
94225,220,140,160,160,160,0,840
94226,210,120,40,80,160,0,610
94227,240,120,80,80,160,0,680
94228,180,100,80,0,0,0,360
94229,200,100,80,160,160,0,700
94230,210,140,200,160,0,0,710
94231,210,120,80,160,160,0,730
94232,190,120,120,160,320,320,1230
94233,210,120,120,80,160,0,690
94234,210,140,160,160,160,0,830
94235,180,100,120,80,160,0,640
94236,200,160,120,240,320,0,1040
94237,180,140,120,0,0,0,440
94238,150,120,120,80,160,0,630
94239,210,120,120,80,0,0,530
94240,200,80,80,0,0,0,360
94241,170,100,80,0,0,0,350
94242,240,180,120,80,160,320,1100
94243,220,100,80,80,160,0,640
94244,190,80,120,0,0,0,390
94245,240,100,160,160,160,0,820
94246,150,80,40,80,160,320,830
94247,170,120,80,0,0,0,370
94248,200,140,160,160,0,0,660
94249,160,140,40,80,160,0,580
94250,190,80,40,80,160,0,550
94251,230,160,120,80,160,0,750
94252,170,120,80,80,160,0,610
94253,190,160,80,160,0,0,590
94254,170,100,80,0,0,0,350
94255,160,100,80,80,160,320,900
94256,210,160,160,80,0,0,610
94257,180,100,40,80,160,0,560
94258,210,160,80,80,160,0,690
94259,140,80,80,160,320,0,780
94260,220,120,200,160,320,0,1020
94261,230,120,80,160,320,0,910
94262,200,120,160,80,0,0,560
94263,240,100,80,160,0,0,580
94264,190,160,40,0,0,0,390
94265,190,120,120,0,0,0,430
94266,200,120,120,160,320,320,1240
94267,230,80,80,80,160,0,630
94268,240,60,80,160,160,0,700
94269,190,120,80,0,0,0,390
94270,170,60,80,80,0,0,390
94271,220,140,160,80,160,0,760
94272,180,140,160,160,0,0,640
94273,180,140,200,160,320,0,1000
94274,180,180,160,0,0,0,520
94275,170,120,120,240,160,0,810
94276,220,140,40,80,160,0,640
94277,220,100,80,80,0,0,480
94278,190,120,160,80,0,0,550
94279,210,100,0,0,0,0,310
94280,230,160,120,80,160,0,750
94281,170,120,200,80,160,0,730
94282,210,180,160,80,160,320,1110
94283,170,160,200,160,160,0,850
94284,200,120,120,80,0,0,520
94285,210,140,80,80,0,0,510
94286,240,140,120,160,160,0,820
94287,170,160,80,160,320,0,890
94288,210,100,120,160,160,0,750
94289,230,140,120,160,160,0,810
94290,210,160,80,0,0,0,450
94291,170,60,80,80,160,0,550
94292,220,100,80,80,0,0,480
94293,230,160,80,80,160,0,710
94294,250,100,120,80,160,0,710
94295,200,140,120,160,0,0,620
94296,180,80,160,240,320,0,980
94297,190,120,160,160,320,0,950
94298,200,100,80,160,160,0,700
94299,180,60,40,80,160,320,840
94300,170,80,80,80,160,0,570
94301,190,120,40,80,160,320,910
94302,180,80,80,80,160,0,580
94303,200,140,120,80,160,320,1020
94304,200,100,120,80,160,0,660
94305,170,120,160,80,160,0,690
94306,160,140,160,160,160,320,1100
94307,180,140,80,80,0,0,480
94308,210,200,80,80,160,0,730
94309,160,140,200,240,160,0,900
94310,190,120,40,80,160,0,590
94311,190,140,80,80,160,320,970
94312,200,160,200,160,160,0,880
94313,200,120,120,160,160,0,760
94314,210,120,160,0,0,0,490
94315,190,100,120,240,160,0,810
94316,200,180,80,80,160,0,700
94317,220,140,120,160,160,0,800
94318,200,120,80,80,160,0,640
94319,190,120,120,160,160,0,750
94320,190,120,40,80,160,0,590
94321,170,80,80,160,320,0,810
94322,140,120,120,80,160,0,620
94323,210,120,200,80,160,0,770
94324,190,140,120,80,160,0,690
94325,190,120,80,80,160,0,630
94326,210,160,160,80,0,0,610
94327,190,120,120,160,160,0,750
94328,170,160,80,0,0,0,410
94329,200,140,160,80,160,320,1060
94330,200,140,120,160,320,0,940
94331,190,120,80,0,0,0,390
94332,110,160,80,80,0,0,430
94333,160,60,80,80,0,0,380
94334,160,140,160,160,320,0,940
94335,180,100,120,240,160,320,1120
94336,190,80,40,0,0,0,310
94337,220,200,120,160,160,0,860
94338,170,120,120,80,0,0,490
94339,190,120,40,0,0,0,350
94340,220,140,120,160,320,320,1280
94341,190,120,40,80,160,320,910
94342,180,80,80,80,0,0,420
94343,220,180,120,240,320,0,1080
94344,180,140,160,160,160,0,800
94345,200,160,80,80,160,0,680
94346,210,140,80,160,160,0,750
94347,200,100,0,0,0,0,300
94348,160,80,40,80,160,0,520
94349,180,100,160,160,0,0,600
94350,220,140,120,0,0,0,480
94351,250,100,120,80,160,0,710
94352,230,100,120,160,160,320,1090
94353,170,80,40,0,0,0,290
94354,220,160,80,0,0,0,460
94355,170,100,40,0,0,0,310
94356,200,120,120,160,320,320,1240
94357,210,180,160,240,320,320,1430
94358,180,120,120,160,160,0,740
94359,210,140,120,80,0,0,550
94360,160,160,80,80,160,320,960
94361,190,120,120,80,160,0,670
94362,140,60,40,80,160,0,480
94363,200,80,80,0,0,0,360
94364,160,100,160,160,160,0,740
94365,180,60,0,0,0,0,240
94366,220,180,160,80,0,0,640
94367,210,80,120,80,0,0,490
94368,220,120,40,0,0,0,380
94369,190,160,120,160,160,0,790
94370,210,160,160,160,160,0,850
94371,160,140,40,80,0,0,420
94372,150,120,120,80,0,0,470
94373,210,100,80,80,160,0,630
94374,180,120,160,240,320,0,1020
94375,200,80,40,80,0,0,400
94376,220,100,80,80,160,0,640
94377,180,160,120,240,320,0,1020
94378,200,180,80,0,0,0,460
94379,190,80,80,80,0,0,430
94380,180,100,120,80,0,0,480
94381,220,140,80,160,160,0,760
94382,180,140,120,0,0,0,440
94383,200,180,160,240,160,0,940
94384,190,100,80,160,320,320,1170
94385,210,140,120,80,0,0,550
94386,190,120,80,80,0,0,470
94387,210,140,80,160,160,320,1070
94388,210,100,120,80,160,0,670
94389,170,120,120,160,160,320,1050
94390,180,140,120,80,160,0,680
94391,230,140,120,80,0,0,570
94392,180,120,120,80,160,0,660
94393,170,140,120,80,160,0,670
94394,160,100,80,160,160,0,660
94395,220,140,0,0,0,0,360
94396,190,120,40,80,160,0,590
94397,170,80,40,80,160,0,530
94398,160,80,120,160,0,0,520
94399,170,140,40,80,0,0,430
94400,190,80,80,80,0,0,430
94401,210,120,80,0,0,0,410
94402,180,120,160,80,160,0,700
94403,200,100,80,80,160,0,620
94404,160,120,120,80,160,0,640
94405,240,80,80,0,0,0,400
94406,220,160,80,80,160,320,1020
94407,190,100,40,80,160,0,570
94408,200,100,80,80,160,320,940
94409,210,140,40,80,0,0,470
94410,180,140,120,160,320,320,1240
94411,180,160,40,0,0,0,380
94412,190,160,120,160,320,320,1270
94413,200,160,120,160,160,0,800
94414,170,100,40,80,160,0,550
94415,230,140,80,80,0,0,530
94416,150,140,80,160,160,0,690
94417,210,200,80,80,0,0,570
94418,200,120,120,160,320,0,920
94419,180,120,120,80,0,0,500
94420,170,140,160,160,0,0,630
94421,160,140,160,160,160,0,780
94422,180,120,160,80,160,0,700
94423,170,100,120,80,0,0,470
94424,230,200,160,160,160,320,1230
94425,200,120,120,160,160,0,760
94426,180,120,120,160,160,0,740
94427,160,120,120,160,320,0,880
94428,190,100,80,80,160,0,610
94429,170,80,80,80,160,0,570
94430,190,140,120,80,160,320,1010
94431,170,140,160,80,0,0,550
94432,160,120,120,80,0,0,480
94433,180,180,160,240,0,0,760
94434,160,20,0,0,0,0,180
94435,180,140,200,160,160,320,1160
94436,200,160,120,160,160,0,800
94437,190,120,120,160,160,320,1070
94438,220,160,120,160,160,0,820
94439,190,100,80,80,0,0,450
94440,230,140,120,80,160,0,730
94441,190,140,80,160,160,0,730
94442,260,200,240,160,0,0,860
94443,210,100,80,80,160,0,630
94444,180,140,200,160,160,320,1160
94445,170,100,120,80,160,320,950
94446,160,160,120,80,160,0,680
94447,210,160,160,160,160,0,850
94448,170,140,160,160,0,0,630
94449,170,100,0,0,0,0,270
94450,180,120,120,160,320,320,1220
94451,150,100,120,0,0,0,370
94452,210,140,160,160,160,0,830
94453,190,120,40,0,0,0,350
94454,230,140,80,80,0,0,530
94455,160,100,80,80,0,0,420
94456,230,140,160,240,160,0,930
94457,150,100,80,80,160,0,570
94458,200,100,40,80,160,0,580
94459,200,100,120,0,0,0,420
94460,200,80,120,160,320,0,880
94461,190,100,80,80,160,0,610
94462,180,120,120,0,0,0,420
94463,170,120,120,0,0,0,410
94464,160,120,120,80,0,0,480
94465,180,120,160,80,160,0,700
94466,220,160,80,80,160,0,700
94467,210,80,160,160,160,0,770
94468,230,120,0,0,0,0,350
94469,190,140,120,0,0,0,450
94470,180,120,80,80,160,320,940
94471,220,120,80,0,0,0,420
94472,120,100,80,80,160,0,540
94473,200,140,160,160,160,0,820
94474,200,100,80,0,0,0,380
94475,250,160,120,80,160,0,770
94476,250,120,80,0,0,0,450
94477,220,180,200,240,0,0,840
94478,230,200,200,80,160,0,870
94479,200,120,160,160,160,0,800
94480,190,100,120,80,160,0,650
94481,200,120,80,80,0,0,480
94482,230,160,160,80,0,0,630
94483,180,140,120,80,0,0,520
94484,230,140,160,240,160,0,930
94485,170,100,120,80,160,320,950
94486,220,160,200,80,160,0,820
94487,210,120,80,160,320,0,890
94488,190,100,80,160,160,0,690
94489,220,120,160,160,160,320,1140
94490,230,220,120,80,160,0,810
94491,210,80,80,160,0,0,530
94492,170,100,0,0,0,0,270
94493,230,180,160,240,320,320,1450
94494,220,120,120,0,0,0,460
94495,190,60,80,160,160,0,650
94496,220,120,40,0,0,0,380
94497,220,120,80,80,0,0,500
94498,240,140,40,80,0,0,500
94499,200,160,160,160,160,0,840
94500,190,160,160,80,160,0,750
94501,190,140,160,240,160,0,890
94502,220,180,160,80,160,0,800
94503,210,180,160,240,160,0,950
94504,190,120,120,80,160,0,670
94505,190,120,80,160,160,320,1030
94506,200,140,160,160,160,0,820
94507,170,120,80,160,160,320,1010
94508,170,120,120,160,0,0,570
94509,190,180,120,0,0,0,490
94510,210,140,120,80,160,320,1030
94511,240,160,80,80,160,0,720
94512,170,160,80,160,320,0,890
94513,200,80,80,160,0,0,520
94514,160,120,80,160,160,320,1000
94515,200,140,40,80,160,0,620
94516,200,100,120,160,320,0,900
94517,190,160,160,80,0,0,590
94518,180,60,80,80,160,0,560
94519,190,160,80,160,320,0,910
94520,240,160,160,160,320,320,1360
94521,190,180,160,80,160,0,770
94522,210,180,200,160,160,0,910
94523,200,140,160,80,0,0,580
94524,260,140,120,160,0,0,680
94525,190,80,40,0,0,0,310
94526,230,160,120,160,160,0,830
94527,200,160,200,160,320,320,1360
94528,220,120,160,160,320,0,980
94529,180,80,80,160,0,0,500
94530,160,160,120,80,160,0,680
94531,180,160,160,160,160,0,820
94532,210,160,80,80,0,0,530
94533,210,140,80,160,0,0,590
94534,200,160,80,80,160,320,1000
94535,200,120,120,80,160,0,680
94536,160,60,80,0,0,0,300
94537,230,140,120,160,320,0,970
94538,180,140,160,160,160,0,800
94539,210,140,120,80,160,320,1030
94540,190,100,80,80,160,0,610
94541,190,140,120,80,160,0,690
94542,250,160,120,80,160,0,770
94543,200,160,40,80,0,0,480
94544,180,140,160,80,0,0,560
94545,200,100,120,160,320,0,900
94546,230,160,120,80,160,0,750
94547,220,180,120,0,0,0,520
94548,230,80,120,80,160,320,990
94549,200,140,120,160,160,0,780
94550,170,120,200,240,320,320,1370
94551,180,100,80,160,320,0,840
94552,190,120,80,80,0,0,470
94553,190,160,200,160,160,0,870
94554,220,180,120,160,0,0,680
94555,210,140,120,0,0,0,470
94556,250,100,80,0,0,0,430
94557,190,140,80,0,0,0,410
94558,190,120,120,160,320,0,910
94559,210,140,120,80,160,0,710
94560,170,120,80,0,0,0,370
94561,170,140,120,160,0,0,590
94562,230,120,80,160,160,0,750
94563,160,140,80,160,160,0,700
94564,220,120,120,80,0,0,540
94565,200,140,160,80,0,0,580
94566,210,140,80,0,0,0,430
94567,230,80,80,160,160,0,710
94568,200,120,120,160,320,0,920
94569,200,100,80,80,160,320,940
94570,250,180,80,0,0,0,510
94571,220,40,80,80,0,0,420
94572,220,160,120,160,160,0,820
94573,200,120,80,0,0,0,400
94574,170,60,40,80,160,0,510
94575,200,140,120,0,0,0,460
94576,240,100,80,80,160,0,660
94577,180,120,80,0,0,0,380
94578,250,80,160,160,320,0,970
94579,220,180,120,160,320,0,1000
94580,190,100,40,80,0,0,410
94581,190,160,80,0,0,0,430
94582,190,80,80,80,160,0,590
94583,160,80,80,80,160,0,560
94584,170,100,160,160,0,0,590
94585,180,80,40,0,0,0,300
94586,180,80,80,80,0,0,420
94587,200,60,80,80,160,0,580
94588,190,140,200,160,160,0,850
94589,170,160,80,160,320,0,890
94590,210,120,120,240,320,0,1010
94591,210,140,120,80,160,0,710
94592,190,80,120,240,320,320,1270
94593,230,140,40,80,0,0,490
94594,200,80,120,240,320,0,960
94595,190,80,80,160,160,0,670
94596,190,100,40,0,0,0,330
94597,230,140,120,80,160,0,730
94598,230,180,120,0,0,0,530
94599,170,100,120,80,0,0,470
94600,210,160,80,80,0,0,530
94601,230,140,120,80,0,0,570
94602,160,140,120,160,0,0,580
94603,190,160,160,240,0,0,750
94604,160,120,120,160,160,0,720
94605,150,80,0,0,0,0,230
94606,200,100,160,160,160,0,780
94607,220,100,120,160,160,0,760
94608,170,120,80,160,0,0,530
94609,220,120,80,0,0,0,420
94610,190,140,80,80,160,320,970
94611,220,160,120,80,160,320,1060
94612,170,160,120,80,0,0,530
94613,180,80,80,0,0,0,340
94614,200,120,120,160,0,0,600
94615,200,160,80,0,0,0,440
94616,250,140,120,80,160,320,1070
94617,150,120,200,160,0,0,630
94618,260,120,120,160,160,0,820
94619,220,40,0,0,0,0,260
94620,200,100,160,240,160,320,1180
94621,150,140,40,0,0,0,330
94622,210,160,160,80,160,0,770
94623,200,120,120,0,0,0,440
94624,240,200,200,80,0,0,720
94625,180,180,120,160,160,0,800
94626,210,100,80,80,160,0,630
94627,210,140,80,80,160,320,990
94628,210,140,160,240,160,0,910
94629,220,100,120,160,320,320,1240
94630,220,140,120,80,160,0,720
94631,200,100,120,80,160,0,660
94632,240,120,120,80,160,0,720
94633,200,200,120,160,160,0,840
94634,170,120,80,80,160,0,610
94635,230,120,160,80,0,0,590
94636,190,100,200,80,160,0,730
94637,180,40,0,0,0,0,220
94638,210,140,120,160,160,0,790
94639,200,120,120,0,0,0,440
94640,170,100,120,80,160,0,630
94641,190,140,80,80,160,0,650
94642,150,100,80,80,0,0,410
94643,190,60,40,80,0,0,370
94644,200,120,40,0,0,0,360
94645,200,100,160,80,0,0,540
94646,170,140,80,0,0,0,390
94647,190,140,120,160,320,320,1250
94648,240,80,40,80,160,0,600
94649,190,80,80,0,0,0,350
94650,270,200,160,80,160,0,870
94651,180,120,120,80,0,0,500
94652,210,140,80,80,160,0,670
94653,190,100,120,80,0,0,490
94654,200,140,240,240,160,0,980
94655,210,120,40,0,0,0,370
94656,150,120,160,240,320,0,990
94657,250,120,120,80,160,0,730
94658,190,80,120,160,320,320,1190
94659,230,180,80,80,0,0,570
94660,200,120,160,160,160,0,800
94661,200,120,120,160,160,0,760
94662,180,180,40,80,160,0,640
94663,210,160,200,80,0,0,650
94664,210,100,80,80,0,0,470
94665,210,120,80,160,320,320,1210
94666,230,100,80,160,160,320,1050
94667,170,140,120,80,0,0,510
94668,210,120,120,240,320,0,1010
94669,170,160,160,160,0,0,650
94670,210,100,80,0,0,0,390
94671,250,160,160,80,160,320,1130
94672,230,120,120,160,320,0,950
94673,220,140,80,160,160,0,760
94674,180,160,80,80,160,0,660
94675,200,120,80,80,0,0,480
94676,230,160,160,0,0,0,550
94677,170,120,120,160,160,320,1050
94678,210,60,80,160,160,0,670
94679,180,140,80,80,160,0,640
94680,180,100,80,160,160,0,680
94681,180,120,160,80,0,0,540
94682,200,160,160,160,320,320,1320
94683,240,120,80,80,0,0,520
94684,180,140,160,160,160,0,800
94685,210,80,80,80,160,0,610
94686,200,140,80,0,0,0,420
94687,230,140,80,0,0,0,450
94688,210,120,80,0,0,0,410
94689,220,120,40,80,160,320,940
94690,200,100,80,160,160,0,700
94691,200,100,80,0,0,0,380
94692,190,180,80,80,160,0,690
94693,250,140,200,240,160,0,990
94694,200,160,160,160,320,0,1000
94695,220,120,120,160,0,0,620
94696,200,100,80,160,320,320,1180
94697,200,80,120,0,0,0,400
94698,170,100,40,80,0,0,390
94699,220,120,120,160,160,0,780
94700,170,80,40,80,0,0,370
94701,150,120,80,160,320,0,830
94702,230,120,120,160,160,0,790
94703,210,100,80,80,160,320,950
94704,160,100,80,80,160,0,580
94705,200,140,80,80,160,320,980
94706,200,120,160,160,160,0,800
94707,220,160,120,160,320,0,980
94708,190,80,40,0,0,0,310
94709,140,100,120,80,0,0,440
94710,210,80,40,80,160,0,570
94711,190,100,80,160,160,0,690
94712,190,120,120,160,320,320,1230
94713,200,160,80,80,0,0,520
94714,210,140,120,80,0,0,550
94715,200,120,80,80,160,0,640
94716,220,140,40,80,160,320,960
94717,190,160,120,80,160,320,1030
94718,190,100,120,80,0,0,490
94719,200,160,160,80,0,0,600
94720,180,140,80,80,0,0,480
94721,210,160,200,160,0,0,730
94722,190,100,80,0,0,0,370
94723,160,80,120,160,320,320,1160
94724,210,120,160,160,320,0,970
94725,180,160,120,160,0,0,620
94726,190,100,120,80,160,0,650
94727,210,100,80,160,160,0,710
94728,200,100,160,240,160,0,860
94729,200,180,200,160,160,320,1220
94730,170,100,80,80,160,0,590
94731,240,80,40,0,0,0,360
94732,230,120,120,160,160,0,790
94733,150,60,120,80,160,0,570
94734,210,120,80,0,0,0,410
94735,180,120,160,160,0,0,620
94736,200,180,120,160,160,0,820
94737,230,220,80,80,160,0,770
94738,230,180,160,240,320,0,1130
94739,170,120,120,80,160,0,650
94740,190,120,80,80,160,320,950
94741,150,120,80,0,0,0,350
94742,190,120,40,80,160,0,590
94743,220,100,120,160,160,0,760
94744,180,80,40,80,0,0,380
94745,180,140,120,160,160,0,760
94746,200,100,80,160,0,0,540
94747,180,120,80,80,160,0,620
94748,190,120,160,80,160,0,710
94749,250,100,40,80,0,0,470
94750,190,100,0,0,0,0,290
94751,190,120,160,80,160,0,710
94752,180,140,120,0,0,0,440
94753,210,100,40,80,160,0,590
94754,180,120,40,0,0,0,340
94755,220,140,160,80,160,320,1080
94756,160,120,120,0,0,0,400
94757,180,100,120,160,320,0,880
94758,220,100,40,80,160,320,920
94759,190,160,120,80,0,0,550
94760,190,100,80,0,0,0,370
94761,190,140,40,0,0,0,370
94762,230,140,40,0,0,0,410
94763,200,100,0,0,0,0,300
94764,230,100,80,160,160,0,730
94765,200,180,200,160,160,0,900
94766,220,100,200,160,0,0,680
94767,180,120,160,80,160,0,700
94768,200,160,120,160,320,320,1280
94769,200,140,120,80,160,0,700
94770,170,160,200,160,0,0,690
94771,150,80,80,80,160,0,550
94772,190,40,40,0,0,0,270
94773,200,120,160,240,320,320,1360
94774,160,120,160,160,160,0,760
94775,200,140,200,160,320,0,1020
94776,190,160,120,80,0,0,550
94777,200,140,120,80,160,0,700
94778,200,100,120,80,160,0,660
94779,220,180,120,0,0,0,520
94780,170,80,80,160,160,0,650
94781,200,120,160,160,320,0,960
94782,210,160,120,160,160,0,810
94783,210,100,160,80,0,0,550
94784,210,100,120,240,320,320,1310
94785,220,120,80,80,0,0,500
94786,200,80,80,160,320,0,840
94787,170,120,80,80,160,0,610
94788,170,140,80,0,0,0,390
94789,220,160,40,80,160,320,980
94790,230,140,120,160,160,0,810
94791,210,140,80,80,160,0,670
94792,220,120,160,80,160,0,740
94793,190,120,120,80,160,0,670
94794,190,160,120,160,160,0,790
94795,170,100,80,80,0,0,430
94796,200,160,80,80,160,0,680
94797,190,160,40,0,0,0,390
94798,220,180,160,160,160,0,880
94799,170,140,160,80,0,0,550
94800,190,140,120,80,160,320,1010
94801,160,100,80,80,160,320,900
94802,180,100,80,0,0,0,360
94803,200,140,40,0,0,0,380
94804,200,140,120,160,320,0,940
94805,190,160,120,0,0,0,470
94806,180,80,80,80,160,0,580
94807,160,120,120,80,0,0,480
94808,190,80,0,0,0,0,270
94809,190,120,160,80,160,0,710
94810,180,100,40,80,160,0,560
94811,210,120,80,0,0,0,410
94812,150,100,120,240,320,0,930
94813,180,80,120,80,160,320,940
94814,210,140,80,80,160,0,670
94815,160,160,120,80,160,0,680
94816,220,80,0,0,0,0,300
94817,170,80,40,80,0,0,370
94818,180,60,40,80,0,0,360
94819,120,120,120,80,160,0,600
94820,220,100,80,80,0,0,480
94821,190,100,80,80,160,0,610
94822,170,140,120,80,160,0,670
94823,240,160,200,160,160,0,920
94824,200,180,120,160,160,0,820
94825,180,100,40,0,0,0,320
94826,220,100,0,0,0,0,320
94827,200,180,80,80,0,0,540
94828,160,100,0,0,0,0,260
94829,150,120,120,160,160,0,710
94830,210,160,200,160,160,0,890
94831,230,160,40,0,0,0,430
94832,180,120,160,160,0,0,620
94833,220,160,80,0,0,0,460
94834,220,100,40,80,160,0,600
94835,170,80,120,160,320,320,1170
94836,160,60,40,0,0,0,260
94837,190,100,40,0,0,0,330
94838,230,60,120,0,0,0,410
94839,190,140,0,0,0,0,330
94840,200,120,80,160,160,320,1040
94841,200,140,160,160,160,0,820
94842,180,120,80,160,0,0,540
94843,240,160,80,80,160,0,720
94844,160,100,120,80,0,0,460
94845,180,120,120,160,0,0,580
94846,230,80,80,80,160,320,950
94847,240,160,120,80,160,320,1080
94848,200,120,200,160,0,0,680
94849,180,140,80,160,160,0,720
94850,220,200,160,80,0,0,660
94851,200,100,40,80,160,0,580
94852,160,120,80,80,0,0,440
94853,220,140,40,0,0,0,400
94854,220,120,80,0,0,0,420
94855,190,140,80,80,160,0,650
94856,210,140,120,160,0,0,630
94857,230,200,120,160,320,0,1030
94858,210,120,80,160,0,0,570
94859,210,120,120,160,160,0,770
94860,150,120,120,240,320,0,950
94861,200,140,80,80,160,320,980
94862,200,140,200,80,160,0,780
94863,210,120,160,80,0,0,570
94864,190,180,160,160,160,0,850
94865,190,160,120,80,160,0,710
94866,160,80,120,240,320,0,920
94867,210,120,120,160,160,0,770
94868,140,60,120,160,160,0,640
94869,180,180,160,80,160,0,760
94870,210,100,80,160,0,0,550
94871,160,140,80,160,160,0,700
94872,210,160,160,240,320,0,1090
94873,210,120,160,80,160,0,730
94874,170,140,120,160,160,0,750
94875,200,140,200,240,0,0,780
94876,160,80,40,80,160,320,840
94877,180,140,160,80,160,0,720
94878,120,40,80,160,160,0,560
94879,160,120,120,160,160,0,720
94880,190,80,80,160,320,0,830
94881,160,120,80,80,0,0,440
94882,200,180,160,80,160,0,780
94883,200,140,120,240,320,0,1020
94884,220,80,40,80,160,0,580
94885,230,140,80,160,160,0,770
94886,190,120,120,240,160,0,830
94887,190,100,120,80,160,0,650
94888,180,140,80,80,160,320,960
94889,170,160,200,80,160,0,770
94890,200,80,0,0,0,0,280
94891,210,140,120,160,0,0,630
94892,210,160,200,80,160,320,1130
94893,200,140,40,80,0,0,460
94894,210,100,160,0,0,0,470
94895,150,60,40,80,160,320,810
94896,200,120,120,80,0,0,520
94897,190,160,80,160,160,0,750
94898,170,80,120,80,160,0,610
94899,210,60,80,160,160,0,670
94900,160,120,80,0,0,0,360
94901,180,140,120,160,160,0,760
94902,230,140,120,240,320,0,1050
94903,210,160,40,80,160,0,650
94904,180,100,160,240,320,0,1000
94905,230,140,120,160,160,0,810
94906,190,140,160,240,320,320,1370
94907,160,120,80,0,0,0,360
94908,210,160,120,80,160,320,1050
94909,210,120,80,80,160,0,650
94910,200,100,120,80,160,0,660
94911,240,120,120,240,160,0,880
94912,190,100,40,0,0,0,330
94913,210,200,120,0,0,0,530
94914,200,100,40,0,0,0,340
94915,210,120,120,80,0,0,530
94916,170,40,80,80,0,0,370
94917,180,80,80,0,0,0,340
94918,200,140,160,240,320,0,1060
94919,200,100,120,80,0,0,500
94920,210,100,80,80,0,0,470
94921,180,180,200,160,160,0,880
94922,190,100,40,0,0,0,330
94923,190,120,120,160,160,0,750
94924,190,140,120,160,0,0,610
94925,150,100,160,0,0,0,410
94926,200,100,80,0,0,0,380
94927,200,100,160,80,0,0,540
94928,250,180,200,240,160,0,1030
94929,210,100,0,0,0,0,310
94930,220,140,120,80,160,0,720
94931,150,120,160,160,320,0,910
94932,210,180,120,80,0,0,590
94933,160,100,80,0,0,0,340
94934,180,180,160,160,320,320,1320
94935,200,140,80,80,160,0,660
94936,230,80,80,160,160,0,710
94937,200,160,120,80,160,0,720
94938,200,100,120,160,160,0,740
94939,200,40,0,0,0,0,240
94940,200,140,80,160,160,0,740
94941,220,120,120,80,160,0,700
94942,190,120,80,80,160,0,630
94943,150,120,160,160,0,0,590
94944,180,160,160,160,160,0,820
94945,180,120,80,160,0,0,540
94946,150,140,120,160,160,0,730
94947,210,100,40,80,160,0,590
94948,170,80,40,0,0,0,290
94949,160,80,40,0,0,0,280
94950,230,160,120,80,0,0,590
94951,210,100,80,80,0,0,470
94952,180,140,160,160,160,0,800
94953,180,140,120,0,0,0,440
94954,210,160,120,80,0,0,570
94955,200,140,160,240,320,0,1060
94956,210,180,120,160,320,0,990
94957,200,100,80,80,160,0,620
94958,210,140,120,0,0,0,470
94959,200,140,160,240,320,0,1060
94960,220,100,40,80,0,0,440
94961,180,120,120,80,0,0,500
94962,210,160,120,160,320,320,1290
94963,190,120,40,0,0,0,350
94964,240,160,120,80,0,0,600
94965,220,140,40,0,0,0,400
94966,150,60,40,80,0,0,330
94967,160,100,120,160,160,0,700
94968,190,100,80,80,160,0,610
94969,200,160,40,80,160,0,640
94970,160,60,120,160,160,0,660
94971,190,120,40,80,160,0,590
94972,220,180,160,240,160,0,960
94973,180,120,160,80,160,0,700
94974,220,160,240,240,160,0,1020
94975,190,140,160,240,160,0,890
94976,210,100,200,80,160,0,750
94977,190,140,80,80,160,0,650
94978,210,100,120,0,0,0,430
94979,200,160,120,80,0,0,560
94980,220,120,120,160,320,320,1260
94981,200,100,80,80,0,0,460
94982,210,100,80,80,160,320,950
94983,220,180,200,160,160,0,920
94984,200,80,80,0,0,0,360
94985,220,180,120,80,160,0,760
94986,200,100,120,160,160,0,740
94987,190,100,40,0,0,0,330
94988,190,120,80,160,160,0,710
94989,170,120,120,160,320,0,890
94990,220,140,160,80,160,0,760
94991,210,80,80,80,160,320,930
94992,180,120,40,80,0,0,420
94993,210,60,0,0,0,0,270
94994,140,60,80,80,160,0,520
94995,180,120,80,80,0,0,460
94996,200,120,120,160,320,320,1240
94997,170,140,120,160,160,0,750
94998,210,160,160,240,0,0,770
94999,210,80,120,160,160,0,730
95000,180,120,160,160,160,0,780
95001,190,140,120,80,0,0,530
95002,220,120,160,160,160,0,820
95003,160,100,120,160,320,320,1180
95004,190,120,120,160,160,0,750
95005,210,100,120,80,160,0,670
95006,220,140,160,80,160,320,1080
95007,280,160,160,80,160,320,1160
95008,190,80,80,80,160,0,590
95009,160,80,120,160,0,0,520
95010,170,80,80,80,0,0,410
95011,130,60,0,0,0,0,190
95012,200,140,200,160,160,0,860
95013,190,100,80,80,160,0,610
95014,170,140,120,80,0,0,510
95015,200,140,120,240,320,0,1020
95016,230,140,160,160,160,320,1170
95017,190,80,80,80,160,0,590
95018,150,120,40,80,160,0,550
95019,220,100,80,80,160,0,640
95020,200,140,40,80,0,0,460
95021,170,140,80,80,160,320,950
95022,200,100,120,160,320,320,1220
95023,240,120,0,0,0,0,360
95024,180,140,120,80,160,320,1000
95025,220,120,120,80,160,320,1020
95026,190,100,120,160,0,0,570
95027,190,100,80,0,0,0,370
95028,180,80,120,160,160,320,1020
95029,180,100,160,240,160,0,840
95030,240,140,120,0,0,0,500
95031,200,100,80,80,0,0,460
95032,210,120,160,160,160,0,810
95033,160,100,120,240,160,320,1100
95034,240,140,40,0,0,0,420
95035,220,120,120,160,160,0,780
95036,210,120,120,0,0,0,450
95037,180,100,80,80,0,0,440
95038,190,140,80,160,320,0,890
95039,200,140,120,0,0,0,460
95040,230,100,80,80,160,0,650
95041,190,80,80,80,0,0,430
95042,190,140,200,240,160,320,1250
95043,210,160,40,80,160,0,650
95044,200,140,120,160,160,0,780
95045,190,120,80,80,0,0,470
95046,230,100,40,80,0,0,450
95047,200,120,80,80,160,0,640
95048,190,100,80,80,0,0,450
95049,180,140,40,80,160,320,920
95050,190,120,80,80,160,0,630
95051,150,80,80,80,0,0,390
95052,200,140,120,80,160,0,700
95053,210,100,80,0,0,0,390
95054,170,140,160,160,160,0,790
95055,150,40,40,80,160,0,470
95056,200,180,120,80,0,0,580
95057,230,60,40,80,160,0,570
95058,230,160,40,80,160,0,670
95059,200,120,160,80,160,0,720
95060,160,160,160,160,160,0,800
95061,170,120,160,80,0,0,530
95062,180,100,80,160,160,0,680
95063,200,100,160,240,160,0,860
95064,180,40,0,0,0,0,220
95065,200,160,120,240,160,0,880
95066,190,160,200,240,320,0,1110
95067,230,80,80,160,160,0,710
95068,180,120,80,80,0,0,460
95069,150,100,120,160,160,0,690
95070,230,100,160,80,0,0,570
95071,240,160,80,80,160,320,1040
95072,170,120,0,0,0,0,290
95073,210,100,120,160,320,0,910
95074,200,80,80,80,160,0,600
95075,160,60,120,160,160,320,980
95076,230,160,160,240,0,0,790
95077,160,60,80,160,160,320,940
95078,190,80,120,160,160,0,710
95079,210,120,80,80,160,320,970
95080,200,140,120,80,0,0,540
95081,210,100,120,160,160,0,750
95082,240,200,200,160,160,0,960
95083,190,120,160,160,0,0,630
95084,220,180,120,0,0,0,520
95085,220,160,40,80,0,0,500
95086,150,160,160,160,320,320,1270
95087,210,160,200,160,320,320,1370
95088,180,140,80,80,0,0,480
95089,180,160,120,160,320,320,1260
95090,220,80,40,80,160,320,900
95091,190,80,80,80,160,320,910
95092,170,80,40,0,0,0,290
95093,200,120,80,80,160,320,960
95094,220,160,160,160,160,320,1180
95095,180,120,160,160,320,0,940
95096,200,140,120,80,160,320,1020
95097,210,100,80,80,160,0,630
95098,190,100,80,0,0,0,370
95099,220,160,160,80,0,0,620
95100,170,140,120,80,160,0,670
95101,200,180,160,240,320,0,1100
95102,200,160,160,160,0,0,680
95103,190,140,200,80,160,0,770
95104,190,120,120,80,160,320,990
95105,180,80,80,80,0,0,420
95106,200,180,200,160,160,0,900
95107,190,140,120,160,160,0,770
95108,240,160,120,0,0,0,520
95109,190,120,120,160,160,0,750
95110,170,80,40,0,0,0,290
95111,190,80,40,80,160,0,550
95112,190,120,120,160,160,0,750
95113,200,140,80,80,160,0,660
95114,200,100,40,0,0,0,340
95115,210,160,160,80,160,0,770
95116,210,100,160,160,160,0,790
95117,170,80,40,80,160,0,530
95118,200,100,200,160,160,0,820
95119,220,120,120,80,160,0,700
95120,190,140,80,160,0,0,570
95121,190,120,80,80,160,0,630
95122,180,140,120,240,320,0,1000
95123,190,120,160,80,160,0,710
95124,210,140,120,0,0,0,470
95125,190,140,120,160,160,0,770
95126,200,160,160,160,320,0,1000
95127,190,120,80,160,320,0,870
95128,220,200,200,240,160,0,1020
95129,170,140,120,160,160,0,750
95130,200,140,80,160,160,0,740
95131,190,140,40,80,0,0,450
95132,160,80,80,80,0,0,400
95133,220,140,40,0,0,0,400
95134,200,60,80,80,160,320,900
95135,180,160,120,160,320,320,1260
95136,200,100,120,160,320,0,900
95137,210,160,80,80,0,0,530
95138,220,120,120,80,160,0,700
95139,180,120,120,80,160,0,660
95140,200,120,120,160,320,0,920
95141,190,120,40,80,160,320,910
95142,190,120,80,80,160,0,630
95143,190,100,80,160,320,0,850
95144,210,60,40,80,0,0,390
95145,200,100,80,80,160,0,620
95146,210,160,160,80,0,0,610
95147,200,140,200,160,160,0,860
95148,200,140,120,80,0,0,540
95149,200,120,40,80,0,0,440
95150,190,140,80,80,160,0,650
95151,220,80,80,80,160,0,620
95152,200,120,80,80,0,0,480
95153,240,100,80,160,160,0,740
95154,200,160,120,80,0,0,560
95155,180,100,160,160,320,0,920
95156,170,60,80,80,0,0,390
95157,180,100,120,160,160,0,720
95158,200,120,80,160,320,0,880
95159,190,140,80,80,0,0,490
95160,200,100,80,160,160,0,700
95161,180,180,120,160,320,0,960
95162,180,80,40,0,0,0,300
95163,190,120,160,80,0,0,550
95164,170,120,120,160,0,0,570
95165,190,180,120,80,0,0,570
95166,240,140,120,0,0,0,500
95167,200,140,160,240,320,0,1060
95168,220,120,120,240,320,320,1340
95169,180,100,80,0,0,0,360
95170,200,140,120,80,0,0,540
95171,220,120,160,160,160,0,820
95172,200,120,40,0,0,0,360
95173,160,100,160,160,0,0,580
95174,230,200,160,160,320,320,1390
95175,180,60,40,80,160,0,520
95176,190,120,120,80,160,320,990
95177,190,140,160,160,160,0,810
95178,180,60,80,0,0,0,320
95179,200,100,120,160,160,0,740
95180,180,60,40,80,0,0,360
95181,210,80,80,80,160,320,930
95182,190,100,120,80,160,0,650
95183,200,100,80,160,160,0,700
95184,210,120,120,160,160,0,770
95185,160,100,120,80,160,0,620
95186,190,80,40,0,0,0,310
95187,150,140,80,80,160,0,610
95188,200,120,160,80,0,0,560
95189,180,140,160,160,160,0,800
95190,210,180,160,80,0,0,630
95191,230,100,40,80,160,0,610
95192,250,140,120,160,160,0,830
95193,210,160,80,0,0,0,450
95194,240,180,160,0,0,0,580
95195,190,120,120,80,160,0,670
95196,140,120,160,240,320,0,980
95197,130,80,40,80,160,0,490
95198,150,140,120,160,320,0,890
95199,220,160,160,240,160,0,940
95200,210,160,80,80,160,0,690
95201,190,140,120,80,0,0,530
95202,210,120,40,80,0,0,450
95203,190,80,120,80,160,0,630
95204,210,120,120,80,160,0,690
95205,190,120,120,160,160,0,750
95206,190,120,40,80,160,320,910
95207,200,140,120,80,0,0,540
95208,230,100,120,80,160,0,690
95209,190,120,160,160,160,0,790
95210,190,140,80,160,320,0,890
95211,220,160,120,80,160,0,740
95212,220,180,160,240,160,0,960
95213,240,120,80,80,0,0,520
95214,220,180,160,240,160,0,960
95215,230,60,40,80,0,0,410
95216,220,100,120,160,320,0,920
95217,210,100,0,0,0,0,310
95218,210,140,160,240,0,0,750
95219,150,40,40,0,0,0,230
95220,230,120,80,80,160,0,670
95221,230,120,120,160,160,320,1110
95222,210,100,120,80,0,0,510
95223,220,140,80,0,0,0,440
95224,170,100,160,160,160,320,1070
95225,200,120,120,240,160,0,840
95226,170,60,80,160,160,0,630
95227,190,120,80,80,0,0,470
95228,190,140,0,0,0,0,330
95229,210,180,120,0,0,0,510
95230,170,100,80,160,160,320,990
95231,240,120,120,80,160,0,720
95232,180,160,160,160,160,0,820
95233,160,100,80,80,160,0,580
95234,180,140,80,80,160,0,640
95235,180,80,80,80,160,0,580
95236,190,60,40,0,0,0,290
95237,190,80,80,160,160,0,670
95238,170,100,120,80,160,0,630
95239,220,140,160,160,160,0,840
95240,240,160,40,0,0,0,440
95241,240,120,40,0,0,0,400
95242,170,100,40,0,0,0,310
95243,220,140,80,80,160,0,680
95244,190,140,120,160,160,320,1090
95245,200,120,80,80,0,0,480
95246,150,40,40,0,0,0,230
95247,200,100,80,80,160,0,620
95248,230,140,120,0,0,0,490
95249,230,140,160,160,320,0,1010
95250,230,180,160,80,160,0,810
95251,210,120,40,80,0,0,450
95252,210,160,120,160,160,0,810
95253,190,120,120,80,0,0,510
95254,220,200,160,160,320,0,1060
95255,240,140,200,160,320,0,1060
95256,160,120,40,80,160,0,560
95257,190,140,160,80,160,0,730
95258,170,160,160,80,0,0,570
95259,230,100,80,160,160,0,730
95260,230,120,160,80,160,320,1070
95261,180,120,160,80,0,0,540
95262,150,140,120,240,160,0,810
95263,190,160,40,80,160,0,630
95264,170,60,40,0,0,0,270
95265,200,120,80,80,0,0,480
95266,250,120,120,80,0,0,570
95267,190,100,160,160,160,0,770
95268,210,180,160,160,160,0,870
95269,150,120,160,80,0,0,510
95270,180,100,120,80,160,0,640
95271,220,140,120,80,160,0,720
95272,210,140,80,80,160,0,670
95273,190,140,120,80,160,0,690
95274,200,160,160,80,0,0,600
95275,200,180,160,160,160,0,860
95276,150,100,120,160,160,0,690
95277,190,100,120,160,160,0,730
95278,230,160,120,160,0,0,670
95279,190,120,80,80,0,0,470
95280,180,80,80,160,160,0,660
95281,160,100,40,80,160,0,540
95282,220,160,80,80,0,0,540
95283,190,100,120,80,160,0,650
95284,210,160,120,160,320,0,970
95285,210,100,80,80,0,0,470
95286,220,100,80,160,160,0,720
95287,220,140,0,0,0,0,360
95288,230,160,160,0,0,0,550
95289,150,60,40,80,160,0,490
95290,180,140,120,80,160,0,680
95291,210,160,160,0,0,0,530
95292,200,140,120,80,0,0,540
95293,200,120,120,160,160,0,760
95294,170,80,120,240,160,320,1090
95295,210,100,120,160,320,320,1230
95296,210,100,80,160,320,0,870
95297,220,180,200,80,0,0,680
95298,190,120,80,80,0,0,470
95299,200,120,120,160,320,0,920
95300,170,120,80,0,0,0,370
95301,190,160,120,160,160,320,1110
95302,220,160,240,240,160,0,1020
95303,230,140,160,80,160,0,770
95304,200,120,200,240,320,0,1080
95305,160,100,40,80,160,320,860
95306,210,120,80,160,160,0,730
95307,210,180,200,80,160,0,830
95308,170,120,200,160,320,0,970
95309,240,140,40,80,0,0,500
95310,190,60,40,80,0,0,370
95311,200,140,80,0,0,0,420
95312,210,200,160,80,160,0,810
95313,220,120,80,0,0,0,420
95314,170,80,40,0,0,0,290
95315,170,60,80,80,160,0,550
95316,180,80,80,160,320,320,1140
95317,210,140,80,80,0,0,510
95318,190,120,80,160,320,0,870
95319,160,120,120,160,320,0,880
95320,180,120,80,80,0,0,460
95321,250,100,40,80,0,0,470
95322,210,120,80,160,0,0,570
95323,170,100,80,160,0,0,510
95324,180,100,120,80,160,0,640
95325,200,120,120,160,160,0,760
95326,240,120,40,0,0,0,400
95327,190,80,40,80,160,0,550
95328,250,140,80,0,0,0,470
95329,210,100,120,240,320,0,990
95330,170,100,120,160,160,0,710
95331,200,60,80,0,0,0,340
95332,190,100,80,80,160,0,610
95333,210,120,160,160,0,0,650
95334,190,140,120,0,0,0,450
95335,170,100,120,160,0,0,550
95336,200,120,120,160,160,320,1080
95337,210,140,80,80,160,0,670
95338,210,160,120,160,0,0,650
95339,200,180,80,80,160,0,700
95340,180,120,80,80,0,0,460
95341,210,80,80,160,320,0,850
95342,210,80,80,160,160,0,690
95343,220,120,120,80,160,320,1020
95344,190,120,80,80,160,0,630
95345,200,100,80,80,0,0,460
95346,190,100,80,80,0,0,450
95347,210,140,40,80,160,0,630
95348,200,140,120,80,160,0,700
95349,150,100,80,80,160,0,570
95350,200,160,120,80,160,0,720
95351,200,100,120,80,160,320,980
95352,180,100,40,80,160,0,560
95353,160,100,120,160,160,320,1020
95354,180,100,40,80,160,0,560
95355,220,60,40,80,160,0,560
95356,210,80,120,160,160,0,730
95357,180,100,80,80,0,0,440
95358,180,120,40,0,0,0,340
95359,250,140,40,80,160,0,670
95360,240,140,80,80,160,0,700
95361,210,140,0,0,0,0,350
95362,200,100,80,160,0,0,540
95363,210,120,80,80,0,0,490
95364,210,140,120,160,0,0,630
95365,190,100,80,80,160,0,610
95366,190,100,80,80,0,0,450
95367,180,140,80,80,0,0,480
95368,220,120,80,80,160,0,660
95369,200,80,80,0,0,0,360
95370,160,100,120,80,160,0,620
95371,200,140,80,0,0,0,420
95372,210,120,80,0,0,0,410
95373,190,100,120,160,0,0,570
95374,200,140,120,80,0,0,540
95375,180,80,80,0,0,0,340
95376,210,160,160,160,160,0,850
95377,130,100,120,0,0,0,350
95378,210,80,40,80,160,0,570
95379,180,60,40,80,160,0,520
95380,210,120,200,80,160,0,770
95381,190,140,160,80,0,0,570
95382,220,120,80,80,0,0,500
95383,180,140,120,80,160,0,680
95384,170,60,80,80,0,0,390
95385,230,120,80,80,0,0,510
95386,190,120,120,160,0,0,590
95387,210,200,160,0,0,0,570
95388,200,140,200,80,160,0,780
95389,240,140,160,80,160,0,780
95390,220,100,160,240,320,320,1360
95391,210,160,80,0,0,0,450
95392,180,100,0,0,0,0,280
95393,180,80,40,0,0,0,300
95394,220,80,80,80,0,0,460
95395,170,80,120,160,160,0,690
95396,200,120,80,160,160,0,720
95397,210,160,200,0,0,0,570
95398,180,100,120,240,160,0,800
95399,190,120,40,80,160,0,590
95400,190,140,120,80,0,0,530
95401,180,160,80,160,160,0,740
95402,240,180,160,80,0,0,660
95403,220,100,80,160,160,0,720
95404,180,120,40,80,0,0,420
95405,150,80,0,0,0,0,230
95406,210,100,160,80,160,0,710
95407,220,100,80,160,160,0,720
95408,200,80,0,0,0,0,280
95409,230,160,160,80,0,0,630
95410,210,200,120,160,0,0,690
95411,200,140,80,80,160,0,660
95412,180,120,160,160,0,0,620
95413,180,100,120,80,0,0,480
95414,140,80,80,80,160,0,540
95415,190,120,120,80,160,0,670
95416,200,100,80,80,0,0,460
95417,210,160,80,0,0,0,450
95418,220,100,80,80,160,320,960
95419,210,140,40,0,0,0,390
95420,220,160,160,80,160,320,1100
95421,190,100,40,0,0,0,330
95422,180,80,120,80,0,0,460
95423,160,140,120,80,0,0,500
95424,210,120,120,240,320,0,1010
95425,180,120,160,160,160,0,780
95426,190,160,160,80,0,0,590
95427,180,120,120,160,0,0,580
95428,180,120,120,160,160,0,740
95429,190,140,160,160,0,0,650
95430,190,80,120,0,0,0,390
95431,180,180,120,160,160,0,800
95432,190,80,160,160,160,0,750
95433,200,100,80,0,0,0,380
95434,220,100,120,80,160,0,680
95435,230,100,80,0,0,0,410
95436,200,100,40,80,160,0,580
95437,200,160,160,240,160,0,920
95438,230,100,40,0,0,0,370
95439,200,180,120,80,0,0,580
95440,170,120,120,80,160,320,970
95441,150,140,120,80,0,0,490
95442,220,80,40,80,160,0,580
95443,250,140,120,160,160,0,830
95444,200,120,80,0,0,0,400
95445,170,80,120,80,160,320,930
95446,220,140,40,80,160,0,640
95447,180,120,120,80,0,0,500
95448,180,80,120,240,160,0,780
95449,220,60,40,0,0,0,320
95450,210,160,80,80,0,0,530
95451,230,180,120,80,0,0,610
95452,200,120,120,160,160,0,760
95453,190,80,80,0,0,0,350
95454,240,140,80,0,0,0,460
95455,200,40,40,80,160,0,520
95456,220,160,160,160,320,0,1020
95457,210,160,160,160,320,0,1010
95458,190,180,200,240,0,0,810
95459,210,120,160,160,160,0,810
95460,160,100,80,80,160,0,580
95461,190,140,160,80,0,0,570
95462,160,100,120,160,160,0,700
95463,200,140,40,80,160,0,620
95464,150,100,40,80,0,0,370
95465,230,180,120,0,0,0,530
95466,190,80,80,0,0,0,350
95467,180,140,160,160,320,0,960
95468,190,120,120,160,320,0,910
95469,160,160,160,160,160,0,800
95470,170,100,80,0,0,0,350
95471,170,140,120,80,160,320,990
95472,200,160,160,80,0,0,600
95473,190,180,200,240,160,0,970
95474,190,80,80,80,160,0,590
95475,200,60,80,80,160,0,580
95476,200,160,120,80,0,0,560
95477,210,120,120,160,320,320,1250
95478,220,140,120,160,160,0,800
95479,230,140,120,80,160,0,730
95480,150,80,40,80,0,0,350
95481,190,100,80,160,160,0,690
95482,210,80,40,80,0,0,410
95483,170,120,40,0,0,0,330
95484,200,160,120,160,160,0,800
95485,180,120,120,160,160,0,740
95486,230,120,120,160,160,0,790
95487,220,200,160,240,320,0,1140
95488,190,80,120,0,0,0,390
95489,240,120,80,80,160,0,680
95490,200,160,120,80,160,0,720
95491,170,120,80,160,160,0,690
95492,160,120,120,80,0,0,480
95493,200,140,80,80,160,0,660
95494,190,140,80,80,0,0,490
95495,210,140,40,80,160,0,630
95496,210,160,160,240,320,320,1410
95497,250,160,80,80,160,0,730
95498,200,160,120,80,0,0,560
95499,200,140,120,160,0,0,620
95500,140,60,40,80,160,320,800
95501,230,140,80,0,0,0,450
95502,210,120,80,0,0,0,410
95503,180,100,80,160,320,320,1160
95504,160,80,40,80,160,0,520
95505,190,120,80,80,160,0,630
95506,200,40,0,0,0,0,240
95507,200,160,120,80,0,0,560
95508,190,120,120,160,160,0,750
95509,180,140,120,80,160,0,680
95510,220,120,200,160,160,0,860
95511,160,160,120,80,0,0,520
95512,220,140,120,160,0,0,640
95513,190,160,120,160,320,320,1270
95514,210,140,80,80,0,0,510
95515,210,120,120,160,160,0,770
95516,170,160,160,160,160,320,1130
95517,190,140,40,80,0,0,450
95518,200,120,40,80,0,0,440
95519,190,120,120,0,0,0,430
95520,180,160,120,80,160,0,700
95521,180,80,80,160,160,0,660
95522,220,60,40,0,0,0,320
95523,210,120,120,240,160,0,850
95524,190,100,120,80,160,0,650
95525,230,120,120,80,0,0,550
95526,220,140,120,80,0,0,560
95527,190,140,80,0,0,0,410
95528,190,100,80,80,160,320,930
95529,220,120,40,80,160,0,620
95530,170,120,160,160,0,0,610
95531,190,100,80,80,0,0,450
95532,210,100,80,80,160,0,630
95533,230,140,120,160,160,0,810
95534,230,100,120,80,0,0,530
95535,170,120,120,160,160,0,730
95536,210,140,120,160,160,0,790
95537,210,80,80,80,0,0,450
95538,180,100,120,80,160,0,640
95539,190,140,80,80,160,0,650
95540,170,80,120,160,160,0,690
95541,230,160,80,160,160,320,1110
95542,210,180,160,160,160,0,870
95543,230,140,120,160,320,320,1290
95544,190,140,120,160,160,0,770
95545,180,100,40,80,160,0,560
95546,200,100,80,80,160,0,620
95547,180,180,160,80,160,0,760
95548,160,100,120,80,0,0,460
95549,190,140,160,0,0,0,490
95550,210,100,80,160,0,0,550
95551,200,120,120,160,160,0,760
95552,200,100,80,160,160,0,700
95553,180,120,120,0,0,0,420
95554,230,100,80,0,0,0,410
95555,220,160,120,160,160,0,820
95556,210,180,120,80,160,0,750
95557,190,140,160,240,0,0,730
95558,200,80,40,80,0,0,400
95559,190,120,0,0,0,0,310
95560,190,100,40,80,0,0,410
95561,190,120,160,160,0,0,630
95562,180,100,120,160,160,0,720
95563,210,100,120,160,320,0,910
95564,180,120,120,240,160,320,1140
95565,190,100,0,0,0,0,290
95566,240,180,160,160,160,0,900
95567,190,80,40,0,0,0,310
95568,230,120,80,80,160,320,990
95569,190,140,160,160,160,0,810
95570,200,100,120,80,160,0,660
95571,180,140,120,160,160,0,760
95572,200,120,120,0,0,0,440
95573,170,120,160,160,160,0,770
95574,200,140,120,0,0,0,460
95575,210,100,160,240,160,0,870
95576,170,160,80,160,160,0,730
95577,210,140,120,160,0,0,630
95578,150,80,80,160,320,320,1110
95579,200,140,160,0,0,0,500
95580,190,120,160,160,320,320,1270
95581,170,120,80,80,160,0,610
95582,240,120,120,80,160,320,1040
95583,210,160,160,80,160,0,770
95584,210,120,40,80,160,320,930
95585,160,140,120,160,160,0,740
95586,220,120,80,80,160,0,660
95587,180,120,80,80,160,320,940
95588,200,180,200,240,160,0,980
95589,190,140,120,160,160,0,770
95590,170,140,80,0,0,0,390
95591,210,140,120,80,0,0,550
95592,160,100,80,0,0,0,340
95593,190,140,120,160,320,0,930
95594,150,100,120,160,0,0,530
95595,240,100,80,160,320,320,1220
95596,180,100,120,80,160,320,960
95597,210,140,80,0,0,0,430
95598,180,120,80,80,160,0,620
95599,170,140,160,80,160,0,710
95600,220,140,40,80,0,0,480
95601,170,140,120,80,0,0,510
95602,190,100,80,80,160,0,610
95603,190,100,120,80,0,0,490
95604,170,60,120,0,0,0,350
95605,200,100,40,80,0,0,420
95606,200,140,200,80,160,0,780
95607,200,160,120,160,160,0,800
95608,210,160,160,160,160,320,1170
95609,170,100,120,80,0,0,470
95610,210,100,120,160,160,0,750
95611,170,80,80,80,160,0,570
95612,190,120,80,160,0,0,550
95613,210,140,160,80,160,320,1070
95614,200,100,80,0,0,0,380
95615,230,120,40,80,160,320,950
95616,220,140,160,80,0,0,600
95617,150,80,80,80,160,320,870
95618,210,140,80,0,0,0,430
95619,210,160,80,0,0,0,450
95620,240,160,120,80,0,0,600
95621,200,140,160,80,160,0,740
95622,170,100,80,0,0,0,350
95623,250,160,200,240,320,320,1490
95624,200,140,120,0,0,0,460
95625,200,160,120,160,0,0,640
95626,170,100,40,80,0,0,390
95627,220,140,120,80,0,0,560
95628,170,140,200,80,0,0,590
95629,190,160,160,160,320,0,990
95630,180,140,160,80,160,0,720
95631,190,120,40,80,160,0,590
95632,220,120,160,160,160,0,820
95633,200,120,80,80,0,0,480
95634,160,100,0,0,0,0,260
95635,190,160,160,0,0,0,510
95636,160,120,40,80,160,0,560
95637,210,160,80,80,0,0,530
95638,180,120,120,240,320,0,980
95639,190,120,80,0,0,0,390
95640,170,60,40,80,160,320,830
95641,220,120,120,160,160,0,780
95642,150,140,80,160,160,0,690
95643,210,120,40,80,0,0,450
95644,210,100,120,160,160,0,750
95645,190,140,120,160,160,0,770
95646,180,120,40,80,160,320,900
95647,180,140,160,160,320,320,1280
95648,190,100,80,80,0,0,450
95649,220,80,120,160,0,0,580
95650,230,180,200,160,160,0,930
95651,220,180,120,0,0,0,520
95652,160,100,40,80,160,0,540
95653,170,140,40,0,0,0,350
95654,240,120,160,80,0,0,600
95655,180,140,160,160,160,0,800
95656,170,120,160,240,320,0,1010
95657,220,120,80,160,320,0,900
95658,200,140,120,160,160,0,780
95659,190,100,120,80,160,320,970
95660,170,140,120,160,160,0,750
95661,180,160,120,0,0,0,460
95662,180,100,120,240,160,0,800
95663,160,120,80,80,0,0,440
95664,180,120,80,80,160,0,620
95665,210,100,80,0,0,0,390
95666,190,160,200,240,0,0,790
95667,180,140,120,80,0,0,520
95668,180,60,40,80,160,320,840
95669,200,100,120,160,320,0,900
95670,200,120,200,80,0,0,600
95671,220,140,200,240,160,0,960
95672,190,120,40,0,0,0,350
95673,210,120,120,160,160,0,770
95674,210,160,120,160,160,0,810
95675,200,160,160,80,160,0,760
95676,210,120,80,80,160,320,970
95677,230,100,40,80,160,0,610
95678,230,120,80,160,160,0,750
95679,180,80,40,80,160,320,860
95680,210,140,120,80,0,0,550
95681,210,160,40,80,160,0,650
95682,240,180,200,160,160,0,940
95683,210,100,120,160,320,320,1230
95684,190,100,120,80,160,0,650
95685,230,160,120,0,0,0,510
95686,200,100,80,80,0,0,460
95687,200,140,160,160,160,320,1140
95688,170,140,120,80,0,0,510
95689,170,100,120,80,160,0,630
95690,190,120,120,80,160,0,670
95691,200,80,80,0,0,0,360
95692,210,80,40,80,160,0,570
95693,230,160,120,80,160,0,750
95694,170,100,120,80,0,0,470
95695,170,120,80,80,0,0,450
95696,210,160,120,160,320,320,1290
95697,180,140,40,80,160,0,600
95698,220,140,160,80,160,0,760
95699,200,120,120,160,160,0,760
95700,220,140,40,0,0,0,400
95701,240,140,80,160,160,0,780
95702,200,100,80,160,160,0,700
95703,180,80,80,80,0,0,420
95704,170,100,120,0,0,0,390
95705,170,80,40,80,160,0,530
95706,190,120,200,160,160,0,830
95707,180,80,80,0,0,0,340
95708,180,120,120,80,0,0,500
95709,160,140,120,80,0,0,500
95710,210,60,0,0,0,0,270
95711,170,160,120,80,0,0,530
95712,180,160,200,0,0,0,540
95713,200,180,0,0,0,0,380
95714,150,100,80,80,0,0,410
95715,190,100,120,80,160,0,650
95716,220,80,80,80,0,0,460
95717,220,120,80,80,160,0,660
95718,230,180,120,160,160,0,850
95719,200,140,160,160,160,0,820
95720,170,80,80,80,160,0,570
95721,220,140,40,80,160,0,640
95722,200,140,80,80,0,0,500
95723,170,80,40,80,0,0,370
95724,180,100,80,160,320,0,840
95725,190,100,120,160,320,0,890
95726,190,80,120,80,0,0,470
95727,200,140,160,160,160,0,820
95728,190,100,80,80,160,0,610
95729,180,100,80,80,160,0,600
95730,230,160,160,160,320,320,1350
95731,170,120,120,160,160,0,730
95732,210,100,160,240,320,320,1350
95733,210,140,120,160,160,0,790
95734,190,60,40,0,0,0,290
95735,150,120,80,160,0,0,510
95736,200,80,40,80,160,0,560
95737,170,100,80,80,160,0,590
95738,190,120,40,80,0,0,430
95739,200,100,80,0,0,0,380
95740,210,140,160,160,0,0,670
95741,200,100,120,160,160,0,740
95742,200,20,40,80,160,0,500
95743,190,80,0,0,0,0,270
95744,180,120,40,0,0,0,340
95745,190,80,80,80,160,320,910
95746,180,160,120,0,0,0,460
95747,210,160,120,80,0,0,570
95748,170,140,120,160,160,0,750
95749,170,60,40,80,0,0,350
95750,150,140,160,160,160,0,770
95751,220,160,120,0,0,0,500
95752,210,100,120,160,160,320,1070
95753,200,100,200,80,160,0,740
95754,210,120,80,160,160,0,730
95755,200,100,120,80,160,320,980
95756,190,100,120,80,160,0,650
95757,260,120,80,160,160,0,780
95758,190,120,120,160,0,0,590
95759,200,180,40,80,160,0,660
95760,210,80,80,0,0,0,370
95761,190,140,80,80,0,0,490
95762,260,80,80,80,160,0,660
95763,180,180,120,0,0,0,480
95764,190,140,160,160,0,0,650
95765,170,100,120,240,320,0,950
95766,170,140,120,160,160,320,1070
95767,170,60,80,80,0,0,390
95768,180,60,80,80,0,0,400
95769,210,140,120,80,0,0,550
95770,210,140,160,80,0,0,590
95771,150,100,80,0,0,0,330
95772,210,140,160,240,160,0,910
95773,200,60,40,80,160,0,540
95774,160,60,80,80,160,320,860
95775,180,180,160,0,0,0,520
95776,150,140,120,160,320,0,890
95777,170,100,160,80,160,0,670
95778,190,80,80,0,0,0,350
95779,180,80,40,0,0,0,300
95780,180,160,80,80,0,0,500
95781,220,160,160,80,160,0,780
95782,170,100,120,80,0,0,470
95783,200,140,160,240,0,0,740
95784,190,120,120,80,160,0,670
95785,210,180,120,160,0,0,670
95786,200,80,40,80,0,0,400
95787,210,200,120,80,160,0,770
95788,210,100,160,80,0,0,550
95789,180,100,120,80,0,0,480
95790,230,80,160,0,0,0,470
95791,210,60,80,160,320,320,1150
95792,210,140,120,160,160,0,790
95793,180,140,120,80,160,0,680
95794,190,120,120,160,320,0,910
95795,230,100,40,0,0,0,370
95796,220,200,160,80,160,0,820
95797,180,200,120,160,0,0,660
95798,210,100,120,80,160,320,990
95799,230,140,80,0,0,0,450
95800,170,80,80,160,160,0,650
95801,200,120,120,0,0,0,440
95802,210,140,160,240,320,0,1070
95803,180,140,120,160,160,320,1080
95804,210,100,80,0,0,0,390
95805,200,120,200,160,320,0,1000
95806,170,100,80,160,0,0,510
95807,200,140,80,80,0,0,500
95808,220,100,80,80,0,0,480
95809,200,140,120,80,0,0,540
95810,200,200,200,160,0,0,760
95811,190,160,120,80,160,0,710
95812,170,80,120,160,160,0,690
95813,190,140,40,80,0,0,450
95814,150,100,120,160,0,0,530
95815,200,100,40,80,160,0,580
95816,200,160,80,80,160,0,680
95817,180,120,120,80,160,320,980
95818,180,120,120,160,160,0,740
95819,180,80,80,80,160,0,580
95820,170,60,80,80,0,0,390
95821,230,120,120,160,320,320,1270
95822,200,120,120,80,160,0,680
95823,210,100,160,160,160,320,1110
95824,200,120,40,0,0,0,360
95825,230,80,80,80,160,0,630
95826,210,100,80,80,160,0,630
95827,180,160,160,160,320,0,980
95828,180,120,80,80,160,0,620
95829,210,120,120,0,0,0,450
95830,180,100,80,80,0,0,440
95831,200,180,160,80,160,0,780
95832,220,100,160,160,160,0,800
95833,250,120,80,80,160,0,690
95834,200,140,160,80,0,0,580
95835,210,160,120,0,0,0,490
95836,210,120,80,80,0,0,490
95837,230,120,80,0,0,0,430
95838,210,60,0,0,0,0,270
95839,230,100,80,160,160,320,1050
95840,180,140,160,0,0,0,480
95841,220,120,120,160,160,0,780
95842,210,140,80,80,0,0,510
95843,220,160,80,0,0,0,460
95844,200,120,120,160,160,0,760
95845,190,160,120,80,160,0,710
95846,210,140,160,240,0,0,750
95847,190,100,40,80,160,0,570
95848,190,100,80,80,0,0,450
95849,200,140,120,0,0,0,460
95850,180,140,160,160,0,0,640
95851,180,120,40,80,160,0,580
95852,240,160,160,160,0,0,720
95853,190,160,120,160,160,320,1110
95854,190,120,80,0,0,0,390
95855,150,160,80,80,0,0,470
95856,200,140,40,0,0,0,380
95857,210,100,160,160,160,0,790
95858,190,160,80,80,160,320,990
95859,200,120,160,0,0,0,480
95860,180,60,0,0,0,0,240
95861,220,180,160,240,0,0,800
95862,160,100,80,0,0,0,340
95863,200,100,80,80,160,0,620
95864,190,60,80,80,160,320,890
95865,230,140,120,160,160,0,810
95866,180,120,160,80,160,0,700
95867,220,140,120,160,0,0,640
95868,200,120,120,80,160,0,680
95869,230,100,40,0,0,0,370
95870,150,80,40,0,0,0,270
95871,160,120,80,0,0,0,360
95872,210,120,80,80,0,0,490
95873,210,160,80,80,0,0,530
95874,160,100,80,80,0,0,420
95875,200,100,120,80,0,0,500
95876,180,100,120,80,0,0,480
95877,190,120,80,0,0,0,390
95878,230,100,120,0,0,0,450
95879,210,100,120,160,320,0,910
95880,150,80,80,80,160,0,550
95881,210,120,120,160,160,0,770
95882,200,160,160,80,0,0,600
95883,220,120,80,80,160,0,660
95884,210,100,80,160,160,320,1030
95885,160,140,80,80,160,320,940
95886,210,180,80,80,0,0,550
95887,200,120,0,0,0,0,320
95888,190,140,80,80,160,0,650
95889,190,120,120,0,0,0,430
95890,200,80,80,80,160,0,600
95891,210,140,120,160,160,0,790
95892,170,80,40,80,160,0,530
95893,170,120,80,160,320,0,850
95894,170,60,40,0,0,0,270
95895,150,60,80,80,160,0,530
95896,180,120,120,160,160,0,740
95897,200,140,160,160,320,0,980
95898,200,100,80,160,160,0,700
95899,160,120,120,160,160,0,720
95900,180,100,80,80,0,0,440
95901,210,100,160,160,160,0,790
95902,170,160,160,160,0,0,650
95903,190,180,120,240,160,0,890
95904,200,160,40,80,0,0,480
95905,190,100,120,160,320,320,1210
95906,190,100,40,80,160,0,570
95907,240,160,120,160,160,0,840
95908,160,120,160,160,160,0,760
95909,180,80,80,80,160,0,580
95910,160,100,80,160,160,320,980
95911,200,120,120,80,160,0,680
95912,220,180,80,80,160,0,720
95913,230,140,80,80,160,0,690
95914,160,80,80,160,160,0,640
95915,230,100,80,80,160,320,970
95916,170,80,80,80,160,0,570
95917,220,180,80,80,0,0,560
95918,180,80,40,0,0,0,300
95919,200,180,80,160,160,320,1100
95920,150,140,120,80,160,0,650
95921,240,200,160,160,160,320,1240
95922,190,100,120,160,160,320,1050
95923,230,200,120,160,160,320,1190
95924,210,100,80,80,160,320,950
95925,230,140,80,80,160,0,690
95926,150,120,160,80,160,320,990
95927,180,60,40,80,160,0,520
95928,240,120,80,80,0,0,520
95929,170,40,40,0,0,0,250
95930,200,180,120,80,160,320,1060
95931,180,100,120,80,160,0,640
95932,220,40,40,80,0,0,380
95933,230,140,80,160,160,320,1090
95934,200,100,40,0,0,0,340
95935,210,160,200,160,0,0,730
95936,160,100,80,80,160,0,580
95937,210,120,120,0,0,0,450
95938,190,140,80,80,160,0,650
95939,250,160,120,80,0,0,610
95940,150,100,80,0,0,0,330
95941,230,140,160,160,160,0,850
95942,190,120,40,80,160,0,590
95943,200,120,160,160,160,320,1120
95944,230,180,120,80,0,0,610
95945,230,160,40,80,160,0,670
95946,160,60,0,0,0,0,220
95947,210,160,40,80,160,0,650
95948,180,140,160,80,160,320,1040
95949,150,80,120,80,160,0,590
95950,170,100,120,240,160,0,790
95951,190,120,120,80,0,0,510
95952,210,80,40,0,0,0,330
95953,220,140,160,160,160,0,840
95954,220,120,120,160,0,0,620
95955,170,140,80,80,160,320,950
95956,250,100,120,160,160,0,790
95957,190,120,80,0,0,0,390
95958,230,120,80,80,160,0,670
95959,230,160,120,160,320,0,990
95960,200,160,200,240,160,0,960
95961,170,120,80,0,0,0,370
95962,220,160,200,80,160,0,820
95963,240,140,120,160,160,0,820
95964,190,60,0,0,0,0,250
95965,210,180,120,240,0,0,750
95966,210,200,200,240,320,0,1170
95967,180,60,80,160,320,0,800
95968,230,200,160,80,160,0,830
95969,220,80,120,160,160,0,740
95970,210,120,80,160,160,0,730
95971,190,120,40,0,0,0,350
95972,160,140,160,160,160,0,780
95973,190,160,120,0,0,0,470
95974,180,80,80,80,160,0,580
95975,220,140,120,80,160,0,720
95976,220,80,40,80,160,0,580
95977,190,100,80,80,160,0,610
95978,170,100,120,0,0,0,390
95979,190,140,80,80,160,0,650
95980,180,80,40,0,0,0,300
95981,210,120,120,240,160,320,1170
95982,210,160,120,160,320,0,970
95983,170,100,80,80,160,0,590
95984,170,100,120,80,0,0,470
95985,190,140,80,160,160,320,1050
95986,210,120,160,160,160,320,1130
95987,180,120,40,80,160,0,580
95988,190,140,40,0,0,0,370
95989,160,140,80,160,160,0,700
95990,190,100,120,80,160,0,650
95991,140,100,160,80,160,0,640
95992,170,60,40,0,0,0,270
95993,150,100,200,160,160,0,770
95994,200,140,120,160,160,0,780
95995,230,180,160,160,320,0,1050
95996,210,160,120,0,0,0,490
95997,200,120,80,0,0,0,400
95998,160,140,120,80,0,0,500
95999,200,160,160,240,320,320,1400
96000,230,80,120,80,0,0,510
96001,170,100,160,80,160,0,670
96002,220,140,200,240,160,320,1280
96003,220,180,80,0,0,0,480
96004,180,120,120,80,160,0,660
96005,200,80,80,160,160,0,680
96006,240,160,40,80,160,0,680
96007,170,100,160,240,160,0,830
96008,240,180,160,160,160,0,900
96009,180,60,80,80,160,0,560
96010,220,200,120,80,160,320,1100
96011,210,160,200,160,160,0,890
96012,180,140,120,0,0,0,440
96013,220,80,80,80,0,0,460
96014,190,140,80,160,0,0,570
96015,200,140,120,160,160,0,780
96016,170,80,80,80,0,0,410
96017,160,140,120,0,0,0,420
96018,190,100,120,80,160,0,650
96019,170,120,120,80,160,0,650
96020,160,140,80,0,0,0,380
96021,180,20,0,0,0,0,200
96022,160,120,120,0,0,0,400
96023,200,100,40,80,0,0,420
96024,180,120,40,0,0,0,340
96025,230,120,120,80,0,0,550
96026,220,160,80,80,160,0,700
96027,190,80,120,160,160,0,710
96028,130,100,40,0,0,0,270
96029,140,160,120,80,160,0,660
96030,190,100,40,80,0,0,410
96031,180,140,120,160,160,0,760
96032,170,100,160,160,160,0,750
96033,190,200,240,240,160,320,1350
96034,170,120,80,80,0,0,450
96035,190,80,80,80,160,0,590
96036,200,100,120,0,0,0,420
96037,210,200,160,160,160,0,890
96038,220,120,40,80,160,0,620
96039,180,80,80,80,160,0,580
96040,190,140,120,240,160,0,850
96041,170,140,120,80,0,0,510
96042,180,120,80,80,160,0,620
96043,190,140,160,80,0,0,570
96044,210,120,40,80,160,0,610
96045,170,120,120,80,160,0,650
96046,230,120,80,0,0,0,430
96047,200,180,120,0,0,0,500
96048,190,80,120,80,0,0,470
96049,180,80,80,80,160,0,580
96050,200,120,120,160,160,0,760
96051,210,180,120,160,160,0,830
96052,150,120,120,0,0,0,390
96053,200,100,120,160,160,320,1060
96054,210,120,80,80,160,0,650
96055,200,60,40,80,0,0,380
96056,190,100,80,160,160,0,690
96057,190,120,80,160,160,0,710
96058,210,100,120,80,160,0,670
96059,200,140,120,160,0,0,620
96060,200,140,160,240,160,0,900
96061,220,100,80,80,160,0,640
96062,220,140,160,160,160,0,840
96063,230,100,80,160,320,320,1210
96064,240,140,200,160,160,0,900
96065,200,120,160,240,320,320,1360
96066,160,140,40,80,160,0,580
96067,250,140,120,160,320,0,990
96068,180,120,160,160,160,0,780
96069,240,100,80,160,160,0,740
96070,220,140,40,80,0,0,480
96071,190,140,160,80,160,320,1050
96072,220,120,80,80,0,0,500
96073,240,120,40,80,0,0,480
96074,150,60,80,80,0,0,370
96075,220,100,160,160,160,320,1120
96076,200,120,40,80,160,0,600
96077,180,120,160,160,0,0,620
96078,180,120,80,80,160,320,940
96079,180,140,40,0,0,0,360
96080,160,40,40,80,160,0,480
96081,190,160,120,80,160,0,710
96082,180,200,120,80,0,0,580
96083,190,120,40,80,160,0,590
96084,240,200,120,80,160,0,800
96085,170,80,120,80,160,320,930
96086,270,180,160,80,160,0,850
96087,150,100,80,80,0,0,410
96088,230,120,120,80,160,0,710
96089,210,80,40,80,160,320,890
96090,170,100,80,160,160,0,670
96091,180,100,40,0,0,0,320
96092,200,140,80,80,160,0,660
96093,210,140,80,80,0,0,510
96094,210,100,80,0,0,0,390
96095,210,180,160,80,160,0,790
96096,220,140,80,80,160,0,680
96097,180,120,160,80,160,0,700
96098,220,140,80,80,0,0,520
96099,140,100,80,0,0,0,320
96100,180,140,120,160,0,0,600
96101,200,140,80,80,160,0,660
96102,170,140,160,80,160,0,710
96103,170,100,120,80,0,0,470
96104,210,120,120,160,160,0,770
96105,160,60,80,80,160,320,860
96106,170,80,40,0,0,0,290
96107,180,100,160,160,320,320,1240
96108,240,220,200,80,0,0,740
96109,180,120,160,160,160,0,780
96110,220,80,80,80,0,0,460
96111,180,140,80,80,160,0,640
96112,190,160,120,160,160,0,790
96113,220,80,80,80,0,0,460
96114,180,120,120,160,0,0,580
96115,240,80,80,80,0,0,480
96116,160,140,160,80,0,0,540
96117,190,100,120,0,0,0,410
96118,140,140,200,240,320,320,1360
96119,160,160,160,80,0,0,560
96120,240,120,200,160,160,0,880
96121,200,140,160,80,160,320,1060
96122,240,160,120,0,0,0,520
96123,160,120,120,240,160,320,1120
96124,190,200,200,160,160,0,910
96125,210,80,120,240,160,0,810
96126,210,100,40,80,160,0,590
96127,190,120,40,80,0,0,430
96128,210,160,120,80,0,0,570
96129,230,120,80,160,320,320,1230
96130,210,100,80,80,160,0,630
96131,190,60,80,80,0,0,410
96132,210,120,80,80,0,0,490
96133,200,140,80,80,160,0,660
96134,160,140,160,160,320,0,940
96135,200,140,160,240,320,0,1060
96136,170,120,120,0,0,0,410
96137,180,140,200,160,0,0,680
96138,190,140,120,80,0,0,530
96139,150,80,80,80,160,320,870
96140,180,140,240,160,160,0,880
96141,210,140,120,80,0,0,550
96142,220,80,80,80,160,0,620
96143,200,160,160,240,320,0,1080
96144,210,160,160,160,160,0,850
96145,220,40,40,80,160,0,540
96146,170,100,80,160,320,320,1150
96147,200,100,80,160,320,0,860
96148,210,120,120,80,160,0,690
96149,180,140,120,80,160,0,680
96150,200,100,120,80,160,0,660
96151,220,100,160,0,0,0,480
96152,190,100,40,0,0,0,330
96153,200,180,240,240,320,320,1500
96154,210,160,120,80,160,0,730
96155,200,140,120,160,320,0,940
96156,180,140,40,0,0,0,360
96157,180,60,0,0,0,0,240
96158,200,100,160,0,0,0,460
96159,200,120,120,80,160,0,680
96160,200,120,80,160,320,0,880
96161,180,100,80,0,0,0,360
96162,120,80,40,80,0,0,320
96163,160,120,200,160,160,320,1120
96164,180,140,160,160,160,0,800
96165,230,160,80,0,0,0,470
96166,230,140,120,80,160,0,730
96167,190,80,40,0,0,0,310
96168,170,160,200,160,320,0,1010
96169,190,100,120,160,160,0,730
96170,240,140,80,80,160,0,700
96171,230,120,40,80,160,0,630
96172,220,120,80,160,160,320,1060
96173,190,160,120,80,160,320,1030
96174,180,140,160,160,160,0,800
96175,190,140,200,80,160,0,770
96176,220,120,0,0,0,0,340
96177,200,140,120,160,0,0,620
96178,200,140,120,80,160,0,700
96179,170,80,80,80,160,320,890
96180,220,120,120,80,160,0,700
96181,200,120,200,240,160,0,920
96182,200,100,80,160,320,0,860
96183,220,120,80,160,160,0,740
96184,210,140,120,80,160,320,1030
96185,230,120,40,80,0,0,470
96186,200,140,80,80,160,0,660
96187,210,100,80,80,160,0,630
96188,170,80,120,160,160,0,690
96189,240,140,120,80,160,0,740
96190,210,160,160,80,160,0,770
96191,180,140,80,160,0,0,560
96192,160,140,160,240,160,0,860
96193,240,120,40,80,160,320,960
96194,190,100,40,80,160,0,570
96195,130,80,80,80,160,0,530
96196,160,100,120,80,0,0,460
96197,210,140,120,0,0,0,470
96198,170,80,80,80,0,0,410
96199,190,120,120,80,160,320,990
96200,230,140,120,80,0,0,570
96201,180,160,120,80,160,0,700
96202,190,120,80,80,160,0,630
96203,210,120,40,0,0,0,370
96204,220,140,160,80,160,0,760
96205,170,120,160,160,0,0,610
96206,230,180,120,160,160,0,850
96207,240,140,160,0,0,0,540
96208,170,120,80,80,160,0,610
96209,200,80,40,80,0,0,400
96210,160,100,80,160,160,0,660
96211,170,160,120,240,160,0,850
96212,190,120,160,160,320,320,1270
96213,210,160,160,160,0,0,690
96214,200,80,40,80,0,0,400
96215,190,140,120,80,160,0,690
96216,200,80,80,80,0,0,440
96217,220,140,160,160,320,320,1320
96218,190,120,120,160,160,0,750
96219,200,100,120,240,320,0,980
96220,180,100,80,80,0,0,440
96221,230,60,80,80,160,320,930
96222,220,120,120,80,0,0,540
96223,190,100,200,240,320,320,1370
96224,140,120,80,80,160,0,580
96225,200,160,80,80,160,0,680
96226,210,160,120,160,160,0,810
96227,180,120,80,160,160,0,700
96228,160,140,80,160,160,0,700
96229,210,180,160,0,0,0,550
96230,170,140,240,80,0,0,630
96231,170,100,160,80,160,0,670
96232,250,140,160,80,0,0,630
96233,160,120,120,80,160,0,640
96234,210,140,80,0,0,0,430
96235,260,100,120,80,0,0,560
96236,180,60,80,0,0,0,320
96237,200,100,40,80,160,0,580
96238,190,140,160,160,160,0,810
96239,240,160,120,240,320,320,1400
96240,230,160,160,80,0,0,630
96241,190,100,120,160,320,320,1210
96242,200,140,80,80,160,0,660
96243,190,40,40,80,160,0,510
96244,210,120,120,80,160,0,690
96245,200,140,120,160,0,0,620
96246,210,180,120,160,320,0,990
96247,200,140,200,0,0,0,540
96248,220,120,80,80,160,0,660
96249,190,100,120,160,0,0,570
96250,230,140,160,80,0,0,610
96251,190,80,80,160,320,0,830
96252,200,140,80,80,160,0,660
96253,160,120,40,80,160,0,560
96254,210,120,120,160,160,0,770
96255,230,140,160,240,160,0,930
96256,210,120,80,160,160,0,730
96257,180,120,160,240,320,0,1020
96258,200,180,200,80,160,0,820
96259,220,140,80,80,160,0,680
96260,170,80,80,80,160,0,570
96261,230,120,200,240,320,0,1110
96262,230,140,80,0,0,0,450
96263,200,100,80,80,160,0,620
96264,200,180,160,80,0,0,620
96265,160,100,160,160,160,0,740
96266,210,80,40,80,160,0,570
96267,160,100,120,80,160,0,620
96268,200,100,40,0,0,0,340
96269,220,140,40,0,0,0,400
96270,200,100,120,160,160,0,740
96271,210,120,80,80,160,0,650
96272,170,120,200,160,160,320,1130
96273,200,200,120,160,160,0,840
96274,220,120,80,160,320,320,1220
96275,200,140,80,0,0,0,420
96276,210,100,80,80,160,0,630
96277,250,160,80,160,160,320,1130
96278,220,180,80,80,160,0,720
96279,180,160,120,80,0,0,540
96280,160,120,40,80,160,0,560
96281,200,100,80,0,0,0,380
96282,180,100,120,160,160,0,720
96283,220,120,80,0,0,0,420
96284,200,120,80,80,0,0,480
96285,200,80,80,0,0,0,360
96286,210,120,120,160,320,0,930
96287,180,140,200,160,160,0,840
96288,180,100,120,80,160,320,960
96289,190,100,160,160,160,0,770
96290,210,180,120,160,160,0,830
96291,220,200,160,80,160,0,820
96292,220,180,160,80,0,0,640
96293,210,120,80,80,160,320,970
96294,190,100,80,160,160,320,1010
96295,190,120,80,160,320,0,870
96296,210,180,40,0,0,0,430
96297,200,100,80,0,0,0,380
96298,210,120,160,80,160,0,730
96299,190,140,160,80,0,0,570
96300,160,80,120,0,0,0,360
96301,180,120,160,80,160,0,700
96302,190,100,120,80,160,320,970
96303,210,160,120,0,0,0,490
96304,210,100,40,0,0,0,350
96305,260,140,80,80,0,0,560
96306,160,80,80,80,160,0,560
96307,160,100,80,80,0,0,420
96308,170,100,120,160,160,0,710
96309,210,140,120,80,0,0,550
96310,170,80,40,0,0,0,290
96311,150,80,80,160,320,320,1110
96312,170,120,80,80,0,0,450
96313,210,100,160,240,160,0,870
96314,230,180,200,240,160,0,1010
96315,160,100,200,160,160,0,780
96316,190,120,80,80,0,0,470
96317,220,160,200,160,160,320,1220
96318,210,140,120,160,320,320,1270
96319,220,180,120,160,0,0,680
96320,210,140,120,80,160,0,710
96321,210,80,80,0,0,0,370
96322,180,120,120,160,320,320,1220
96323,160,120,80,80,160,0,600
96324,180,80,80,80,160,0,580
96325,180,120,80,80,160,0,620
96326,190,100,40,0,0,0,330
96327,200,140,80,0,0,0,420
96328,220,140,120,160,160,320,1120
96329,220,120,40,80,160,0,620
96330,170,100,80,160,320,320,1150
96331,170,180,160,160,320,0,990
96332,170,120,120,80,0,0,490
96333,200,100,80,0,0,0,380
96334,200,120,120,160,0,0,600
96335,220,140,120,160,320,0,960
96336,180,80,120,80,160,320,940
96337,170,100,120,160,0,0,550
96338,210,200,160,80,0,0,650
96339,190,160,160,160,0,0,670
96340,190,60,0,0,0,0,250
96341,210,140,40,80,160,0,630
96342,190,80,80,80,160,320,910
96343,220,160,80,80,160,0,700
96344,180,160,160,80,160,0,740
96345,170,100,80,80,0,0,430
96346,200,200,80,80,160,320,1040
96347,200,120,80,80,160,320,960
96348,220,140,160,160,0,0,680
96349,160,100,80,0,0,0,340
96350,200,120,160,80,0,0,560
96351,190,100,40,0,0,0,330
96352,190,60,40,80,160,0,530
96353,210,180,160,240,160,0,950
96354,220,120,80,0,0,0,420
96355,200,160,120,80,160,0,720
96356,180,120,80,80,160,0,620
96357,200,120,120,80,160,0,680
96358,200,100,40,0,0,0,340
96359,150,100,80,0,0,0,330
96360,220,80,80,160,160,0,700
96361,180,120,120,160,160,0,740
96362,200,160,120,80,0,0,560
96363,220,160,120,80,160,0,740
96364,180,120,200,160,160,320,1140
96365,170,80,80,160,320,0,810
96366,200,140,120,160,160,0,780
96367,190,160,120,160,160,320,1110
96368,150,100,80,160,320,0,810
96369,220,160,80,160,160,0,780
96370,200,140,0,0,0,0,340
96371,220,120,80,0,0,0,420
96372,190,100,40,80,160,0,570
96373,180,120,120,160,0,0,580
96374,230,140,80,0,0,0,450
96375,190,100,80,80,160,0,610
96376,220,140,80,80,0,0,520
96377,200,100,80,80,160,0,620
96378,210,120,80,0,0,0,410
96379,170,60,40,0,0,0,270
96380,180,80,80,160,160,0,660
96381,170,180,160,0,0,0,510
96382,190,120,80,80,160,320,950
96383,140,140,80,0,0,0,360
96384,200,80,120,80,0,0,480
96385,190,140,80,80,160,0,650
96386,240,120,120,80,160,0,720
96387,190,120,80,80,160,0,630
96388,210,100,120,160,160,0,750
96389,210,140,80,160,160,320,1070
96390,220,80,80,160,0,0,540
96391,190,40,40,0,0,0,270
96392,190,80,40,80,0,0,390
96393,170,140,80,160,0,0,550
96394,140,60,80,0,0,0,280
96395,220,80,40,0,0,0,340
96396,190,120,80,80,0,0,470
96397,180,100,40,80,0,0,400
96398,200,100,80,80,160,0,620
96399,220,200,120,160,160,0,860
96400,200,60,40,80,160,0,540
96401,180,100,160,80,0,0,520
96402,160,120,40,80,160,0,560
96403,170,100,80,160,160,0,670
96404,240,80,40,0,0,0,360
96405,180,100,120,0,0,0,400
96406,200,140,200,160,160,0,860
96407,220,120,80,80,160,0,660
96408,230,180,200,160,160,0,930
96409,230,140,80,80,160,0,690
96410,220,160,160,80,0,0,620
96411,190,120,80,80,0,0,470
96412,200,120,160,80,0,0,560
96413,150,100,120,160,0,0,530
96414,180,120,80,160,160,0,700
96415,190,80,120,160,160,0,710
96416,210,60,80,80,0,0,430
96417,160,80,120,160,160,320,1000
96418,190,120,120,80,160,0,670
96419,230,140,160,240,320,0,1090
96420,210,100,120,0,0,0,430
96421,170,120,40,0,0,0,330
96422,140,120,120,240,160,0,780
96423,190,160,80,80,160,0,670
96424,210,120,120,160,320,320,1250
96425,220,120,40,80,0,0,460
96426,210,100,40,80,0,0,430
96427,240,180,120,80,160,0,780
96428,190,120,160,0,0,0,470
96429,210,160,120,160,160,0,810
96430,230,160,160,160,0,0,710
96431,190,80,120,160,160,0,710
96432,230,80,120,160,160,0,750
96433,230,120,80,80,0,0,510
96434,180,140,80,80,0,0,480
96435,220,120,160,160,160,0,820
96436,190,80,40,80,160,0,550
96437,180,80,40,80,160,0,540
96438,210,140,200,160,0,0,710
96439,250,120,120,160,320,0,970
96440,220,120,120,80,0,0,540
96441,220,80,40,0,0,0,340
96442,210,120,120,160,160,320,1090
96443,200,160,80,160,160,0,760
96444,200,180,160,160,160,0,860
96445,190,160,120,80,0,0,550
96446,210,120,120,160,160,320,1090
96447,200,140,120,240,320,0,1020
96448,190,120,80,80,160,0,630
96449,190,100,40,80,0,0,410
96450,200,140,80,80,160,320,980
96451,250,200,160,80,160,320,1170
96452,210,140,80,80,160,0,670
96453,190,120,120,0,0,0,430
96454,160,80,120,0,0,0,360
96455,200,140,160,80,0,0,580
96456,210,120,120,80,0,0,530
96457,210,100,80,80,0,0,470
96458,180,100,80,80,0,0,440
96459,220,180,120,160,160,0,840
96460,200,120,40,80,160,0,600
96461,210,120,120,160,320,0,930
96462,210,140,80,80,0,0,510
96463,200,160,80,0,0,0,440
96464,210,160,80,80,0,0,530
96465,210,120,40,80,0,0,450
96466,190,100,80,160,160,0,690
96467,160,120,80,80,0,0,440
96468,200,120,80,80,0,0,480
96469,180,140,160,80,160,0,720
96470,170,100,120,160,160,320,1030
96471,230,200,120,160,160,320,1190
96472,210,160,160,240,320,0,1090
96473,220,100,80,80,0,0,480
96474,200,120,160,80,160,0,720
96475,160,120,120,160,320,0,880
96476,210,140,120,80,0,0,550
96477,150,120,80,0,0,0,350
96478,200,80,120,80,0,0,480
96479,190,100,0,0,0,0,290
96480,210,140,120,0,0,0,470
96481,200,100,40,80,160,0,580
96482,180,140,160,80,0,0,560
96483,180,160,120,160,160,320,1100
96484,210,160,160,160,160,0,850
96485,220,120,160,160,160,320,1140
96486,160,120,80,160,160,0,680
96487,160,120,160,160,320,0,920
96488,210,140,80,0,0,0,430
96489,220,100,120,80,160,0,680
96490,220,100,120,160,160,0,760
96491,220,180,160,160,160,0,880
96492,190,120,160,80,0,0,550
96493,210,120,40,80,0,0,450
96494,240,160,160,80,160,320,1120
96495,190,100,120,80,160,0,650
96496,180,140,80,80,0,0,480
96497,140,80,40,80,160,0,500
96498,230,180,160,80,0,0,650
96499,210,80,80,80,160,320,930
96500,200,160,80,160,160,0,760
96501,180,120,120,80,160,0,660
96502,210,80,120,80,0,0,490
96503,220,80,80,80,160,0,620
96504,200,80,80,0,0,0,360
96505,190,120,80,160,0,0,550
96506,230,100,80,0,0,0,410
96507,250,140,80,160,0,0,630
96508,240,160,160,160,160,0,880
96509,190,60,80,160,320,320,1130
96510,190,120,40,80,160,320,910
96511,200,120,80,80,160,0,640
96512,210,140,120,80,160,0,710
96513,200,100,160,160,160,0,780
96514,160,120,160,160,320,320,1240
96515,180,100,160,240,320,0,1000
96516,180,160,120,80,0,0,540
96517,250,140,0,0,0,0,390
96518,180,180,40,80,0,0,480
96519,170,80,80,80,160,0,570
96520,180,60,80,0,0,0,320
96521,220,140,80,0,0,0,440
96522,240,160,120,80,0,0,600
96523,170,100,80,80,0,0,430
96524,220,140,120,160,320,320,1280
96525,190,80,80,0,0,0,350
96526,190,80,120,80,160,0,630
96527,180,60,0,0,0,0,240
96528,170,100,40,0,0,0,310
96529,220,140,200,320,320,0,1200
96530,190,100,80,80,0,0,450
96531,170,40,0,0,0,0,210
96532,190,160,120,240,320,320,1350
96533,200,160,80,160,320,0,920
96534,210,80,120,80,160,0,650
96535,190,120,200,80,160,0,750
96536,140,120,80,80,160,320,900
96537,200,100,80,80,160,0,620
96538,200,100,160,160,160,0,780
96539,200,80,120,80,160,0,640
96540,220,120,80,160,160,0,740
96541,180,80,80,0,0,0,340
96542,190,140,80,80,0,0,490
96543,180,100,40,80,0,0,400
96544,230,160,120,80,0,0,590
96545,210,120,80,80,160,0,650
96546,170,140,160,80,0,0,550
96547,190,160,40,0,0,0,390
96548,240,120,80,80,160,320,1000
96549,220,140,120,80,0,0,560
96550,220,140,40,80,160,0,640
96551,190,120,120,80,160,320,990
96552,220,100,80,80,160,0,640
96553,200,140,80,160,160,0,740
96554,190,120,120,80,160,0,670
96555,190,140,120,0,0,0,450
96556,160,120,200,240,160,0,880
96557,190,140,200,240,320,320,1410
96558,180,80,120,160,0,0,540
96559,200,120,200,160,160,0,840
96560,210,140,120,240,320,0,1030
96561,210,140,160,240,160,320,1230
96562,230,80,40,80,160,0,590
96563,160,80,160,160,160,0,720
96564,200,100,160,160,0,0,620
96565,200,100,40,80,0,0,420
96566,190,100,80,0,0,0,370
96567,190,140,120,160,320,0,930
96568,210,180,120,80,160,0,750
96569,190,140,80,80,160,0,650
96570,220,160,200,160,0,0,740
96571,160,120,160,160,160,0,760
96572,190,140,40,0,0,0,370
96573,150,100,120,160,0,0,530
96574,230,200,160,80,0,0,670
96575,190,140,160,160,160,320,1130
96576,230,120,120,160,320,320,1270
96577,210,120,80,0,0,0,410
96578,220,160,40,0,0,0,420
96579,200,120,120,160,0,0,600
96580,180,100,120,80,160,0,640
96581,200,120,40,0,0,0,360
96582,240,120,120,80,0,0,560
96583,220,120,40,80,160,0,620
96584,200,180,120,160,160,0,820
96585,160,100,40,80,160,0,540
96586,200,140,160,160,160,0,820
96587,230,140,200,0,0,0,570
96588,160,100,160,160,160,320,1060
96589,180,140,80,160,320,320,1200
96590,160,60,120,160,160,0,660
96591,210,120,200,160,320,320,1330
96592,200,120,160,160,160,0,800
96593,220,100,120,80,160,320,1000
96594,160,140,120,80,160,0,660
96595,180,100,40,80,0,0,400
96596,220,140,120,0,0,0,480
96597,210,120,120,240,160,0,850
96598,230,120,80,80,160,0,670
96599,240,120,160,160,160,0,840
96600,200,100,120,80,0,0,500
96601,210,220,200,240,320,320,1510
96602,220,100,40,0,0,0,360
96603,200,180,200,240,320,0,1140
96604,240,140,160,0,0,0,540
96605,180,140,80,80,0,0,480
96606,180,120,40,80,0,0,420
96607,180,140,120,240,160,0,840
96608,220,120,80,0,0,0,420
96609,230,180,120,0,0,0,530
96610,200,100,120,80,0,0,500
96611,220,100,40,80,160,0,600
96612,200,80,120,0,0,0,400
96613,200,120,120,160,320,0,920
96614,190,80,80,80,160,0,590
96615,220,100,80,160,160,320,1040
96616,210,120,40,0,0,0,370
96617,160,120,120,160,0,0,560
96618,190,100,120,80,160,320,970
96619,180,140,40,80,160,0,600
96620,180,140,80,80,160,0,640
96621,210,160,120,0,0,0,490
96622,220,180,120,80,160,0,760
96623,190,120,40,80,0,0,430
96624,260,180,160,160,160,320,1240
96625,190,100,80,80,0,0,450
96626,210,140,120,0,0,0,470
96627,190,160,160,160,160,0,830
96628,180,40,0,0,0,0,220
96629,200,100,120,160,320,320,1220
96630,180,120,40,80,0,0,420
96631,210,160,120,160,320,320,1290
96632,180,140,120,80,0,0,520
96633,180,140,160,80,0,0,560
96634,210,120,80,160,320,0,890
96635,180,140,40,80,160,0,600
96636,170,180,40,80,0,0,470
96637,140,140,120,160,160,0,720
96638,160,100,160,160,160,320,1060
96639,200,100,80,0,0,0,380
96640,190,80,40,0,0,0,310
96641,190,140,120,80,160,0,690
96642,190,100,120,80,160,320,970
96643,170,120,40,0,0,0,330
96644,190,120,80,80,160,320,950
96645,160,100,80,80,160,320,900
96646,160,80,80,0,0,0,320
96647,190,100,120,80,0,0,490
96648,190,140,40,0,0,0,370
96649,180,100,120,240,320,320,1280
96650,250,140,160,80,160,0,790
96651,190,120,120,0,0,0,430
96652,180,100,40,80,160,0,560
96653,180,120,120,160,160,320,1060
96654,230,120,80,80,160,0,670
96655,170,100,40,0,0,0,310
96656,220,180,200,160,320,320,1400
96657,180,100,40,0,0,0,320
96658,180,120,120,0,0,0,420
96659,190,100,160,240,0,0,690
96660,210,180,120,160,160,0,830
96661,190,60,120,160,320,0,850
96662,180,100,40,0,0,0,320
96663,230,140,80,0,0,0,450
96664,190,120,80,0,0,0,390
96665,220,140,80,80,160,0,680
96666,210,120,160,160,160,0,810
96667,210,160,160,240,160,0,930
96668,200,80,80,80,0,0,440
96669,200,160,160,160,160,320,1160
96670,190,100,0,0,0,0,290
96671,210,100,80,0,0,0,390
96672,220,40,0,0,0,0,260
96673,170,140,160,160,0,0,630
96674,230,120,120,160,160,320,1110
96675,200,160,80,80,160,0,680
96676,190,140,120,160,0,0,610
96677,210,120,40,0,0,0,370
96678,170,100,120,80,160,0,630
96679,170,80,40,80,160,0,530
96680,200,80,0,0,0,0,280
96681,180,120,160,160,160,0,780
96682,200,160,240,160,160,0,920
96683,190,140,160,240,160,320,1210
96684,180,140,80,160,160,0,720
96685,180,160,160,80,160,320,1060
96686,190,120,80,160,160,320,1030
96687,230,120,80,0,0,0,430
96688,190,120,120,160,160,0,750
96689,210,120,200,80,0,0,610
96690,160,80,120,80,160,0,600
96691,200,140,120,80,160,0,700
96692,210,160,120,160,320,0,970
96693,170,120,120,0,0,0,410
96694,190,120,120,80,160,0,670
96695,190,140,120,80,160,0,690
96696,190,120,120,160,160,0,750
96697,160,120,120,80,160,320,960
96698,200,180,120,0,0,0,500
96699,230,160,120,80,160,0,750
96700,210,160,120,80,160,320,1050
96701,190,80,120,160,320,0,870
96702,200,80,40,0,0,0,320
96703,180,140,160,160,320,320,1280
96704,220,140,200,80,0,0,640
96705,190,120,120,160,0,0,590
96706,180,140,200,160,160,320,1160
96707,190,180,120,160,320,0,970
96708,230,160,120,0,0,0,510
96709,260,80,0,0,0,0,340
96710,240,140,120,160,160,0,820
96711,180,160,200,80,0,0,620
96712,190,180,160,80,160,0,770
96713,150,120,40,80,160,0,550
96714,180,180,80,80,160,0,680
96715,170,160,200,160,160,0,850
96716,200,100,120,80,160,0,660
96717,200,100,80,0,0,0,380
96718,170,80,80,0,0,0,330
96719,160,100,40,0,0,0,300
96720,230,100,120,160,160,320,1090
96721,180,120,80,80,0,0,460
96722,170,180,80,160,160,0,750
96723,210,120,80,160,160,0,730
96724,220,100,40,80,160,0,600
96725,190,200,200,160,160,320,1230
96726,220,140,80,160,160,320,1080
96727,180,120,40,0,0,0,340
96728,210,100,80,80,160,0,630
96729,200,120,120,160,0,0,600
96730,210,140,80,80,0,0,510
96731,230,120,160,160,320,0,990
96732,200,100,80,80,160,0,620
96733,200,140,80,80,160,320,980
96734,160,100,120,160,160,0,700
96735,220,140,120,80,160,0,720
96736,170,80,40,0,0,0,290
96737,170,120,120,160,160,0,730
96738,150,120,120,160,0,0,550
96739,160,140,160,160,320,0,940
96740,190,100,120,160,160,0,730
96741,170,20,0,0,0,0,190
96742,210,100,80,80,160,0,630
96743,170,120,80,80,160,0,610
96744,190,160,160,80,160,320,1070
96745,200,180,120,80,160,0,740
96746,200,140,120,160,0,0,620
96747,210,140,120,80,0,0,550
96748,190,120,80,80,0,0,470
96749,210,160,120,0,0,0,490
96750,160,120,120,80,160,0,640
96751,220,80,120,80,160,0,660
96752,210,140,120,240,160,0,870
96753,180,140,40,80,160,0,600
96754,230,160,160,160,160,320,1190
96755,200,80,80,0,0,0,360
96756,230,160,160,240,160,0,950
96757,160,120,120,0,0,0,400
96758,190,140,80,160,160,0,730
96759,200,120,200,240,160,0,920
96760,190,140,120,80,0,0,530
96761,180,140,80,0,0,0,400
96762,200,140,80,80,160,0,660
96763,180,120,120,160,160,320,1060
96764,200,160,80,0,0,0,440
96765,180,80,40,80,160,0,540
96766,190,100,0,0,0,0,290
96767,180,100,40,0,0,0,320
96768,240,180,120,0,0,0,540
96769,180,180,200,160,160,320,1200
96770,250,160,200,160,160,0,930
96771,180,100,160,160,160,0,760
96772,220,140,120,160,0,0,640
96773,230,140,160,160,160,0,850
96774,200,80,40,80,160,320,880
96775,210,140,120,80,0,0,550
96776,190,80,40,80,0,0,390
96777,230,180,160,80,0,0,650
96778,220,160,80,80,160,0,700
96779,190,160,120,160,160,0,790
96780,190,120,120,80,0,0,510
96781,180,100,120,160,0,0,560
96782,190,100,80,160,320,320,1170
96783,230,140,120,0,0,0,490
96784,200,120,160,160,160,0,800
96785,280,140,80,80,0,0,580
96786,190,120,120,80,160,320,990
96787,170,120,80,160,160,0,690
96788,230,160,200,160,0,0,750
96789,190,120,120,160,320,320,1230
96790,210,120,80,80,160,0,650
96791,210,120,120,0,0,0,450
96792,190,80,40,80,160,0,550
96793,130,120,80,160,160,0,650
96794,170,100,160,0,0,0,430
96795,200,160,120,240,160,0,880
96796,200,100,80,80,160,320,940
96797,150,80,80,80,0,0,390
96798,210,120,120,0,0,0,450
96799,180,100,40,80,160,0,560
96800,220,140,80,0,0,0,440
96801,220,140,160,80,160,0,760
96802,240,120,120,80,160,0,720
96803,200,100,40,80,0,0,420
96804,220,100,80,0,0,0,400
96805,170,80,40,80,160,0,530
96806,180,80,40,80,0,0,380
96807,200,100,80,80,160,0,620
96808,230,120,120,80,160,0,710
96809,210,200,160,80,0,0,650
96810,210,140,240,240,320,0,1150
96811,180,80,80,160,160,320,980
96812,160,100,120,160,160,0,700
96813,210,140,200,80,160,0,790
96814,170,140,120,80,160,0,670
96815,230,140,160,160,0,0,690
96816,180,100,80,80,160,320,920
96817,210,100,160,240,160,0,870
96818,140,120,120,80,160,0,620
96819,200,160,80,80,160,0,680
96820,190,80,80,80,160,320,910
96821,220,100,80,80,160,0,640
96822,170,100,40,80,160,0,550
96823,190,180,120,0,0,0,490
96824,200,120,120,80,160,0,680
96825,210,120,40,80,160,0,610
96826,210,160,120,80,0,0,570
96827,180,100,80,80,160,0,600
96828,190,80,80,160,320,0,830
96829,200,120,120,160,160,0,760
96830,150,80,40,80,160,0,510
96831,220,100,160,160,160,0,800
96832,220,160,0,0,0,0,380
96833,190,100,80,0,0,0,370
96834,220,140,160,160,320,320,1320
96835,240,140,200,240,160,0,980
96836,200,160,160,160,160,320,1160
96837,210,100,120,80,0,0,510
96838,220,140,200,160,320,320,1360
96839,230,100,80,0,0,0,410
96840,180,100,80,80,160,0,600
96841,160,100,80,80,160,0,580
96842,220,60,80,80,160,320,920
96843,200,160,200,160,160,0,880
96844,210,80,80,80,0,0,450
96845,210,80,80,80,160,0,610
96846,190,120,40,80,160,0,590
96847,190,80,120,240,0,0,630
96848,160,120,120,80,160,0,640
96849,140,80,40,80,160,0,500
96850,220,140,80,80,160,0,680
96851,240,100,80,80,0,0,500
96852,210,180,200,80,160,320,1150
96853,170,120,80,80,160,0,610
96854,210,140,120,160,160,0,790
96855,190,120,160,160,160,0,790
96856,160,80,40,80,160,320,840
96857,240,100,0,0,0,0,340
96858,200,80,80,160,320,0,840
96859,210,160,40,0,0,0,410
96860,230,140,160,160,0,0,690
96861,180,100,80,80,160,0,600
96862,220,140,80,80,0,0,520
96863,160,160,120,160,160,0,760
96864,180,100,80,160,160,0,680
96865,170,100,0,0,0,0,270
96866,190,120,80,80,160,0,630
96867,160,60,40,80,160,0,500
96868,200,140,80,80,0,0,500
96869,180,140,120,80,160,0,680
96870,220,160,120,80,160,0,740
96871,190,160,200,160,0,0,710
96872,170,100,120,160,160,0,710
96873,230,120,160,240,160,0,910
96874,230,140,160,160,160,0,850
96875,230,120,80,160,160,0,750
96876,250,180,200,80,0,0,710
96877,230,160,120,160,160,0,830
96878,230,80,120,80,0,0,510
96879,220,120,40,80,160,0,620
96880,230,80,40,80,160,0,590
96881,170,100,40,0,0,0,310
96882,190,100,80,0,0,0,370
96883,190,120,80,0,0,0,390
96884,200,140,80,80,160,0,660
96885,200,80,120,80,160,0,640
96886,200,80,80,160,160,0,680
96887,180,120,120,160,0,0,580
96888,220,140,120,160,160,0,800
96889,190,120,40,0,0,0,350
96890,210,160,160,80,160,0,770
96891,200,140,160,160,320,0,980
96892,180,120,80,160,0,0,540
96893,180,100,160,80,0,0,520
96894,190,80,80,160,0,0,510
96895,180,80,80,80,160,0,580
96896,200,200,200,160,0,0,760
96897,190,180,120,160,160,0,810
96898,150,100,120,80,0,0,450
96899,190,100,80,0,0,0,370
96900,160,40,40,80,0,0,320
96901,190,160,200,80,160,0,790
96902,150,100,120,160,320,320,1170
96903,200,60,0,0,0,0,260
96904,220,120,120,240,160,0,860
96905,180,160,80,80,160,0,660
96906,230,140,80,80,0,0,530
96907,230,160,120,160,160,320,1150
96908,240,100,120,80,160,320,1020
96909,190,120,160,160,160,320,1110
96910,200,140,120,160,160,0,780
96911,180,120,120,80,160,0,660
96912,230,120,80,80,0,0,510
96913,230,100,160,160,160,0,810
96914,210,160,120,0,0,0,490
96915,180,80,0,0,0,0,260
96916,190,180,120,80,160,320,1050
96917,220,160,160,160,160,0,860
96918,180,160,120,160,160,0,780
96919,170,140,160,160,160,0,790
96920,180,80,80,0,0,0,340
96921,200,160,40,80,160,0,640
96922,190,100,120,160,160,320,1050
96923,180,100,40,80,160,0,560
96924,200,140,160,0,0,0,500
96925,200,100,80,160,160,0,700
96926,180,40,40,0,0,0,260
96927,210,100,80,160,320,320,1190
96928,210,220,120,240,320,0,1110
96929,180,140,120,160,160,0,760
96930,260,120,120,80,0,0,580
96931,270,120,80,80,0,0,550
96932,190,80,40,80,160,0,550
96933,140,100,80,0,0,0,320
96934,170,160,160,80,0,0,570
96935,210,140,80,0,0,0,430
96936,180,120,120,240,320,0,980
96937,210,180,160,160,160,0,870
96938,200,100,80,80,160,0,620
96939,210,80,80,160,160,0,690
96940,230,100,120,80,0,0,530
96941,240,140,160,80,0,0,620
96942,220,120,160,240,320,320,1380
96943,210,140,120,160,160,0,790
96944,210,140,160,80,0,0,590
96945,170,140,120,80,160,0,670
96946,180,120,120,160,160,0,740
96947,200,160,120,80,0,0,560
96948,240,100,0,0,0,0,340
96949,180,80,80,80,160,320,900
96950,170,140,200,240,320,320,1390
96951,110,20,40,0,0,0,170
96952,190,140,80,80,0,0,490
96953,140,120,160,80,0,0,500
96954,170,120,40,80,160,0,570
96955,220,180,160,80,160,0,800
96956,180,120,160,160,320,320,1260
96957,200,80,0,0,0,0,280
96958,240,140,120,160,160,0,820
96959,220,100,160,160,160,0,800
96960,230,160,120,160,160,0,830
96961,220,80,80,80,160,0,620
96962,180,100,120,160,0,0,560
96963,230,200,160,240,320,0,1150
96964,200,120,80,160,0,0,560
96965,220,100,80,0,0,0,400
96966,210,140,40,80,160,320,950
96967,150,100,80,0,0,0,330
96968,190,120,80,80,0,0,470
96969,170,100,80,0,0,0,350
96970,180,120,80,0,0,0,380
96971,150,100,120,80,160,0,610
96972,160,40,40,0,0,0,240
96973,210,100,80,80,160,0,630
96974,180,120,80,0,0,0,380
96975,200,100,80,80,160,0,620
96976,230,140,160,240,160,0,930
96977,200,140,120,160,160,0,780
96978,220,140,120,160,160,0,800
96979,180,120,160,160,160,0,780
96980,200,140,120,80,160,0,700
96981,210,80,0,0,0,0,290
96982,200,120,120,80,0,0,520
96983,180,140,80,80,160,0,640
96984,190,160,160,240,320,0,1070
96985,150,100,120,160,160,0,690
96986,220,200,80,160,0,0,660
96987,230,120,120,80,160,320,1030
96988,180,140,120,160,160,320,1080
96989,200,100,120,160,160,0,740
96990,190,120,40,0,0,0,350
96991,190,80,80,80,160,320,910
96992,140,80,80,80,160,0,540
96993,200,100,80,80,160,0,620
96994,230,100,120,80,160,0,690
96995,190,100,80,80,0,0,450
96996,230,140,160,160,160,320,1170
96997,190,100,80,80,160,0,610
96998,210,160,40,80,160,0,650
96999,170,100,80,80,160,0,590
97000,180,200,120,80,160,320,1060
97001,230,140,40,80,0,0,490
97002,230,200,200,80,160,0,870
97003,160,140,80,0,0,0,380
97004,210,140,120,160,320,320,1270
97005,180,120,120,160,320,0,900
97006,220,140,160,160,0,0,680
97007,170,140,120,80,0,0,510
97008,170,140,120,80,0,0,510
97009,210,120,40,0,0,0,370
97010,230,140,160,160,160,0,850
97011,200,100,80,0,0,0,380
97012,220,140,120,240,320,0,1040
97013,180,80,120,160,320,0,860
97014,170,120,120,0,0,0,410
97015,210,160,160,80,0,0,610
97016,200,140,160,160,160,0,820
97017,190,80,80,80,0,0,430
97018,210,100,80,0,0,0,390
97019,240,160,120,160,160,0,840
97020,210,140,80,80,160,0,670
97021,220,120,120,80,160,0,700
97022,210,140,160,160,320,320,1310
97023,190,140,160,160,160,0,810
97024,230,180,200,240,160,320,1330
97025,160,160,160,160,320,0,960
97026,170,140,80,80,0,0,470
97027,230,100,0,0,0,0,330
97028,180,100,40,80,0,0,400
97029,200,160,160,80,160,320,1080
97030,200,120,80,160,320,0,880
97031,200,100,80,80,160,0,620
97032,150,140,160,160,0,0,610
97033,200,80,40,80,160,320,880
97034,210,100,120,160,160,0,750
97035,180,100,160,160,160,0,760
97036,180,160,40,0,0,0,380
97037,230,60,40,80,160,0,570
97038,180,160,80,160,160,0,740
97039,210,100,120,80,0,0,510
97040,230,120,120,80,160,0,710
97041,210,40,40,0,0,0,290
97042,200,140,120,80,0,0,540
97043,190,160,160,80,0,0,590
97044,180,100,160,160,160,0,760
97045,190,160,40,80,160,320,950
97046,200,160,80,160,320,0,920
97047,200,140,40,80,160,320,940
97048,190,100,120,160,160,320,1050
97049,210,80,80,80,0,0,450
97050,210,160,120,80,160,320,1050
97051,220,140,40,80,0,0,480
97052,170,140,40,0,0,0,350
97053,170,140,120,80,160,0,670
97054,170,140,120,80,160,320,990
97055,220,100,80,160,160,0,720
97056,210,140,40,0,0,0,390
97057,180,80,80,80,160,0,580
97058,170,140,160,80,0,0,550
97059,180,120,120,80,160,0,660
97060,220,160,160,80,160,0,780
97061,180,100,40,80,160,0,560
97062,120,120,120,80,160,0,600
97063,200,140,80,80,0,0,500
97064,160,140,200,160,320,0,980
97065,190,100,80,0,0,0,370
97066,200,80,120,80,0,0,480
97067,190,60,120,0,0,0,370
97068,140,100,120,80,160,0,600
97069,130,140,160,160,160,0,750
97070,210,120,120,80,160,320,1010
97071,180,140,120,160,160,0,760
97072,240,120,80,0,0,0,440
97073,200,80,40,80,160,0,560
97074,170,100,40,80,160,0,550
97075,160,80,80,80,160,0,560
97076,190,160,80,80,0,0,510
97077,190,100,120,160,0,0,570
97078,170,100,80,160,160,0,670
97079,210,100,120,160,0,0,590
97080,210,220,120,160,160,0,870
97081,190,120,80,80,0,0,470
97082,200,120,80,0,0,0,400
97083,220,80,120,80,0,0,500
97084,170,80,40,80,160,0,530
97085,180,120,120,80,160,0,660
97086,170,120,120,160,0,0,570
97087,210,180,200,240,160,320,1310
97088,190,80,120,160,320,320,1190
97089,200,140,160,80,160,0,740
97090,220,100,120,80,0,0,520
97091,170,120,40,0,0,0,330
97092,220,140,80,0,0,0,440
97093,220,140,120,80,0,0,560
97094,180,140,120,160,160,0,760
97095,230,140,80,80,160,0,690
97096,170,140,80,160,0,0,550
97097,190,140,200,160,160,0,850
97098,170,100,40,0,0,0,310
97099,230,140,160,240,320,320,1410
97100,170,100,40,80,160,0,550
97101,170,100,120,160,160,0,710
97102,190,140,80,80,160,0,650
97103,200,100,120,80,160,320,980
97104,230,160,120,160,320,320,1310
97105,190,120,120,160,160,0,750
97106,210,160,120,80,0,0,570
97107,160,100,120,0,0,0,380
97108,220,100,120,160,160,320,1080
97109,170,120,80,80,0,0,450
97110,190,140,80,160,320,320,1210
97111,160,120,160,160,160,0,760
97112,170,100,80,80,160,320,910
97113,190,120,80,160,320,0,870
97114,190,100,160,0,0,0,450
97115,160,140,120,80,160,320,980
97116,200,140,160,80,0,0,580
97117,200,160,200,240,160,0,960
97118,240,120,40,80,0,0,480
97119,250,140,120,160,320,320,1310
97120,200,120,160,80,160,320,1040
97121,200,100,160,160,160,0,780
97122,180,120,80,0,0,0,380
97123,220,160,160,80,160,0,780
97124,230,160,40,0,0,0,430
97125,150,80,40,80,0,0,350
97126,200,140,80,0,0,0,420
97127,170,140,120,160,0,0,590
97128,180,120,160,240,160,0,860
97129,160,140,80,80,0,0,460
97130,220,120,80,80,160,320,980
97131,220,100,80,80,0,0,480
97132,230,160,200,240,160,0,990
97133,200,160,120,80,160,320,1040
97134,180,100,80,0,0,0,360
97135,220,180,160,80,0,0,640
97136,200,180,120,160,0,0,660
97137,200,160,120,160,160,0,800
97138,210,100,40,0,0,0,350
97139,160,80,40,0,0,0,280
97140,230,160,120,240,160,0,910
97141,200,80,40,0,0,0,320
97142,240,160,120,160,320,0,1000
97143,180,100,40,0,0,0,320
97144,210,100,80,80,160,0,630
97145,180,120,80,80,160,0,620
97146,200,140,80,0,0,0,420
97147,200,140,40,0,0,0,380
97148,200,40,40,80,160,0,520
97149,220,80,40,80,160,0,580
97150,150,100,40,80,160,0,530
97151,250,220,160,160,160,320,1270
97152,170,120,120,160,0,0,570
97153,180,120,160,240,320,0,1020
97154,190,80,120,80,160,320,950
97155,160,40,80,80,160,320,840
97156,210,40,40,80,0,0,370
97157,190,140,160,80,160,0,730
97158,140,140,80,0,0,0,360
97159,140,120,40,0,0,0,300
97160,210,140,80,80,160,0,670
97161,170,140,120,80,160,0,670
97162,180,140,120,80,0,0,520
97163,180,120,80,0,0,0,380
97164,160,80,40,80,160,0,520
97165,140,120,120,80,0,0,460
97166,190,160,160,160,0,0,670
97167,230,100,80,0,0,0,410
97168,210,120,80,80,160,0,650
97169,200,80,40,0,0,0,320
97170,210,120,80,0,0,0,410
97171,180,80,40,0,0,0,300
97172,190,140,80,160,160,0,730
97173,220,140,120,160,320,0,960
97174,200,140,120,0,0,0,460
97175,190,100,120,160,320,320,1210
97176,230,120,160,240,0,0,750
97177,190,120,80,80,0,0,470
97178,180,100,80,0,0,0,360
97179,160,80,80,160,320,0,800
97180,210,160,80,0,0,0,450
97181,190,120,80,80,0,0,470
97182,190,120,120,0,0,0,430
97183,210,100,120,240,160,0,830
97184,210,180,200,160,160,320,1230
97185,210,80,80,80,160,320,930
97186,180,140,120,160,0,0,600
97187,230,120,40,80,160,0,630
97188,200,140,120,80,160,0,700
97189,240,80,80,80,0,0,480
97190,230,120,80,80,160,0,670
97191,200,140,160,240,160,0,900
97192,200,140,160,160,160,0,820
97193,210,120,160,160,160,0,810
97194,180,100,120,80,160,0,640
97195,190,100,80,80,160,0,610
97196,180,120,120,80,0,0,500
97197,150,100,120,160,0,0,530
97198,150,120,120,80,0,0,470
97199,270,200,160,80,160,0,870
97200,200,120,120,0,0,0,440
97201,190,100,40,80,160,0,570
97202,220,80,40,80,160,320,900
97203,160,120,80,80,160,0,600
97204,160,200,80,80,0,0,520
97205,160,100,80,80,160,0,580
97206,220,80,40,80,0,0,420
97207,200,120,80,160,0,0,560
97208,170,120,160,80,160,0,690
97209,200,80,120,160,160,0,720
97210,210,100,120,160,160,0,750
97211,200,140,120,160,160,0,780
97212,190,140,160,160,320,320,1290
97213,250,100,200,160,160,0,870
97214,200,80,80,160,320,0,840
97215,180,160,120,80,160,0,700
97216,160,80,80,0,0,0,320
97217,180,140,120,160,0,0,600
97218,210,180,200,160,160,0,910
97219,200,160,160,160,0,0,680
97220,220,160,80,160,160,0,780
97221,240,160,120,160,160,0,840
97222,180,120,120,80,0,0,500
97223,220,100,120,240,160,0,840
97224,140,100,160,160,0,0,560
97225,200,80,40,80,160,0,560
97226,180,100,160,80,160,320,1000
97227,250,160,160,160,160,0,890
97228,190,160,120,0,0,0,470
97229,170,80,80,80,0,0,410
97230,260,200,160,80,160,0,860
97231,160,140,160,80,160,0,700
97232,210,140,120,80,160,0,710
97233,180,80,40,80,160,0,540
97234,210,220,120,160,160,0,870
97235,140,80,80,0,0,0,300
97236,190,180,120,160,160,0,810
97237,220,100,160,160,160,0,800
97238,220,100,120,160,160,0,760
97239,230,120,80,80,0,0,510
97240,190,80,120,80,160,320,950
97241,200,160,160,80,0,0,600
97242,190,100,80,80,0,0,450
97243,210,140,80,80,160,0,670
97244,190,100,80,160,160,0,690
97245,210,160,120,80,160,0,730
97246,190,120,80,0,0,0,390
97247,200,120,120,160,320,0,920
97248,220,80,40,80,0,0,420
97249,190,100,120,160,320,0,890
97250,220,160,40,80,0,0,500
97251,180,180,160,160,160,320,1160
97252,200,140,120,80,160,0,700
97253,190,140,120,80,160,0,690
97254,160,100,120,160,320,0,860
97255,210,80,40,80,0,0,410
97256,210,120,80,0,0,0,410
97257,210,80,80,80,160,0,610
97258,200,80,40,80,0,0,400
97259,170,60,80,80,160,0,550
97260,240,200,160,160,0,0,760
97261,190,80,40,80,160,0,550
97262,180,80,160,160,160,0,740
97263,190,100,40,80,160,0,570
97264,220,100,120,80,160,320,1000
97265,210,120,80,160,320,0,890
97266,210,140,160,80,0,0,590
97267,170,140,120,160,0,0,590
97268,200,120,120,160,0,0,600
97269,190,100,80,80,160,0,610
97270,220,200,160,80,0,0,660
97271,160,200,160,80,160,0,760
97272,200,120,160,80,0,0,560
97273,190,120,160,80,0,0,550
97274,220,100,120,80,160,320,1000
97275,170,100,80,80,160,0,590
97276,250,120,120,80,0,0,570
97277,190,160,160,80,160,0,750
97278,220,120,80,160,160,320,1060
97279,200,100,80,80,160,0,620
97280,160,60,120,160,160,320,980
97281,230,120,80,80,160,320,990
97282,210,120,200,80,160,320,1090
97283,160,80,80,80,0,0,400
97284,210,140,80,80,160,320,990
97285,210,80,160,80,160,0,690
97286,210,180,160,160,160,0,870
97287,170,180,160,240,320,0,1070
97288,220,120,80,80,160,0,660
97289,150,120,120,80,0,0,470
97290,220,160,160,160,0,0,700
97291,180,80,80,160,160,0,660
97292,200,200,160,80,0,0,640
97293,240,140,120,0,0,0,500
97294,250,200,160,80,160,0,850
97295,170,120,120,80,160,0,650
97296,190,80,120,80,0,0,470
97297,190,80,160,80,160,0,670
97298,200,180,160,240,160,0,940
97299,190,180,200,80,0,0,650
97300,180,120,120,160,320,0,900
97301,200,120,40,80,160,0,600
97302,150,100,80,80,0,0,410
97303,180,160,160,160,0,0,660
97304,210,80,40,80,0,0,410
97305,210,160,80,80,160,0,690
97306,200,140,120,160,160,0,780
97307,180,100,120,160,320,0,880
97308,210,100,40,0,0,0,350
97309,190,80,80,160,160,0,670
97310,150,120,40,0,0,0,310
97311,190,60,40,80,160,0,530
97312,210,140,240,80,160,0,830
97313,200,100,160,80,160,0,700
97314,190,100,80,160,320,0,850
97315,210,120,120,80,160,0,690
97316,170,140,120,240,320,0,990
97317,200,100,120,160,160,0,740
97318,170,120,120,160,320,0,890
97319,190,140,120,80,0,0,530
97320,220,160,40,0,0,0,420
97321,200,140,160,160,320,0,980
97322,220,120,80,160,0,0,580
97323,180,120,160,160,320,0,940
97324,140,140,120,80,160,0,640
97325,170,40,40,80,160,0,490
97326,220,100,200,160,160,0,840
97327,180,140,40,80,160,0,600
97328,170,140,160,80,0,0,550
97329,200,120,120,80,160,0,680
97330,230,80,40,0,0,0,350
97331,200,60,0,0,0,0,260
97332,210,100,80,80,160,0,630
97333,220,160,120,160,160,0,820
97334,170,120,120,80,0,0,490
97335,220,120,120,160,160,320,1100
97336,200,100,80,80,0,0,460
97337,190,80,80,80,160,0,590
97338,220,180,120,160,0,0,680
97339,200,100,200,160,160,0,820
97340,170,140,160,160,160,0,790
97341,180,100,80,80,0,0,440
97342,210,140,160,160,160,0,830
97343,190,120,40,0,0,0,350
97344,160,80,80,0,0,0,320
97345,160,120,120,80,160,0,640
97346,220,160,160,80,0,0,620
97347,210,120,160,240,320,0,1050
97348,200,140,160,160,160,0,820
97349,190,100,120,80,0,0,490
97350,160,100,80,80,160,0,580
97351,160,100,120,160,160,0,700
97352,220,140,80,0,0,0,440
97353,200,120,120,80,0,0,520
97354,190,120,160,80,0,0,550
97355,200,100,80,160,0,0,540
97356,220,120,80,160,160,0,740
97357,210,100,120,0,0,0,430
97358,180,100,120,160,160,320,1040
97359,210,160,120,80,160,320,1050
97360,200,140,80,80,0,0,500
97361,190,80,120,80,160,0,630
97362,200,180,200,160,160,0,900
97363,170,120,160,160,320,0,930
97364,170,120,80,160,320,0,850
97365,190,100,80,80,160,0,610
97366,180,140,80,80,160,0,640
97367,190,100,120,80,160,0,650
97368,220,120,80,160,320,0,900
97369,180,120,120,80,0,0,500
97370,190,120,80,160,160,0,710
97371,190,160,120,160,160,0,790
97372,200,120,120,160,160,0,760
97373,220,180,80,80,0,0,560
97374,210,160,80,80,160,0,690
97375,170,80,40,80,160,0,530
97376,180,160,160,240,160,320,1220
97377,200,120,80,160,160,0,720
97378,200,180,160,0,0,0,540
97379,150,100,40,0,0,0,290
97380,160,100,120,240,320,0,940
97381,200,140,80,0,0,0,420
97382,200,120,120,160,160,0,760
97383,220,160,120,240,160,320,1220
97384,210,80,40,0,0,0,330
97385,180,100,160,0,0,0,440
97386,170,140,40,80,0,0,430
97387,230,100,40,80,0,0,450
97388,200,160,80,160,320,0,920
97389,190,140,160,80,0,0,570
97390,200,140,120,80,0,0,540
97391,180,140,80,80,0,0,480
97392,220,160,80,160,160,320,1100
97393,180,120,120,160,160,320,1060
97394,160,140,160,240,320,320,1340
97395,190,80,40,80,0,0,390
97396,190,160,120,160,0,0,630
97397,190,180,120,80,160,320,1050
97398,230,120,160,80,0,0,590
97399,220,100,80,80,160,0,640
97400,150,60,40,0,0,0,250
97401,190,180,120,160,160,320,1130
97402,220,100,40,80,160,320,920
97403,200,140,160,160,0,0,660
97404,170,60,40,0,0,0,270
97405,190,160,160,80,0,0,590
97406,180,160,160,0,0,0,500
97407,230,100,160,160,0,0,650
97408,180,120,120,80,0,0,500
97409,190,80,40,80,160,0,550
97410,180,120,80,160,160,0,700
97411,200,180,160,160,160,0,860
97412,130,120,120,240,160,0,770
97413,170,140,120,80,0,0,510
97414,200,120,120,160,160,0,760
97415,190,120,160,240,320,0,1030
97416,190,80,120,160,160,0,710
97417,190,160,160,80,0,0,590
97418,210,100,80,80,160,320,950
97419,170,60,80,80,160,0,550
97420,210,180,160,160,160,0,870
97421,220,100,160,160,320,320,1280
97422,210,100,40,80,160,0,590
97423,160,100,40,80,160,0,540
97424,160,100,80,160,160,0,660
97425,200,140,80,80,160,0,660
97426,190,120,160,80,0,0,550
97427,200,80,40,80,160,0,560
97428,200,160,160,80,160,0,760
97429,160,120,80,160,0,0,520
97430,210,200,200,160,160,320,1250
97431,180,140,120,160,320,0,920
97432,160,60,80,0,0,0,300
97433,220,140,120,160,160,0,800
97434,170,120,120,0,0,0,410
97435,190,160,160,240,320,0,1070
97436,210,80,80,80,160,0,610
97437,200,60,0,0,0,0,260
97438,250,140,80,80,160,0,710
97439,230,140,160,160,320,0,1010
97440,140,120,40,0,0,0,300
97441,180,140,120,80,160,0,680
97442,220,120,120,80,160,0,700
97443,200,180,160,80,160,0,780
97444,190,120,120,80,160,320,990
97445,220,120,120,80,0,0,540
97446,190,140,120,160,160,0,770
97447,180,140,160,80,0,0,560
97448,200,80,80,0,0,0,360
97449,160,120,120,160,320,320,1200
97450,200,100,80,80,0,0,460
97451,210,140,120,80,0,0,550
97452,210,80,0,0,0,0,290
97453,210,80,80,160,0,0,530
97454,230,160,200,240,320,320,1470
97455,220,180,200,160,160,0,920
97456,220,160,160,240,320,0,1100
97457,210,140,120,80,160,320,1030
97458,220,140,120,80,0,0,560
97459,250,120,160,0,0,0,530
97460,200,160,160,160,0,0,680
97461,200,160,200,160,160,0,880
97462,170,120,120,160,160,0,730
97463,190,140,120,160,160,320,1090
97464,190,180,160,160,0,0,690
97465,200,120,40,0,0,0,360
97466,160,60,80,80,0,0,380
97467,170,120,40,80,160,0,570
97468,210,120,40,80,0,0,450
97469,170,40,80,160,160,0,610
97470,220,60,40,0,0,0,320
97471,210,120,160,80,160,0,730
97472,230,180,160,160,160,320,1210
97473,240,140,80,80,160,0,700
97474,190,80,120,240,160,0,790
97475,230,140,160,160,320,0,1010
97476,200,140,120,80,160,0,700
97477,160,100,40,0,0,0,300
97478,220,140,120,0,0,0,480
97479,160,60,120,80,160,0,580
97480,210,180,120,80,0,0,590
97481,200,120,160,0,0,0,480
97482,190,140,80,0,0,0,410
97483,200,160,160,80,160,0,760
97484,210,120,0,0,0,0,330
97485,190,100,80,80,160,0,610
97486,190,100,120,160,160,0,730
97487,230,120,120,160,320,0,950
97488,150,80,80,80,0,0,390
97489,210,120,80,80,0,0,490
97490,170,100,120,0,0,0,390
97491,200,140,80,80,0,0,500
97492,240,140,80,80,0,0,540
97493,180,160,200,160,160,320,1180
97494,210,120,160,80,0,0,570
97495,220,140,160,160,160,0,840
97496,170,140,160,160,320,0,950
97497,160,120,0,0,0,0,280
97498,200,120,80,80,160,0,640
97499,170,100,120,160,0,0,550
97500,230,120,80,80,160,0,670
97501,210,120,120,80,0,0,530
97502,200,120,80,80,0,0,480
97503,220,100,120,160,320,0,920
97504,210,100,120,160,320,0,910
97505,150,100,160,160,160,320,1050
97506,230,120,120,80,160,0,710
97507,220,120,80,160,320,0,900
97508,190,140,160,160,160,0,810
97509,200,120,120,240,320,0,1000
97510,210,180,80,80,0,0,550
97511,160,100,80,160,160,320,980
97512,180,120,240,80,0,0,620
97513,200,140,120,0,0,0,460
97514,190,80,80,80,0,0,430
97515,220,160,120,80,160,320,1060
97516,170,100,120,160,320,0,870
97517,200,100,80,160,320,0,860
97518,180,120,160,240,320,0,1020
97519,160,160,160,0,0,0,480
97520,160,140,200,80,0,0,580
97521,190,100,120,160,160,0,730
97522,190,160,40,0,0,0,390
97523,160,160,160,80,160,320,1040
97524,180,60,120,80,160,0,600
97525,220,40,40,80,160,0,540
97526,170,160,120,160,160,0,770
97527,170,140,160,160,160,0,790
97528,190,60,40,0,0,0,290
97529,220,140,160,0,0,0,520
97530,180,140,120,80,160,0,680
97531,220,140,120,160,320,0,960
97532,170,140,120,160,160,0,750
97533,210,120,120,0,0,0,450
97534,230,140,40,80,0,0,490
97535,160,120,120,80,160,0,640
97536,190,140,200,240,160,0,930
97537,230,160,120,0,0,0,510
97538,190,120,160,80,160,0,710
97539,200,140,120,160,160,0,780
97540,200,120,160,240,160,0,880
97541,180,100,40,80,0,0,400
97542,200,160,120,0,0,0,480
97543,200,100,40,80,160,0,580
97544,230,100,80,160,160,0,730
97545,210,140,40,80,160,0,630
97546,170,120,160,160,160,0,770
97547,150,100,200,160,320,0,930
97548,210,160,120,0,0,0,490
97549,190,160,200,240,160,0,950
97550,160,100,40,80,160,0,540
97551,220,160,120,0,0,0,500
97552,180,100,80,0,0,0,360
97553,180,160,120,80,0,0,540
97554,200,140,120,160,160,0,780
97555,190,100,0,0,0,0,290
97556,150,80,160,80,160,0,630
97557,220,80,80,80,160,0,620
97558,210,80,160,160,0,0,610
97559,200,80,40,0,0,0,320
97560,210,100,120,0,0,0,430
97561,230,100,80,80,0,0,490
97562,190,120,120,160,0,0,590
97563,200,100,120,160,0,0,580
97564,200,120,120,80,160,0,680
97565,230,100,40,80,160,320,930
97566,180,100,120,160,160,0,720
97567,190,80,40,80,0,0,390
97568,200,120,120,160,160,0,760
97569,240,120,120,160,160,0,800
97570,170,80,80,160,160,0,650
97571,200,120,120,160,0,0,600
97572,170,140,80,80,160,0,630
97573,200,140,160,0,0,0,500
97574,220,80,120,240,320,0,980
97575,190,160,160,160,160,320,1150
97576,180,160,120,80,160,320,1020
97577,170,80,80,80,0,0,410
97578,270,160,80,80,160,0,750
97579,180,140,120,160,160,0,760
97580,240,100,120,160,160,0,780
97581,180,80,80,80,160,0,580
97582,160,120,120,160,320,0,880
97583,200,140,80,80,160,0,660
97584,220,180,80,80,0,0,560
97585,180,80,80,80,160,0,580
97586,150,60,40,80,160,320,810
97587,180,80,80,80,160,0,580
97588,210,200,80,80,160,320,1050
97589,160,120,120,80,160,320,960
97590,200,60,40,0,0,0,300
97591,210,120,80,160,320,0,890
97592,170,140,200,160,0,0,670
97593,240,120,80,160,160,0,760
97594,230,160,160,160,320,320,1350
97595,190,140,120,0,0,0,450
97596,220,140,80,80,160,0,680
97597,230,120,120,160,160,0,790
97598,240,140,40,0,0,0,420
97599,200,140,80,80,0,0,500
97600,190,140,200,240,320,0,1090
97601,200,160,160,160,160,0,840
97602,190,160,160,80,0,0,590
97603,210,160,200,160,160,0,890
97604,240,140,120,240,160,0,900
97605,160,140,40,80,160,0,580
97606,210,140,80,0,0,0,430
97607,180,100,40,80,0,0,400
97608,180,160,160,160,160,0,820
97609,190,100,120,80,0,0,490
97610,230,120,120,160,160,0,790
97611,190,160,200,240,160,0,950
97612,220,120,120,160,160,0,780
97613,210,160,120,80,0,0,570
97614,200,140,120,160,160,320,1100
97615,180,140,80,80,0,0,480
97616,200,140,80,0,0,0,420
97617,150,100,120,80,160,0,610
97618,200,140,160,240,160,0,900
97619,180,200,120,160,320,0,980
97620,190,120,80,80,160,0,630
97621,170,120,160,240,160,320,1170
97622,190,80,40,80,160,0,550
97623,200,100,120,80,160,0,660
97624,230,100,40,80,160,0,610
97625,170,80,80,160,160,0,650
97626,190,160,200,160,320,0,1030
97627,190,140,120,80,160,0,690
97628,200,200,160,160,160,320,1200
97629,200,160,120,160,160,0,800
97630,190,80,80,0,0,0,350
97631,190,140,40,0,0,0,370
97632,180,120,80,80,160,0,620
97633,190,140,80,160,160,0,730
97634,230,120,40,0,0,0,390
97635,190,60,80,160,160,0,650
97636,150,120,160,160,160,0,750
97637,190,60,80,80,160,0,570
97638,170,160,200,160,160,0,850
97639,190,140,160,160,320,320,1290
97640,150,100,40,80,160,0,530
97641,180,80,80,80,0,0,420
97642,180,160,200,0,0,0,540
97643,190,100,80,80,0,0,450
97644,180,160,120,160,160,320,1100
97645,180,120,80,160,160,0,700
97646,230,120,120,80,160,320,1030
97647,190,160,200,240,320,320,1430
97648,190,100,80,0,0,0,370
97649,220,160,240,160,320,320,1420
97650,220,120,80,160,160,0,740
97651,220,100,80,0,0,0,400
97652,190,120,40,80,0,0,430
97653,160,80,40,80,160,0,520
97654,240,140,80,80,160,0,700
97655,210,180,120,80,0,0,590
97656,190,40,40,80,0,0,350
97657,200,160,160,160,0,0,680
97658,220,120,160,160,0,0,660
97659,190,140,160,160,160,0,810
97660,160,160,120,80,0,0,520
97661,180,80,40,0,0,0,300
97662,250,100,120,160,320,0,950
97663,180,120,40,0,0,0,340
97664,170,100,120,160,320,0,870
97665,220,160,160,80,160,0,780
97666,200,160,200,240,0,0,800
97667,200,100,120,80,160,0,660
97668,210,120,80,80,0,0,490
97669,200,160,120,240,160,0,880
97670,220,120,160,240,160,0,900
97671,170,140,160,0,0,0,470
97672,180,140,120,160,320,320,1240
97673,180,120,120,160,160,320,1060
97674,160,100,40,80,160,0,540
97675,160,40,40,0,0,0,240
97676,190,120,160,160,160,0,790
97677,210,80,80,80,0,0,450
97678,230,140,120,80,0,0,570
97679,190,120,80,80,160,0,630
97680,190,100,120,80,0,0,490
97681,170,140,40,80,160,0,590
97682,180,160,200,80,0,0,620
97683,190,140,200,80,160,0,770
97684,220,120,120,160,0,0,620
97685,200,120,80,160,160,0,720
97686,190,100,40,0,0,0,330
97687,170,80,80,80,0,0,410
97688,200,100,80,80,160,0,620
97689,180,80,120,160,160,0,700
97690,200,140,120,80,160,0,700
97691,200,140,120,160,320,0,940
97692,230,100,40,0,0,0,370
97693,180,120,120,80,160,0,660
97694,200,120,120,80,160,0,680
97695,180,160,40,80,0,0,460
97696,190,120,80,0,0,0,390
97697,160,120,40,80,0,0,400
97698,220,140,160,240,0,0,760
97699,170,120,160,160,160,0,770
97700,190,140,120,80,160,320,1010
97701,190,100,80,80,160,0,610
97702,220,140,200,240,320,320,1440
97703,230,120,120,160,320,0,950
97704,200,100,160,160,320,320,1260
97705,230,160,80,80,160,0,710
97706,190,160,120,80,160,0,710
97707,190,140,200,160,160,320,1170
97708,190,120,160,160,160,320,1110
97709,190,80,80,80,0,0,430
97710,190,120,80,80,160,0,630
97711,180,140,160,80,160,320,1040
97712,200,160,160,160,320,320,1320
97713,190,100,120,240,160,0,810
97714,180,40,40,0,0,0,260
97715,210,160,120,0,0,0,490
97716,220,140,120,160,160,320,1120
97717,200,120,120,160,320,0,920
97718,170,80,80,0,0,0,330
97719,180,60,80,80,160,0,560
97720,200,80,120,160,320,320,1200
97721,200,100,80,80,160,0,620
97722,160,80,120,160,320,0,840
97723,220,100,80,80,160,0,640
97724,210,140,80,80,160,0,670
97725,210,120,80,80,0,0,490
97726,200,140,120,160,160,0,780
97727,210,140,80,80,160,320,990
97728,180,140,120,0,0,0,440
97729,200,140,200,160,160,0,860
97730,180,160,200,80,0,0,620
97731,210,200,200,160,160,320,1250
97732,160,80,80,80,0,0,400
97733,200,140,200,160,160,0,860
97734,200,160,160,160,160,320,1160
97735,230,140,120,0,0,0,490
97736,210,100,80,0,0,0,390
97737,190,160,80,160,320,320,1230
97738,190,140,80,80,160,0,650
97739,170,140,120,80,160,320,990
97740,230,140,160,0,0,0,530
97741,190,120,120,0,0,0,430
97742,180,100,40,80,0,0,400
97743,200,100,120,80,0,0,500
97744,220,160,160,0,0,0,540
97745,190,140,120,80,0,0,530
97746,210,100,160,240,160,0,870
97747,230,100,40,80,160,320,930
97748,190,60,80,80,160,0,570
97749,190,120,120,160,160,0,750
97750,180,120,120,80,0,0,500
97751,150,100,120,80,160,0,610
97752,180,80,120,160,160,0,700
97753,190,100,40,80,160,0,570
97754,150,80,80,160,160,0,630
97755,180,100,40,0,0,0,320
97756,200,120,120,160,0,0,600
97757,180,160,160,160,160,320,1140
97758,200,140,120,160,320,320,1260
97759,200,60,80,0,0,0,340
97760,210,160,80,80,0,0,530
97761,210,60,40,80,160,0,550
97762,150,120,160,80,0,0,510
97763,180,120,120,160,160,0,740
97764,230,120,40,80,160,0,630
97765,230,120,0,0,0,0,350
97766,180,100,80,80,160,0,600
97767,190,140,80,80,0,0,490
97768,180,120,40,80,160,0,580
97769,230,160,80,160,160,0,790
97770,220,80,80,0,0,0,380
97771,160,100,120,160,320,0,860
97772,220,60,40,80,0,0,400
97773,170,120,160,80,0,0,530
97774,190,120,160,80,160,0,710
97775,190,140,120,80,160,0,690
97776,180,160,160,160,320,0,980
97777,190,120,80,80,160,0,630
97778,180,40,40,80,0,0,340
97779,220,180,160,80,160,0,800
97780,210,100,80,80,160,0,630
97781,160,100,0,0,0,0,260
97782,170,100,80,80,160,320,910
97783,180,160,160,80,0,0,580
97784,190,120,160,160,160,0,790
97785,230,80,0,0,0,0,310
97786,190,100,80,80,160,0,610
97787,190,100,160,80,160,0,690
97788,200,120,160,160,0,0,640
97789,210,120,160,160,160,0,810
97790,220,80,80,160,0,0,540
97791,190,120,120,160,160,0,750
97792,200,220,120,160,320,320,1340
97793,250,120,80,160,160,0,770
97794,190,120,160,160,160,0,790
97795,180,120,120,0,0,0,420
97796,230,100,80,80,160,0,650
97797,190,100,80,0,0,0,370
97798,210,140,40,80,0,0,470
97799,210,120,120,160,0,0,610
97800,180,120,40,0,0,0,340
97801,190,140,160,160,160,0,810
97802,220,60,40,80,160,0,560
97803,180,80,40,0,0,0,300
97804,200,160,160,160,0,0,680
97805,230,140,160,0,0,0,530
97806,200,80,40,0,0,0,320
97807,200,80,40,80,0,0,400
97808,200,140,120,0,0,0,460
97809,210,120,120,80,160,0,690
97810,170,160,40,0,0,0,370
97811,210,80,0,0,0,0,290
97812,180,120,120,80,160,0,660
97813,190,120,80,0,0,0,390
97814,230,120,120,80,160,0,710
97815,180,140,160,80,0,0,560
97816,200,100,80,80,0,0,460
97817,190,100,80,80,0,0,450
97818,150,60,40,0,0,0,250
97819,180,180,160,160,160,0,840
97820,220,100,40,0,0,0,360
97821,220,100,120,80,160,0,680
97822,190,80,120,80,160,0,630
97823,190,140,80,80,0,0,490
97824,200,100,120,160,0,0,580
97825,190,80,120,160,320,0,870
97826,190,140,120,160,160,320,1090
97827,180,140,120,80,160,0,680
97828,160,60,120,160,160,320,980
97829,210,160,80,0,0,0,450
97830,200,100,80,80,0,0,460
97831,190,100,160,160,160,320,1090
97832,200,120,120,80,0,0,520
97833,170,140,120,160,160,320,1070
97834,210,40,0,0,0,0,250
97835,170,120,80,80,0,0,450
97836,230,140,120,80,160,0,730
97837,200,100,40,0,0,0,340
97838,180,60,80,160,0,0,480
97839,230,80,80,80,0,0,470
97840,180,120,80,160,0,0,540
97841,230,180,160,160,0,0,730
97842,210,180,120,0,0,0,510
97843,260,100,80,80,0,0,520
97844,200,120,40,80,0,0,440
97845,190,140,80,80,0,0,490
97846,230,100,80,80,160,0,650
97847,190,140,120,160,320,320,1250
97848,160,80,80,80,160,320,880
97849,180,140,80,80,0,0,480
97850,220,120,120,160,320,0,940
97851,200,60,0,0,0,0,260
97852,200,80,0,0,0,0,280
97853,220,180,200,160,320,0,1080
97854,170,100,120,160,320,0,870
97855,160,100,120,160,160,0,700
97856,200,100,40,0,0,0,340
97857,210,180,160,160,160,320,1190
97858,210,100,80,80,160,0,630
97859,160,160,80,80,0,0,480
97860,170,180,160,80,0,0,590
97861,180,100,80,80,0,0,440
97862,180,120,120,80,160,0,660
97863,190,80,40,0,0,0,310
97864,170,140,120,160,160,0,750
97865,240,120,160,240,160,320,1240
97866,220,140,120,160,320,0,960
97867,220,120,120,80,160,320,1020
97868,220,100,80,0,0,0,400
97869,200,80,80,160,320,0,840
97870,190,120,80,80,160,0,630
97871,200,160,160,80,0,0,600
97872,210,120,200,240,160,0,930
97873,200,100,120,0,0,0,420
97874,220,160,200,80,160,0,820
97875,140,100,120,0,0,0,360
97876,220,160,200,160,0,0,740
97877,230,120,80,80,0,0,510
97878,240,140,160,80,0,0,620
97879,190,120,120,160,160,0,750
97880,250,80,120,0,0,0,450
97881,220,140,160,240,160,0,920
97882,220,140,120,160,320,0,960
97883,220,140,80,80,0,0,520
97884,210,140,120,160,0,0,630
97885,220,60,40,0,0,0,320
97886,220,120,160,160,160,320,1140
97887,190,120,80,80,0,0,470
97888,170,120,160,160,160,0,770
97889,220,160,160,160,160,0,860
97890,160,140,120,80,160,0,660
97891,180,160,80,80,0,0,500
97892,200,80,120,160,320,0,880
97893,160,120,120,0,0,0,400
97894,200,100,40,80,160,0,580
97895,230,140,120,80,160,0,730
97896,210,140,160,160,320,320,1310
97897,190,140,80,0,0,0,410
97898,180,120,80,80,160,0,620
97899,210,160,80,160,160,0,770
97900,180,160,200,0,0,0,540
97901,180,100,120,160,0,0,560
97902,200,120,120,80,160,0,680
97903,170,120,40,80,0,0,410
97904,140,120,40,80,0,0,380
97905,230,120,40,0,0,0,390
97906,190,140,120,160,0,0,610
97907,210,140,120,0,0,0,470
97908,170,100,120,160,160,0,710
97909,180,120,80,80,160,320,940
97910,200,140,160,80,0,0,580
97911,200,140,80,80,160,320,980
97912,180,140,120,80,160,0,680
97913,200,120,80,0,0,0,400
97914,190,120,120,160,160,0,750
97915,210,100,80,80,160,0,630
97916,160,60,40,80,0,0,340
97917,220,100,120,80,0,0,520
97918,200,140,120,160,320,0,940
97919,170,80,80,80,0,0,410
97920,180,120,40,0,0,0,340
97921,170,80,40,80,160,0,530
97922,200,120,80,80,160,0,640
97923,170,160,160,240,160,320,1210
97924,170,140,160,160,160,0,790
97925,220,140,200,80,160,0,800
97926,150,120,80,80,160,320,910
97927,170,80,80,80,160,0,570
97928,200,80,0,0,0,0,280
97929,190,100,120,160,0,0,570
97930,170,140,120,80,160,0,670
97931,180,120,80,80,0,0,460
97932,190,140,120,160,160,320,1090
97933,250,160,120,240,160,0,930
97934,240,120,40,80,0,0,480
97935,160,80,120,160,160,0,680
97936,200,140,200,160,0,0,700
97937,210,140,160,240,160,0,910
97938,200,140,120,160,160,320,1100
97939,240,160,120,80,160,320,1080
97940,200,140,120,80,0,0,540
97941,150,100,160,80,160,0,650
97942,200,180,120,80,160,0,740
97943,210,120,80,160,160,0,730
97944,210,80,80,80,160,0,610
97945,190,100,80,80,160,0,610
97946,220,140,200,0,0,0,560
97947,150,100,40,80,160,0,530
97948,170,100,80,0,0,0,350
97949,190,140,80,160,160,0,730
97950,210,60,40,80,160,0,550
97951,180,120,120,160,160,0,740
97952,210,120,80,80,160,0,650
97953,210,140,80,80,160,0,670
97954,200,140,120,80,160,320,1020
97955,200,100,160,240,320,320,1340
97956,180,120,120,160,320,0,900
97957,190,140,120,80,0,0,530
97958,180,80,40,80,0,0,380
97959,220,140,120,0,0,0,480
97960,180,80,40,80,160,320,860
97961,190,100,120,160,0,0,570
97962,200,140,120,80,0,0,540
97963,180,80,120,240,160,0,780
97964,210,120,160,240,320,0,1050
97965,180,120,120,160,0,0,580
97966,230,100,160,80,0,0,570
97967,200,120,80,160,320,0,880
97968,190,120,0,0,0,0,310
97969,180,120,120,0,0,0,420
97970,140,120,120,160,0,0,540
97971,210,100,0,0,0,0,310
97972,210,40,0,0,0,0,250
97973,260,180,120,80,0,0,640
97974,210,100,160,160,0,0,630
97975,210,140,120,80,160,0,710
97976,170,140,120,160,320,0,910
97977,170,100,80,80,0,0,430
97978,160,140,160,80,160,0,700
97979,170,80,40,80,0,0,370
97980,210,140,120,80,0,0,550
97981,220,120,80,80,0,0,500
97982,200,160,160,240,320,0,1080
97983,200,80,80,80,160,0,600
97984,170,80,120,80,160,0,610
97985,210,140,160,80,160,0,750
97986,210,140,80,0,0,0,430
97987,220,160,160,240,160,320,1260
97988,240,120,40,80,160,0,640
97989,180,140,160,80,160,0,720
97990,170,140,120,80,160,0,670
97991,230,140,120,0,0,0,490
97992,210,160,160,160,160,0,850
97993,210,160,200,80,160,0,810
97994,210,140,120,160,320,320,1270
97995,190,140,120,160,320,320,1250
97996,200,80,80,80,160,0,600
97997,190,80,80,80,160,0,590
97998,210,160,160,160,160,0,850
97999,160,60,80,80,160,320,860
98000,230,80,80,0,0,0,390
98001,200,120,120,80,0,0,520
98002,180,120,80,80,0,0,460
98003,160,80,40,0,0,0,280
98004,220,160,160,160,0,0,700
98005,230,100,120,80,160,320,1010
98006,170,100,160,160,160,0,750
98007,160,40,80,160,320,320,1080
98008,190,120,120,80,160,320,990
98009,230,180,40,80,0,0,530
98010,220,160,80,80,160,0,700
98011,200,100,120,80,0,0,500
98012,210,140,120,80,160,320,1030
98013,210,60,40,80,160,0,550
98014,200,140,80,80,160,320,980
98015,180,100,120,80,160,0,640
98016,220,120,80,80,0,0,500
98017,210,120,80,160,160,0,730
98018,170,60,40,0,0,0,270
98019,190,140,120,80,0,0,530
98020,220,160,160,80,0,0,620
98021,160,80,80,160,0,0,480
98022,220,200,160,80,160,0,820
98023,230,140,160,80,160,320,1090
98024,180,100,120,80,160,320,960
98025,150,140,120,80,0,0,490
98026,190,100,40,0,0,0,330
98027,170,120,80,80,160,320,930
98028,210,180,120,80,160,0,750
98029,190,120,120,80,160,0,670
98030,140,100,80,80,160,320,880
98031,190,120,80,0,0,0,390
98032,210,120,120,160,160,320,1090
98033,150,120,80,0,0,0,350
98034,180,140,120,80,0,0,520
98035,160,120,40,80,160,320,880
98036,160,100,80,160,0,0,500
98037,150,80,80,80,160,0,550
98038,210,100,80,80,0,0,470
98039,210,140,120,160,160,0,790
98040,190,120,120,80,0,0,510
98041,190,100,120,160,0,0,570
98042,210,160,160,160,160,0,850
98043,220,140,120,80,160,0,720
98044,180,120,120,160,320,0,900
98045,160,100,80,80,160,0,580
98046,230,120,40,80,0,0,470
98047,180,120,120,80,160,0,660
98048,210,120,120,160,0,0,610
98049,210,60,40,80,0,0,390
98050,190,60,80,160,160,0,650
98051,170,140,120,0,0,0,430
98052,190,120,80,0,0,0,390
98053,150,100,80,80,160,0,570
98054,190,100,120,160,160,0,730
98055,210,180,80,160,160,0,790
98056,160,60,80,80,160,0,540
98057,140,100,160,160,160,320,1040
98058,240,100,80,160,160,0,740
98059,200,100,80,80,160,0,620
98060,220,100,120,160,0,0,600
98061,170,100,120,80,0,0,470
98062,220,140,40,80,0,0,480
98063,190,60,80,160,160,0,650
98064,180,80,120,160,0,0,540
98065,170,160,120,0,0,0,450
98066,230,140,120,160,160,0,810
98067,200,120,120,240,160,0,840
98068,230,80,120,160,320,320,1230
98069,160,120,120,80,160,320,960
98070,210,120,120,80,160,0,690
98071,160,120,120,0,0,0,400
98072,210,160,80,160,0,0,610
98073,250,120,80,0,0,0,450
98074,210,140,120,160,0,0,630
98075,210,120,80,80,160,0,650
98076,180,160,160,160,320,0,980
98077,190,100,80,80,0,0,450
98078,230,140,80,0,0,0,450
98079,220,140,120,160,0,0,640
98080,210,160,160,160,160,0,850
98081,200,140,40,0,0,0,380
98082,160,140,80,80,0,0,460
98083,190,80,120,80,160,0,630
98084,180,80,120,160,160,0,700
98085,200,40,40,80,160,0,520
98086,190,80,80,0,0,0,350
98087,210,180,160,0,0,0,550
98088,170,140,120,160,320,0,910
98089,220,120,80,0,0,0,420
98090,200,160,160,160,160,0,840
98091,170,120,80,80,0,0,450
98092,210,60,40,80,160,0,550
98093,190,140,40,80,160,320,930
98094,200,100,80,0,0,0,380
98095,230,140,80,80,160,0,690
98096,150,120,80,80,160,320,910
98097,170,80,160,160,160,0,730
98098,180,120,160,160,160,0,780
98099,200,140,120,160,0,0,620
98100,190,100,80,160,160,0,690
98101,180,80,120,80,0,0,460
98102,210,180,160,160,160,0,870
98103,220,100,80,160,320,320,1200
98104,220,80,80,80,160,0,620
98105,190,160,80,80,160,320,990
98106,150,180,200,240,320,320,1410
98107,160,80,120,80,160,0,600
98108,280,140,80,0,0,0,500
98109,150,80,0,0,0,0,230
98110,210,120,120,80,0,0,530
98111,200,160,160,0,0,0,520
98112,190,100,80,80,0,0,450
98113,170,180,120,160,0,0,630
98114,150,80,120,160,160,0,670
98115,250,120,120,240,320,320,1370
98116,210,80,40,80,160,0,570
98117,190,120,160,80,160,0,710
98118,210,140,80,80,0,0,510
98119,200,80,120,240,160,320,1120
98120,220,160,40,0,0,0,420
98121,170,120,120,80,160,0,650
98122,180,160,80,80,160,0,660
98123,220,140,120,80,160,0,720
98124,170,140,120,160,320,0,910
98125,220,100,80,80,160,0,640
98126,190,100,80,160,320,320,1170
98127,190,120,80,0,0,0,390
98128,240,120,80,80,160,0,680
98129,180,100,160,80,160,0,680
98130,170,80,0,0,0,0,250
98131,190,120,160,160,0,0,630
98132,180,140,120,80,0,0,520
98133,200,160,160,80,0,0,600
98134,200,140,80,80,0,0,500
98135,180,100,80,80,0,0,440
98136,220,140,160,160,160,0,840
98137,210,140,120,160,320,0,950
98138,190,160,80,80,160,0,670
98139,200,100,80,80,160,320,940
98140,160,100,80,80,0,0,420
98141,210,120,80,0,0,0,410
98142,190,80,40,80,0,0,390
98143,200,160,80,0,0,0,440
98144,210,120,120,80,0,0,530
98145,190,120,80,160,320,0,870
98146,230,100,120,160,0,0,610
98147,220,180,80,0,0,0,480
98148,170,100,80,80,160,0,590
98149,160,100,120,240,160,0,780
98150,220,120,40,80,0,0,460
98151,240,120,80,80,0,0,520
98152,190,60,120,160,320,0,850
98153,210,140,160,160,160,0,830
98154,160,120,80,160,160,0,680
98155,190,120,80,80,0,0,470
98156,180,160,0,0,0,0,340
98157,210,160,80,0,0,0,450
98158,210,120,120,80,160,320,1010
98159,190,100,40,0,0,0,330
98160,210,160,80,80,0,0,530
98161,180,120,80,160,160,0,700
98162,180,160,160,160,0,0,660
98163,200,100,160,160,160,320,1100
98164,200,80,40,80,160,0,560
98165,190,120,120,160,160,0,750
98166,180,120,160,160,0,0,620
98167,200,180,120,80,0,0,580
98168,200,120,120,160,160,320,1080
98169,220,120,80,0,0,0,420
98170,190,100,120,80,160,0,650
98171,200,100,120,80,160,0,660
98172,250,100,80,160,320,0,910
98173,200,40,40,80,0,0,360
98174,240,140,120,160,160,320,1140
98175,190,100,40,80,160,0,570
98176,170,120,80,0,0,0,370
98177,150,100,120,160,160,320,1010
98178,190,100,120,80,0,0,490
98179,190,160,120,160,0,0,630
98180,200,100,80,160,320,0,860
98181,180,120,120,160,0,0,580
98182,180,60,40,80,160,0,520
98183,190,120,120,160,320,320,1230
98184,180,140,40,0,0,0,360
98185,200,140,40,0,0,0,380
98186,240,120,160,160,320,0,1000
98187,180,160,40,80,0,0,460
98188,230,180,120,80,160,0,770
98189,190,100,80,80,160,320,930
98190,190,180,120,80,160,320,1050
98191,180,120,40,80,160,0,580
98192,180,120,80,80,0,0,460
98193,230,180,160,0,0,0,570
98194,190,100,80,80,0,0,450
98195,160,100,120,80,160,320,940
98196,210,140,80,160,320,0,910
98197,210,120,120,80,160,0,690
98198,160,160,160,160,320,320,1280
98199,170,100,120,80,160,0,630
98200,160,120,120,160,160,320,1040
98201,140,100,80,160,160,0,640
98202,150,80,0,0,0,0,230
98203,180,80,80,160,160,0,660
98204,200,120,40,80,160,320,920
98205,200,180,120,160,160,0,820
98206,180,120,40,80,0,0,420
98207,180,60,120,160,320,320,1160
98208,200,140,80,80,160,0,660
98209,190,80,40,80,0,0,390
98210,180,80,40,80,160,0,540
98211,220,160,120,80,0,0,580
98212,210,160,160,160,320,0,1010
98213,170,60,40,0,0,0,270
98214,180,120,80,160,160,0,700
98215,170,40,40,80,0,0,330
98216,220,140,120,160,160,320,1120
98217,200,80,120,80,160,0,640
98218,240,100,40,80,160,0,620
98219,200,60,40,0,0,0,300
98220,220,140,160,80,160,0,760
98221,210,180,160,160,160,0,870
98222,180,80,40,0,0,0,300
98223,250,80,80,80,0,0,490
98224,200,100,120,160,160,0,740
98225,210,160,200,160,160,0,890
98226,210,160,160,160,160,0,850
98227,170,140,80,160,160,0,710
98228,190,100,160,160,320,320,1250
98229,170,60,0,0,0,0,230
98230,240,120,40,0,0,0,400
98231,210,140,120,160,160,0,790
98232,190,160,160,0,0,0,510
98233,180,100,40,0,0,0,320
98234,180,80,120,80,160,0,620
98235,190,100,120,160,0,0,570
98236,250,160,120,80,160,0,770
98237,190,160,80,80,160,0,670
98238,170,100,160,240,0,0,670
98239,200,120,120,160,160,0,760
98240,190,140,80,160,160,0,730
98241,200,100,80,160,160,0,700
98242,200,100,80,160,0,0,540
98243,150,120,160,80,0,0,510
98244,220,120,40,80,160,0,620
98245,200,160,120,0,0,0,480
98246,170,140,160,80,160,0,710
98247,220,120,120,160,0,0,620
98248,170,140,120,160,320,0,910
98249,200,140,120,80,0,0,540
98250,190,140,120,80,0,0,530
98251,240,120,120,240,320,0,1040
98252,180,140,120,0,0,0,440
98253,190,40,80,80,0,0,390
98254,200,140,160,160,160,0,820
98255,220,120,120,240,160,320,1180
98256,210,60,80,160,160,320,990
98257,150,100,40,80,0,0,370
98258,240,120,120,160,160,0,800
98259,140,140,160,80,0,0,520
98260,210,160,120,80,0,0,570
98261,200,100,80,80,0,0,460
98262,210,140,40,0,0,0,390
98263,160,80,120,80,160,320,920
98264,210,180,200,240,320,0,1150
98265,200,180,160,240,160,0,940
98266,180,180,200,80,160,0,800
98267,180,80,120,80,160,0,620
98268,190,140,80,0,0,0,410
98269,200,120,80,80,0,0,480
98270,160,100,160,80,0,0,500
98271,200,100,160,80,160,320,1020
98272,170,80,40,80,160,0,530
98273,220,160,40,80,0,0,500
98274,190,160,80,160,160,0,750
98275,170,80,40,80,160,320,850
98276,220,180,80,80,160,0,720
98277,180,120,120,160,160,320,1060
98278,200,120,160,160,160,0,800
98279,150,120,80,160,0,0,510
98280,170,140,200,80,0,0,590
98281,200,140,40,80,160,320,940
98282,180,120,80,0,0,0,380
98283,180,100,160,80,0,0,520
98284,210,100,120,160,160,0,750
98285,180,100,160,80,160,320,1000
98286,200,80,80,80,160,320,920
98287,190,60,80,80,0,0,410
98288,190,60,40,0,0,0,290
98289,170,160,80,80,0,0,490
98290,180,80,80,160,320,0,820
98291,210,120,200,160,160,0,850
98292,210,140,80,80,160,0,670
98293,200,120,120,160,160,0,760
98294,190,100,120,80,160,0,650
98295,220,120,120,80,0,0,540
98296,170,80,40,80,160,0,530
98297,190,180,160,0,0,0,530
98298,170,120,160,160,160,0,770
98299,210,160,120,160,320,0,970
98300,180,140,160,80,0,0,560
98301,210,100,40,0,0,0,350
98302,140,120,160,80,160,320,980
98303,130,120,120,80,0,0,450
98304,210,120,80,0,0,0,410
98305,220,180,120,80,0,0,600
98306,200,180,120,160,320,0,980
98307,190,80,80,0,0,0,350
98308,190,180,40,80,160,0,650
98309,220,140,160,80,0,0,600
98310,170,80,40,0,0,0,290
98311,200,180,80,160,160,0,780
98312,190,80,120,160,160,320,1030
98313,240,120,120,0,0,0,480
98314,210,100,120,0,0,0,430
98315,190,80,80,80,0,0,430
98316,190,100,40,80,160,0,570
98317,190,100,120,80,0,0,490
98318,190,80,80,80,0,0,430
98319,190,80,80,80,0,0,430
98320,200,120,120,80,160,320,1000
98321,180,160,80,80,160,0,660
98322,190,100,120,160,320,0,890
98323,180,160,160,80,0,0,580
98324,240,100,40,80,160,0,620
98325,190,120,120,160,160,0,750
98326,210,120,120,0,0,0,450
98327,180,140,240,240,160,320,1280
98328,190,160,200,160,0,0,710
98329,220,120,40,80,160,0,620
98330,190,120,40,0,0,0,350
98331,160,100,40,80,0,0,380
98332,210,120,160,80,160,0,730
98333,200,140,120,0,0,0,460
98334,250,140,160,80,160,0,790
98335,190,160,160,240,320,320,1390
98336,220,180,200,240,160,0,1000
98337,220,160,120,0,0,0,500
98338,220,160,200,240,160,0,980
98339,180,120,40,0,0,0,340
98340,170,180,160,160,160,0,830
98341,210,200,120,240,320,320,1410
98342,210,120,80,80,160,0,650
98343,190,100,80,0,0,0,370
98344,200,120,80,80,160,0,640
98345,220,120,120,160,320,0,940
98346,170,140,80,80,160,0,630
98347,190,120,120,0,0,0,430
98348,180,160,120,160,160,0,780
98349,200,120,120,160,160,0,760
98350,150,80,120,160,320,0,830
98351,160,60,40,80,160,320,820
98352,220,120,160,80,160,0,740
98353,180,120,80,160,160,0,700
98354,220,100,40,0,0,0,360
98355,190,120,160,240,160,0,870
98356,220,140,120,80,160,0,720
98357,220,140,40,80,160,0,640
98358,190,80,0,0,0,0,270
98359,190,140,160,240,160,0,890
98360,200,120,120,160,320,320,1240
98361,200,100,80,0,0,0,380
98362,200,180,200,240,320,0,1140
98363,190,160,160,80,0,0,590
98364,170,100,80,80,0,0,430
98365,200,140,80,80,160,0,660
98366,190,140,80,80,160,0,650
98367,200,140,120,160,160,320,1100
98368,170,120,120,80,0,0,490
98369,210,80,80,80,0,0,450
98370,210,120,160,160,160,0,810
98371,170,120,120,80,160,0,650
98372,230,100,120,80,160,0,690
98373,210,100,120,0,0,0,430
98374,180,160,160,240,320,0,1060
98375,170,60,80,80,160,0,550
98376,160,100,40,0,0,0,300
98377,190,140,160,0,0,0,490
98378,140,60,80,80,160,0,520
98379,200,100,0,0,0,0,300
98380,210,120,80,160,160,0,730
98381,180,60,80,0,0,0,320
98382,210,160,200,80,0,0,650
98383,190,120,160,160,160,0,790
98384,170,80,40,80,160,0,530
98385,180,80,40,0,0,0,300
98386,200,140,120,160,0,0,620
98387,200,120,80,160,160,0,720
98388,180,120,200,160,0,0,660
98389,220,180,200,160,160,0,920
98390,260,160,160,160,160,320,1220
98391,240,160,120,160,0,0,680
98392,210,120,80,0,0,0,410
98393,170,120,120,80,0,0,490
98394,200,140,120,80,160,0,700
98395,210,100,80,160,160,0,710
98396,220,60,0,0,0,0,280
98397,200,140,160,0,0,0,500
98398,200,120,40,80,0,0,440
98399,210,100,120,160,160,0,750
98400,230,80,80,80,160,0,630
98401,190,80,40,0,0,0,310
98402,160,140,80,0,0,0,380
98403,140,100,80,160,0,0,480
98404,180,120,80,80,160,0,620
98405,170,140,160,80,160,0,710
98406,170,80,40,0,0,0,290
98407,170,60,80,0,0,0,310
98408,210,140,160,160,160,0,830
98409,210,180,200,320,160,0,1070
98410,170,120,40,80,160,320,890
98411,180,140,120,80,160,320,1000
98412,200,40,40,80,160,0,520
98413,190,120,120,160,320,320,1230
98414,160,80,80,80,160,0,560
98415,250,180,200,160,0,0,790
98416,180,120,80,80,0,0,460
98417,220,80,120,80,0,0,500
98418,190,160,160,80,0,0,590
98419,190,140,120,160,160,0,770
98420,200,180,200,160,160,320,1220
98421,170,100,80,80,0,0,430
98422,240,100,80,160,160,0,740
98423,220,120,80,160,320,0,900
98424,150,120,120,160,0,0,550
98425,190,80,80,80,0,0,430
98426,190,120,80,80,0,0,470
98427,240,160,80,0,0,0,480
98428,160,160,160,240,0,0,720
98429,200,180,160,80,160,0,780
98430,210,160,120,0,0,0,490
98431,170,60,40,80,0,0,350
98432,210,120,160,160,320,0,970
98433,200,100,80,80,160,0,620
98434,200,140,160,240,160,320,1220
98435,190,100,120,160,0,0,570
98436,180,120,120,160,320,0,900
98437,180,140,120,80,160,0,680
98438,210,140,160,80,0,0,590
98439,180,100,80,0,0,0,360
98440,160,80,160,80,160,0,640
98441,200,180,160,0,0,0,540
98442,190,120,120,160,160,0,750
98443,240,140,120,80,0,0,580
98444,250,100,80,80,160,0,670
98445,220,160,40,0,0,0,420
98446,150,80,40,80,160,0,510
98447,190,100,120,0,0,0,410
98448,230,120,120,0,0,0,470
98449,200,160,160,240,320,320,1400
98450,150,80,40,80,160,320,830
98451,160,80,160,80,0,0,480
98452,190,120,80,80,160,0,630
98453,190,140,120,160,0,0,610
98454,220,60,0,0,0,0,280
98455,210,140,80,80,160,0,670
98456,190,140,160,160,160,0,810
98457,170,80,120,160,0,0,530
98458,180,140,120,160,320,320,1240
98459,210,100,80,160,0,0,550
98460,170,80,40,0,0,0,290
98461,220,120,40,80,160,0,620
98462,170,120,40,80,0,0,410
98463,140,120,160,160,0,0,580
98464,180,160,120,160,320,0,940
98465,210,160,120,160,320,0,970
98466,160,100,120,80,0,0,460
98467,190,100,80,80,0,0,450
98468,210,120,80,80,0,0,490
98469,190,100,80,160,160,320,1010
98470,210,160,120,160,160,0,810
98471,190,160,120,80,0,0,550
98472,200,120,80,0,0,0,400
98473,140,100,120,240,320,320,1240
98474,190,180,160,80,0,0,610
98475,220,140,120,160,160,0,800
98476,170,80,120,80,160,0,610
98477,160,120,80,80,160,320,920
98478,180,140,120,80,160,0,680
98479,220,180,240,240,160,0,1040
98480,190,120,120,160,0,0,590
98481,210,140,200,240,320,320,1430
98482,230,160,160,80,160,0,790
98483,210,120,80,80,0,0,490
98484,210,140,80,160,160,0,750
98485,220,200,160,160,160,0,900
98486,200,100,80,0,0,0,380
98487,170,120,80,0,0,0,370
98488,200,140,120,160,160,0,780
98489,190,160,80,80,160,0,670
98490,200,140,80,0,0,0,420
98491,230,140,120,160,320,320,1290
98492,210,120,160,160,160,0,810
98493,250,140,80,80,160,0,710
98494,210,140,160,80,160,320,1070
98495,190,80,40,80,0,0,390
98496,230,100,80,80,160,0,650
98497,230,140,200,160,160,0,890
98498,200,80,40,0,0,0,320
98499,240,120,120,160,160,0,800
98500,190,100,40,80,160,0,570
98501,170,140,80,160,160,320,1030
98502,190,180,160,80,160,0,770
98503,160,180,120,80,160,0,700
98504,210,120,80,80,0,0,490
98505,230,160,120,160,160,0,830
98506,200,140,200,160,160,0,860
98507,180,120,120,160,160,0,740
98508,200,120,120,160,160,0,760
98509,190,120,120,80,0,0,510
98510,190,120,200,160,160,0,830
98511,240,80,120,160,160,0,760
98512,210,100,80,80,160,0,630
98513,180,140,80,80,0,0,480
98514,170,120,160,160,0,0,610
98515,190,120,120,80,0,0,510
98516,180,180,120,80,160,320,1040
98517,160,160,120,160,320,0,920
98518,230,180,160,80,0,0,650
98519,210,140,120,160,160,0,790
98520,170,100,40,0,0,0,310
98521,160,100,120,80,0,0,460
98522,190,100,80,80,160,0,610
98523,190,100,120,80,160,0,650
98524,210,160,120,160,160,0,810
98525,220,160,120,80,160,0,740
98526,200,140,200,0,0,0,540
98527,190,80,80,80,0,0,430
98528,200,160,160,160,160,320,1160
98529,210,100,80,80,0,0,470
98530,210,120,80,160,160,0,730
98531,210,160,40,0,0,0,410
98532,210,120,160,160,320,0,970
98533,200,140,80,80,160,320,980
98534,190,100,120,160,0,0,570
98535,150,100,40,80,160,0,530
98536,190,100,120,80,160,320,970
98537,170,100,120,160,320,0,870
98538,190,160,120,160,160,0,790
98539,140,120,80,80,160,0,580
98540,240,140,120,160,320,0,980
98541,190,80,120,80,160,0,630
98542,160,140,120,80,0,0,500
98543,200,120,120,0,0,0,440
98544,190,100,80,80,0,0,450
98545,160,100,80,0,0,0,340
98546,180,100,40,0,0,0,320
98547,220,140,120,160,160,0,800
98548,210,140,0,0,0,0,350
98549,180,120,120,80,0,0,500
98550,260,120,120,80,160,0,740
98551,200,120,120,0,0,0,440
98552,180,80,120,160,160,0,700
98553,180,140,120,80,0,0,520
98554,210,180,160,240,320,0,1110
98555,170,100,80,0,0,0,350
98556,210,120,80,80,160,0,650
98557,160,80,40,80,160,320,840
98558,200,80,120,80,160,0,640
98559,230,120,120,160,0,0,630
98560,190,120,40,0,0,0,350
98561,230,140,40,0,0,0,410
98562,180,140,80,80,0,0,480
98563,180,140,160,240,320,0,1040
98564,200,80,40,0,0,0,320
98565,170,80,40,0,0,0,290
98566,230,80,40,0,0,0,350
98567,190,200,120,80,160,0,750
98568,230,160,80,0,0,0,470
98569,160,100,40,80,160,0,540
98570,210,120,160,160,160,0,810
98571,170,140,200,160,160,0,830
98572,200,120,120,80,160,0,680
98573,160,140,160,160,320,320,1260
98574,200,120,40,80,0,0,440
98575,190,140,160,80,0,0,570
98576,170,140,120,160,160,0,750
98577,270,120,80,80,0,0,550
98578,180,180,120,160,160,0,800
98579,200,80,40,80,160,0,560
98580,230,140,200,160,160,0,890
98581,200,160,80,80,0,0,520
98582,170,80,80,0,0,0,330
98583,190,140,120,160,160,0,770
98584,190,100,120,80,160,0,650
98585,190,140,80,160,320,0,890
98586,210,140,40,0,0,0,390
98587,150,40,40,80,160,0,470
98588,180,80,160,240,320,0,980
98589,240,120,160,160,160,0,840
98590,230,60,80,80,160,0,610
98591,220,120,40,80,0,0,460
98592,180,100,80,80,160,0,600
98593,190,120,80,80,160,0,630
98594,170,100,120,0,0,0,390
98595,200,180,160,160,160,0,860
98596,190,160,120,160,320,0,950
98597,220,160,120,0,0,0,500
98598,150,120,160,80,0,0,510
98599,240,100,0,0,0,0,340
98600,220,160,120,80,160,0,740
98601,160,160,80,80,0,0,480
98602,210,160,160,80,160,0,770
98603,200,80,160,160,160,0,760
98604,230,80,120,80,160,0,670
98605,210,140,160,160,320,0,990
98606,210,140,160,80,160,320,1070
98607,220,120,40,80,0,0,460
98608,180,160,80,0,0,0,420
98609,140,120,40,0,0,0,300
98610,200,120,0,0,0,0,320
98611,190,80,40,80,0,0,390
98612,160,80,80,0,0,0,320
98613,210,100,80,0,0,0,390
98614,180,140,120,160,0,0,600
98615,180,80,80,80,160,0,580
98616,130,60,40,0,0,0,230
98617,190,120,120,80,160,0,670
98618,210,220,280,160,160,0,1030
98619,180,160,160,160,160,0,820
98620,200,120,80,160,160,320,1040
98621,140,140,160,160,160,320,1080
98622,200,120,80,80,160,320,960
98623,150,80,80,160,160,0,630
98624,200,180,80,160,160,320,1100
98625,170,120,0,0,0,0,290
98626,200,140,120,160,160,0,780
98627,200,120,160,160,160,0,800
98628,200,160,200,160,0,0,720
98629,220,140,160,160,0,0,680
98630,210,120,80,80,0,0,490
98631,190,120,120,0,0,0,430
98632,210,80,80,160,160,0,690
98633,190,120,120,160,320,320,1230
98634,210,180,160,160,160,0,870
98635,170,100,120,160,160,0,710
98636,190,140,120,80,160,0,690
98637,160,100,80,80,160,0,580
98638,180,140,160,0,0,0,480
98639,190,200,160,0,0,0,550
98640,220,120,120,160,320,0,940
98641,200,160,120,80,160,0,720
98642,160,80,80,80,0,0,400
98643,230,100,160,80,160,0,730
98644,220,160,80,160,160,320,1100
98645,200,80,80,0,0,0,360
98646,170,120,120,0,0,0,410
98647,190,140,40,0,0,0,370
98648,170,80,40,80,160,320,850
98649,180,80,80,80,0,0,420
98650,190,160,80,80,0,0,510
98651,200,120,80,80,160,320,960
98652,230,80,40,80,160,0,590
98653,200,160,120,160,0,0,640
98654,180,120,80,80,160,0,620
98655,170,140,80,80,160,0,630
98656,220,180,160,160,320,320,1360
98657,170,140,40,80,0,0,430
98658,190,100,80,80,0,0,450
98659,200,160,40,80,160,0,640
98660,180,100,120,160,160,0,720
98661,170,60,80,80,160,0,550
98662,200,100,80,80,160,0,620
98663,200,140,80,160,320,0,900
98664,220,160,200,240,320,0,1140
98665,170,100,40,0,0,0,310
98666,210,100,40,80,0,0,430
98667,180,60,40,80,160,0,520
98668,140,40,40,80,160,0,460
98669,190,140,200,160,160,0,850
98670,230,140,80,0,0,0,450
98671,150,160,80,80,160,0,630
98672,150,120,160,80,0,0,510
98673,210,180,200,160,160,0,910
98674,210,120,80,160,160,0,730
98675,140,100,160,80,0,0,480
98676,170,100,40,0,0,0,310
98677,200,100,40,0,0,0,340
98678,180,60,80,160,160,0,640
98679,170,100,160,80,160,0,670
98680,180,140,120,160,320,0,920
98681,190,20,40,80,160,0,490
98682,230,140,120,0,0,0,490
98683,170,100,40,0,0,0,310
98684,200,100,40,80,160,0,580
98685,220,200,40,80,0,0,540
98686,210,100,160,80,160,0,710
98687,190,100,120,240,320,320,1290
98688,240,160,200,80,0,0,680
98689,170,180,200,160,160,320,1190
98690,160,100,80,80,160,0,580
98691,220,140,40,80,0,0,480
98692,210,160,40,80,160,0,650
98693,170,180,120,80,0,0,550
98694,210,140,40,0,0,0,390
98695,210,100,120,160,160,320,1070
98696,220,180,80,80,160,0,720
98697,220,160,160,0,0,0,540
98698,180,100,120,160,320,0,880
98699,200,120,80,0,0,0,400
98700,200,140,120,80,160,0,700
98701,180,120,120,80,160,320,980
98702,200,140,200,0,0,0,540
98703,180,100,80,160,160,0,680
98704,180,100,80,0,0,0,360
98705,240,120,120,160,320,320,1280
98706,200,160,80,80,0,0,520
98707,250,180,160,160,160,0,910
98708,220,120,120,80,160,0,700
98709,170,180,200,160,160,0,870
98710,190,120,120,160,320,0,910
98711,190,120,80,80,0,0,470
98712,180,80,40,0,0,0,300
98713,200,140,160,240,160,320,1220
98714,210,140,120,160,160,0,790
98715,190,100,80,160,0,0,530
98716,160,120,120,160,160,0,720
98717,200,120,80,80,0,0,480
98718,190,80,120,160,320,0,870
98719,220,120,120,80,0,0,540
98720,220,160,80,80,0,0,540
98721,200,120,200,0,0,0,520
98722,180,140,80,160,320,0,880
98723,220,120,120,80,160,0,700
98724,190,160,160,80,0,0,590
98725,190,60,40,80,0,0,370
98726,200,100,120,80,160,0,660
98727,230,160,120,80,0,0,590
98728,200,80,40,80,160,0,560
98729,200,100,120,240,160,0,820
98730,200,140,120,160,0,0,620
98731,180,60,80,160,160,0,640
98732,200,120,40,80,0,0,440
98733,160,80,0,0,0,0,240
98734,200,120,80,80,160,0,640
98735,210,100,80,80,160,320,950
98736,160,100,120,160,160,0,700
98737,230,180,200,80,160,0,850
98738,220,140,80,80,160,0,680
98739,180,40,40,80,160,0,500
98740,170,60,80,80,160,320,870
98741,260,180,160,240,160,0,1000
98742,170,100,80,160,320,320,1150
98743,170,120,120,160,160,0,730
98744,170,100,40,0,0,0,310
98745,220,140,80,80,0,0,520
98746,170,80,40,80,160,0,530
98747,150,60,80,80,0,0,370
98748,190,200,120,160,320,0,990
98749,180,120,120,160,320,0,900
98750,180,100,80,80,160,0,600
98751,230,140,160,160,160,0,850
98752,180,120,80,80,160,0,620
98753,230,160,120,240,0,0,750
98754,190,120,120,80,160,0,670
98755,200,80,80,0,0,0,360
98756,230,140,120,160,320,320,1290
98757,210,160,80,160,160,0,770
98758,160,140,160,240,160,0,860
98759,240,140,160,240,160,0,940
98760,190,140,120,160,160,320,1090
98761,220,180,120,0,0,0,520
98762,200,160,120,160,160,0,800
98763,220,180,120,160,160,0,840
98764,170,180,120,80,0,0,550
98765,180,100,80,80,160,0,600
98766,180,120,80,160,160,0,700
98767,160,100,120,160,160,0,700
98768,200,60,40,0,0,0,300
98769,180,120,40,0,0,0,340
98770,210,120,40,80,160,0,610
98771,230,160,120,80,0,0,590
98772,160,120,120,160,160,0,720
98773,210,140,120,160,160,0,790
98774,190,140,120,160,0,0,610
98775,210,120,120,80,160,0,690
98776,170,80,80,80,0,0,410
98777,220,200,40,0,0,0,460
98778,200,120,120,160,320,0,920
98779,240,160,160,160,160,0,880
98780,170,100,120,80,160,320,950
98781,160,120,160,80,0,0,520
98782,180,140,200,160,320,0,1000
98783,170,80,120,80,160,0,610
98784,160,120,160,160,320,0,920
98785,180,100,40,80,160,0,560
98786,170,80,80,0,0,0,330
98787,210,60,40,0,0,0,310
98788,210,140,120,80,160,0,710
98789,200,140,40,0,0,0,380
98790,180,100,120,160,160,0,720
98791,210,180,160,240,320,320,1430
98792,210,140,160,240,160,320,1230
98793,220,100,80,80,0,0,480
98794,170,80,80,80,160,0,570
98795,220,120,40,0,0,0,380
98796,190,100,40,0,0,0,330
98797,200,100,160,80,0,0,540
98798,210,140,80,80,160,320,990
98799,190,80,80,160,160,320,990
98800,250,120,120,80,160,0,730
98801,240,140,200,160,160,0,900
98802,180,120,40,0,0,0,340
98803,180,100,80,160,160,0,680
98804,190,140,80,0,0,0,410
98805,230,160,160,160,160,0,870
98806,180,120,120,160,0,0,580
98807,200,160,200,160,160,320,1200
98808,180,140,120,80,160,320,1000
98809,170,100,80,160,160,0,670
98810,190,140,160,160,160,0,810
98811,190,80,0,0,0,0,270
98812,180,180,120,80,160,0,720
98813,200,120,40,80,160,0,600
98814,150,80,80,160,160,320,950
98815,240,180,120,160,320,0,1020
98816,230,180,120,80,160,0,770
98817,200,100,40,80,160,0,580
98818,180,120,160,240,320,0,1020
98819,220,140,80,80,160,0,680
98820,200,100,40,0,0,0,340
98821,200,120,120,160,160,0,760
98822,230,140,160,80,160,0,770
98823,190,140,40,0,0,0,370
98824,210,60,40,80,0,0,390
98825,230,140,40,0,0,0,410
98826,170,120,80,0,0,0,370
98827,200,120,200,160,160,0,840
98828,170,140,120,80,160,0,670
98829,170,60,40,0,0,0,270
98830,210,140,120,80,160,320,1030
98831,220,80,40,80,0,0,420
98832,180,120,120,80,160,320,980
98833,200,160,120,160,160,0,800
98834,180,140,80,80,160,0,640
98835,170,100,40,0,0,0,310
98836,160,160,120,80,0,0,520
98837,190,140,0,0,0,0,330
98838,170,160,120,160,160,0,770
98839,200,80,0,0,0,0,280
98840,230,140,120,80,160,0,730
98841,190,140,160,240,320,0,1050
98842,210,140,40,80,160,0,630
98843,190,160,160,160,320,0,990
98844,240,120,80,0,0,0,440
98845,190,60,40,0,0,0,290
98846,190,100,80,160,160,0,690
98847,210,60,80,80,0,0,430
98848,200,100,80,160,0,0,540
98849,210,100,120,0,0,0,430
98850,200,140,120,80,0,0,540
98851,200,160,160,80,0,0,600
98852,200,120,80,80,160,0,640
98853,200,140,40,80,160,0,620
98854,210,140,80,0,0,0,430
98855,180,120,200,160,160,0,820
98856,170,100,160,80,160,0,670
98857,170,160,160,0,0,0,490
98858,180,120,160,80,0,0,540
98859,250,140,120,0,0,0,510
98860,190,120,120,80,0,0,510
98861,220,100,160,80,160,0,720
98862,160,160,80,0,0,0,400
98863,200,60,40,0,0,0,300
98864,210,120,160,0,0,0,490
98865,190,160,120,80,160,0,710
98866,200,120,80,0,0,0,400
98867,190,160,40,80,160,0,630
98868,230,140,40,80,160,320,970
98869,220,120,120,80,160,0,700
98870,230,180,200,240,160,320,1330
98871,190,140,160,160,320,320,1290
98872,170,80,120,80,0,0,450
98873,170,120,120,80,160,0,650
98874,190,100,80,160,160,0,690
98875,170,120,160,80,0,0,530
98876,140,40,80,80,0,0,340
98877,200,160,120,160,160,0,800
98878,220,160,120,160,320,0,980
98879,200,140,160,80,0,0,580
98880,150,120,80,80,160,0,590
98881,190,140,120,160,160,320,1090
98882,220,120,160,160,320,0,980
98883,170,120,200,160,320,320,1290
98884,220,100,40,0,0,0,360
98885,220,80,80,80,160,320,940
98886,210,120,80,80,160,0,650
98887,210,140,160,80,0,0,590
98888,210,140,80,160,160,0,750
98889,220,80,120,240,320,0,980
98890,220,140,200,160,160,0,880
98891,190,120,40,80,0,0,430
98892,200,140,80,80,160,0,660
98893,230,100,80,80,160,0,650
98894,150,80,120,80,0,0,430
98895,160,160,120,80,0,0,520
98896,190,120,80,80,160,0,630
98897,200,120,40,80,160,0,600
98898,210,140,160,160,0,0,670
98899,190,160,80,160,160,320,1070
98900,200,100,80,80,160,0,620
98901,200,140,120,0,0,0,460
98902,190,160,200,240,160,320,1270
98903,190,100,120,160,160,0,730
98904,190,120,120,160,160,0,750
98905,220,140,120,160,0,0,640
98906,210,160,200,160,0,0,730
98907,260,200,200,240,320,320,1540
98908,210,100,40,80,160,0,590
98909,150,80,80,80,0,0,390
98910,180,100,40,80,160,0,560
98911,190,80,80,80,0,0,430
98912,200,120,120,160,160,0,760
98913,180,100,80,160,160,0,680
98914,190,160,0,0,0,0,350
98915,230,100,80,80,160,0,650
98916,220,200,80,80,0,0,580
98917,150,140,160,160,320,0,930
98918,190,120,120,80,160,320,990
98919,220,100,40,80,0,0,440
98920,210,120,160,80,0,0,570
98921,200,120,80,80,0,0,480
98922,190,60,80,80,160,0,570
98923,190,80,40,0,0,0,310
98924,180,60,80,160,320,320,1120
98925,220,120,80,160,320,320,1220
98926,190,40,40,80,0,0,350
98927,230,160,160,160,160,320,1190
98928,210,160,160,80,0,0,610
98929,180,140,80,80,160,320,960
98930,190,120,80,80,160,0,630
98931,170,100,120,80,160,0,630
98932,160,140,80,80,0,0,460
98933,190,100,40,80,160,320,890
98934,190,120,80,80,160,0,630
98935,240,200,120,160,160,0,880
98936,220,180,120,80,0,0,600
98937,180,80,40,0,0,0,300
98938,230,140,80,0,0,0,450
98939,190,140,80,80,0,0,490
98940,210,80,80,80,160,0,610
98941,200,100,160,160,320,320,1260
98942,180,120,0,0,0,0,300
98943,220,160,120,160,160,0,820
98944,220,100,120,160,160,0,760
98945,230,180,160,80,0,0,650
98946,220,60,80,0,0,0,360
98947,240,120,40,0,0,0,400
98948,200,120,80,80,160,0,640
98949,170,100,120,160,160,0,710
98950,190,160,120,160,160,0,790
98951,220,160,80,0,0,0,460
98952,200,140,160,160,160,0,820
98953,190,100,120,160,320,0,890
98954,210,180,80,0,0,0,470
98955,160,120,160,80,160,0,680
98956,170,140,120,0,0,0,430
98957,200,160,120,80,160,0,720
98958,180,160,120,160,160,0,780
98959,170,120,80,80,160,0,610
98960,130,80,80,80,160,0,530
98961,180,80,40,0,0,0,300
98962,240,180,120,160,320,0,1020
98963,210,160,160,80,0,0,610
98964,160,60,40,0,0,0,260
98965,190,120,40,80,160,0,590
98966,200,80,80,160,160,0,680
98967,210,120,80,80,160,320,970
98968,190,120,40,0,0,0,350
98969,210,160,80,80,160,0,690
98970,190,100,120,160,160,0,730
98971,160,120,120,160,320,0,880
98972,210,160,160,0,0,0,530
98973,230,100,80,80,0,0,490
98974,190,200,120,80,160,320,1070
98975,150,120,80,0,0,0,350
98976,210,120,80,160,0,0,570
98977,180,120,120,240,320,0,980
98978,230,120,160,80,160,0,750
98979,210,100,160,80,160,0,710
98980,190,120,40,0,0,0,350
98981,220,100,120,80,160,0,680
98982,180,120,80,160,320,0,860
98983,200,200,160,160,320,320,1360
98984,220,80,120,160,160,0,740
98985,220,180,80,80,160,0,720
98986,190,80,120,160,320,0,870
98987,170,60,80,80,0,0,390
98988,200,80,80,80,160,0,600
98989,190,120,80,80,0,0,470
98990,250,120,160,160,0,0,690
98991,240,160,120,160,160,0,840
98992,200,160,120,80,160,0,720
98993,190,120,120,160,320,0,910
98994,220,120,80,160,0,0,580
98995,210,160,40,0,0,0,410
98996,180,60,40,0,0,0,280
98997,230,160,120,80,160,320,1070
98998,180,120,160,80,0,0,540
98999,210,100,80,0,0,0,390
99000,160,140,200,160,320,320,1300
99001,190,100,120,160,0,0,570
99002,220,180,120,80,160,0,760
99003,180,100,40,0,0,0,320
99004,160,100,160,0,0,0,420
99005,180,80,40,0,0,0,300
99006,210,180,80,80,0,0,550
99007,210,140,120,80,160,0,710
99008,230,140,40,80,160,0,650
99009,230,140,120,160,0,0,650
99010,190,140,80,160,160,320,1050
99011,180,140,120,0,0,0,440
99012,170,80,120,80,160,0,610
99013,200,120,120,160,160,0,760
99014,190,140,40,0,0,0,370
99015,200,40,40,80,160,0,520
99016,200,80,160,80,160,0,680
99017,190,140,80,0,0,0,410
99018,190,140,160,160,160,0,810
99019,150,80,40,0,0,0,270
99020,200,160,80,160,0,0,600
99021,230,140,160,80,160,0,770
99022,230,60,80,160,160,0,690
99023,210,120,80,0,0,0,410
99024,170,120,120,80,0,0,490
99025,210,140,120,80,160,0,710
99026,250,120,80,160,160,0,770
99027,180,80,120,160,160,0,700
99028,210,120,80,80,160,320,970
99029,190,120,40,80,0,0,430
99030,170,100,0,0,0,0,270
99031,180,100,120,160,160,0,720
99032,200,120,120,80,0,0,520
99033,210,160,120,160,160,0,810
99034,220,140,40,80,160,0,640
99035,200,160,80,80,0,0,520
99036,160,120,80,0,0,0,360
99037,210,140,120,80,160,0,710
99038,230,160,160,160,160,320,1190
99039,180,120,120,160,160,0,740
99040,140,100,120,160,160,0,680
99041,150,100,80,160,160,0,650
99042,170,140,120,160,0,0,590
99043,170,60,80,160,0,0,470
99044,170,120,80,160,320,320,1170
99045,260,200,120,0,0,0,580
99046,210,140,200,240,320,0,1110
99047,220,100,0,0,0,0,320
99048,220,80,80,0,0,0,380
99049,170,100,120,80,160,320,950
99050,210,160,200,240,160,0,970
99051,190,120,120,160,160,0,750
99052,170,140,0,0,0,0,310
99053,210,100,160,160,320,0,950
99054,220,100,80,160,320,0,880
99055,190,180,80,80,160,0,690
99056,190,120,120,160,160,0,750
99057,150,120,120,80,0,0,470
99058,210,80,80,80,160,0,610
99059,170,160,120,160,160,0,770
99060,180,100,120,80,160,0,640
99061,230,80,80,80,160,0,630
99062,200,120,200,160,160,0,840
99063,180,140,80,160,320,320,1200
99064,120,160,200,240,160,0,880
99065,160,140,80,80,160,0,620
99066,210,80,120,160,160,0,730
99067,210,120,40,80,160,0,610
99068,170,80,80,0,0,0,330
99069,190,120,120,80,0,0,510
99070,210,120,160,160,320,320,1290
99071,210,140,40,0,0,0,390
99072,160,120,120,80,160,0,640
99073,220,200,160,160,160,0,900
99074,180,60,40,0,0,0,280
99075,190,80,40,0,0,0,310
99076,170,160,120,80,0,0,530
99077,160,120,80,80,160,0,600
99078,220,120,120,160,160,0,780
99079,180,140,40,80,0,0,440
99080,220,120,40,80,160,0,620
99081,190,140,120,80,160,0,690
99082,210,80,160,80,0,0,530
99083,210,160,160,160,160,0,850
99084,220,180,120,80,160,320,1080
99085,200,80,80,0,0,0,360
99086,210,180,160,80,160,0,790
99087,200,160,120,80,160,0,720
99088,190,180,160,160,160,0,850
99089,170,100,80,0,0,0,350
99090,190,140,120,160,320,320,1250
99091,160,100,40,80,160,0,540
99092,190,140,120,80,0,0,530
99093,160,140,160,160,160,0,780
99094,210,120,40,80,0,0,450
99095,210,180,200,160,160,320,1230
99096,150,60,80,80,160,0,530
99097,220,80,120,160,320,320,1220
99098,190,120,120,160,320,0,910
99099,260,160,120,240,320,0,1100
99100,180,60,120,80,0,0,440
99101,220,80,120,160,160,0,740
99102,170,120,160,160,160,0,770
99103,200,140,120,160,160,320,1100
99104,190,140,80,160,0,0,570
99105,210,120,80,80,0,0,490
99106,180,140,200,80,0,0,600
99107,190,100,40,80,0,0,410
99108,230,140,200,160,160,0,890
99109,190,120,80,80,160,0,630
99110,180,160,160,80,160,0,740
99111,170,120,160,80,160,0,690
99112,230,120,40,0,0,0,390
99113,210,140,200,240,0,0,790
99114,240,140,120,80,160,0,740
99115,160,80,120,160,320,320,1160
99116,220,120,120,160,160,320,1100
99117,210,120,80,80,160,320,970
99118,170,120,120,160,0,0,570
99119,190,100,80,0,0,0,370
99120,210,140,80,160,160,0,750
99121,250,240,160,160,160,0,970
99122,200,160,160,160,320,320,1320
99123,180,140,160,240,160,0,880
99124,180,120,160,240,160,0,860
99125,210,180,200,160,160,0,910
99126,190,160,160,160,320,0,990
99127,210,160,120,80,160,0,730
99128,190,140,120,160,320,0,930
99129,180,140,80,80,160,0,640
99130,190,80,80,80,160,0,590
99131,190,100,160,160,160,320,1090
99132,190,140,40,80,160,0,610
99133,200,100,120,80,0,0,500
99134,210,100,120,160,0,0,590
99135,220,160,160,80,0,0,620
99136,160,100,120,160,160,0,700
99137,200,100,80,160,0,0,540
99138,260,120,120,160,0,0,660
99139,190,120,120,80,0,0,510
99140,200,180,160,160,160,0,860
99141,210,120,0,0,0,0,330
99142,250,100,120,160,160,0,790
99143,230,140,40,80,160,0,650
99144,170,60,80,80,0,0,390
99145,190,140,160,160,0,0,650
99146,190,120,80,80,160,0,630
99147,200,160,160,80,0,0,600
99148,180,120,80,80,160,0,620
99149,130,100,80,0,0,0,310
99150,170,160,120,240,0,0,690
99151,200,160,160,240,160,320,1240
99152,160,100,40,80,160,320,860
99153,200,160,40,0,0,0,400
99154,190,80,80,160,160,0,670
99155,230,180,80,80,0,0,570
99156,190,100,120,80,0,0,490
99157,160,140,160,80,0,0,540
99158,170,60,80,0,0,0,310
99159,200,120,80,80,160,0,640
99160,160,140,120,240,320,0,980
99161,170,120,120,80,160,0,650
99162,220,160,80,80,160,0,700
99163,190,120,120,80,160,0,670
99164,210,160,120,160,160,0,810
99165,200,180,240,160,320,0,1100
99166,150,80,120,80,160,320,910
99167,220,160,160,240,320,320,1420
99168,170,120,120,240,320,0,970
99169,190,120,80,80,0,0,470
99170,220,100,120,80,160,320,1000
99171,200,120,160,80,160,0,720
99172,230,100,80,80,0,0,490
99173,200,120,40,80,160,0,600
99174,170,120,80,80,160,0,610
99175,210,160,120,80,0,0,570
99176,150,140,80,160,320,320,1170
99177,200,160,120,240,160,0,880
99178,210,80,0,0,0,0,290
99179,210,100,120,80,160,320,990
99180,160,160,200,160,160,0,840
99181,200,100,80,0,0,0,380
99182,180,140,160,80,0,0,560
99183,180,140,160,160,160,320,1120
99184,230,120,120,0,0,0,470
99185,160,100,80,80,160,0,580
99186,200,140,120,80,0,0,540
99187,210,100,80,0,0,0,390
99188,220,120,120,0,0,0,460
99189,220,140,80,160,160,0,760
99190,210,140,200,160,160,0,870
99191,190,120,80,80,160,320,950
99192,220,100,120,80,0,0,520
99193,170,140,120,80,160,0,670
99194,210,180,160,80,160,0,790
99195,200,160,160,80,160,0,760
99196,200,160,160,160,160,0,840
99197,160,80,40,80,0,0,360
99198,180,160,160,160,160,0,820
99199,230,120,200,160,0,0,710
99200,200,100,80,80,160,0,620
99201,240,120,40,80,0,0,480
99202,210,100,160,240,160,0,870
99203,190,140,80,80,160,320,970
99204,180,100,80,160,160,0,680
99205,190,120,120,80,0,0,510
99206,220,140,80,80,160,0,680
99207,220,220,120,160,160,0,880
99208,190,160,80,160,160,0,750
99209,200,80,120,160,160,0,720
99210,160,180,120,0,0,0,460
99211,190,140,120,0,0,0,450
99212,220,100,80,0,0,0,400
99213,150,100,80,80,160,0,570
99214,210,180,120,80,160,0,750
99215,200,100,160,160,0,0,620
99216,210,60,0,0,0,0,270
99217,200,100,120,160,0,0,580
99218,200,140,120,80,0,0,540
99219,190,120,160,80,0,0,550
99220,220,100,40,0,0,0,360
99221,190,60,40,80,160,0,530
99222,190,100,120,0,0,0,410
99223,140,100,120,240,320,0,920
99224,200,120,80,0,0,0,400
99225,130,100,160,240,160,0,790
99226,180,100,80,80,0,0,440
99227,190,120,120,160,0,0,590
99228,220,160,120,0,0,0,500
99229,210,120,160,160,160,0,810
99230,210,140,40,80,0,0,470
99231,200,120,80,0,0,0,400
99232,200,120,160,160,160,0,800
99233,240,160,80,80,0,0,560
99234,240,160,200,0,0,0,600
99235,180,140,160,160,320,320,1280
99236,170,140,200,80,160,0,750
99237,200,180,200,240,160,0,980
99238,190,80,40,80,160,0,550
99239,180,120,160,0,0,0,460
99240,170,60,80,80,160,0,550
99241,170,120,80,0,0,0,370
99242,180,40,40,80,0,0,340
99243,200,140,120,0,0,0,460
99244,200,140,160,240,320,0,1060
99245,210,120,120,160,0,0,610
99246,190,60,80,80,160,0,570
99247,210,120,40,80,160,0,610
99248,210,140,120,80,160,0,710
99249,220,140,120,80,0,0,560
99250,220,140,80,80,0,0,520
99251,170,60,40,80,160,0,510
99252,180,120,120,80,160,320,980
99253,200,100,80,0,0,0,380
99254,190,160,80,0,0,0,430
99255,200,160,200,240,320,320,1440
99256,190,120,80,80,0,0,470
99257,200,80,120,160,160,0,720
99258,200,80,40,80,160,0,560
99259,180,140,200,160,160,320,1160
99260,160,120,80,160,320,0,840
99261,210,100,40,80,160,0,590
99262,200,140,120,80,160,320,1020
99263,180,120,160,160,320,320,1260
99264,180,80,80,160,160,0,660
99265,190,60,80,160,320,0,810
99266,200,140,120,0,0,0,460
99267,200,120,80,160,160,0,720
99268,200,80,80,80,160,0,600
99269,220,120,80,80,160,320,980
99270,180,80,80,80,160,0,580
99271,210,120,80,80,0,0,490
99272,210,100,120,160,320,0,910
99273,230,140,160,0,0,0,530
99274,220,140,80,80,160,0,680
99275,160,100,80,0,0,0,340
99276,200,120,80,160,160,0,720
99277,170,160,160,160,160,0,810
99278,200,140,160,80,0,0,580
99279,210,140,120,0,0,0,470
99280,220,200,200,160,320,0,1100
99281,240,100,80,160,160,320,1060
99282,200,60,80,80,160,0,580
99283,190,100,160,160,160,0,770
99284,160,80,80,80,0,0,400
99285,200,180,160,160,0,0,700
99286,170,120,120,160,160,0,730
99287,170,120,120,160,320,0,890
99288,220,160,200,160,160,0,900
99289,210,60,0,0,0,0,270
99290,220,60,40,80,160,0,560
99291,220,100,80,160,0,0,560
99292,200,140,160,160,160,320,1140
99293,230,120,40,0,0,0,390
99294,220,160,80,80,160,0,700
99295,200,120,160,160,320,0,960
99296,240,160,160,240,160,0,960
99297,230,120,120,160,160,0,790
99298,200,120,160,80,0,0,560
99299,180,100,80,80,160,0,600
99300,170,60,0,0,0,0,230
99301,210,180,160,160,160,0,870
99302,200,140,80,0,0,0,420
99303,160,140,40,0,0,0,340
99304,180,120,160,240,160,0,860
99305,210,80,80,160,160,320,1010
99306,230,120,80,0,0,0,430
99307,210,140,200,240,320,0,1110
99308,220,120,160,80,0,0,580
99309,180,80,80,160,320,320,1140
99310,200,140,160,240,320,0,1060
99311,190,160,160,0,0,0,510
99312,220,140,120,80,0,0,560
99313,210,100,80,80,0,0,470
99314,220,140,120,160,320,320,1280
99315,150,80,80,0,0,0,310
99316,210,80,120,160,0,0,570
99317,180,120,80,0,0,0,380
99318,190,120,160,0,0,0,470
99319,210,80,160,80,160,0,690
99320,170,120,120,80,160,0,650
99321,190,140,80,80,160,0,650
99322,210,100,120,240,320,0,990
99323,140,80,80,80,160,0,540
99324,140,120,160,160,160,0,740
99325,170,80,40,80,160,0,530
99326,240,140,160,160,0,0,700
99327,180,160,120,240,320,0,1020
99328,180,120,160,80,160,320,1020
99329,180,160,120,0,0,0,460
99330,200,120,0,0,0,0,320
99331,180,120,120,160,0,0,580
99332,190,120,80,80,160,0,630
99333,150,120,120,160,160,0,710
99334,220,160,80,0,0,0,460
99335,220,140,80,80,160,0,680
99336,190,100,160,80,160,0,690
99337,190,100,80,160,160,0,690
99338,220,140,80,160,160,0,760
99339,150,140,120,160,160,0,730
99340,170,100,80,160,160,0,670
99341,170,100,120,160,0,0,550
99342,210,160,200,160,160,320,1210
99343,190,100,40,0,0,0,330
99344,230,120,40,0,0,0,390
99345,170,160,240,160,0,0,730
99346,170,120,120,160,160,0,730
99347,220,180,120,160,160,0,840
99348,170,40,80,80,160,0,530
99349,220,100,80,0,0,0,400
99350,200,140,80,160,0,0,580
99351,190,120,80,160,320,320,1190
99352,220,160,160,160,0,0,700
99353,180,80,80,0,0,0,340
99354,210,100,160,240,160,0,870
99355,210,180,40,80,160,0,670
99356,190,160,160,160,160,0,830
99357,230,100,120,160,160,0,770
99358,230,120,120,160,160,0,790
99359,140,60,80,80,160,320,840
99360,220,140,120,80,0,0,560
99361,170,140,120,80,0,0,510
99362,190,120,120,80,0,0,510
99363,230,180,120,80,160,0,770
99364,190,60,120,160,320,0,850
99365,130,100,80,160,160,0,630
99366,180,160,120,0,0,0,460
99367,230,140,120,160,160,0,810
99368,220,60,40,0,0,0,320
99369,160,100,120,160,320,0,860
99370,190,140,200,240,320,0,1090
99371,220,180,160,160,0,0,720
99372,200,120,120,240,320,0,1000
99373,200,140,80,0,0,0,420
99374,200,120,80,80,160,0,640
99375,200,140,200,160,160,0,860
99376,200,120,120,160,320,320,1240
99377,130,160,120,80,160,320,970
99378,190,120,40,0,0,0,350
99379,180,120,40,0,0,0,340
99380,230,80,80,160,320,320,1190
99381,190,140,40,80,160,0,610
99382,280,140,160,80,160,0,820
99383,230,100,40,80,160,0,610
99384,200,180,120,80,0,0,580
99385,180,120,120,160,160,320,1060
99386,150,160,120,160,160,0,750
99387,220,100,120,160,0,0,600
99388,200,140,120,80,0,0,540
99389,230,100,80,160,320,320,1210
99390,180,80,40,0,0,0,300
99391,240,140,120,80,0,0,580
99392,210,160,120,160,160,0,810
99393,180,120,200,80,0,0,580
99394,210,180,120,160,320,0,990
99395,170,120,160,160,0,0,610
99396,180,120,40,80,0,0,420
99397,210,100,160,80,160,0,710
99398,170,60,120,160,160,0,670
99399,180,100,0,0,0,0,280
99400,170,80,120,160,160,0,690
99401,190,140,160,240,320,0,1050
99402,160,100,80,80,0,0,420
99403,220,80,120,160,160,0,740
99404,190,100,40,0,0,0,330
99405,200,100,80,0,0,0,380
99406,200,120,80,80,0,0,480
99407,170,80,120,240,320,320,1250
99408,190,120,200,80,0,0,590
99409,210,140,160,80,0,0,590
99410,190,160,120,240,320,320,1350
99411,160,120,160,240,160,0,840
99412,210,100,80,80,160,0,630
99413,200,100,0,0,0,0,300
99414,200,140,160,240,160,0,900
99415,190,140,120,0,0,0,450
99416,240,140,120,240,160,0,900
99417,220,160,200,80,0,0,660
99418,180,120,120,80,0,0,500
99419,210,100,160,160,0,0,630
99420,160,140,120,160,320,0,900
99421,200,120,120,0,0,0,440
99422,210,120,80,80,0,0,490
99423,180,160,160,160,320,0,980
99424,190,140,160,240,160,0,890
99425,200,120,80,80,160,320,960
99426,220,140,80,160,320,0,920
99427,200,160,160,80,0,0,600
99428,210,140,240,160,160,0,910
99429,210,120,160,80,0,0,570
99430,200,140,120,160,0,0,620
99431,220,140,80,80,160,0,680
99432,240,120,120,160,320,320,1280
99433,210,160,40,80,0,0,490
99434,200,160,80,80,0,0,520
99435,190,100,80,80,0,0,450
99436,170,80,40,0,0,0,290
99437,160,120,160,160,320,0,920
99438,170,100,80,80,0,0,430
99439,160,100,80,160,160,0,660
99440,200,160,160,80,0,0,600
99441,220,160,160,80,160,0,780
99442,160,60,40,0,0,0,260
99443,180,140,120,0,0,0,440
99444,200,160,160,80,160,320,1080
99445,220,100,120,160,160,320,1080
99446,210,200,120,80,0,0,610
99447,180,140,160,240,320,0,1040
99448,180,100,120,160,160,320,1040
99449,140,100,120,0,0,0,360
99450,210,160,160,0,0,0,530
99451,210,100,120,160,160,320,1070
99452,210,120,80,0,0,0,410
99453,190,120,40,0,0,0,350
99454,190,120,120,160,160,0,750
99455,170,100,80,0,0,0,350
99456,190,160,160,80,0,0,590
99457,230,60,80,160,320,320,1170
99458,200,60,80,0,0,0,340
99459,240,120,120,80,160,320,1040
99460,200,100,0,0,0,0,300
99461,210,120,160,320,320,0,1130
99462,210,160,40,0,0,0,410
99463,200,120,80,160,320,320,1200
99464,210,140,80,160,0,0,590
99465,220,140,120,80,0,0,560
99466,170,80,80,80,160,0,570
99467,200,160,120,240,320,0,1040
99468,160,140,120,80,160,320,980
99469,170,140,120,80,0,0,510
99470,200,140,200,160,0,0,700
99471,190,80,80,80,160,0,590
99472,200,100,40,0,0,0,340
99473,230,100,40,80,160,0,610
99474,210,160,80,80,160,0,690
99475,180,140,80,80,0,0,480
99476,180,100,120,160,320,0,880
99477,230,160,80,160,320,0,950
99478,190,100,80,160,0,0,530
99479,170,80,120,160,320,0,850
99480,130,80,120,160,160,0,650
99481,200,140,120,160,320,0,940
99482,170,80,80,80,0,0,410
99483,270,140,120,160,160,0,850
99484,190,120,40,80,0,0,430
99485,180,40,40,0,0,0,260
99486,210,120,160,80,160,0,730
99487,170,140,120,160,160,0,750
99488,200,120,120,160,160,0,760
99489,200,160,160,160,320,0,1000
99490,170,120,120,160,0,0,570
99491,220,100,120,160,160,0,760
99492,200,140,200,160,160,0,860
99493,160,140,120,80,0,0,500
99494,160,160,120,0,0,0,440
99495,150,100,120,0,0,0,370
99496,210,180,120,80,160,0,750
99497,150,100,40,0,0,0,290
99498,220,160,120,80,0,0,580
99499,210,100,40,80,0,0,430
99500,200,140,160,80,160,0,740
99501,180,60,80,0,0,0,320
99502,220,120,120,80,0,0,540
99503,230,140,160,160,320,0,1010
99504,220,80,120,160,160,320,1060
99505,200,140,80,160,0,0,580
99506,230,120,80,0,0,0,430
99507,160,40,80,80,160,0,520
99508,180,80,40,80,160,0,540
99509,220,160,200,240,0,0,820
99510,250,120,80,160,160,0,770
99511,230,200,160,80,0,0,670
99512,200,100,80,0,0,0,380
99513,210,120,80,80,160,0,650
99514,150,140,160,80,0,0,530
99515,240,140,200,240,0,0,820
99516,220,120,160,80,0,0,580
99517,220,180,200,240,160,0,1000
99518,180,160,120,160,160,320,1100
99519,210,140,160,80,160,0,750
99520,190,160,160,80,160,320,1070
99521,210,120,40,0,0,0,370
99522,150,120,80,80,160,0,590
99523,160,180,120,160,320,0,940
99524,160,120,40,80,0,0,400
99525,220,100,0,0,0,0,320
99526,200,80,40,0,0,0,320
99527,200,100,120,80,0,0,500
99528,240,160,120,160,160,0,840
99529,210,100,120,0,0,0,430
99530,170,120,120,80,160,320,970
99531,200,140,120,160,160,0,780
99532,180,60,40,0,0,0,280
99533,180,140,40,80,160,0,600
99534,190,120,120,80,160,0,670
99535,190,120,120,80,160,0,670
99536,220,160,120,80,160,320,1060
99537,200,80,120,80,0,0,480
99538,230,140,120,0,0,0,490
99539,190,180,200,240,160,0,970
99540,210,100,120,160,320,0,910
99541,160,120,120,0,0,0,400
99542,220,100,120,160,0,0,600
99543,220,100,160,160,160,0,800
99544,220,100,120,80,0,0,520
99545,190,100,120,160,320,0,890
99546,200,120,80,80,160,0,640
99547,240,140,200,240,320,0,1140
99548,180,160,40,0,0,0,380
99549,180,120,80,0,0,0,380
99550,210,120,80,80,0,0,490
99551,190,100,120,80,160,0,650
99552,170,120,120,80,0,0,490
99553,170,80,80,160,0,0,490
99554,200,80,120,240,160,0,800
99555,200,140,120,80,0,0,540
99556,160,100,80,80,160,0,580
99557,190,120,200,80,160,0,750
99558,200,140,160,160,320,0,980
99559,210,100,80,160,160,0,710
99560,180,100,80,80,160,320,920
99561,190,100,80,80,0,0,450
99562,200,120,120,160,160,0,760
99563,220,180,120,80,160,0,760
99564,160,100,0,0,0,0,260
99565,230,120,120,0,0,0,470
99566,160,120,80,0,0,0,360
99567,190,100,80,0,0,0,370
99568,220,120,120,80,160,0,700
99569,160,120,80,0,0,0,360
99570,210,160,200,160,160,320,1210
99571,190,180,120,80,0,0,570
99572,170,100,80,160,160,0,670
99573,190,80,40,80,160,0,550
99574,180,140,80,160,320,0,880
99575,190,160,160,160,160,0,830
99576,190,140,160,160,320,320,1290
99577,170,100,80,80,0,0,430
99578,200,80,80,80,160,0,600
99579,200,160,80,0,0,0,440
99580,210,200,120,240,160,0,930
99581,180,80,120,160,0,0,540
99582,160,100,120,80,160,0,620
99583,180,120,40,80,0,0,420
99584,210,140,80,160,160,320,1070
99585,200,140,80,80,160,0,660
99586,210,160,80,160,0,0,610
99587,250,80,80,0,0,0,410
99588,190,160,120,160,0,0,630
99589,180,100,80,80,160,0,600
99590,220,180,160,160,320,0,1040
99591,170,100,120,160,320,0,870
99592,190,140,40,80,0,0,450
99593,180,120,40,0,0,0,340
99594,210,120,80,160,0,0,570
99595,170,120,160,80,160,0,690
99596,170,120,80,0,0,0,370
99597,220,140,160,160,160,0,840
99598,230,80,160,80,160,0,710
99599,160,100,80,80,160,0,580
99600,190,120,120,0,0,0,430
99601,180,100,120,80,160,320,960
99602,190,140,160,160,160,0,810
99603,170,100,200,160,160,0,790
99604,250,140,80,80,160,0,710
99605,220,100,80,0,0,0,400
99606,210,140,80,160,0,0,590
99607,190,100,40,80,0,0,410
99608,160,140,80,160,320,320,1180
99609,190,140,160,80,0,0,570
99610,170,40,0,0,0,0,210
99611,190,100,120,80,160,0,650
99612,160,120,120,160,320,0,880
99613,170,180,160,80,0,0,590
99614,200,140,120,240,160,0,860
99615,190,100,40,0,0,0,330
99616,200,160,120,160,160,320,1120
99617,220,160,160,160,160,0,860
99618,170,120,120,0,0,0,410
99619,200,160,80,80,0,0,520
99620,230,140,40,80,0,0,490
99621,220,120,120,80,0,0,540
99622,160,100,80,80,160,320,900
99623,180,180,160,240,160,0,920
99624,170,80,80,80,160,320,890
99625,210,180,120,80,160,0,750
99626,240,140,80,80,0,0,540
99627,220,120,80,0,0,0,420
99628,210,160,120,80,0,0,570
99629,220,160,40,80,160,0,660
99630,230,160,120,160,0,0,670
99631,190,100,80,80,0,0,450
99632,150,60,40,80,160,0,490
99633,180,100,80,0,0,0,360
99634,200,80,40,80,0,0,400
99635,180,100,40,80,160,0,560
99636,190,140,80,80,160,0,650
99637,160,80,120,160,320,320,1160
99638,180,100,120,0,0,0,400
99639,190,140,80,80,0,0,490
99640,220,120,120,80,160,0,700
99641,200,180,80,80,0,0,540
99642,220,80,80,160,320,0,860
99643,200,140,160,160,0,0,660
99644,200,180,80,160,160,0,780
99645,190,120,80,80,160,0,630
99646,170,80,80,80,0,0,410
99647,180,160,160,160,320,0,980
99648,220,180,160,240,320,320,1440
99649,210,140,160,160,160,0,830
99650,200,160,80,80,160,0,680
99651,200,100,40,80,160,0,580
99652,190,100,80,80,160,0,610
99653,160,100,120,160,0,0,540
99654,170,120,80,160,160,320,1010
99655,220,100,120,0,0,0,440
99656,240,160,160,240,320,0,1120
99657,230,140,120,80,160,0,730
99658,180,100,120,160,0,0,560
99659,160,140,80,0,0,0,380
99660,210,180,160,160,160,0,870
99661,180,80,120,160,320,0,860
99662,240,140,120,80,0,0,580
99663,170,80,120,160,320,0,850
99664,210,220,160,160,160,0,910
99665,200,160,80,0,0,0,440
99666,200,160,160,160,0,0,680
99667,160,80,160,240,320,320,1280
99668,180,120,40,0,0,0,340
99669,230,140,80,160,160,0,770
99670,180,180,160,80,0,0,600
99671,230,180,120,0,0,0,530
99672,220,140,120,0,0,0,480
99673,160,80,80,80,160,0,560
99674,230,160,80,80,160,0,710
99675,230,140,40,80,160,0,650
99676,210,120,120,80,160,0,690
99677,200,140,120,80,160,0,700
99678,200,120,160,160,320,0,960
99679,220,140,160,80,0,0,600
99680,210,100,120,160,160,0,750
99681,150,80,120,160,160,0,670
99682,210,120,200,80,160,0,770
99683,190,100,80,160,160,0,690
99684,190,140,40,0,0,0,370
99685,220,120,120,240,320,0,1020
99686,210,180,160,80,0,0,630
99687,200,80,120,160,0,0,560
99688,200,200,160,160,0,0,720
99689,220,160,200,160,0,0,740
99690,180,140,80,160,160,0,720
99691,180,80,40,80,160,0,540
99692,240,120,120,160,320,0,960
99693,130,100,120,160,320,320,1150
99694,240,180,160,80,160,0,820
99695,200,120,80,160,0,0,560
99696,190,80,80,80,160,0,590
99697,220,60,40,0,0,0,320
99698,190,60,40,80,160,0,530
99699,190,140,120,160,320,320,1250
99700,200,120,80,80,160,0,640
99701,180,160,120,240,0,0,700
99702,190,120,120,80,0,0,510
99703,220,160,80,80,160,320,1020
99704,200,140,80,160,160,320,1060
99705,170,60,40,0,0,0,270
99706,190,120,160,80,160,0,710
99707,220,120,160,160,320,320,1300
99708,170,100,80,0,0,0,350
99709,190,120,80,160,320,0,870
99710,230,120,120,160,0,0,630
99711,220,140,120,240,160,0,880
99712,190,160,200,240,320,0,1110
99713,180,140,80,80,160,0,640
99714,190,140,160,160,0,0,650
99715,240,160,120,0,0,0,520
99716,190,140,120,80,160,0,690
99717,220,100,120,80,160,0,680
99718,210,140,160,80,160,320,1070
99719,170,20,40,0,0,0,230
99720,210,140,40,80,0,0,470
99721,210,100,160,240,160,0,870
99722,230,120,80,0,0,0,430
99723,200,140,120,80,160,0,700
99724,220,100,80,80,160,0,640
99725,200,140,80,160,320,320,1220
99726,190,100,120,160,320,0,890
99727,220,180,120,80,160,0,760
99728,210,160,120,80,160,0,730
99729,190,120,160,160,160,320,1110
99730,220,80,80,80,160,320,940
99731,210,140,40,80,0,0,470
99732,210,120,120,80,160,0,690
99733,210,140,120,80,160,0,710
99734,200,100,40,0,0,0,340
99735,220,160,120,80,0,0,580
99736,170,120,200,240,320,320,1370
99737,180,140,120,160,160,0,760
99738,170,140,120,80,0,0,510
99739,180,140,160,160,160,0,800
99740,200,180,200,80,160,0,820
99741,170,80,80,80,160,0,570
99742,230,100,120,80,160,0,690
99743,220,100,120,80,160,0,680
99744,240,160,120,80,160,0,760
99745,230,100,120,80,160,0,690
99746,220,120,40,80,0,0,460
99747,240,120,80,80,0,0,520
99748,170,140,160,80,0,0,550
99749,210,140,120,160,320,0,950
99750,220,120,80,80,160,320,980
99751,170,120,120,160,160,320,1050
99752,210,80,80,80,160,0,610
99753,170,100,80,0,0,0,350
99754,200,160,120,160,160,0,800
99755,190,80,40,0,0,0,310
99756,250,100,160,160,160,0,830
99757,190,120,160,240,320,0,1030
99758,190,160,80,80,0,0,510
99759,230,140,120,80,160,0,730
99760,230,100,40,0,0,0,370
99761,170,60,40,80,160,0,510
99762,140,120,80,0,0,0,340
99763,180,120,120,160,160,0,740
99764,190,100,80,160,320,0,850
99765,180,100,120,80,160,0,640
99766,190,80,80,0,0,0,350
99767,210,120,120,0,0,0,450
99768,150,120,160,240,0,0,670
99769,200,140,80,80,160,0,660
99770,200,140,120,80,0,0,540
99771,220,80,40,0,0,0,340
99772,230,140,160,0,0,0,530
99773,190,120,80,80,0,0,470
99774,230,160,160,80,160,0,790
99775,190,120,120,0,0,0,430
99776,180,80,80,80,0,0,420
99777,220,140,40,80,160,0,640
99778,180,100,80,80,0,0,440
99779,200,140,120,160,160,320,1100
99780,220,140,80,0,0,0,440
99781,210,80,40,0,0,0,330
99782,180,100,40,80,160,320,880
99783,220,120,40,80,0,0,460
99784,180,40,40,80,0,0,340
99785,260,180,160,80,160,0,840
99786,200,140,120,160,320,0,940
99787,190,80,40,80,160,0,550
99788,220,160,120,0,0,0,500
99789,240,120,120,0,0,0,480
99790,220,160,200,160,160,0,900
99791,170,100,80,80,160,0,590
99792,220,160,160,160,320,0,1020
99793,180,180,200,80,160,0,800
99794,180,140,160,160,0,0,640
99795,170,100,160,80,160,0,670
99796,210,160,160,80,0,0,610
99797,200,120,160,160,160,320,1120
99798,170,100,80,80,160,0,590
99799,160,120,80,80,0,0,440
99800,170,120,80,80,160,0,610
99801,150,100,200,240,0,0,690
99802,220,140,160,80,160,0,760
99803,170,80,80,160,0,0,490
99804,170,80,80,80,160,0,570
99805,170,60,40,0,0,0,270
99806,200,40,40,80,160,0,520
99807,220,180,240,240,320,0,1200
99808,190,100,40,80,160,0,570
99809,160,80,40,80,160,0,520
99810,150,80,80,80,160,0,550
99811,200,120,120,80,160,0,680
99812,210,180,80,80,160,0,710
99813,170,80,120,80,160,0,610
99814,230,120,80,80,160,0,670
99815,230,140,80,0,0,0,450
99816,170,160,80,80,0,0,490
99817,170,100,120,160,320,0,870
99818,170,120,160,160,160,0,770
99819,180,140,120,160,320,0,920
99820,200,120,120,160,160,0,760
99821,210,160,40,0,0,0,410
99822,170,80,40,80,0,0,370
99823,210,140,80,0,0,0,430
99824,190,180,120,0,0,0,490
99825,220,140,160,80,160,0,760
99826,190,160,80,160,0,0,590
99827,220,140,120,80,160,0,720
99828,180,100,160,160,320,320,1240
99829,240,140,120,160,0,0,660
99830,240,140,120,80,0,0,580
99831,170,100,120,160,160,0,710
99832,170,100,160,80,160,0,670
99833,210,120,80,0,0,0,410
99834,240,120,40,80,0,0,480
99835,220,100,80,160,320,320,1200
99836,230,160,80,80,160,0,710
99837,180,140,80,160,160,0,720
99838,220,100,120,160,320,0,920
99839,180,120,160,80,0,0,540
99840,190,100,0,0,0,0,290
99841,150,140,80,80,160,0,610
99842,230,160,120,80,0,0,590
99843,230,200,80,80,160,0,750
99844,220,120,80,0,0,0,420
99845,160,120,80,80,0,0,440
99846,180,80,80,80,0,0,420
99847,240,120,40,0,0,0,400
99848,170,140,120,160,160,0,750
99849,150,160,80,80,160,0,630
99850,180,180,200,80,0,0,640
99851,200,160,80,80,0,0,520
99852,240,200,160,80,160,0,840
99853,220,140,160,80,160,0,760
99854,200,100,120,80,0,0,500
99855,230,120,160,0,0,0,510
99856,210,160,200,240,160,0,970
99857,180,80,80,80,160,0,580
99858,190,80,120,0,0,0,390
99859,210,120,40,0,0,0,370
99860,200,120,200,160,0,0,680
99861,270,140,120,0,0,0,530
99862,190,140,120,80,160,0,690
99863,230,140,200,160,160,0,890
99864,200,100,80,80,160,320,940
99865,210,140,160,240,320,0,1070
99866,190,100,40,0,0,0,330
99867,200,160,80,80,160,320,1000
99868,170,140,120,160,160,0,750
99869,210,100,120,160,160,0,750
99870,200,160,80,80,160,0,680
99871,180,140,120,80,0,0,520
99872,220,100,80,80,160,0,640
99873,160,40,40,80,0,0,320
99874,180,100,40,0,0,0,320
99875,220,60,80,160,160,0,680
99876,220,140,120,80,160,0,720
99877,190,140,80,0,0,0,410
99878,180,80,80,160,0,0,500
99879,200,120,160,160,0,0,640
99880,170,80,120,240,0,0,610
99881,180,140,160,80,160,0,720
99882,190,140,160,240,320,0,1050
99883,230,100,40,80,160,320,930
99884,170,120,80,80,160,0,610
99885,190,120,40,0,0,0,350
99886,130,80,40,80,0,0,330
99887,220,140,120,0,0,0,480
99888,160,80,80,80,160,0,560
99889,180,140,120,160,320,0,920
99890,180,120,80,0,0,0,380
99891,190,100,40,0,0,0,330
99892,170,100,120,160,160,320,1030
99893,220,120,80,0,0,0,420
99894,220,120,40,0,0,0,380
99895,200,160,80,0,0,0,440
99896,170,80,80,80,0,0,410
99897,180,160,120,160,160,0,780
99898,180,120,80,160,320,0,860
99899,190,100,120,80,160,0,650
99900,220,160,120,160,160,0,820
99901,220,120,120,0,0,0,460
99902,210,160,200,160,320,0,1050
99903,190,120,160,240,320,0,1030
99904,230,100,80,160,320,0,890
99905,230,60,0,0,0,0,290
99906,200,120,40,80,0,0,440
99907,200,100,120,80,160,320,980
99908,190,80,120,160,160,0,710
99909,200,220,160,80,160,0,820
99910,230,140,40,80,160,0,650
99911,200,140,40,0,0,0,380
99912,190,100,120,0,0,0,410
99913,150,120,200,80,160,0,710
99914,200,160,160,160,0,0,680
99915,230,100,80,0,0,0,410
99916,200,120,120,160,160,320,1080
99917,160,120,120,160,320,320,1200
99918,220,160,40,0,0,0,420
99919,200,120,160,240,160,0,880
99920,220,120,80,80,160,0,660
99921,170,80,80,80,160,0,570
99922,210,160,160,160,160,0,850
99923,200,180,80,0,0,0,460
99924,210,80,40,80,0,0,410
99925,170,140,120,80,160,0,670
99926,220,140,120,80,160,0,720
99927,220,160,80,80,160,0,700
99928,160,80,80,80,160,0,560
99929,180,120,120,80,160,0,660
99930,190,160,160,160,160,0,830
99931,210,40,40,0,0,0,290
99932,170,120,120,80,160,0,650
99933,220,140,80,80,0,0,520
99934,230,100,160,240,160,0,890
99935,200,180,120,80,0,0,580
99936,210,100,80,80,160,0,630
99937,150,100,80,80,0,0,410
99938,200,120,120,160,160,320,1080
99939,210,120,80,160,160,0,730
99940,210,120,80,80,160,0,650
99941,170,160,160,240,320,0,1050
99942,180,120,80,0,0,0,380
99943,210,120,40,0,0,0,370
99944,180,100,80,160,0,0,520
99945,200,180,240,240,160,0,1020
99946,210,180,120,160,320,320,1310
99947,170,120,160,240,160,0,850
99948,180,100,120,160,320,0,880
99949,240,140,120,80,160,0,740
99950,200,140,160,240,0,0,740
99951,210,100,80,80,160,0,630
99952,190,80,40,80,0,0,390
99953,230,80,40,0,0,0,350
99954,200,100,120,80,160,0,660
99955,210,180,80,80,160,0,710
99956,190,120,80,160,0,0,550
99957,190,160,120,160,160,0,790
99958,200,120,80,160,0,0,560
99959,220,140,160,160,0,0,680
99960,190,140,160,160,160,0,810
99961,230,140,120,160,320,0,970
99962,210,80,120,160,160,0,730
99963,160,120,80,160,160,0,680
99964,210,100,80,80,160,0,630
99965,180,160,120,240,320,0,1020
99966,190,160,120,160,0,0,630
99967,190,120,200,160,160,0,830
99968,190,140,120,160,0,0,610
99969,160,60,80,80,160,320,860
99970,180,120,80,80,0,0,460
99971,180,80,80,80,160,0,580
99972,160,100,40,0,0,0,300
99973,200,120,120,160,0,0,600
99974,210,140,200,240,0,0,790
99975,160,120,80,0,0,0,360
99976,210,180,160,160,0,0,710
99977,190,120,80,160,160,0,710
99978,170,120,120,80,160,320,970
99979,190,100,120,160,320,0,890
99980,200,100,80,80,160,0,620
99981,200,120,120,80,160,320,1000
99982,190,80,80,0,0,0,350
99983,160,120,120,80,160,320,960
99984,170,140,0,0,0,0,310
99985,170,100,200,240,160,0,870
99986,210,180,240,80,160,0,870
99987,230,140,40,80,160,0,650
99988,210,100,80,0,0,0,390
99989,170,60,0,0,0,0,230
99990,220,160,160,80,0,0,620
99991,200,120,80,160,160,0,720
99992,220,120,120,160,160,0,780
99993,200,120,120,80,160,0,680
99994,150,120,0,0,0,0,270
99995,190,80,80,80,0,0,430
99996,210,180,160,160,0,0,710
99997,170,120,160,160,320,0,930
99998,180,140,160,240,0,0,720
99999,230,120,160,240,320,0,1070
